id,year,land,building,total,method
06079711205070000,2021,177007,834650,1011657,COST
06079711205070000,2020,140953,675347,816300,MKT
06079711205070000,2019,140953,675347,816300,MKT
06079711205090000,2021,193889,795711,989600,MKT
06079711205090000,2020,155516,637584,793100,MKT
06079711205090000,2019,155516,637584,793100,MKT
06079711205110000,2021,195420,810970,1006390,COST
06079711205110000,2020,156842,690120,846962,COST
06079711205110000,2019,156842,690120,846962,COST
06079711205130000,2021,177007,695693,872700,MKT
06079711205130000,2020,140953,630747,771700,MKT
06079711205130000,2019,140953,630747,771700,MKT
06079711205150000,2021,167182,0,167182,COST
06079711205150000,2020,132528,0,132528,COST
06079711205150000,2019,132528,0,132528,COST
06079711205170000,2021,163994,580106,744100,MKT
06079711205170000,2020,129803,530597,660400,MKT
06079711205170000,2019,129803,530597,660400,MKT
06079711205190000,2021,160676,856924,1017600,MKT
06079711205190000,2020,126970,638530,765500,MKT
06079711205190000,2019,126970,0,126970,COST
06079711205210000,2021,151069,840271,991340,MRA
06079711205210000,2020,118797,715903,834700,MKT
06079711205210000,2019,118797,715903,834700,MKT
06079711205230000,2021,162903,620597,783500,MKT
06079711205230000,2020,128871,646929,775800,MKT
06079711205230000,2019,128871,646929,775800,MKT
06079711205250000,2021,169241,663459,832700,MKT
06079711205250000,2020,134290,617510,751800,MKT
06079711205250000,2019,134290,617510,751800,MKT
06079711205270000,2021,174177,0,174177,COST
06079711205270000,2020,138522,0,138522,COST
06079711205270000,2019,138522,0,138522,COST
06079711205290000,2021,170251,584849,755100,MKT
06079711205290000,2020,135156,615344,750500,MKT
06079711205290000,2019,135156,615344,750500,MKT
06079711205310000,2021,157212,886188,1043400,MKT
06079711205310000,2020,124018,700182,824200,MKT
06079711205310000,2019,124018,700182,824200,MKT
06079711205330000,2021,162903,818997,981900,MKT
06079711205330000,2020,128871,622829,751700,MKT
06079711205330000,2019,128871,622829,751700,MKT
06079711205350000,2021,165071,843329,1008400,MKT
06079711205350000,2020,130723,634177,764900,MKT
06079711205350000,2019,130723,634177,764900,MKT
06079711205370000,2021,172237,783063,955300,MKT
06079711205370000,2020,136858,685842,822700,MKT
06079711205370000,2019,136858,686442,823300,MKT
06079711205390000,2021,156022,0,156022,COST
06079711205390000,2020,123006,0,123006,COST
06079711205390000,2019,123006,0,123006,COST
06079711205410000,2021,149778,418522,568300,MKT
06079711205410000,2020,117701,430699,548400,MKT
06079711205410000,2019,117701,430699,548400,MKT
06079711205430000,2021,170251,0,170251,COST
06079711205430000,2020,135156,0,135156,COST
06079711205430000,2019,135156,0,135156,COST
06079711205450000,2021,171250,0,171250,COST
06079711205450000,2020,136012,0,136012,COST
06079711205450000,2019,136012,0,136012,COST
06079711206010000,2021,190444,1379256,1569700,INCOME
06079711206010000,2020,155916,1358984,1514900,INCOME
06079711206010000,2019,155916,1358984,1514900,INCOME
06079711206030000,2021,209551,673949,883500,MKT
06079711206030000,2020,170762,566238,737000,MKT
06079711206030000,2019,170762,321340,492102,COST
06079711206050000,2021,202027,835173,1037200,MKT
06079711206050000,2020,162573,546227,708800,MKT
06079711206050000,2019,162573,534427,697000,MKT
06079711206070000,2021,251779,0,251779,COST
06079711206070000,2020,187457,0,187457,COST
06079711206070000,2019,187457,0,187457,COST
06079711206177000,2021,411421,0,411421,COST
06079711206177000,2020,370201,0,370201,COST
06079711206177000,2019,370201,0,370201,COST
06079711207010000,2021,718600,0,718600,COST
06079711207010000,2020,374498,0,374498,COST
06079711207010000,2019,374498,0,374498,COST
06079711207050000,2021,576718,0,576718,COST
06079711207050000,2020,323905,0,323905,COST
06079711207050000,2019,323905,0,323905,COST
06079711207090000,2021,475903,0,475903,COST
06079711207090000,2020,285335,0,285335,COST
06079711207090000,2019,285335,0,285335,COST
06079711207130000,2021,620882,19759530,20380412,COST
06079711207130000,2020,451872,19379460,19831332,COST
06079711207130000,2019,451872,19379460,19831332,COST
06079711207170000,2021,706221,0,706221,COST
06079711207170000,2020,370229,0,370229,COST
06079711207170000,2019,370229,0,370229,COST
06079711208016500,2021,216014,0,216014,COST
06079711208016500,2020,192280,0,192280,COST
06079711208016500,2019,192280,0,192280,COST
06079711209016500,2021,107690,0,107690,COST
06079711209016500,2020,96454,0,96454,COST
06079711209016500,2019,96454,0,96454,COST
06079711209027000,2021,234613,5830,240443,COST
06079711209027000,2020,295552,6940,302492,COST
06079711209027000,2019,295552,6940,302492,COST
06079711209187000,2021,186520,0,186520,COST
06079711209187000,2020,228452,0,228452,COST
06079711209187000,2019,228452,0,228452,COST
06079711210016500,2021,128792,0,128792,COST
06079711210016500,2020,174510,0,174510,COST
06079711210016500,2019,174510,0,174510,COST
06079711210157000,2021,306661,0,306661,COST
06079711210157000,2020,399205,0,399205,COST
06079711210157000,2019,399205,0,399205,COST
06079711210257000,2021,234613,0,234613,COST
06079711210257000,2020,295552,0,295552,COST
06079711210257000,2019,295552,0,295552,COST
06079711210367000,2021,153184,0,153184,COST
06079711210367000,2020,183148,0,183148,COST
06079711210367000,2019,183148,0,183148,COST
06079711210387000,2021,155493,0,155493,COST
06079711210387000,2020,186249,0,186249,COST
06079711210387000,2019,186249,0,186249,COST
06079711211016500,2021,160351,0,160351,COST
06079711211016500,2020,150803,0,150803,COST
06079711211016500,2019,150803,0,150803,COST
06079711211020000,2021,154032,994168,1148200,INCOME
06079711211020000,2020,184286,660314,844600,INCOME
06079711211020000,2019,184286,660314,844600,INCOME
06079711211040000,2021,154032,994168,1148200,INCOME
06079711211040000,2020,184286,660314,844600,INCOME
06079711211040000,2019,184286,660314,844600,INCOME
06079711211055001,2021,96146,222554,318700,MKT
06079711211055001,2020,108573,213427,322000,MKT
06079711211055001,2019,108573,213427,322000,MKT
06079711211060000,2021,154032,994168,1148200,INCOME
06079711211060000,2020,184286,660314,844600,INCOME
06079711211060000,2019,184286,660314,844600,INCOME
06079711211075002,2021,87095,223105,310200,MKT
06079711211075002,2020,97168,233032,330200,MKT
06079711211075002,2019,97168,233032,330200,MKT
06079711211085003,2021,87095,223105,310200,MKT
06079711211085003,2020,97168,233032,330200,MKT
06079711211085003,2019,97168,233032,330200,MKT
06079711211095004,2021,103029,222271,325300,MKT
06079711211095004,2020,117336,213364,330700,MKT
06079711211095004,2019,117336,213364,330700,MKT
06079711211107000,2021,234568,0,234568,COST
06079711211107000,2020,295489,0,295489,COST
06079711211107000,2019,295489,0,295489,COST
06079711211167000,2021,351950,0,351950,COST
06079711211167000,2020,465963,0,465963,COST
06079711211167000,2019,465963,0,465963,COST
06079711211247000,2021,189544,0,189544,COST
06079711211247000,2020,232614,0,232614,COST
06079711211247000,2019,232614,0,232614,COST
06079711211307000,2021,186592,0,186592,COST
06079711211307000,2020,228550,0,228550,COST
06079711211307000,2019,228550,0,228550,COST
06079711211327000,2021,186734,4450,191184,COST
06079711211327000,2020,228747,5260,234007,COST
06079711211327000,2019,228747,5260,234007,COST
06079711211360000,2021,148456,999744,1148200,INCOME
06079711211360000,2020,176814,667786,844600,INCOME
06079711211360000,2019,176814,667786,844600,INCOME
06079711211380000,2021,148456,999744,1148200,INCOME
06079711211380000,2020,176814,667786,844600,INCOME
06079711211380000,2019,176814,667786,844600,INCOME
06079711211427000,2021,268280,0,268280,COST
06079711211427000,2020,343565,0,343565,COST
06079711211427000,2019,343565,0,343565,COST
06079711301030000,2021,109431,0,109431,COST
06079711301030000,2020,113811,0,113811,COST
06079711301030000,2019,113811,0,113811,COST
06079711305017000,2021,394419,135660,530079,COST
06079711305017000,2020,252078,1149522,1401600,INCOME
06079711305017000,2019,252078,808722,1060800,INCOME
06079711305030000,2021,242603,502197,744800,INCOME
06079711305030000,2020,182920,488180,671100,INCOME
06079711305030000,2019,182920,488180,671100,INCOME
06079711305050000,2021,242603,188897,431500,INCOME
06079711305050000,2020,182920,159680,342600,INCOME
06079711305050000,2019,182920,159680,342600,INCOME
06079711305077000,2021,267614,29060,296674,COST
06079711305077000,2020,195156,30170,225326,COST
06079711305077000,2019,195156,30170,225326,COST
06079711306010000,2021,283438,1226462,1509900,INCOME
06079711306010000,2020,202695,1132305,1335000,INCOME
06079711306010000,2019,202695,1132305,1335000,INCOME
06079711306030000,2021,291040,1179160,1470200,INCOME
06079711306030000,2020,206266,1118034,1324300,INCOME
06079711306030000,2019,206266,1118034,1324300,INCOME
06079711306050000,2021,349147,771553,1120700,INCOME
06079711306050000,2020,232592,710608,943200,INCOME
06079711306050000,2019,232592,710608,943200,INCOME
06079711401010000,2021,120873,250827,371700,MKT
06079711401010000,2020,123843,220157,344000,MKT
06079711401010000,2019,123843,220157,344000,MKT
06079711401020000,2021,201642,3360,205002,COST
06079711401020000,2020,191277,3400,194677,COST
06079711401020000,2019,191277,3400,194677,COST
06079711401020900,2021,709123,3537160,4246283,COST
06079711401020900,2020,612658,2597260,3209918,COST
06079711401020900,2019,612658,2076010,2688668,COST
06079711401030000,2021,302511,278389,580900,MKT
06079711401030000,2020,251352,228748,480100,MKT
06079711401030000,2019,251352,228748,480100,MKT
06079711401047000,2021,273363,14610,287973,COST
06079711401047000,2020,197912,15610,213522,COST
06079711401047000,2019,197912,15610,213522,COST
06079711401080000,2021,245605,468095,713700,INCOME
06079711401080000,2020,184411,446689,631100,INCOME
06079711401080000,2019,184411,446689,631100,INCOME
06079711401100000,2021,245605,678595,924200,INCOME
06079711401100000,2020,184411,599889,784300,INCOME
06079711401100000,2019,184411,753589,938000,INCOME
06079711401127000,2021,327058,0,327058,COST
06079711401127000,2020,222775,0,222775,COST
06079711401127000,2019,222775,0,222775,COST
06079711401147000,2021,298838,37790,336628,COST
06079711401147000,2020,209897,39340,249237,COST
06079711401147000,2019,209897,39340,249237,COST
06079711402017000,2021,213748,23160,236908,COST
06079711402017000,2020,179872,28560,208432,COST
06079711402017000,2019,179872,28560,208432,COST
06079711402057000,2021,260868,45540,306408,COST
06079711402057000,2020,191895,48510,240405,COST
06079711402057000,2019,191895,48510,240405,COST
06079711402090000,2021,297565,3080,300645,COST
06079711402090000,2020,209307,3170,212477,COST
06079711402090000,2019,209307,3170,212477,COST
06079711402130000,2021,265681,1089619,1355300,INCOME
06079711402130000,2020,194224,1083876,1278100,INCOME
06079711402130000,2019,194224,1083876,1278100,INCOME
06079711410010000,2021,611837,651163,1263000,INCOME
06079711410010000,2020,555815,501585,1057400,INCOME
06079711410010000,2019,555815,501585,1057400,INCOME
06079711410020000,2021,430871,553429,984300,INCOME
06079711410020000,2020,267219,539381,806600,INCOME
06079711410020000,2019,267219,539381,806600,INCOME
06079711410030000,2021,548597,394003,942600,INCOME
06079711410030000,2020,517207,245193,762400,INCOME
06079711410030000,2019,517207,245193,762400,INCOME
06079711410040000,2021,385466,710134,1095600,INCOME
06079711410040000,2020,246249,630651,876900,INCOME
06079711410040000,2019,246249,630651,876900,INCOME
06079711410067000,2021,413582,40220,453802,COST
06079711410067000,2020,257959,41920,299879,COST
06079711410067000,2019,257959,41920,299879,COST
06079711410120000,2021,212231,631369,843600,INCOME
06079711410120000,2020,167468,596610,764078,COST
06079711410120000,2019,167468,596610,764078,COST
06079711420010000,2021,869916,0,869916,COST
06079711420010000,2020,774978,0,774978,COST
06079711420010000,2019,774978,0,774978,COST
06079711420057000,2021,446666,0,446666,COST
06079711420057000,2020,299991,0,299991,COST
06079711420057000,2019,299991,0,299991,COST
06079711420077000,2021,416383,59610,475993,COST
06079711420077000,2020,286410,63950,350360,COST
06079711420077000,2019,286410,63950,350360,COST
06079711420090000,2021,465796,1329804,1795600,INCOME
06079711420090000,2020,513192,1004780,1517972,COST
06079711420090000,2019,513192,724408,1237600,INCOME
06079711420136500,2021,244934,0,244934,COST
06079711420136500,2020,133980,0,133980,COST
06079711420136500,2019,133980,0,133980,COST
06079711421010000,2021,245772,667028,912800,INCOME
06079711421010000,2020,202258,584142,786400,INCOME
06079711421010000,2019,202258,584142,786400,INCOME
06079711421037000,2021,314306,53100,367406,COST
06079711421037000,2020,237899,57570,295469,COST
06079711421037000,2019,237899,57570,295469,COST
06079711421050000,2021,260357,1108743,1369100,INCOME
06079711421050000,2020,210100,532700,742800,INCOME
06079711421050000,2019,210100,532700,742800,INCOME
06079711421070000,2021,220184,1372316,1592500,INCOME
06079711421070000,2020,313006,0,313006,COST
06079711421070000,2019,313006,0,313006,COST
06079711421090000,2021,130463,0,130463,COST
06079711421090000,2020,142555,0,142555,COST
06079711421090000,2019,142555,0,142555,COST
06079711421110000,2021,155834,0,155834,COST
06079711421110000,2020,142555,0,142555,COST
06079711421110000,2019,142555,0,142555,COST
06079711421130000,2021,146924,384876,531800,INCOME
06079711421130000,2020,239673,344427,584100,INCOME
06079711421130000,2019,239673,344427,584100,INCOME
06079711421150000,2021,203911,0,203911,COST
06079711421150000,2020,178812,0,178812,COST
06079711421150000,2019,178812,0,178812,COST
06079711422017000,2021,280576,34110,314686,COST
06079711422017000,2020,220729,35250,255979,COST
06079711422017000,2019,220729,35250,255979,COST
06079711422050000,2021,483366,1163834,1647200,INCOME
06079711422050000,2020,316037,1118763,1434800,INCOME
06079711422050000,2019,316037,1118763,1434800,INCOME
06079711422090000,2021,516334,1797866,2314200,INCOME
06079711422090000,2020,330100,1818300,2148400,INCOME
06079711422090000,2019,330100,1818300,2148400,INCOME
06079711422110000,2021,247419,587681,835100,INCOME
06079711422110000,2020,203151,577649,780800,INCOME
06079711422110000,2019,203151,577649,780800,INCOME
06079711422130000,2021,241958,815842,1057800,INCOME
06079711422130000,2020,200181,770419,970600,INCOME
06079711422130000,2019,200181,770419,970600,INCOME
06079711422150000,2021,252968,1408732,1661700,INCOME
06079711422150000,2020,206146,1277054,1483200,INCOME
06079711422150000,2019,206146,1277054,1483200,INCOME
06079711440010000,2021,942920,7362680,8305600,INCOME
06079711440010000,2020,448029,7295371,7743400,INCOME
06079711440010000,2019,448029,7295371,7743400,INCOME
06079711441010000,2021,386902,1107800,1494702,COST
06079711441010000,2020,410765,1070420,1481185,COST
06079711441010000,2019,410765,1070420,1481185,COST
06079711441057000,2021,611237,23570,634807,COST
06079711441057000,2020,555455,24540,579995,COST
06079711441057000,2019,555455,24540,579995,COST
06079711441100000,2021,89768,0,89768,COST
06079711441100000,2020,63018,0,63018,COST
06079711441100000,2019,63018,0,63018,COST
06079711442010000,2021,217946,678654,896600,INCOME
06079711442010000,2020,170430,627170,797600,INCOME
06079711442010000,2019,170430,627170,797600,INCOME
06079711442040000,2021,239941,0,239941,COST
06079711442040000,2020,181594,0,181594,COST
06079711442040000,2019,181594,0,181594,COST
06079711442070000,2021,449383,9080500,9529883,COST
06079711442070000,2020,395635,5113490,5509125,COST
06079711442070000,2019,395635,5113490,5509125,COST
06079711442160000,2021,522272,2602728,3125000,INCOME
06079711442160000,2020,303388,2513512,2816900,INCOME
06079711442160000,2019,303388,2513512,2816900,INCOME
06079711442207000,2021,470082,43010,513092,COST
06079711442207000,2020,283026,44670,327696,COST
06079711442207000,2019,283026,44670,327696,COST
06079711443010000,2021,17342,0,17342,COST
06079711443010000,2020,21296,0,21296,COST
06079711443010000,2019,21296,0,21296,COST
06079711443047000,2021,383867,58600,442467,COST
06079711443047000,2020,408636,62150,470786,COST
06079711443047000,2019,408636,62150,470786,COST
06079711443070000,2021,68475,188525,257000,INCOME
06079711443070000,2020,52707,172093,224800,INCOME
06079711443070000,2019,52707,172093,224800,INCOME
06079711443100000,2021,77217,0,77217,COST
06079711443100000,2020,57056,0,57056,COST
06079711443100000,2019,57056,0,57056,COST
06079711450016500,2021,152207,0,152207,COST
06079711450016500,2020,142233,0,142233,COST
06079711450016500,2019,142233,0,142233,COST
06079711450020000,2021,186214,0,186214,COST
06079711450020000,2020,153622,0,153622,COST
06079711450020000,2019,153622,0,153622,COST
06079711450030000,2021,358596,637580,996176,COST
06079711450030000,2020,236727,451270,687997,COST
06079711450030000,2019,236727,451270,687997,COST
06079711450050000,2021,160263,297437,457700,MKT
06079711450050000,2020,142707,254293,397000,MKT
06079711450050000,2019,142707,254293,397000,MKT
06079711450070000,2021,171901,274299,446200,MKT
06079711450070000,2020,154391,224909,379300,MKT
06079711450070000,2019,154391,224909,379300,MKT
06079711450090000,2021,164177,283223,447400,MKT
06079711450090000,2020,146625,247475,394100,MKT
06079711450090000,2019,146625,247475,394100,MKT
06079711450110000,2021,127103,397097,524200,MKT
06079711450110000,2020,132471,364429,496900,MKT
06079711450110000,2019,132471,364429,496900,MKT
06079711450130000,2021,112178,318622,430800,MKT
06079711450130000,2020,115139,281861,397000,MKT
06079711450130000,2019,115139,281861,397000,MKT
06079711450150000,2021,119320,304980,424300,MKT
06079711450150000,2020,123400,263900,387300,MKT
06079711450150000,2019,123400,263900,387300,MKT
06079711451010000,2021,122084,265316,387400,MKT
06079711451010000,2020,126612,211988,338600,MKT
06079711451010000,2019,126612,211988,338600,MKT
06079711451030000,2021,111977,266923,378900,MKT
06079711451030000,2020,114908,221192,336100,MKT
06079711451030000,2019,114908,221192,336100,MKT
06079711451050000,2021,119673,270727,390400,MKT
06079711451050000,2020,123809,211091,334900,MKT
06079711451050000,2019,123809,211091,334900,MKT
06079711451070000,2021,159457,315743,475200,MKT
06079711451070000,2020,141901,265999,407900,MKT
06079711451070000,2019,141901,265999,407900,MKT
06079711451090000,2021,162478,261922,424400,MKT
06079711451090000,2020,144923,218377,363300,MKT
06079711451090000,2019,144923,218377,363300,MKT
06079711451110000,2021,158314,342686,501000,MKT
06079711451110000,2020,140760,303940,444700,MKT
06079711451110000,2019,140760,303940,444700,MKT
06079711452010000,2021,116976,295324,412300,MKT
06079711452010000,2020,91425,263975,355400,MKT
06079711452010000,2019,91425,263975,355400,MKT
06079711452030000,2021,114724,293476,408200,MKT
06079711452030000,2020,89451,253049,342500,MKT
06079711452030000,2019,89451,253049,342500,MKT
06079711452050000,2021,114724,356276,471000,MKT
06079711452050000,2020,89451,275549,365000,MKT
06079711452050000,2019,89451,275549,365000,MKT
06079711452070000,2021,114724,308176,422900,MKT
06079711452070000,2020,89451,261049,350500,MKT
06079711452070000,2019,89451,261049,350500,MKT
06079711452090000,2021,114724,337476,452200,MKT
06079711452090000,2020,89451,302049,391500,MKT
06079711452090000,2019,89451,302049,391500,MKT
06079711452110000,2021,114724,305676,420400,MKT
06079711452110000,2020,89451,260549,350000,MKT
06079711452110000,2019,89451,260549,350000,MKT
06079711452130000,2021,114724,282176,396900,MKT
06079711452130000,2020,89451,251649,341100,MKT
06079711452130000,2019,89451,251649,341100,MKT
06079711452150000,2021,116235,417165,533400,MKT
06079711452150000,2020,90775,383525,474300,MKT
06079711452150000,2019,90775,383525,474300,MKT
06079711452170000,2021,128640,291060,419700,MKT
06079711452170000,2020,101720,268580,370300,MKT
06079711452170000,2019,101720,268580,370300,MKT
06079711452190000,2021,114724,303776,418500,MKT
06079711452190000,2020,89451,263049,352500,MKT
06079711452190000,2019,89451,263049,352500,MKT
06079711452210000,2021,114724,298776,413500,MKT
06079711452210000,2020,89451,259149,348600,MKT
06079711452210000,2019,89451,262949,352400,MKT
06079711452230000,2021,114724,295276,410000,MKT
06079711452230000,2020,89451,263649,353100,MKT
06079711452230000,2019,89451,263649,353100,MKT
06079711452250000,2021,114724,317276,432000,MKT
06079711452250000,2020,89451,284949,374400,MKT
06079711452250000,2019,89451,284949,374400,MKT
06079711452270000,2021,114724,313476,428200,MKT
06079711452270000,2020,89451,266549,356000,MKT
06079711452270000,2019,89451,266549,356000,MKT
06079711452290000,2021,114724,348576,463300,MKT
06079711452290000,2020,89451,296449,385900,MKT
06079711452290000,2019,89451,296449,385900,MKT
06079711452310000,2021,124076,266424,390500,MKT
06079711452310000,2020,97677,241223,338900,MKT
06079711452310000,2019,97677,241223,338900,MKT
06079711453010000,2021,144059,257041,401100,MKT
06079711453010000,2020,126612,226588,353200,MKT
06079711453010000,2019,126612,226588,353200,MKT
06079711453030000,2021,138031,242969,381000,MKT
06079711453030000,2020,120681,211919,332600,MKT
06079711453030000,2019,120681,211919,332600,MKT
06079711453050000,2021,138031,257369,395400,MKT
06079711453050000,2020,120681,222419,343100,MKT
06079711453050000,2019,120681,222419,343100,MKT
06079711453070000,2021,138031,257369,395400,MKT
06079711453070000,2020,120681,222419,343100,MKT
06079711453070000,2019,120681,222419,343100,MKT
06079711453090000,2021,138248,267152,405400,MKT
06079711453090000,2020,120894,244006,364900,MKT
06079711453090000,2019,120894,244006,364900,MKT
06079711453110000,2021,138248,248852,387100,MKT
06079711453110000,2020,120894,217906,338800,MKT
06079711453110000,2019,120894,217906,338800,MKT
06079711453130000,2021,144654,269746,414400,MKT
06079711453130000,2020,127199,230001,357200,MKT
06079711453130000,2019,127199,230001,357200,MKT
06079711454010000,2021,116421,299979,416400,MKT
06079711454010000,2020,90938,250362,341300,MKT
06079711454010000,2019,90938,250362,341300,MKT
06079711454030000,2021,114724,286276,401000,MKT
06079711454030000,2020,89451,241549,331000,MKT
06079711454030000,2019,89451,241549,331000,MKT
06079711454050000,2021,114724,299576,414300,MKT
06079711454050000,2020,89451,252649,342100,MKT
06079711454050000,2019,89451,252649,342100,MKT
06079711454070000,2021,114724,278876,393600,MKT
06079711454070000,2020,89451,238749,328200,MKT
06079711454070000,2019,89451,238749,328200,MKT
06079711454090000,2021,114724,264076,378800,MKT
06079711454090000,2020,89451,232349,321800,MKT
06079711454090000,2019,89451,232349,321800,MKT
06079711454110000,2021,114724,314076,428800,MKT
06079711454110000,2020,89451,265549,355000,MKT
06079711454110000,2019,89451,265549,355000,MKT
06079711454130000,2021,114724,311676,426400,MKT
06079711454130000,2020,89451,269449,358900,MKT
06079711454130000,2019,89451,269449,358900,MKT
06079711454150000,2021,117159,271241,388400,MKT
06079711454150000,2020,91586,236414,328000,MKT
06079711454150000,2019,91586,236414,328000,MKT
06079711454170000,2021,127259,319441,446700,MKT
06079711454170000,2020,100494,289406,389900,MKT
06079711454170000,2019,100494,289406,389900,MKT
06079711454190000,2021,114724,336976,451700,MKT
06079711454190000,2020,89451,323949,413400,MKT
06079711454190000,2019,89451,323949,413400,MKT
06079711454210000,2021,114724,243576,358300,MKT
06079711454210000,2020,89451,224349,313800,MKT
06079711454210000,2019,89451,224349,313800,MKT
06079711454230000,2021,114724,301376,416100,MKT
06079711454230000,2020,89451,262249,351700,MKT
06079711454230000,2019,89451,262249,351700,MKT
06079711454250000,2021,114724,281776,396500,MKT
06079711454250000,2020,89451,241349,330800,MKT
06079711454250000,2019,89451,241349,330800,MKT
06079711454270000,2021,114724,325676,440400,MKT
06079711454270000,2020,89451,313549,403000,MKT
06079711454270000,2019,89451,313549,403000,MKT
06079711454290000,2021,127259,277441,404700,MKT
06079711454290000,2020,100494,255706,356200,MKT
06079711454290000,2019,100494,255706,356200,MKT
06079711455010000,2021,132841,267459,400300,MKT
06079711455010000,2020,115599,256201,371800,MKT
06079711455010000,2019,115599,256201,371800,MKT
06079711455030000,2021,130936,268364,399300,MKT
06079711455030000,2020,113739,241161,354900,MKT
06079711455030000,2019,113739,237761,351500,MKT
06079711455050000,2021,130936,271864,402800,MKT
06079711455050000,2020,113739,244261,358000,MKT
06079711455050000,2019,113739,244261,358000,MKT
06079711455070000,2021,130936,240964,371900,MKT
06079711455070000,2020,113739,213861,327600,MKT
06079711455070000,2019,113739,213861,327600,MKT
06079711455090000,2021,130936,256264,387200,MKT
06079711455090000,2020,113739,238761,352500,MKT
06079711455090000,2019,113739,238761,352500,MKT
06079711455110000,2021,130936,258064,389000,MKT
06079711455110000,2020,113739,232461,346200,MKT
06079711455110000,2019,113739,232461,346200,MKT
06079711455130000,2021,132841,266559,399400,MKT
06079711455130000,2020,115599,247201,362800,MKT
06079711455130000,2019,115599,247201,362800,MKT
06079711456010000,2021,117343,296357,413700,MKT
06079711456010000,2020,91747,257953,349700,MKT
06079711456010000,2019,91747,257953,349700,MKT
06079711456030000,2021,114724,288976,403700,MKT
06079711456030000,2020,89451,249649,339100,MKT
06079711456030000,2019,89451,249649,339100,MKT
06079711456050000,2021,114724,331476,446200,MKT
06079711456050000,2020,89451,295949,385400,MKT
06079711456050000,2019,89451,295949,385400,MKT
06079711456070000,2021,114724,295376,410100,MKT
06079711456070000,2020,89451,257649,347100,MKT
06079711456070000,2019,89451,257649,347100,MKT
06079711456090000,2021,114724,281376,396100,MKT
06079711456090000,2020,89451,235749,325200,MKT
06079711456090000,2019,89451,235749,325200,MKT
06079711456110000,2021,114724,288176,402900,MKT
06079711456110000,2020,89451,246849,336300,MKT
06079711456110000,2019,89451,246849,336300,MKT
06079711456130000,2021,118070,302230,420300,MKT
06079711456130000,2020,92385,270715,363100,MKT
06079711456130000,2019,92385,270715,363100,MKT
06079711456150000,2021,119320,317680,437000,MKT
06079711456150000,2020,93485,304515,398000,MKT
06079711456150000,2019,93485,304515,398000,MKT
06079711456170000,2021,114724,278876,393600,MKT
06079711456170000,2020,89451,244549,334000,MKT
06079711456170000,2019,89451,244549,334000,MKT
06079711456190000,2021,114915,314185,429100,MKT
06079711456190000,2020,89619,282281,371900,MKT
06079711456190000,2019,89619,282281,371900,MKT
06079711456210000,2021,114915,362985,477900,MKT
06079711456210000,2020,89619,343281,432900,MKT
06079711456210000,2019,89619,343281,432900,MKT
06079711456230000,2021,114915,307685,422600,MKT
06079711456230000,2020,89619,277781,367400,MKT
06079711456230000,2019,89619,277781,367400,MKT
06079711456250000,2021,118966,324334,443300,MKT
06079711456250000,2020,93173,323327,416500,MKT
06079711456250000,2019,93173,323327,416500,MKT
06079711457010000,2021,157984,277516,435500,MKT
06079711457010000,2020,140431,236569,377000,MKT
06079711457010000,2019,140431,236569,377000,MKT
06079711457030000,2021,165990,258210,424200,MKT
06079711457030000,2020,148444,213256,361700,MKT
06079711457030000,2019,148444,213256,361700,MKT
06079711457050000,2021,161220,374280,535500,MKT
06079711457050000,2020,143664,350236,493900,MKT
06079711457050000,2019,143664,350236,493900,MKT
06079711457070000,2021,118788,300312,419100,MKT
06079711457070000,2020,122781,241219,364000,MKT
06079711457070000,2019,122781,241219,364000,MKT
06079711457090000,2021,117343,296657,414000,MKT
06079711457090000,2020,121106,230894,352000,MKT
06079711457090000,2019,121106,230894,352000,MKT
06079711457110000,2021,117343,295657,413000,MKT
06079711457110000,2020,121106,224594,345700,MKT
06079711457110000,2019,121106,224594,345700,MKT
06079711458010000,2021,149059,246541,395600,MKT
06079711458010000,2020,131556,208744,340300,MKT
06079711458010000,2019,131556,208744,340300,MKT
06079711458030000,2021,161852,259448,421300,MKT
06079711458030000,2020,144296,217404,361700,MKT
06079711458030000,2019,144296,217404,361700,MKT
06079711458050000,2021,168202,366998,535200,MKT
06079711458050000,2020,150666,324634,475300,MKT
06079711458050000,2019,150666,324634,475300,MKT
06079711458070000,2021,122755,338045,460800,MKT
06079711458070000,2020,127394,288906,416300,MKT
06079711458070000,2019,127394,288906,416300,MKT
06079712101010000,2021,306870,984520,1291390,COST
06079712101010000,2020,269939,893020,1162959,COST
06079712101010000,2019,269939,893020,1162959,COST
06079712101040000,2021,308425,1261980,1570405,COST
06079712101040000,2020,271476,1152430,1423906,COST
06079712101040000,2019,271476,1152430,1423906,COST
06079712101070000,2021,617507,1092510,1710017,COST
06079712101070000,2020,236383,1038540,1274923,COST
06079712101070000,2019,236383,1038540,1274923,COST
06079712101080000,2021,325452,1748,327200,INCOME
06079712101080000,2020,222052,85248,307300,INCOME
06079712101080000,2019,222052,85248,307300,INCOME
06079712101100000,2021,336679,228400,565079,COST
06079712101100000,2020,299546,204960,504506,COST
06079712101100000,2019,299546,204960,504506,COST
06079712101120000,2021,392796,408540,801336,COST
06079712101120000,2020,327127,372920,700047,COST
06079712101120000,2019,327127,372920,700047,COST
06079712101180000,2021,326591,1449940,1776531,COST
06079712101180000,2020,289489,1294600,1584089,COST
06079712101180000,2019,289489,1294600,1584089,COST
06079712101210000,2021,326591,811420,1138011,COST
06079712101210000,2020,289489,723320,1012809,COST
06079712101210000,2019,289489,723320,1012809,COST
06079712101250000,2021,567,0,567,COST
06079712101250000,2020,528,0,528,COST
06079712101250000,2019,528,0,528,COST
06079712101310000,2021,413155,65600,478755,COST
06079712101310000,2020,376927,62800,439727,COST
06079712101310000,2019,376927,62800,439727,COST
06079712101320000,2021,206155,292745,498900,MKT
06079712101320000,2020,172715,254385,427100,MKT
06079712101320000,2019,172715,254385,427100,MKT
06079712101330000,2021,206155,391745,597900,MKT
06079712101330000,2020,172715,234930,407645,COST
06079712101330000,2019,172715,77140,249855,COST
06079712101350000,2021,163072,640,163712,COST
06079712101350000,2020,132750,660,133410,COST
06079712101350000,2019,132750,660,133410,COST
06079712101490000,2021,423463,388240,811703,COST
06079712101490000,2020,387500,345530,733030,COST
06079712101490000,2019,387500,345530,733030,COST
06079712102010000,2021,421554,521350,942904,COST
06079712102010000,2020,385540,0,385540,COST
06079712102010000,2019,6950,0,6950,COST
06079712102100000,2021,9005,0,9005,COST
06079712102100000,2020,11761,0,11761,COST
06079712102100000,2019,11761,0,11761,COST
06079712132010000,2021,239193,950170,1189363,COST
06079712132010000,2020,204078,850100,1054178,COST
06079712132010000,2019,2187,850100,852287,COST
06079712148010000,2021,7764,0,7764,COST
06079712148010000,2020,10707,0,10707,COST
06079712148010000,2019,10707,0,10707,COST
06079712154010000,2021,23755,0,23755,COST
06079712154010000,2020,31971,0,31971,COST
06079712154010000,2019,31971,0,31971,COST
06079712201010000,2021,8693,0,8693,COST
06079712201010000,2020,11739,0,11739,COST
06079712201010000,2019,11739,0,11739,COST
06079712201100000,2021,419074,0,419074,COST
06079712201100000,2020,382995,0,382995,COST
06079712201100000,2019,382995,0,382995,COST
06079712201200000,2021,10494,0,10494,COST
06079712201200000,2020,13450,0,13450,COST
06079712201200000,2019,13450,0,13450,COST
06079712205010000,2021,695589,1442111,2137700,INCOME
06079712205010000,2020,489031,1276269,1765300,INCOME
06079712205010000,2019,489031,1276269,1765300,INCOME
06079712205016500,2021,158016,0,158016,COST
06079712205016500,2020,58703,0,58703,COST
06079712205016500,2019,58703,0,58703,COST
06079712205050000,2021,448070,0,448070,COST
06079712205050000,2020,365845,0,365845,COST
06079712205050000,2019,365845,0,365845,COST
06079712205070000,2021,420832,884768,1305600,INCOME
06079712205070000,2020,351014,0,351014,COST
06079712205070000,2019,351014,0,351014,COST
06079712205090000,2021,448560,0,448560,COST
06079712205090000,2020,366109,0,366109,COST
06079712205090000,2019,366109,0,366109,COST
06079712205110000,2021,418535,0,418535,COST
06079712205110000,2020,349748,0,349748,COST
06079712205110000,2019,349748,0,349748,COST
06079712205130000,2021,421596,0,421596,COST
06079712205130000,2020,351434,0,351434,COST
06079712205130000,2019,351434,0,351434,COST
06079712205150000,2021,435956,0,435956,COST
06079712205150000,2020,359288,0,359288,COST
06079712205150000,2019,359288,0,359288,COST
06079712208010000,2021,1016728,2917172,3933900,INCOME
06079712208010000,2020,628227,2550673,3178900,INCOME
06079712208010000,2019,628227,2550673,3178900,INCOME
06079712208090000,2021,927311,4405189,5332500,INCOME
06079712208090000,2020,591201,2151440,2742641,COST
06079712208090000,2019,591201,2151440,2742641,COST
06079712210010000,2021,541260,701940,1243200,INCOME
06079712210010000,2020,199243,622657,821900,INCOME
06079712210010000,2019,199243,622657,821900,INCOME
06079712210037000,2021,192816,24040,216856,COST
06079712210037000,2020,140970,25020,165990,COST
06079712210037000,2019,140970,25020,165990,COST
06079712210050000,2021,464074,926326,1390400,INCOME
06079712210050000,2020,180008,0,180008,COST
06079712210050000,2019,180008,0,180008,COST
06079712210070000,2021,424391,0,424391,COST
06079712210070000,2020,169697,0,169697,COST
06079712210070000,2019,169697,0,169697,COST
06079712210090000,2021,447334,733066,1180400,INCOME
06079712210090000,2020,175696,959804,1135500,INCOME
06079712210090000,2019,175696,959804,1135500,INCOME
06079712210110000,2021,431955,0,431955,COST
06079712210110000,2020,171687,0,171687,COST
06079712210110000,2019,171687,0,171687,COST
06079712210130000,2021,677517,871783,1549300,INCOME
06079712210130000,2020,231062,1134938,1366000,INCOME
06079712210130000,2019,231062,1134938,1366000,INCOME
06079712210170000,2021,465512,0,465512,COST
06079712210170000,2020,180375,0,180375,COST
06079712210170000,2019,180375,0,180375,COST
06079712210190000,2021,451006,0,451006,COST
06079712210190000,2020,176647,0,176647,COST
06079712210190000,2019,176647,0,176647,COST
06079712210217000,2021,264997,28030,293027,COST
06079712210217000,2020,193894,27130,221024,COST
06079712210217000,2019,193894,27130,221024,COST
06079712210237000,2021,240669,29230,269899,COST
06079712210237000,2020,181957,30430,212387,COST
06079712210237000,2019,181957,30430,212387,COST
06079712210257000,2021,286928,5370,292298,COST
06079712210257000,2020,204339,5200,209539,COST
06079712210257000,2019,204339,1214761,1419100,INCOME
06079712210270000,2021,280362,2003638,2284000,INCOME
06079712210270000,2020,201241,1818159,2019400,INCOME
06079712210270000,2019,201241,1190959,1392200,INCOME
06079712210300000,2021,272690,519610,792300,INCOME
06079712210300000,2020,197591,497309,694900,INCOME
06079712210300000,2019,197591,497309,694900,INCOME
06079712210330000,2021,318674,257326,576000,INCOME
06079712210330000,2020,218990,290910,509900,INCOME
06079712210330000,2019,218990,290910,509900,INCOME
06079712210360000,2021,799776,454824,1254600,INCOME
06079712210360000,2020,401903,675597,1077500,INCOME
06079712210360000,2019,401903,675597,1077500,INCOME
06079712210400000,2021,852080,2191020,3043100,INCOME
06079712210400000,2020,419059,2306941,2726000,INCOME
06079712210400000,2019,419059,1474541,1893600,INCOME
06079712210550000,2021,197002,186180,383182,COST
06079712210550000,2020,164126,166550,330676,COST
06079712210550000,2019,164126,166550,330676,COST
06079712303010000,2021,183410,335690,519100,INCOME
06079712303010000,2020,251003,191297,442300,INCOME
06079712303010000,2019,251003,191297,442300,INCOME
06079712303020000,2021,188177,641123,829300,INCOME
06079712303020000,2020,255289,450111,705400,INCOME
06079712303020000,2019,255289,450111,705400,INCOME
06079712303030000,2021,188177,379923,568100,INCOME
06079712303030000,2020,255289,199811,455100,INCOME
06079712303030000,2019,255289,199811,455100,INCOME
06079712303040000,2021,194337,657363,851700,INCOME
06079712303040000,2020,260774,340426,601200,INCOME
06079712303040000,2019,260774,340426,601200,INCOME
06079712303050000,2021,218549,1077151,1295700,INCOME
06079712303050000,2020,281781,808019,1089800,INCOME
06079712303050000,2019,281781,808019,1089800,INCOME
06079712303060000,2021,168503,525197,693700,INCOME
06079712303060000,2020,143818,456182,600000,INCOME
06079712303060000,2019,143818,456182,600000,INCOME
06079712303070000,2021,137201,1606799,1744000,INCOME
06079712303070000,2020,125579,1244421,1370000,INCOME
06079712303070000,2019,125579,1244421,1370000,INCOME
06079712303080000,2021,146939,254361,401300,INCOME
06079712303080000,2020,131392,223408,354800,INCOME
06079712303080000,2019,131392,223408,354800,INCOME
06079712303090900,2021,139759,423941,563700,INCOME
06079712303090900,2020,127120,337380,464500,INCOME
06079712303090900,2019,127120,337380,464500,INCOME
06079712303100000,2021,136169,143690,279859,COST
06079712303100000,2020,124955,136640,261595,COST
06079712303100000,2019,124955,136640,261595,COST
06079712303110000,2021,135996,325604,461600,INCOME
06079712303110000,2020,124851,292949,417800,INCOME
06079712303110000,2019,124851,292949,417800,INCOME
06079712303120000,2021,135996,352904,488900,INCOME
06079712303120000,2020,124851,315649,440500,INCOME
06079712303120000,2019,124851,315649,440500,INCOME
06079712303130000,2021,135996,403440,539436,COST
06079712303130000,2020,124851,401349,526200,INCOME
06079712303130000,2019,124851,401349,526200,INCOME
06079712303140000,2021,135996,472204,608200,INCOME
06079712303140000,2020,124851,426049,550900,INCOME
06079712303140000,2019,124851,426049,550900,INCOME
06079712303150000,2021,140943,301460,442403,COST
06079712303150000,2020,127830,272770,400600,INCOME
06079712303150000,2019,127830,272770,400600,INCOME
06079712303170000,2021,536887,0,536887,COST
06079712303170000,2020,198179,0,198179,COST
06079712303170000,2019,198179,0,198179,COST
06079712303190000,2021,469809,0,469809,COST
06079712303190000,2020,377463,0,377463,COST
06079712303190000,2019,377463,0,377463,COST
06079712305020000,2021,438942,1225120,1664062,COST
06079712305020000,2020,446435,927965,1374400,INCOME
06079712305020000,2019,446435,927965,1374400,INCOME
06079712305047000,2021,223062,13020,236082,COST
06079712305047000,2020,173060,13970,187030,COST
06079712305047000,2019,173060,13970,187030,COST
06079712305050000,2021,158342,413858,572200,INCOME
06079712305050000,2020,138035,368665,506700,INCOME
06079712305050000,2019,138035,368665,506700,INCOME
06079712305060000,2021,152305,286395,438700,INCOME
06079712305060000,2020,134539,198861,333400,INCOME
06079712305060000,2019,134539,198861,333400,INCOME
06079712305070000,2021,268238,903662,1171900,INCOME
06079712305070000,2020,322568,639632,962200,INCOME
06079712305070000,2019,322568,639632,962200,INCOME
06079712305120000,2021,422542,904860,1327402,COST
06079712305120000,2020,435358,823942,1259300,INCOME
06079712305120000,2019,435358,823942,1259300,INCOME
06079712308020000,2021,199521,292879,492400,MKT
06079712308020000,2020,166488,212012,378500,MKT
06079712308020000,2019,166488,212012,378500,MKT
06079712308030000,2021,196545,319355,515900,MKT
06079712308030000,2020,163703,248497,412200,MKT
06079712308030000,2019,163703,248497,412200,MKT
06079712308040000,2021,196866,264934,461800,MKT
06079712308040000,2020,164003,233997,398000,MKT
06079712308040000,2019,164003,233997,398000,MKT
06079712308050000,2021,194334,429166,623500,MKT
06079712308050000,2020,161637,416763,578400,MKT
06079712308050000,2019,161637,416763,578400,MKT
06079712308060000,2021,194990,321910,516900,MKT
06079712308060000,2020,162249,287851,450100,MKT
06079712308060000,2019,162249,287851,450100,MKT
06079712308070000,2021,188220,245180,433400,MKT
06079712308070000,2020,155940,220260,376200,MKT
06079712308070000,2019,155940,220260,376200,MKT
06079712308080000,2021,199770,341430,541200,MKT
06079712308080000,2020,166722,292178,458900,MKT
06079712308080000,2019,166722,292178,458900,MKT
06079712308090000,2021,252738,232362,485100,MKT
06079712308090000,2020,217096,194204,411300,MKT
06079712308090000,2019,217096,194204,411300,MKT
06079712308100000,2021,275708,739492,1015200,INCOME
06079712308100000,2020,199031,695569,894600,INCOME
06079712308100000,2019,199031,695569,894600,INCOME
06079712308110000,2021,134786,227014,361800,INCOME
06079712308110000,2020,124116,200184,324300,INCOME
06079712308110000,2019,124116,200184,324300,INCOME
06079712308120000,2021,134438,289562,424000,INCOME
06079712308120000,2020,123905,266895,390800,INCOME
06079712308120000,2019,123905,266895,390800,INCOME
06079712308130000,2021,134091,199809,333900,INCOME
06079712308130000,2020,123694,171580,295274,COST
06079712308130000,2019,123694,171580,295274,COST
06079712308140000,2021,133568,437232,570800,INCOME
06079712308140000,2020,123375,427525,550900,INCOME
06079712308140000,2019,123375,427525,550900,INCOME
06079712308150000,2021,133219,279481,412700,INCOME
06079712308150000,2020,123163,248637,371800,INCOME
06079712308150000,2019,123163,248637,371800,INCOME
06079712308160000,2021,132694,283006,415700,INCOME
06079712308160000,2020,122842,248840,371682,COST
06079712308160000,2019,122842,248840,371682,COST
06079712308170000,2021,133044,323756,456800,INCOME
06079712308170000,2020,123056,267944,391000,INCOME
06079712308170000,2019,123056,106844,229900,INCOME
06079712308180000,2021,150853,259147,410000,INCOME
06079712308180000,2020,133691,215950,349641,COST
06079712308180000,2019,133691,215950,349641,COST
06079712308197000,2021,413429,36640,450069,COST
06079712308197000,2020,429139,942161,1371300,INCOME
06079712308197000,2019,429139,942161,1371300,INCOME
06079712309010000,2021,211777,623023,834800,MKT
06079712309010000,2020,178011,477589,655600,MKT
06079712309010000,2019,178011,477589,655600,MKT
06079712309020000,2021,213313,448540,661853,COST
06079712309020000,2020,179461,0,179461,COST
06079712309020000,2019,179461,0,179461,COST
06079712309030000,2021,236705,271995,508700,MKT
06079712309030000,2020,201697,245203,446900,MKT
06079712309030000,2019,201697,245203,446900,MKT
06079712309040000,2021,215630,338970,554600,MKT
06079712309040000,2020,181650,298550,480200,MKT
06079712309040000,2019,181650,298550,480200,MKT
06079712309050000,2021,209146,428754,637900,MKT
06079712309050000,2020,175531,358469,534000,MKT
06079712309050000,2019,175531,358469,534000,MKT
06079712309060000,2021,205394,428706,634100,MKT
06079712309060000,2020,171999,346301,518300,MKT
06079712309060000,2019,171999,346301,518300,MKT
06079712309070000,2021,199770,531130,730900,MKT
06079712309070000,2020,166722,448078,614800,MKT
06079712309070000,2019,166722,448078,614800,MKT
06079712309080000,2021,228052,277448,505500,MKT
06079712309080000,2020,193439,257761,451200,MKT
06079712309080000,2019,193439,257761,451200,MKT
06079712310010000,2021,264037,685890,949927,COST
06079712310010000,2020,228021,546979,775000,OVR
06079712310010000,2019,228021,567720,795741,COST
06079712310020000,2021,259322,438478,697800,MKT
06079712310020000,2020,223455,336610,560065,COST
06079712310020000,2019,223455,336610,560065,COST
06079712310030000,2021,256617,218720,475337,COST
06079712310030000,2020,220840,200400,421240,COST
06079712310030000,2019,220840,200400,421240,COST
06079712310040000,2021,254426,398374,652800,MKT
06079712310040000,2020,218724,337600,556324,COST
06079712310040000,2019,218724,337600,556324,COST
06079712310050000,2021,254807,264693,519500,MKT
06079712310050000,2020,219092,243908,463000,MKT
06079712310050000,2019,219092,243908,463000,MKT
06079712310060000,2021,247532,0,247532,COST
06079712310060000,2020,212082,0,212082,COST
06079712310060000,2019,212082,0,212082,COST
06079712310070000,2021,246317,380120,626437,COST
06079712310070000,2020,210914,345340,556254,COST
06079712310070000,2019,210914,345340,556254,COST
06079712311010000,2021,199021,267279,466300,MKT
06079712311010000,2020,166020,272880,438900,MKT
06079712311010000,2019,166020,272880,438900,MKT
06079712311020000,2021,262580,378690,641270,COST
06079712311020000,2020,226609,333620,560229,COST
06079712311020000,2019,226609,313970,540579,COST
06079712311030000,2021,272325,362875,635200,MKT
06079712311030000,2020,236071,247929,484000,MKT
06079712311030000,2019,236071,247929,484000,MKT
06079712311040000,2021,253470,300780,554250,COST
06079712311040000,2020,217802,267150,484952,COST
06079712311040000,2019,217802,267150,484952,COST
06079712311050000,2021,256317,517550,773867,COST
06079712311050000,2020,220550,455877,676427,MRA
06079712311050000,2019,220550,455877,676427,MRA
06079712311060000,2021,227527,480273,707800,MKT
06079712311060000,2020,192939,384061,577000,MKT
06079712311060000,2019,192939,384061,577000,MKT
06079712311070000,2021,195900,0,195900,COST
06079712311070000,2020,163100,0,163100,COST
06079712311070000,2019,163100,0,163100,COST
06079712321010000,2021,293889,712970,1006859,COST
06079712321010000,2020,257155,646970,904125,COST
06079712321010000,2019,257155,646970,904125,COST
06079712321020000,2021,317297,1109900,1427197,COST
06079712321020000,2020,280257,1003030,1283287,COST
06079712321020000,2019,280257,945300,1225557,COST
06079712321030000,2021,196198,1312830,1509028,COST
06079712321030000,2020,163377,1294310,1457687,OVR
06079712321030000,2019,163377,1294310,1457687,COST
06079712321040000,2021,171,0,171,COST
06079712321040000,2020,159,0,159,COST
06079712321040000,2019,159,0,159,COST
06079712321050000,2021,298178,238622,536800,MKT
06079712321050000,2020,261371,182229,443600,MKT
06079712321050000,2019,261371,182229,443600,MKT
06079712322010000,2021,265199,0,265199,COST
06079712322010000,2020,229147,0,229147,COST
06079712322010000,2019,229147,0,229147,COST
06079712322020000,2021,243768,351132,594900,MKT
06079712322020000,2020,208465,285935,494400,MKT
06079712322020000,2019,208465,285935,494400,MKT
06079712322030000,2021,239624,433476,673100,MKT
06079712322030000,2020,204491,441409,645900,MKT
06079712322030000,2019,204491,419240,623731,COST
06079712322040000,2021,238977,249823,488800,MKT
06079712322040000,2020,203871,213200,417071,COST
06079712322040000,2019,203871,213200,417071,COST
06079712322050000,2021,256842,323540,580382,COST
06079712322050000,2020,221057,285460,506517,COST
06079712322050000,2019,221057,285460,506517,COST
06079712322060000,2021,280381,502050,782431,COST
06079712322060000,2020,243925,454320,698245,COST
06079712322060000,2019,243925,454320,698245,COST
06079712322070000,2021,255979,483040,739019,COST
06079712322070000,2020,220223,397600,617823,COST
06079712322070000,2019,220223,397600,617823,COST
06079712330010000,2021,427174,0,427174,COST
06079712330010000,2020,170430,0,170430,COST
06079712330010000,2019,170430,0,170430,COST
06079712330030000,2021,416999,2410801,2827800,INCOME
06079712330030000,2020,167741,2363159,2530900,INCOME
06079712330030000,2019,167741,1029059,1196800,INCOME
06079712330050000,2021,420067,782133,1202200,INCOME
06079712330050000,2020,168554,992446,1161000,INCOME
06079712330050000,2019,168554,992446,1161000,INCOME
06079712330070000,2021,421087,323813,744900,INCOME
06079712330070000,2020,168824,422276,591100,INCOME
06079712330070000,2019,168824,422276,591100,INCOME
06079712330090000,2021,415973,260227,676200,INCOME
06079712330090000,2020,167468,342432,509900,INCOME
06079712330090000,2019,167468,342432,509900,INCOME
06079712330110000,2021,469571,0,469571,COST
06079712330110000,2020,181412,0,181412,COST
06079712330110000,2019,181412,0,181412,COST
06079712330130000,2021,465512,0,465512,COST
06079712330130000,2020,180375,0,180375,COST
06079712330130000,2019,180375,0,180375,COST
06079712330157000,2021,229482,76030,305512,COST
06079712330157000,2020,176331,75860,252191,COST
06079712330157000,2019,176331,75860,252191,COST
06079712330170000,2021,445122,428678,873800,INCOME
06079712330170000,2020,175122,624478,799600,INCOME
06079712330170000,2019,175122,624478,799600,INCOME
06079712330190000,2021,424137,535863,960000,INCOME
06079712330190000,2020,169630,442270,611900,INCOME
06079712330190000,2019,169630,442270,611900,INCOME
06079712330210000,2021,445614,506686,952300,INCOME
06079712330210000,2020,175250,582250,757500,INCOME
06079712330210000,2019,175250,582250,757500,INCOME
06079712330230000,2021,416967,453580,870547,COST
06079712330230000,2020,168564,436690,605254,COST
06079712330230000,2019,168564,436690,605254,COST
06079712332010000,2021,498092,462108,960200,INCOME
06079712332010000,2020,392308,490792,883100,INCOME
06079712332010000,2019,392308,490792,883100,INCOME
06079712332030000,2021,467902,1096230,1564132,COST
06079712332030000,2020,376451,1017349,1393800,INCOME
06079712332030000,2019,376451,1017349,1393800,INCOME
06079712332050000,2021,446598,1563202,2009800,INCOME
06079712332050000,2020,365051,1308449,1673500,INCOME
06079712332050000,2019,365051,1308449,1673500,INCOME
06079712332070000,2021,444630,822070,1266700,INCOME
06079712332070000,2020,363989,916011,1280000,INCOME
06079712332070000,2019,363989,916011,1280000,INCOME
06079712332090000,2021,439190,0,439190,COST
06079712332090000,2020,361044,0,361044,COST
06079712332090000,2019,361044,0,361044,COST
06079712332110000,2021,464074,0,464074,COST
06079712332110000,2020,374416,0,374416,COST
06079712332110000,2019,374416,0,374416,COST
06079712332130000,2021,470047,1123253,1593300,INCOME
06079712332130000,2020,377589,727511,1105100,INCOME
06079712332130000,2019,377589,727511,1105100,INCOME
06079712401010000,2021,792531,4017169,4809700,INCOME
06079712401010000,2020,659305,3018595,3677900,INCOME
06079712401010000,2019,659305,3018595,3677900,INCOME
06079712401060000,2021,706931,575969,1282900,INCOME
06079712401060000,2020,611408,499292,1110700,INCOME
06079712401060000,2019,611408,499292,1110700,INCOME
06079712401120000,2021,694797,3932403,4627200,INCOME
06079712401120000,2020,604463,2689137,3293600,INCOME
06079712401120000,2019,604463,2689137,3293600,INCOME
06079712401160000,2021,313129,909571,1222700,INCOME
06079712401160000,2020,357245,693055,1050300,INCOME
06079712401160000,2019,357245,693055,1050300,INCOME
06079712401180000,2021,243085,1292415,1535500,INCOME
06079712401180000,2020,183160,1203940,1387100,INCOME
06079712401180000,2019,183160,1203940,1387100,INCOME
06079712401216500,2021,42212,1180,43392,COST
06079712401216500,2020,38303,1200,39503,COST
06079712401216500,2019,38303,1200,39503,COST
06079712401280000,2021,263577,0,263577,COST
06079712401280000,2020,227575,0,227575,COST
06079712401280000,2019,227575,0,227575,COST
06079712401320000,2021,267008,702570,969578,COST
06079712401320000,2020,230903,636810,867713,COST
06079712401320000,2019,230903,636810,867713,COST
06079712401360000,2021,267250,0,267250,COST
06079712401360000,2020,231137,0,231137,COST
06079712401360000,2019,231137,0,231137,COST
06079712401400000,2021,264813,0,264813,COST
06079712401400000,2020,228773,0,228773,COST
06079712401400000,2019,228773,0,228773,COST
06079712401500000,2021,313799,709840,1023639,COST
06079712401500000,2020,276792,651230,928022,COST
06079712401500000,2019,276792,651230,928022,COST
06079712402010000,2021,184106,586394,770500,MKT
06079712402010000,2020,131201,582299,713500,MKT
06079712402010000,2019,131201,582299,713500,MKT
06079712402030000,2021,184106,411494,595600,MKT
06079712402030000,2020,131201,376299,507500,MKT
06079712402030000,2019,131201,376299,507500,MKT
06079712402050000,2021,184106,655594,839700,MKT
06079712402050000,2020,131201,668870,800071,COST
06079712402050000,2019,131201,668870,800071,COST
06079712402070000,2021,184106,651794,835900,MKT
06079712402070000,2020,131201,633399,764600,MKT
06079712402070000,2019,131201,589999,721200,MKT
06079712402090000,2021,161685,440615,602300,MKT
06079712402090000,2020,113403,409597,523000,MKT
06079712402090000,2019,113403,409597,523000,MKT
06079712402110000,2021,161685,492415,654100,MKT
06079712402110000,2020,113403,488997,602400,MKT
06079712402110000,2019,113403,495997,609400,MKT
06079712402136500,2021,144909,0,144909,COST
06079712402136500,2020,116087,0,116087,COST
06079712402136500,2019,116087,0,116087,COST
06079712402150000,2021,159682,507018,666700,MKT
06079712402150000,2020,111827,470373,582200,MKT
06079712402150000,2019,111827,470373,582200,MKT
06079712402170000,2021,153343,445157,598500,MKT
06079712402170000,2020,106856,424944,531800,MKT
06079712402170000,2019,106856,424944,531800,MKT
06079712402190000,2021,157626,456774,614400,MKT
06079712402190000,2020,110212,440588,550800,MKT
06079712402190000,2019,110212,440588,550800,MKT
06079712402210000,2021,153343,490457,643800,MKT
06079712402210000,2020,106856,435244,542100,MKT
06079712402210000,2019,106856,435244,542100,MKT
06079712402230000,2021,157626,467974,625600,MKT
06079712402230000,2020,110212,469988,580200,MKT
06079712402230000,2019,110212,469988,580200,MKT
06079712402250000,2021,161685,467015,628700,MKT
06079712402250000,2020,113403,445597,559000,MKT
06079712402250000,2019,113403,445597,559000,MKT
06079712403010000,2021,155514,424486,580000,MKT
06079712403010000,2020,108556,398544,507100,MKT
06079712403010000,2019,108556,398544,507100,MKT
06079712403030000,2021,155514,524986,680500,MKT
06079712403030000,2020,108556,480044,588600,MKT
06079712403030000,2019,108556,480044,588600,MKT
06079712403050000,2021,155514,396886,552400,MKT
06079712403050000,2020,108556,373944,482500,MKT
06079712403050000,2019,108556,373944,482500,MKT
06079712403070000,2021,155514,539686,695200,MKT
06079712403070000,2020,108556,492844,601400,MKT
06079712403070000,2019,108556,492844,601400,MKT
06079712403090000,2021,191412,450588,642000,MKT
06079712403090000,2020,137059,429641,566700,MKT
06079712403090000,2019,137059,429641,566700,MKT
06079712403110000,2021,159682,503918,663600,MKT
06079712403110000,2020,111827,459673,571500,MKT
06079712403110000,2019,111827,459673,571500,MKT
06079712403130000,2021,163640,541060,704700,MKT
06079712403130000,2020,114943,468357,583300,MKT
06079712403130000,2019,114943,400657,515600,MKT
06079712403150000,2021,159682,508918,668600,MKT
06079712403150000,2020,111827,483173,595000,MKT
06079712403150000,2019,111827,483173,595000,MKT
06079712403170000,2021,157626,458774,616400,MKT
06079712403170000,2020,110212,429188,539400,MKT
06079712403170000,2019,110212,429188,539400,MKT
06079712403190000,2021,157626,413074,570700,MKT
06079712403190000,2020,110212,442988,553200,MKT
06079712403190000,2019,110212,442988,553200,MKT
06079712403210000,2021,157626,333374,491000,MKT
06079712403210000,2020,110212,326088,436300,MKT
06079712403210000,2019,110212,326088,436300,MKT
06079712403230000,2021,157626,322174,479800,MKT
06079712403230000,2020,110212,320988,431200,MKT
06079712403230000,2019,110212,320988,431200,MKT
06079712403250000,2021,157626,606274,763900,MKT
06079712403250000,2020,110212,542188,652400,MKT
06079712403250000,2019,110212,542188,652400,MKT
06079712403270000,2021,157626,500274,657900,MKT
06079712403270000,2020,110212,473188,583400,MKT
06079712403270000,2019,110212,473188,583400,MKT
06079712403290000,2021,157626,396874,554500,MKT
06079712403290000,2020,110212,388288,498500,MKT
06079712403290000,2019,110212,388288,498500,MKT
06079712403310000,2021,157626,428474,586100,MKT
06079712403310000,2020,110212,356988,467200,MKT
06079712403310000,2019,110212,356988,467200,MKT
06079712403330000,2021,157626,487574,645200,MKT
06079712403330000,2020,110212,473188,583400,MKT
06079712403330000,2019,110212,473188,583400,MKT
06079712403350000,2021,157626,462974,620600,MKT
06079712403350000,2020,110212,423788,534000,MKT
06079712403350000,2019,110212,423788,534000,MKT
06079712403370000,2021,157626,478574,636200,MKT
06079712403370000,2020,110212,448488,558700,MKT
06079712403370000,2019,110212,448488,558700,MKT
06079712403390000,2021,157626,389174,546800,MKT
06079712403390000,2020,110212,328288,438500,MKT
06079712403390000,2019,110212,328288,438500,MKT
06079712404010000,2021,176160,295940,472100,MKT
06079712404010000,2020,124861,245839,370700,MKT
06079712404010000,2019,124861,245839,370700,MKT
06079712404030000,2021,169236,350464,519700,MKT
06079712404030000,2020,119365,334535,453900,MKT
06079712404030000,2019,119365,334535,453900,MKT
06079712404050000,2021,165548,298452,464000,MKT
06079712404050000,2020,116449,267451,383900,MKT
06079712404050000,2019,116449,267451,383900,MKT
06079712404070000,2021,159682,303718,463400,MKT
06079712404070000,2020,111827,275673,387500,MKT
06079712404070000,2019,111827,275673,387500,MKT
06079712404090000,2021,159682,526718,686400,MKT
06079712404090000,2020,111827,472473,584300,MKT
06079712404090000,2019,111827,351573,463400,MKT
06079712404110000,2021,159682,320418,480100,MKT
06079712404110000,2020,111827,313573,425400,MKT
06079712404110000,2019,111827,313573,425400,MKT
06079712404130000,2021,159682,355218,514900,MKT
06079712404130000,2020,111827,294273,406100,MKT
06079712404130000,2019,111827,294273,406100,MKT
06079712404150000,2021,159682,349718,509400,MKT
06079712404150000,2020,111827,328673,440500,MKT
06079712404150000,2019,111827,328673,440500,MKT
06079712404170000,2021,159682,504218,663900,MKT
06079712404170000,2020,111827,459673,571500,MKT
06079712404170000,2019,111827,459673,571500,MKT
06079712404190000,2021,159682,300518,460200,MKT
06079712404190000,2020,111827,307273,419100,MKT
06079712404190000,2019,111827,307273,419100,MKT
06079712404210000,2021,159682,393618,553300,MKT
06079712404210000,2020,111827,335773,447600,MKT
06079712404210000,2019,111827,335773,447600,MKT
06079712404230000,2021,159682,363618,523300,MKT
06079712404230000,2020,111827,323973,435800,MKT
06079712404230000,2019,111827,323973,435800,MKT
06079712404250000,2021,159682,404818,564500,MKT
06079712404250000,2020,111827,383373,495200,MKT
06079712404250000,2019,111827,383373,495200,MKT
06079712404270000,2021,159682,362918,522600,MKT
06079712404270000,2020,111827,357473,469300,MKT
06079712404270000,2019,111827,357473,469300,MKT
06079712404290000,2021,159682,405218,564900,MKT
06079712404290000,2020,111827,385873,497700,MKT
06079712404290000,2019,111827,385873,497700,MKT
06079712404310000,2021,165548,324452,490000,MKT
06079712404310000,2020,116449,291351,407800,MKT
06079712404310000,2019,116449,291351,407800,MKT
06079712404330000,2021,176160,430680,606840,COST
06079712404330000,2020,124861,394220,519081,COST
06079712404330000,2019,124861,394220,519081,COST
06079712405010000,2021,576189,5372230,5948419,COST
06079712405010000,2020,472248,5157000,5629248,COST
06079712405010000,2019,472248,5157000,5629248,COST
06079712406010000,2021,161685,400015,561700,MKT
06079712406010000,2020,113403,334097,447500,MKT
06079712406010000,2019,113403,334097,447500,MKT
06079712406030000,2021,161685,441115,602800,MKT
06079712406030000,2020,113403,409597,523000,OVR
06079712406030000,2019,113403,409597,523000,OVR
06079712406050000,2021,161685,532715,694400,MKT
06079712406050000,2020,113403,466597,580000,MKT
06079712406050000,2019,113403,466597,580000,MKT
06079712406070000,2021,161685,424615,586300,MKT
06079712406070000,2020,113403,345097,458500,MKT
06079712406070000,2019,113403,345097,458500,MKT
06079712406090000,2021,161685,483715,645400,MKT
06079712406090000,2020,113403,442197,555600,MKT
06079712406090000,2019,113403,442197,555600,MKT
06079712406110000,2021,161685,457115,618800,MKT
06079712406110000,2020,113403,380997,494400,MKT
06079712406110000,2019,113403,380997,494400,MKT
06079712406130000,2021,155514,306286,461800,MKT
06079712406130000,2020,108556,301044,409600,MKT
06079712406130000,2019,108556,301044,409600,MKT
06079712406150000,2021,167413,328887,496300,MKT
06079712406150000,2020,117923,294077,412000,MKT
06079712406150000,2019,117923,294077,412000,MKT
06079712406170000,2021,174481,430219,604700,MKT
06079712406170000,2020,123526,424374,547900,MKT
06079712406170000,2019,123526,424374,547900,MKT
06079712406190000,2021,184106,283294,467400,MKT
06079712406190000,2020,131201,236699,367900,MKT
06079712406190000,2019,131201,236699,367900,MKT
06079712406210000,2021,172769,498420,671189,COST
06079712406210000,2020,122166,445640,567806,COST
06079712406210000,2019,122166,445640,567806,COST
06079712406230000,2021,159682,441218,600900,MKT
06079712406230000,2020,111827,409573,521400,MKT
06079712406230000,2019,111827,409573,521400,MKT
06079712406250000,2021,161685,373915,535600,MKT
06079712406250000,2020,113403,329797,443200,MKT
06079712406250000,2019,113403,329797,443200,MKT
06079712406270000,2021,161685,436715,598400,MKT
06079712406270000,2020,113403,408897,522300,MKT
06079712406270000,2019,113403,408897,522300,MKT
06079712406290000,2021,161685,374515,536200,MKT
06079712406290000,2020,113403,321597,435000,MKT
06079712406290000,2019,113403,321597,435000,MKT
06079712406310000,2021,161685,265415,427100,MKT
06079712406310000,2020,113403,237097,350500,MKT
06079712406310000,2019,113403,237097,350500,MKT
06079712406330000,2021,161685,337415,499100,MKT
06079712406330000,2020,113403,315997,429400,MKT
06079712406330000,2019,113403,315997,429400,MKT
06079712406350000,2021,161685,411615,573300,MKT
06079712406350000,2020,113403,333597,447000,MKT
06079712406350000,2019,113403,333597,447000,MKT
06079712407010000,2021,169236,548864,718100,MKT
06079712407010000,2020,119365,515535,634900,MKT
06079712407010000,2019,119365,515535,634900,MKT
06079712407030000,2021,163640,446160,609800,MKT
06079712407030000,2020,114943,433357,548300,MKT
06079712407030000,2019,114943,433357,548300,MKT
06079712407050000,2021,167413,420087,587500,MKT
06079712407050000,2020,117923,408777,526700,MKT
06079712407050000,2019,117923,408777,526700,MKT
06079712407070000,2021,176160,400340,576500,MKT
06079712407070000,2020,124861,369439,494300,MKT
06079712407070000,2019,124861,369439,494300,MKT
06079712408010000,2021,436369,49250,485619,COST
06079712408010000,2020,345670,47690,393360,COST
06079712408010000,2019,345670,47690,393360,COST
06079712408030000,2021,270377,288023,558400,MKT
06079712408030000,2020,201975,245625,447600,MKT
06079712408030000,2019,201975,245625,447600,MKT
06079712408050000,2021,167413,413387,580800,MKT
06079712408050000,2020,117923,380377,498300,MKT
06079712408050000,2019,117923,380377,498300,MKT
06079712408070000,2021,167413,384787,552200,MKT
06079712408070000,2020,117923,352177,470100,MKT
06079712408070000,2019,117923,352177,470100,MKT
06079712408090000,2021,171021,620179,791200,MKT
06079712408090000,2020,120779,587221,708000,MKT
06079712408090000,2019,120779,587221,708000,MKT
06079712408110000,2021,171021,359579,530600,MKT
06079712408110000,2020,120779,324621,445400,MKT
06079712408110000,2019,120779,324621,445400,MKT
06079712408130000,2021,171021,429379,600400,MKT
06079712408130000,2020,120779,362821,483600,OVR
06079712408130000,2019,120779,362821,483600,MKT
06079712408150000,2021,171021,468079,639100,MKT
06079712408150000,2020,120779,474521,595300,MKT
06079712408150000,2019,120779,474521,595300,MKT
06079712408170000,2021,165548,423552,589100,MKT
06079712408170000,2020,116449,387851,504300,MKT
06079712408170000,2019,116449,387851,504300,MKT
06079712408190000,2021,165548,433152,598700,MKT
06079712408190000,2020,116449,403751,520200,MKT
06079712408190000,2019,116449,403751,520200,MKT
06079712408210000,2021,177808,417292,595100,MKT
06079712408210000,2020,126173,409927,536100,MKT
06079712408210000,2019,126173,409927,536100,MKT
06079712408230000,2021,185614,514686,700300,MKT
06079712408230000,2020,132408,529292,661700,MKT
06079712408230000,2019,132408,529292,661700,MKT
06079712448010000,2021,284087,493170,777257,COST
06079712448010000,2020,247547,434860,682407,COST
06079712448010000,2019,247547,434860,682407,COST
06079712448020000,2021,257810,311390,569200,MKT
06079712448020000,2020,221993,265730,487723,COST
06079712448020000,2019,221993,265730,487723,COST
06079712448030000,2021,507821,6267090,6774911,COST
06079712448030000,2020,297822,6046110,6343932,COST
06079712448030000,2019,297822,6046110,6343932,COST
06079712448040000,2021,253316,270084,523400,MKT
06079712448040000,2020,217653,247447,465100,MKT
06079712448040000,2019,217653,247447,465100,MKT
06079712448050000,2021,284877,402423,687300,MKT
06079712448050000,2020,248320,438070,686390,COST
06079712448050000,2019,248320,438070,686390,COST
06079712448060000,2021,223983,337590,561573,COST
06079712448060000,2020,189569,301770,491339,COST
06079712448060000,2019,189569,301770,491339,COST
06079712448070000,2021,278173,620860,899033,COST
06079712448070000,2020,241769,550660,792429,COST
06079712448070000,2019,241769,550660,792429,COST
06079712448080000,2021,484594,851330,1335924,COST
06079712448080000,2020,164319,777120,941439,COST
06079712448080000,2019,164319,777120,941439,COST
06079712448090000,2021,294626,708870,1003496,COST
06079712448090000,2020,257879,648260,906139,COST
06079712448090000,2019,257879,648260,906139,COST
06079712448100000,2021,280194,514110,794304,COST
06079712448100000,2020,243741,462320,706061,COST
06079712448100000,2019,243741,462320,706061,COST
06079712448110000,2021,242850,281650,524500,MKT
06079712448110000,2020,207584,263416,471000,MKT
06079712448110000,2019,207584,263416,471000,MKT
06079712448120000,2021,333407,0,333407,COST
06079712448120000,2020,296280,0,296280,COST
06079712448120000,2019,296280,0,296280,COST
06079712448130000,2021,333407,343180,676587,COST
06079712448130000,2020,296280,309540,605820,COST
06079712448130000,2019,296280,309540,605820,COST
06079712461010000,2021,341448,119970,461418,COST
06079712461010000,2020,304314,115410,419724,COST
06079712461010000,2019,304314,115410,419724,COST
06079712461050000,2021,325253,0,325253,COST
06079712461050000,2020,288158,0,288158,COST
06079712461050000,2019,288158,0,288158,COST
06079713101010000,2021,386223,0,386223,COST
06079713101010000,2020,349457,0,349457,COST
06079713101010000,2019,349457,0,349457,COST
06079713101020000,2021,314048,56600,370648,COST
06079713101020000,2020,277038,51460,328498,COST
06079713101020000,2019,277038,51460,328498,COST
06079713101030900,2021,246317,254283,500600,MKT
06079713101030900,2020,210914,195850,406764,COST
06079713101030900,2019,210914,195850,406764,COST
06079713101040000,2021,196965,525630,722595,COST
06079713101040000,2020,164091,496530,660621,COST
06079713101040000,2019,164091,496530,660621,COST
06079713101050000,2021,399475,287950,687425,COST
06079713101050000,2020,345177,144670,489847,COST
06079713101050000,2019,345177,144670,489847,COST
06079713101060000,2021,195900,9820,205720,COST
06079713101060000,2020,163100,10240,173340,COST
06079713101060000,2019,163100,10240,173340,COST
06079713101070000,2021,246317,0,246317,COST
06079713101070000,2020,210914,0,210914,COST
06079713101070000,2019,210914,0,210914,COST
06079713101080000,2021,195900,219600,415500,MKT
06079713101080000,2020,163100,196800,359900,MKT
06079713101080000,2019,163100,196800,359900,MKT
06079713101090000,2021,199708,223992,423700,MKT
06079713101090000,2020,166663,246337,413000,MKT
06079713101090000,2019,166663,246337,413000,MKT
06079713101100000,2021,246317,262883,509200,MKT
06079713101100000,2020,210914,212620,423534,COST
06079713101100000,2019,210914,212620,423534,COST
06079713101110000,2021,243017,606420,849437,COST
06079713101110000,2020,207745,547020,754765,COST
06079713101110000,2019,207745,547020,754765,COST
06079713101120000,2021,255086,531400,786486,COST
06079713101120000,2020,212360,502940,715300,COST
06079713101120000,2019,212360,430340,642700,COST
06079713101130000,2021,243476,296524,540000,MKT
06079713101130000,2020,208186,257014,465200,MKT
06079713101130000,2019,208186,196314,404500,MKT
06079713101130900,2021,243476,0,243476,COST
06079713101130900,2020,208186,0,208186,COST
06079713101130900,2019,208186,0,208186,COST
06079713101140000,2021,164078,144110,308188,COST
06079713101140000,2020,164302,49040,213342,COST
06079713101140000,2019,280402,49040,329442,COST
06079713101150000,2021,195965,229735,425700,MKT
06079713101150000,2020,163160,187740,350900,MKT
06079713101150000,2019,163160,187740,350900,MKT
06079713101160000,2021,269913,193450,463363,COST
06079713101160000,2020,233725,180180,413905,COST
06079713101160000,2019,233725,180180,413905,COST
06079713101160900,2021,283366,315700,599066,COST
06079713101160900,2020,334460,304560,639020,COST
06079713101160900,2019,334460,304560,639020,COST
06079713101160901,2021,211998,30440,242438,COST
06079713101160901,2020,178219,27360,205579,COST
06079713101160901,2019,178219,27360,205579,COST
06079713101170000,2021,274302,286498,560800,MKT
06079713101170000,2020,237996,280330,518326,COST
06079713101170000,2019,237996,280330,518326,COST
06079713101180000,2021,290078,479020,769098,COST
06079713101180000,2020,339667,443870,783537,COST
06079713101180000,2019,339667,443870,783537,COST
06079713101190000,2021,377299,0,377299,COST
06079713101190000,2020,340406,0,340406,COST
06079713101190000,2019,340406,0,340406,COST
06079713101200000,2021,362524,910676,1273200,INCOME
06079713101200000,2020,393498,726602,1120100,INCOME
06079713101200000,2019,393498,726602,1120100,INCOME
06079713101210000,2021,233893,0,233893,COST
06079713101210000,2020,199009,0,199009,COST
06079713101210000,2019,199009,0,199009,COST
06079713101220000,2021,266211,208089,474300,MKT
06079713101220000,2020,230129,144200,374329,COST
06079713101220000,2019,230129,144200,374329,COST
06079713101230000,2021,278459,150320,428779,COST
06079713101230000,2020,242048,138090,380138,COST
06079713101230000,2019,242048,138090,380138,COST
06079713101240000,2021,11758,166390,178148,COST
06079713101240000,2020,16008,149380,165388,COST
06079713101240000,2019,16008,149380,165388,COST
06079713101240900,2021,3151,6040,9191,COST
06079713101240900,2020,2675,5460,8135,COST
06079713101240900,2019,2675,5460,8135,COST
06079713101250000,2021,279439,195400,474839,COST
06079713101250000,2020,243005,177420,420425,OVR
06079713101250000,2019,243005,177420,420425,COST
06079713101260000,2021,381073,0,381073,COST
06079713101260000,2020,377337,0,377337,COST
06079713101260000,2019,377337,0,377337,COST
06079713101270000,2021,293224,279680,572904,COST
06079713101270000,2020,281172,255770,536942,COST
06079713101270000,2019,281172,255770,536942,COST
06079713101280000,2021,385944,293230,679174,COST
06079713101280000,2020,349174,264270,613444,COST
06079713101280000,2019,349174,264270,613444,COST
06079713101300000,2021,282863,358137,641000,MKT
06079713101300000,2020,246350,330840,577190,COST
06079713101300000,2019,246350,290560,536910,COST
06079713101320000,2021,246317,477680,723997,COST
06079713101320000,2020,210914,433760,644674,COST
06079713101320000,2019,210914,433760,644674,COST
06079713101340000,2021,195900,360160,556060,COST
06079713101340000,2020,163100,323890,486990,COST
06079713101340000,2019,163100,323890,486990,COST
06079713101350000,2021,5169,143990,149159,COST
06079713101350000,2020,5216,129930,135146,COST
06079713101350000,2019,5216,129930,135146,COST
06079713101350100,2021,121,0,121,COST
06079713101350100,2020,112,0,112,COST
06079713101350100,2019,112,0,112,COST
06079713101370000,2021,331412,83310,414722,COST
06079713101370000,2020,294290,77350,371640,COST
06079713101370000,2019,294290,77350,371640,COST
06079713101390000,2021,130140,0,130140,COST
06079713101390000,2020,103052,0,103052,COST
06079713101390000,2019,103052,0,103052,COST
06079713101400000,2021,301182,347318,648500,INCOME
06079713101400000,2020,348192,195208,543400,INCOME
06079713101400000,2019,348192,195208,543400,INCOME
06079713101410000,2021,203374,0,203374,COST
06079713101410000,2020,170102,0,170102,COST
06079713101410000,2019,170102,0,170102,COST
06079713101420000,2021,116976,4240,121216,COST
06079713101420000,2020,91425,4110,95535,COST
06079713101420000,2019,91425,4110,95535,COST
06079713101430000,2021,364180,77460,441640,COST
06079713101430000,2020,394684,71510,466194,COST
06079713101430000,2019,394684,71510,466194,COST
06079713101440000,2021,233003,272560,505563,COST
06079713101440000,2020,293944,254220,548164,COST
06079713101440000,2019,293944,254220,548164,COST
06079713101450000,2021,182725,202275,385000,MKT
06079713101450000,2020,150838,195062,345900,MKT
06079713101450000,2019,150838,195062,345900,MKT
06079713101470000,2021,303469,585280,888749,COST
06079713101470000,2020,266584,533020,799604,COST
06079713101470000,2019,266584,533020,799604,COST
06079713101490000,2021,246317,164583,410900,MKT
06079713101490000,2020,210914,145980,356894,COST
06079713101490000,2019,210914,145980,356894,COST
06079713101500000,2021,236573,184727,421300,MKT
06079713101500000,2020,201571,159080,360651,COST
06079713101500000,2019,201571,159080,360651,COST
06079713101510000,2021,455880,434380,890260,COST
06079713101510000,2020,420954,397210,818164,COST
06079713101510000,2019,420954,397210,818164,COST
06079713101530000,2021,79590,0,79590,COST
06079713101530000,2020,68692,0,68692,COST
06079713101530000,2019,68692,0,68692,COST
06079713101600000,2021,290346,0,290346,COST
06079713101600000,2020,253677,0,253677,COST
06079713101800000,2021,296622,367440,664062,COST
06079713101800000,2020,259841,330410,590251,COST
06079713101800000,2019,259841,330410,590251,COST
06079713101820000,2021,275178,303920,579098,COST
06079713101820000,2020,194286,257010,451296,COST
06079713101820000,2019,194286,257010,451296,COST
06079713102010000,2021,211998,253202,465200,MKT
06079713102010000,2020,178219,235581,413800,MKT
06079713102010000,2019,178219,235581,413800,MKT
06079713102030000,2021,198581,192219,390800,MKT
06079713102030000,2020,165608,155792,321400,MKT
06079713102030000,2019,165608,155792,321400,MKT
06079713102050000,2021,198644,263956,462600,MKT
06079713102050000,2020,165667,234833,400500,MKT
06079713102050000,2019,165667,234833,400500,MKT
06079713102070000,2021,198455,306545,505000,MKT
06079713102070000,2020,165490,287810,453300,MKT
06079713102070000,2019,165490,287810,453300,MKT
06079713102090000,2021,198455,239945,438400,MKT
06079713102090000,2020,165490,206310,371800,MKT
06079713102090000,2019,165490,206310,371800,MKT
06079713102110000,2021,198455,212245,410700,MKT
06079713102110000,2020,165490,183410,348900,MKT
06079713102110000,2019,165490,183410,348900,MKT
06079713102130000,2021,198455,241545,440000,MKT
06079713102130000,2020,165490,206310,371800,MKT
06079713102130000,2019,165490,206310,371800,MKT
06079713103010000,2021,202773,331227,534000,MKT
06079713103010000,2020,169537,281063,450600,MKT
06079713103010000,2019,169537,281063,450600,MKT
06079713103030000,2021,197823,266777,464600,MKT
06079713103030000,2020,164898,210002,374900,MKT
06079713103030000,2019,164898,210002,374900,MKT
06079713103050000,2021,197823,244177,442000,MKT
06079713103050000,2020,164898,212302,377200,MKT
06079713103050000,2019,164898,212302,377200,MKT
06079713103070000,2021,197058,198242,395300,MKT
06079713103070000,2020,164183,191217,355400,MKT
06079713103070000,2019,164183,191217,355400,MKT
06079713103090000,2021,206039,222161,428200,MKT
06079713103090000,2020,172605,215795,388400,MKT
06079713103090000,2019,172605,215795,388400,MKT
06079713103110000,2021,221033,358667,579700,MKT
06079713103110000,2020,186768,352932,539700,MKT
06079713103110000,2019,186768,352932,539700,MKT
06079713104010000,2021,202167,189033,391200,MKT
06079713104010000,2020,168969,190731,359700,MKT
06079713104010000,2019,168969,190731,359700,MKT
06079713104030000,2021,198455,190345,388800,MKT
06079713104030000,2020,165490,179010,344500,MKT
06079713104030000,2019,165490,179010,344500,MKT
06079713104050000,2021,198455,211845,410300,MKT
06079713104050000,2020,165490,214310,379800,MKT
06079713104050000,2019,165490,214310,379800,MKT
06079713104070000,2021,198958,324142,523100,MKT
06079713104070000,2020,165961,299139,465100,MKT
06079713104070000,2019,165961,299139,465100,MKT
06079713150550000,2021,308786,0,308786,COST
06079713150550000,2020,271833,0,271833,COST
06079713150550000,2019,271833,0,271833,COST
06079713150680000,2021,156720,0,156720,COST
06079713150680000,2020,130480,0,130480,COST
06079713150680000,2019,130480,0,130480,COST
06079713201100000,2021,2768,0,2768,COST
06079713201100000,2020,2576,0,2576,COST
06079713201100000,2019,2576,0,2576,COST
06079713201300000,2021,64284,0,64284,COST
06079713201300000,2020,67505,0,67505,COST
06079713201300000,2019,67505,0,67505,COST
06079713252010000,2021,333953,559547,893500,INCOME
06079713252010000,2020,372750,443750,816500,INCOME
06079713252010000,2019,372750,443750,816500,INCOME
06079713252020000,2021,337432,282868,620300,INCOME
06079713252020000,2020,375308,178492,553800,INCOME
06079713252020000,2019,375308,178492,553800,INCOME
06079713252030000,2021,395918,661682,1057600,INCOME
06079713252030000,2020,417057,522143,939200,INCOME
06079713252030000,2019,417057,522143,939200,INCOME
06079713252040000,2021,336564,498636,835200,INCOME
06079713252040000,2020,374671,148329,523000,INCOME
06079713252040000,2019,374671,148329,523000,INCOME
06079713252050000,2021,366161,1348239,1714400,INCOME
06079713252050000,2020,396100,977200,1373300,INCOME
06079713252050000,2019,396100,977200,1373300,INCOME
06079713252060000,2021,166382,322518,488900,MKT
06079713252060000,2020,135779,305721,441500,MKT
06079713252060000,2019,135779,305721,441500,MKT
06079713252070000,2021,162790,223210,386000,MKT
06079713252070000,2020,133263,212737,346000,MKT
06079713252070000,2019,133263,212737,346000,MKT
06079713252080000,2021,162695,257905,420600,MKT
06079713252080000,2020,132406,230494,362900,MKT
06079713252080000,2019,132406,230494,362900,MKT
06079713252090000,2021,181222,383678,564900,MKT
06079713252090000,2020,149446,340554,490000,MKT
06079713252090000,2019,149446,340554,490000,MKT
06079713252100000,2021,186377,252323,438700,MKT
06079713252100000,2020,154227,233473,387700,MKT
06079713252100000,2019,154227,233473,387700,MKT
06079713252110000,2021,178137,285463,463600,MKT
06079713252110000,2020,146593,251107,397700,MKT
06079713252110000,2019,146593,251107,397700,MKT
06079713252120000,2021,191936,261564,453500,MKT
06079713252120000,2020,159400,221300,380700,MKT
06079713252120000,2019,159400,221300,380700,MKT
06079713252130000,2021,178137,270963,449100,MKT
06079713252130000,2020,146593,242107,388700,MKT
06079713252130000,2019,146593,242107,388700,MKT
06079713252140000,2021,188641,388959,577600,MKT
06079713252140000,2020,156331,347669,504000,MKT
06079713252140000,2019,156331,347669,504000,MKT
06079713252150000,2021,192876,298124,491000,MKT
06079713252150000,2020,160276,258524,418800,MKT
06079713252150000,2019,160276,258524,418800,MKT
06079713252160000,2021,178918,277882,456800,MKT
06079713252160000,2020,147315,256685,404000,MKT
06079713252160000,2019,147315,256685,404000,MKT
06079713252170000,2021,177507,277093,454600,MKT
06079713252170000,2020,146011,279089,425100,MKT
06079713252170000,2019,146011,279089,425100,MKT
06079713252180000,2021,241627,0,241627,COST
06079713252180000,2020,301079,0,301079,COST
06079713252180000,2019,301079,0,301079,COST
06079713252190000,2021,155802,376240,532042,COST
06079713252190000,2020,126125,349875,476000,MKT
06079713252190000,2019,126125,349875,476000,MKT
06079713252200000,2021,155802,417250,573052,COST
06079713252200000,2020,126125,381280,507405,COST
06079713252200000,2019,126125,381280,507405,COST
06079713252210000,2021,155802,268498,424300,MKT
06079713252210000,2020,126125,248775,374900,MKT
06079713252210000,2019,126125,248775,374900,MKT
06079713252220000,2021,155802,284898,440700,MKT
06079713252220000,2020,126125,264975,391100,MKT
06079713252220000,2019,126125,264975,391100,MKT
06079713252230000,2021,155802,288298,444100,MKT
06079713252230000,2020,126125,257275,383400,MKT
06079713252230000,2019,126125,223275,349400,MKT
06079713252240000,2021,155802,370598,526400,MKT
06079713252240000,2020,126125,329875,456000,MKT
06079713252240000,2019,126125,329875,456000,MKT
06079713252250000,2021,156213,217987,374200,MKT
06079713252250000,2020,126499,208801,335300,MKT
06079713252250000,2019,126499,208801,335300,MKT
06079713252260000,2021,176553,257447,434000,MKT
06079713252260000,2020,145131,221969,367100,MKT
06079713252260000,2019,145131,221969,367100,MKT
06079713252306500,2021,3699,0,3699,COST
06079713252306500,2020,7683,0,7683,COST
06079713252306500,2019,7683,0,7683,COST
06079713253010000,2021,155802,221798,377600,MKT
06079713253010000,2020,126125,202875,329000,MKT
06079713253010000,2019,126125,202875,329000,MKT
06079713253020000,2021,148229,189871,338100,MKT
06079713253020000,2020,119263,187937,307200,MKT
06079713253020000,2019,119263,187937,307200,MKT
06079713253030000,2021,158831,337100,495931,COST
06079713253030000,2020,128881,301550,430431,COST
06079713253030000,2019,128881,301550,430431,COST
06079713253040000,2021,157835,0,157835,COST
06079713253040000,2020,127973,0,127973,COST
06079713253040000,2019,127973,0,127973,COST
06079713253050000,2021,158831,224169,383000,MKT
06079713253050000,2020,128881,204719,333600,MKT
06079713253050000,2019,128881,204719,333600,MKT
06079713253060000,2021,161747,248753,410500,MKT
06079713253060000,2020,131540,218960,350500,MKT
06079713253060000,2019,131540,218960,350500,MKT
06079713253070000,2021,164560,244240,408800,MKT
06079713253070000,2020,134111,218289,352400,MKT
06079713253070000,2019,134111,218289,352400,MKT
06079713253080000,2021,164560,0,164560,COST
06079713253080000,2020,134111,0,134111,COST
06079713253080000,2019,134111,0,134111,COST
06079713253090000,2021,333603,0,333603,COST
06079713253090000,2020,372493,0,372493,COST
06079713253090000,2019,372493,0,372493,COST
06079713253100000,2021,368465,860500,1228965,COST
06079713253100000,2020,397742,888958,1286700,INCOME
06079713253100000,2019,397742,888958,1286700,INCOME
06079713253110000,2021,161747,0,161747,COST
06079713253110000,2020,131540,0,131540,COST
06079713253110000,2019,131540,0,131540,COST
06079713253120000,2021,160787,223613,384400,MKT
06079713253120000,2020,130664,198636,329300,MKT
06079713253120000,2019,130664,198636,329300,MKT
06079713253130000,2021,159815,315885,475700,MKT
06079713253130000,2020,129777,259523,389300,MKT
06079713253130000,2019,129777,259523,389300,MKT
06079713253140000,2021,159815,191585,351400,MKT
06079713253140000,2020,129777,197123,326900,MKT
06079713253140000,2019,129777,197123,326900,MKT
06079713253150000,2021,160787,265813,426600,MKT
06079713253150000,2020,130664,250136,380800,MKT
06079713253150000,2019,130664,250136,380800,MKT
06079713253160000,2021,158831,253069,411900,MKT
06079713253160000,2020,128881,226919,355800,MKT
06079713253160000,2019,128881,226919,355800,MKT
06079713253170000,2021,148229,209671,357900,MKT
06079713253170000,2020,119263,202937,322200,MKT
06079713253170000,2019,119263,202937,322200,MKT
06079713253180000,2021,153715,264385,418100,MKT
06079713253180000,2020,124230,236570,360800,MKT
06079713253180000,2019,124230,236570,360800,MKT
06079713254010000,2021,161460,253940,415400,MKT
06079713254010000,2020,131278,223422,354700,MKT
06079713254010000,2019,131278,223422,354700,MKT
06079713254020000,2021,157129,222271,379400,MKT
06079713254020000,2020,127332,228168,355500,MKT
06079713254020000,2019,127332,228168,355500,MKT
06079713254030000,2021,158831,218769,377600,MKT
06079713254030000,2020,128881,195319,324200,MKT
06079713254030000,2019,128881,195319,324200,MKT
06079713254040000,2021,159619,262281,421900,MKT
06079713254040000,2020,129599,257101,386700,MKT
06079713254040000,2019,129599,257101,386700,MKT
06079713254050000,2021,173462,363038,536500,MKT
06079713254050000,2020,142282,325418,467700,MKT
06079713254050000,2019,142282,325418,467700,MKT
06079713254060000,2021,209033,347567,556600,MKT
06079713254060000,2020,175424,281876,457300,MKT
06079713254060000,2019,175424,281876,457300,MKT
06079713254070000,2021,177507,243393,420900,MKT
06079713254070000,2020,146011,198889,344900,MKT
06079713254070000,2019,146011,198889,344900,MKT
06079713254080000,2021,149134,366866,516000,MKT
06079713254080000,2020,120082,332418,452500,MKT
06079713254080000,2019,120082,332418,452500,MKT
06079713254090000,2021,207027,378573,585600,MKT
06079713254090000,2020,173535,300665,474200,MKT
06079713254090000,2019,173535,300665,474200,MKT
06079713254100000,2021,179616,264884,444500,MKT
06079713254100000,2020,147960,238940,386900,MKT
06079713254100000,2019,147960,238940,386900,MKT
06079713254110000,2021,174859,187541,362400,MKT
06079713254110000,2020,143568,192332,335900,MKT
06079713254110000,2019,143568,192332,335900,MKT
06079713254120000,2021,211445,225455,436900,MKT
06079713254120000,2020,177698,228702,406400,MKT
06079713254120000,2019,177698,228702,406400,MKT
06079713254130000,2021,160496,390204,550700,MKT
06079713254130000,2020,130399,356701,487100,MKT
06079713254130000,2019,130399,356701,487100,MKT
06079713254140000,2021,146849,240051,386900,MKT
06079713254140000,2020,118018,228182,346200,MKT
06079713254140000,2019,118018,228182,346200,MKT
06079713255010000,2021,156825,344675,501500,MKT
06079713255010000,2020,127055,316045,443100,MKT
06079713255010000,2019,127055,316045,443100,MKT
06079713255020000,2021,160980,267920,428900,MKT
06079713255020000,2020,130840,239460,370300,MKT
06079713255020000,2019,130840,239460,370300,MKT
06079713255030000,2021,152327,240973,393300,MKT
06079713255030000,2020,122971,216929,339900,MKT
06079713255030000,2019,122971,216929,339900,MKT
06079713255040000,2021,166202,279298,445500,MKT
06079713255040000,2020,135614,249486,385100,MKT
06079713255040000,2019,135614,249486,385100,MKT
06079713255050000,2021,167635,279265,446900,MKT
06079713255050000,2020,136927,250173,387100,MKT
06079713255050000,2019,136927,250173,387100,MKT
06079713255060000,2021,160980,244020,405000,MKT
06079713255060000,2020,130840,212660,343500,MKT
06079713255060000,2019,130840,212660,343500,MKT
06079713256010000,2021,153926,271274,425200,MKT
06079713256010000,2020,124422,234978,359400,OVR
06079713256010000,2019,124422,234978,359400,MKT
06079713256020000,2021,163633,230467,394100,MKT
06079713256020000,2020,133263,231537,364800,MKT
06079713256020000,2019,133263,231537,364800,MKT
06079713256030000,2021,160883,252117,413000,MKT
06079713256030000,2020,130752,233248,364000,MKT
06079713256030000,2019,130752,233248,364000,MKT
06079713257010000,2021,173876,231524,405400,MKT
06079713257010000,2020,142662,202438,345100,MKT
06079713257010000,2019,142662,202438,345100,MKT
06079713257020000,2021,182127,294273,476400,MKT
06079713257020000,2020,150284,237916,388200,MKT
06079713257020000,2019,150284,237916,388200,MKT
06079713257030000,2021,165567,237833,403400,MKT
06079713257030000,2020,135033,223967,359000,MKT
06079713257030000,2019,135033,223967,359000,MKT
06079713257040000,2021,172797,285803,458600,MKT
06079713257040000,2020,141669,250131,391800,MKT
06079713257040000,2019,141669,250131,391800,MKT
06079713257050000,2021,173711,222889,396600,MKT
06079713257050000,2020,142510,194990,337500,MKT
06079713257050000,2019,142510,194990,337500,MKT
06079713257060000,2021,160010,263690,423700,MKT
06079713257060000,2020,129955,255545,385500,MKT
06079713257060000,2019,129955,255545,385500,MKT
06079713258010000,2021,180461,188939,369400,MKT
06079713258010000,2020,148741,153559,302300,MKT
06079713258010000,2019,148741,153559,302300,MKT
06079713258020000,2021,167900,242200,410100,MKT
06079713258020000,2020,137170,222230,359400,MKT
06079713258020000,2019,137170,222230,359400,MKT
06079713259010000,2021,169911,286089,456000,MKT
06079713259010000,2020,139016,260484,399500,MKT
06079713259010000,2019,139016,260484,399500,MKT
06079713259020000,2021,164190,295010,459200,MKT
06079713259020000,2020,133773,270227,404000,MKT
06079713259020000,2019,133773,270827,404600,MKT
06079713259030000,2021,180231,266969,447200,MKT
06079713259030000,2020,148529,256671,405200,MKT
06079713259030000,2019,148529,256671,405200,MKT
06079713259040000,2021,167279,292821,460100,MKT
06079713259040000,2020,136600,251800,388400,MKT
06079713259040000,2019,136600,251800,388400,MKT
06079713259050000,2021,172127,0,172127,COST
06079713259050000,2020,141053,0,141053,COST
06079713259050000,2019,141053,0,141053,COST
06079713259060000,2021,175022,290778,465800,MKT
06079713259060000,2020,143718,259582,403300,MKT
06079713259060000,2019,143718,259582,403300,MKT
06079713259070000,2021,158235,322665,480900,MKT
06079713259070000,2020,128338,267262,395600,MKT
06079713259070000,2019,128338,267262,395600,MKT
06079713259080000,2021,158732,187468,346200,MKT
06079713259080000,2020,128790,182310,311100,MKT
06079713259080000,2019,128790,182310,311100,MKT
06079713259090000,2021,197823,250777,448600,MKT
06079713259090000,2020,164898,216002,380900,MKT
06079713259090000,2019,164898,216002,380900,MKT
06079713259100000,2021,161651,289149,450800,MKT
06079713259100000,2020,131453,270147,401600,MKT
06079713259100000,2019,131453,270147,401600,MKT
06079713259110000,2021,161364,337836,499200,MKT
06079713259110000,2020,131190,281910,413100,MKT
06079713259110000,2019,131190,281910,413100,MKT
06079713259120000,2021,159423,197077,356500,MKT
06079713259120000,2020,129420,204180,333600,MKT
06079713259120000,2019,129420,204180,333600,MKT
06079713259130000,2021,161172,205128,366300,MKT
06079713259130000,2020,131015,206885,337900,MKT
06079713259130000,2019,131015,206885,337900,MKT
06079713259140000,2021,174777,367123,541900,MKT
06079713259140000,2020,143493,335707,479200,MKT
06079713259140000,2019,143493,335707,479200,MKT
06079713292010000,2021,271622,870570,1142192,COST
06079713292010000,2020,325248,856330,1181578,COST
06079713292010000,2019,325248,856330,1181578,COST
06079713292030000,2021,321415,368990,690405,COST
06079713292030000,2020,363456,245444,608900,INCOME
06079713292030000,2019,363456,245444,608900,INCOME
06079713301010000,2021,270520,148200,418720,COST
06079713301010000,2020,234315,131570,365885,COST
06079713301010000,2019,234315,131570,365885,COST
06079713301100000,2021,73,0,73,COST
06079713301100000,2020,68,0,68,COST
06079713301100000,2019,68,0,68,COST
06079713301120000,2021,53,0,53,COST
06079713301120000,2020,50,0,50,COST
06079713301120000,2019,50,0,50,COST
06079713301140000,2021,161606,2841820,3003426,COST
06079713301140000,2020,143798,2405800,2549598,COST
06079713301140000,2019,143798,2405800,2549598,COST
06079713301200000,2021,51,0,51,COST
06079713301200000,2020,48,0,48,COST
06079713301200000,2019,48,0,48,COST
06079713301220000,2021,52,0,52,COST
06079713301220000,2020,49,0,49,COST
06079713301220000,2019,49,0,49,COST
06079713302040000,2021,1972,0,1972,COST
06079713302040000,2020,1835,0,1835,COST
06079713302040000,2019,1835,0,1835,COST
06079713302180000,2021,195900,351700,547600,MKT
06079713302180000,2020,163100,302800,465900,MKT
06079713302180000,2019,163100,302800,465900,MKT
06079713303010000,2021,250792,226510,477302,COST
06079713303010000,2020,215220,203850,419070,COST
06079713303010000,2019,215220,203850,419070,COST
06079713303040000,2021,244992,200608,445600,MKT
06079713303040000,2020,206778,123370,330148,COST
06079713303040000,2019,206778,123370,330148,COST
06079713303070000,2021,238326,190874,429200,MKT
06079713303070000,2020,203248,193970,397218,COST
06079713303070000,2019,203248,193970,397218,COST
06079713303100000,2021,229751,186049,415800,MKT
06079713303100000,2020,195058,126270,321328,OVR
06079713303100000,2019,195058,126270,321328,COST
06079713304010000,2021,2002,611820,613822,COST
06079713304010000,2020,2271,553560,555831,COST
06079713304010000,2019,2271,553560,555831,COST
06079713304100000,2021,14750,685980,700730,COST
06079713304100000,2020,15048,617170,632218,COST
06079713304100000,2019,15048,617170,632218,COST
06079713305200000,2021,218,0,218,COST
06079713305200000,2020,204,0,204,COST
06079713305200000,2019,204,0,204,COST
06079713401010000,2021,195900,0,195900,COST
06079713401010000,2020,163100,0,163100,COST
06079713401010000,2019,163100,0,163100,COST
06079713401310000,2021,239624,76570,316194,COST
06079713401310000,2020,204491,55120,259611,COST
06079713401310000,2019,204491,55120,259611,COST
06079713401320000,2021,225939,405110,631049,COST
06079713401320000,2020,191428,364740,556168,COST
06079713401320000,2019,191428,364740,556168,COST
06079713401330000,2021,303736,233364,537100,MKT
06079713401330000,2020,266847,204453,471300,MKT
06079713401330000,2019,266847,204453,471300,MKT
06079713401340000,2021,339038,291290,630328,COST
06079713401340000,2020,301903,259580,561483,COST
06079713401340000,2019,301903,259580,561483,COST
06079713401350000,2021,252274,378890,631164,COST
06079713401350000,2020,216648,347810,564458,COST
06079713401350000,2019,216648,347810,564458,COST
06079713401360000,2021,245501,0,245501,COST
06079713401360000,2020,210130,0,210130,COST
06079713401360000,2019,210130,0,210130,COST
06079713401370000,2021,162884,37330,200214,COST
06079713401370000,2020,132578,37680,170258,COST
06079713401370000,2019,132578,37680,170258,COST
06079713401380000,2021,261611,867589,1129200,MKT
06079713401380000,2020,225670,670230,895900,MKT
06079713401380000,2019,225670,670230,895900,MKT
06079713401390000,2021,203972,301420,505392,COST
06079713401390000,2020,170664,259936,430600,MKT
06079713401390000,2019,170664,259936,430600,MKT
06079713401400000,2021,260889,0,260889,COST
06079713401400000,2020,224971,0,224971,COST
06079713401400000,2019,224971,0,224971,COST
06079713401410000,2021,199146,126880,326026,COST
06079713401410000,2020,166137,123310,289447,COST
06079713401410000,2019,166137,123310,289447,COST
06079713401516500,2021,92683,0,92683,COST
06079713401516500,2020,81500,0,81500,COST
06079713401516500,2019,81500,0,81500,COST
06079713401550000,2021,231771,386029,617800,MKT
06079713401550000,2020,215929,296290,512219,COST
06079713401550000,2019,215929,296290,512219,COST
06079713401560000,2021,198770,318010,516780,COST
06079713401560000,2020,165785,286320,452105,COST
06079713401560000,2019,165785,286320,452105,COST
06079713401570000,2021,196223,352877,549100,MKT
06079713401570000,2020,163402,280210,443612,COST
06079713401570000,2019,163402,280210,443612,COST
06079713401580000,2021,187090,257510,444600,MKT
06079713401580000,2020,154889,242111,397000,MKT
06079713401580000,2019,154889,242111,397000,MKT
06079713401590000,2021,196094,226806,422900,MKT
06079713401590000,2020,163281,211619,374900,MKT
06079713401590000,2019,163281,211619,374900,MKT
06079713401600000,2021,227192,331308,558500,MKT
06079713401600000,2020,192620,262640,455260,COST
06079713401600000,2019,192620,262640,455260,COST
06079713401610000,2021,227048,307652,534700,MKT
06079713401610000,2020,192483,292417,484900,MKT
06079713401610000,2019,192483,292417,484900,MKT
06079713401620000,2021,215736,136010,351746,COST
06079713401620000,2020,181751,123410,305161,COST
06079713401620000,2019,181751,123410,305161,COST
06079713401630000,2021,198392,0,198392,COST
06079713401630000,2020,165431,0,165431,COST
06079713401630000,2019,165431,0,165431,COST
06079713401640000,2021,198392,325970,524362,COST
06079713401640000,2020,165431,292320,457751,COST
06079713401640000,2019,165431,292320,457751,COST
06079713401650000,2021,198392,238708,437100,MKT
06079713401650000,2020,165431,215969,381400,MKT
06079713401650000,2019,165431,215969,381400,MKT
06079713401660000,2021,197058,209542,406600,MKT
06079713401660000,2020,164183,206917,371100,MKT
06079713401660000,2019,164183,206917,371100,MKT
06079713401670000,2021,201985,296915,498900,MKT
06079713401670000,2020,168798,287302,456100,MKT
06079713401670000,2019,168798,287302,456100,MKT
06079713401680000,2021,200143,168030,368173,COST
06079713401680000,2020,167071,160280,327351,COST
06079713401680000,2019,167071,160280,327351,COST
06079713402010000,2021,208292,192208,400500,MKT
06079713402010000,2020,174726,189874,364600,MKT
06079713402010000,2019,174726,189874,364600,MKT
06079713402020000,2021,280444,0,280444,COST
06079713402020000,2020,243986,0,243986,COST
06079713402020000,2019,243986,0,243986,COST
06079713402100000,2021,293789,0,293789,COST
06079713402100000,2020,281780,0,281780,COST
06079713402100000,2019,281780,0,281780,COST
06079713403010000,2021,218417,259283,477700,MKT
06079713403010000,2020,184288,202312,386600,MKT
06079713403010000,2019,184288,202312,386600,MKT
06079713403030000,2021,217897,0,217897,COST
06079713403030000,2020,183796,0,183796,COST
06079713403030000,2019,183796,0,183796,COST
06079713403050000,2021,209768,0,209768,COST
06079713403050000,2020,176116,0,176116,COST
06079713403050000,2019,176116,0,176116,COST
06079713403070000,2021,209203,382297,591500,MKT
06079713403070000,2020,175584,340116,515700,MKT
06079713403070000,2019,175584,340116,515700,MKT
06079713405200000,2021,392796,427360,820156,COST
06079713405200000,2020,327127,388720,715847,COST
06079713405200000,2019,327127,388720,715847,COST
06079714101020000,2021,243062,127480,370542,COST
06079714101020000,2020,224173,112327,336500,MKT
06079714101020000,2019,224173,112327,336500,MKT
06079714101030000,2021,85640,81130,166770,COST
06079714101030000,2020,92416,124784,217200,MKT
06079714101030000,2019,92416,124784,217200,MKT
06079714101047000,2021,192797,0,192797,COST
06079714101047000,2020,222233,0,222233,COST
06079714101047000,2019,145373,0,145373,COST
06079714101180000,2021,583256,2495940,3079196,COST
06079714101180000,2020,326323,2484360,2810683,COST
06079714101180000,2019,326323,2100570,2426893,COST
06079714101200000,2021,400580,55540,456120,COST
06079714101200000,2020,342682,57970,400652,COST
06079714101200000,2019,342682,57970,400652,COST
06079714101250000,2021,206819,428081,634900,INCOME
06079714101250000,2020,164638,467962,632600,INCOME
06079714101250000,2019,164638,467962,632600,INCOME
06079714101300000,2021,160997,801503,962500,INCOME
06079714101300000,2020,139558,575142,714700,INCOME
06079714101300000,2019,139558,575142,714700,INCOME
06079714107010000,2021,159448,25620,185068,COST
06079714107010000,2020,110875,26140,137015,COST
06079714107010000,2019,110875,26140,137015,COST
06079714107020000,2021,159448,0,159448,COST
06079714107020000,2020,110875,0,110875,COST
06079714107020000,2019,110875,0,110875,COST
06079714107030000,2021,159448,0,159448,COST
06079714107030000,2020,110875,0,110875,COST
06079714107030000,2019,110875,0,110875,COST
06079714107080000,2021,127552,0,127552,COST
06079714107080000,2020,91727,0,91727,COST
06079714107080000,2019,91727,0,91727,COST
06079714108010000,2021,162848,87760,250608,COST
06079714108010000,2020,112880,0,112880,COST
06079714108010000,2019,112880,0,112880,COST
06079714108020000,2021,159448,0,159448,COST
06079714108020000,2020,110875,0,110875,COST
06079714108020000,2019,110875,0,110875,COST
06079714108030000,2021,159448,0,159448,COST
06079714108030000,2020,110875,0,110875,COST
06079714108030000,2019,110875,0,110875,COST
06079714108040000,2021,159448,0,159448,COST
06079714108040000,2020,110875,0,110875,COST
06079714108040000,2019,110875,0,110875,COST
06079714108050000,2021,159448,0,159448,COST
06079714108050000,2020,110875,0,110875,COST
06079714108050000,2019,110875,0,110875,COST
06079714108060000,2021,159448,0,159448,COST
06079714108060000,2020,110875,0,110875,COST
06079714108060000,2019,110875,0,110875,COST
06079714108110000,2021,159448,0,159448,COST
06079714108110000,2020,110875,0,110875,COST
06079714108110000,2019,110875,0,110875,COST
06079714108120000,2021,159448,0,159448,COST
06079714108120000,2020,110875,0,110875,COST
06079714108120000,2019,110875,0,110875,COST
06079714108130000,2021,159448,0,159448,COST
06079714108130000,2020,110875,0,110875,COST
06079714108130000,2019,110875,0,110875,COST
06079714108140000,2021,159448,0,159448,COST
06079714108140000,2020,110875,0,110875,COST
06079714108140000,2019,110875,0,110875,COST
06079714108150000,2021,202533,4480,207013,COST
06079714108150000,2020,108793,4530,113323,COST
06079714108150000,2019,108793,4530,113323,COST
06079714109010000,2021,159448,236852,396300,MKT
06079714109010000,2020,110875,203925,314800,MKT
06079714109010000,2019,110875,203925,314800,MKT
06079714109060000,2021,159448,0,159448,COST
06079714109060000,2020,110875,0,110875,COST
06079714109060000,2019,110875,0,110875,COST
06079714109070000,2021,159448,0,159448,COST
06079714109070000,2020,110875,0,110875,COST
06079714109070000,2019,110875,0,110875,COST
06079714109080000,2021,159448,0,159448,COST
06079714109080000,2020,110875,0,110875,COST
06079714109080000,2019,110875,0,110875,COST
06079714109090000,2021,159448,0,159448,COST
06079714109090000,2020,110875,0,110875,COST
06079714109090000,2019,110875,0,110875,COST
06079714109100000,2021,159448,0,159448,COST
06079714109100000,2020,110875,0,110875,COST
06079714109100000,2019,110875,0,110875,COST
06079714109110000,2021,159448,0,159448,COST
06079714109110000,2020,110875,0,110875,COST
06079714109110000,2019,110875,0,110875,COST
06079714109120000,2021,159448,0,159448,COST
06079714109120000,2020,110875,0,110875,COST
06079714109120000,2019,110875,0,110875,COST
06079714109130000,2021,153987,238713,392700,MKT
06079714109130000,2020,106217,262920,369137,COST
06079714109130000,2019,106217,194450,300667,COST
06079714111030000,2021,84418,0,84418,COST
06079714111030000,2020,54363,0,54363,COST
06079714111030000,2019,54363,0,54363,COST
06079714111057000,2021,566012,38580,604592,COST
06079714111057000,2020,527983,40060,568043,COST
06079714111057000,2019,527983,40060,568043,COST
06079714111080000,2021,92293,0,92293,COST
06079714111080000,2020,201077,0,201077,COST
06079714111080000,2019,201077,0,201077,COST
06079714111110000,2021,92293,388007,480300,INCOME
06079714111110000,2020,64770,315830,380600,INCOME
06079714111110000,2019,64770,315830,380600,INCOME
06079714111130000,2021,60148,277652,337800,INCOME
06079714111130000,2020,48829,235871,284700,INCOME
06079714111130000,2019,48829,235871,284700,INCOME
06079714111140000,2021,92708,0,92708,COST
06079714111140000,2020,58865,0,58865,COST
06079714111140000,2019,58865,0,58865,COST
06079714114010000,2021,258324,686976,945300,INCOME
06079714114010000,2020,396570,494830,891400,INCOME
06079714114010000,2019,396570,494830,891400,INCOME
06079714114100000,2021,95820,0,95820,COST
06079714114100000,2020,60540,0,60540,COST
06079714114100000,2019,60540,0,60540,COST
06079714114110000,2021,95820,219180,315000,MKT
06079714114110000,2020,60540,178160,238700,MKT
06079714114110000,2019,60540,178160,238700,MKT
06079714114130000,2021,88401,0,88401,COST
06079714114130000,2020,67180,0,67180,COST
06079714114130000,2019,67180,0,67180,COST
06079714114160000,2021,87301,64770,152071,COST
06079714114160000,2020,66468,55390,121858,COST
06079714114160000,2019,66468,55390,121858,COST
06079714115017000,2021,210787,19730,230517,COST
06079714115017000,2020,111699,20480,132179,COST
06079714115017000,2019,111699,20480,132179,COST
06079714115035001,2021,54251,236310,290561,COST
06079714115035001,2020,45614,222486,268100,INCOME
06079714115035001,2019,45614,222486,268100,INCOME
06079714115035002,2021,54251,236310,290561,COST
06079714115035002,2020,45614,222486,268100,INCOME
06079714115035002,2019,45614,222486,268100,INCOME
06079714115035003,2021,54251,236310,290561,COST
06079714115035003,2020,45614,201486,247100,INCOME
06079714115035003,2019,45614,201486,247100,INCOME
06079714115187000,2021,163933,0,163933,COST
06079714115187000,2020,127109,0,127109,COST
06079714115187000,2019,58865,435810,494675,COST
06079714116030000,2021,114418,0,114418,COST
06079714116030000,2020,83639,0,83639,COST
06079714116030000,2019,83639,0,83639,COST
06079714116050000,2021,92708,0,92708,COST
06079714116050000,2020,58865,0,58865,COST
06079714116050000,2019,58865,0,58865,COST
06079714116080000,2021,101530,0,101530,COST
06079714116080000,2020,75565,0,75565,COST
06079714116080000,2019,75565,0,75565,COST
06079714116090000,2021,92708,0,92708,COST
06079714116090000,2020,58865,0,58865,COST
06079714116090000,2019,58865,0,58865,COST
06079714116107000,2021,146610,7640,154250,COST
06079714116107000,2020,87903,7930,95833,COST
06079714116107000,2019,87903,7930,95833,COST
06079714116150000,2021,54251,130370,184621,COST
06079714116150000,2020,45614,125920,171534,COST
06079714116150000,2019,45614,125920,171534,COST
06079714116170000,2021,101402,0,101402,COST
06079714116170000,2020,75484,0,75484,COST
06079714116170000,2019,75484,0,75484,COST
06079714117010000,2021,52380,0,52380,COST
06079714117010000,2020,58865,0,58865,COST
06079714117010000,2019,58865,0,58865,COST
06079714117020000,2021,52380,0,52380,COST
06079714117020000,2020,47093,0,47093,COST
06079714117020000,2019,47093,0,47093,COST
06079714117030000,2021,52380,221280,273660,COST
06079714117030000,2020,58865,188190,247055,COST
06079714117030000,2019,58865,188190,247055,COST
06079714117080000,2021,168093,178507,346600,MKT
06079714117080000,2020,115961,148839,264800,MKT
06079714117080000,2019,115961,148839,264800,MKT
06079714117160000,2021,101402,0,101402,COST
06079714117160000,2020,75484,0,75484,COST
06079714117160000,2019,75484,0,75484,COST
06079714117170000,2021,92708,0,92708,COST
06079714117170000,2020,58865,0,58865,COST
06079714117170000,2019,58865,0,58865,COST
06079714117180000,2021,92708,310,93018,COST
06079714117180000,2020,58865,320,59185,COST
06079714117180000,2019,58865,320,59185,COST
06079714118017000,2021,146610,12210,158820,COST
06079714118017000,2020,87903,12710,100613,COST
06079714118017000,2019,87903,12710,100613,COST
06079714118070000,2021,85531,3340,88871,COST
06079714118070000,2020,65322,3420,68742,COST
06079714118070000,2019,65322,3420,68742,COST
06079714118090000,2021,85531,91710,177241,COST
06079714118090000,2020,65322,143478,208800,MKT
06079714118090000,2019,65322,143478,208800,MKT
06079714118130000,2021,114418,66290,180708,COST
06079714118130000,2020,83639,66620,150259,COST
06079714118130000,2019,83639,66620,150259,COST
06079714118140000,2021,92708,0,92708,COST
06079714118140000,2020,58865,0,58865,COST
06079714118140000,2019,58865,0,58865,COST
06079714118150000,2021,92708,0,92708,COST
06079714118150000,2020,58865,0,58865,COST
06079714118150000,2019,58865,0,58865,COST
06079714118177000,2021,106937,2490,109427,COST
06079714118177000,2020,71380,2580,73960,COST
06079714118177000,2019,71380,2580,73960,COST
06079714119010000,2021,92708,0,92708,COST
06079714119010000,2020,58865,0,58865,COST
06079714119010000,2019,58865,0,58865,COST
06079714119020000,2021,92708,0,92708,COST
06079714119020000,2020,58865,0,58865,COST
06079714119020000,2019,58865,0,58865,COST
06079714119030000,2021,92708,0,92708,COST
06079714119030000,2020,58865,0,58865,COST
06079714119030000,2019,58865,0,58865,COST
06079714119040000,2021,74166,0,74166,COST
06079714119040000,2020,52325,0,52325,COST
06079714119040000,2019,58865,0,58865,COST
06079714119050000,2021,92708,0,92708,COST
06079714119050000,2020,58865,0,58865,COST
06079714119050000,2019,58865,0,58865,COST
06079714119070000,2021,85531,85530,171061,COST
06079714119070000,2020,65322,72760,138082,COST
06079714119070000,2019,65322,72760,138082,COST
06079714119080000,2021,92708,0,92708,COST
06079714119080000,2020,58865,0,58865,COST
06079714119080000,2019,58865,0,58865,COST
06079714119090000,2021,92708,173892,266600,MKT
06079714119090000,2020,58865,149935,208800,MKT
06079714119090000,2019,58865,149935,208800,MKT
06079714119110000,2021,85531,1460,86991,COST
06079714119110000,2020,65322,1500,66822,COST
06079714119110000,2019,65322,1500,66822,COST
06079714119140000,2021,101530,1250170,1351700,INCOME
06079714119140000,2020,75565,967035,1042600,INCOME
06079714119140000,2019,75565,967035,1042600,INCOME
06079714119150000,2021,74166,5070,79236,COST
06079714119150000,2020,52325,5180,57505,COST
06079714119150000,2019,58865,5180,64045,COST
06079714119160000,2021,74166,0,74166,COST
06079714119160000,2020,52325,0,52325,COST
06079714119160000,2019,58865,0,58865,COST
06079714119187000,2021,83244,1180,84424,COST
06079714119187000,2020,60506,1230,61736,COST
06079714119187000,2019,60506,1230,61736,COST
06079714120010000,2021,98798,0,98798,COST
06079714120010000,2020,62134,0,62134,COST
06079714120010000,2019,62134,0,62134,COST
06079714120030000,2021,82520,150560,233080,COST
06079714120030000,2020,63364,202736,266100,OVR
06079714120030000,2019,63364,202736,266100,MKT
06079714120060000,2021,152134,0,152134,COST
06079714120060000,2020,221871,0,221871,COST
06079714120060000,2019,221871,0,221871,COST
06079714120080000,2021,118207,196293,314500,INCOME
06079714120080000,2020,187841,259,188100,INCOME
06079714120080000,2019,187841,259,188100,INCOME
06079714120127000,2021,256485,23600,280085,COST
06079714120127000,2020,313171,24640,337811,COST
06079714120127000,2019,313171,24640,337811,COST
06079714120160000,2021,76656,0,76656,COST
06079714120160000,2020,53813,0,53813,COST
06079714120160000,2019,60540,0,60540,COST
06079714120170000,2021,76656,0,76656,COST
06079714120170000,2020,53813,0,53813,COST
06079714120170000,2019,60540,0,60540,COST
06079714120180000,2021,76656,0,76656,COST
06079714120180000,2020,53813,0,53813,COST
06079714120180000,2019,60540,0,60540,COST
06079714121010000,2021,195996,393304,589300,INCOME
06079714121010000,2020,330514,194686,525200,INCOME
06079714121010000,2019,330514,194686,525200,INCOME
06079714121020000,2021,278315,7650,285965,COST
06079714121020000,2020,330514,7980,338494,COST
06079714121020000,2019,330514,7980,338494,COST
06079714121030000,2021,278119,110670,388789,COST
06079714121030000,2020,330361,109810,440171,COST
06079714121030000,2019,330361,109810,440171,COST
06079714121060000,2021,159448,21220,180668,COST
06079714121060000,2020,110875,21620,132495,COST
06079714121060000,2019,110875,21620,132495,COST
06079714130010000,2021,605336,0,605336,COST
06079714130010000,2020,432265,0,432265,COST
06079714130010000,2019,432265,0,432265,COST
06079714130016500,2021,296171,0,296171,COST
06079714130016500,2020,166634,0,166634,COST
06079714130016500,2019,166634,0,166634,COST
06079714130090000,2021,1432998,0,1432998,COST
06079714130090000,2020,763316,0,763316,COST
06079714130090000,2019,763316,0,763316,COST
06079714130110000,2021,529786,0,529786,COST
06079714130110000,2020,237899,0,237899,COST
06079714130110000,2019,237899,0,237899,COST
06079714130130000,2021,310894,0,310894,COST
06079714130130000,2020,431226,0,431226,COST
06079714130130000,2019,431226,0,431226,COST
06079714131010000,2021,703849,1903851,2607700,INCOME
06079714131010000,2020,477485,1410915,1888400,INCOME
06079714131010000,2019,477485,1253715,1731200,INCOME
06079714131030000,2021,555673,14430,570103,COST
06079714131030000,2020,245507,14980,260487,COST
06079714131030000,2019,245507,14980,260487,COST
06079714131057000,2021,291187,47130,338317,COST
06079714131057000,2020,248190,48940,297130,COST
06079714131057000,2019,248190,48940,297130,COST
06079714131070000,2021,265635,1431365,1697000,INCOME
06079714131070000,2020,233596,1278804,1512400,INCOME
06079714131070000,2019,233596,1278804,1512400,INCOME
06079714131097000,2021,270616,18540,289156,COST
06079714131097000,2020,236477,20570,257047,COST
06079714131097000,2019,236477,20570,257047,COST
06079714131110000,2021,176202,5350,181552,COST
06079714131110000,2020,178167,5110,183277,COST
06079714131110000,2019,178167,5110,183277,COST
06079714131130000,2021,312482,625118,937600,INCOME
06079714131130000,2020,260023,553577,813600,INCOME
06079714131130000,2019,260023,553577,813600,INCOME
06079714131157000,2021,242456,34600,277056,COST
06079714131157000,2020,219938,37260,257198,COST
06079714131157000,2019,219938,37260,257198,COST
06079714131170000,2021,258052,1515948,1774000,INCOME
06079714131170000,2020,229174,1339526,1568700,INCOME
06079714131170000,2019,229174,1339526,1568700,INCOME
06079714131190000,2021,265635,1221065,1486700,INCOME
06079714131190000,2020,233596,1224004,1457600,INCOME
06079714131190000,2019,233596,1224004,1457600,INCOME
06079714131250000,2021,580941,0,580941,COST
06079714131250000,2020,391489,0,391489,COST
06079714131250000,2019,391489,0,391489,COST
06079714132010000,2021,441530,1971370,2412900,INCOME
06079714132010000,2020,210946,1810354,2021300,INCOME
06079714132010000,2019,210946,920250,1131196,COST
06079714132030000,2021,233065,806235,1039300,INCOME
06079714132030000,2020,214279,690921,905200,INCOME
06079714132030000,2019,214279,690921,905200,INCOME
06079714132057000,2021,213826,19490,233316,COST
06079714132057000,2020,202437,20230,222667,COST
06079714132057000,2019,202437,20230,222667,COST
06079714132070000,2021,233065,1714635,1947700,INCOME
06079714132070000,2020,214279,1656621,1870900,INCOME
06079714132070000,2019,214279,1656621,1870900,INCOME
06079714132090000,2021,233065,1670635,1903700,INCOME
06079714132090000,2020,214279,1468921,1683200,INCOME
06079714132090000,2019,214279,1468921,1683200,INCOME
06079714132110000,2021,351336,2136264,2487600,INCOME
06079714132110000,2020,280930,2059370,2340300,INCOME
06079714132110000,2019,280930,2059370,2340300,INCOME
06079714132150000,2021,239796,318404,558200,INCOME
06079714132150000,2020,218343,261457,479800,INCOME
06079714132150000,2019,218343,261457,479800,INCOME
06079714132170000,2021,252920,1294180,1547100,INCOME
06079714132170000,2020,226156,1247544,1473700,OVR
06079714132170000,2019,226156,1247544,1473700,OVR
06079714132197000,2021,219087,13450,232537,COST
06079714132197000,2020,205710,14010,219720,COST
06079714132197000,2019,205710,14010,219720,COST
06079714132210000,2021,252920,0,252920,COST
06079714132210000,2020,226156,0,226156,COST
06079714132210000,2019,226156,0,226156,COST
06079714132230000,2021,186260,0,186260,COST
06079714132230000,2020,100000,0,100000,OVR
06079714132230000,2019,100000,0,100000,OVR
06079714132250000,2021,372031,2134669,2506700,INCOME
06079714132250000,2020,291743,1872757,2164500,INCOME
06079714132250000,2019,291743,1872757,2164500,INCOME
06079714132290000,2021,242456,0,242456,COST
06079714132290000,2020,219938,0,219938,COST
06079714132290000,2019,219938,0,219938,COST
06079714132310000,2021,242456,0,242456,COST
06079714132310000,2020,219938,0,219938,COST
06079714132310000,2019,219938,0,219938,COST
06079714132337000,2021,242456,36410,278866,COST
06079714132337000,2020,219938,35250,255188,COST
06079714132337000,2019,219938,0,219938,COST
06079714132350000,2021,457398,1096602,1554000,INCOME
06079714132350000,2020,215918,0,215918,COST
06079714132350000,2019,215918,0,215918,COST
06079714133010000,2021,338549,1567051,1905600,INCOME
06079714133010000,2020,274141,1525859,1800000,INCOME
06079714133010000,2019,274141,1525859,1800000,INCOME
06079714133037000,2021,298234,0,298234,COST
06079714133037000,2020,252138,0,252138,COST
06079714133037000,2019,252138,0,252138,COST
06079714133057000,2021,305180,0,305180,COST
06079714133057000,2020,255998,0,255998,COST
06079714133057000,2019,255998,0,255998,COST
06079714133070000,2021,338549,0,338549,COST
06079714133070000,2020,274141,0,274141,COST
06079714133070000,2019,274141,0,274141,COST
06079714133090000,2021,338549,1950751,2289300,INCOME
06079714133090000,2020,274141,1619659,1893800,INCOME
06079714133090000,2019,274141,1619659,1893800,INCOME
06079714133110000,2021,254484,1363916,1618400,INCOME
06079714133110000,2020,265295,1147005,1412300,INCOME
06079714133110000,2019,265295,1147005,1412300,INCOME
06079714133130000,2021,226279,83100,309379,COST
06079714133130000,2020,245507,81310,326817,COST
06079714133130000,2019,245507,81310,326817,COST
06079714180600000,2021,583843,1447657,2031500,INCOME
06079714180600000,2020,538901,1128440,1667341,COST
06079714180600000,2019,538901,1128440,1667341,COST
06079714201011001,2021,163,0,163,COST
06079714201011001,2020,152,0,152,COST
06079714201011001,2019,152,0,152,COST
06079714201011002,2021,504538,1591000,2095538,COST
06079714201011002,2020,502810,1276830,1779640,COST
06079714201011002,2019,502810,1276830,1779640,COST
06079714201300000,2021,291,0,291,COST
06079714201300000,2020,330,0,330,COST
06079714201300000,2019,330,0,330,COST
06079714201460000,2021,1113,0,1113,COST
06079714201460000,2020,5769,0,5769,COST
06079714201460000,2019,5769,0,5769,COST
06079714202021001,2021,3285,0,3285,COST
06079714202021001,2020,3063,0,3063,COST
06079714202021001,2019,3063,0,3063,COST
06079714202021002,2021,5205,18870,24075,COST
06079714202021002,2020,4844,18780,23624,COST
06079714202021002,2019,4844,18780,23624,COST
06079714202030000,2021,313440,1149230,1462670,COST
06079714202030000,2020,303885,813430,1117315,COST
06079714202030000,2019,303885,813430,1117315,COST
06079714202040000,2021,50886,0,50886,COST
06079714202040000,2020,37727,0,37727,COST
06079714202040000,2019,37727,0,37727,COST
06079714202060000,2021,273028,0,273028,COST
06079714202060000,2020,270263,0,270263,COST
06079714202060000,2019,270263,0,270263,COST
06079714202101001,2021,167656,778960,946616,COST
06079714202101001,2020,178612,549970,728582,COST
06079714202101001,2019,178612,549970,728582,COST
06079714202101002,2021,672,109050,109722,COST
06079714202101002,2020,625,108990,109615,COST
06079714202101002,2019,625,108990,109615,COST
06079714204010000,2021,149880,465720,615600,INCOME
06079714204010000,2020,133122,460478,593600,INCOME
06079714204010000,2019,133122,460478,593600,INCOME
06079714204030000,2021,149880,336270,486150,COST
06079714204030000,2020,97843,296760,394603,COST
06079714204030000,2019,97843,296760,394603,COST
06079714204050000,2021,571058,1336642,1907700,INCOME
06079714204050000,2020,321803,1213297,1535100,INCOME
06079714204050000,2019,321803,1213297,1535100,INCOME
06079714204196500,2021,52898,0,52898,COST
06079714204196500,2020,51202,0,51202,COST
06079714204196500,2019,51202,0,51202,COST
06079714204227000,2021,243017,0,243017,COST
06079714204227000,2020,207745,0,207745,COST
06079714204227000,2019,207745,0,207745,COST
06079714204257000,2021,377983,0,377983,COST
06079714204257000,2020,341099,0,341099,COST
06079714204257000,2019,300621,0,300621,COST
06079714204280000,2021,65904,271740,337644,COST
06079714204280000,2020,66649,220151,286800,MKT
06079714204280000,2019,66649,220151,286800,MKT
06079714260010000,2021,241637,342263,583900,INCOME
06079714260010000,2020,182440,269960,452400,INCOME
06079714260010000,2019,182440,262030,444470,COST
06079714260040000,2021,124049,5520,129569,COST
06079714260040000,2020,126602,6400,133002,COST
06079714260040000,2019,126602,6400,133002,COST
06079714260070000,2021,122702,449898,572600,MKT
06079714260070000,2020,125433,412967,538400,MKT
06079714260070000,2019,125433,426167,551600,MKT
06079714260110000,2021,152534,11670,164204,COST
06079714260110000,2020,150903,12010,162913,COST
06079714260110000,2019,150903,12010,162913,COST
06079714260150000,2021,107644,226656,334300,MKT
06079714260150000,2020,112230,194870,307100,MKT
06079714260150000,2019,112230,194870,307100,MKT
06079714301200000,2021,2667,0,2667,COST
06079714301200000,2020,2826,0,2826,COST
06079714301200000,2019,2826,0,2826,COST
06079714301250000,2021,185046,209254,394300,MKT
06079714301250000,2020,186745,121900,308645,COST
06079714301250000,2019,186745,121900,308645,COST
06079714302010000,2021,359895,0,359895,COST
06079714302010000,2020,267328,0,267328,COST
06079714302010000,2019,267328,0,267328,COST
06079714302030000,2021,238050,0,238050,COST
06079714302030000,2020,188175,0,188175,COST
06079714302030000,2019,188175,0,188175,COST
06079714302040000,2021,246212,0,246212,COST
06079714302040000,2020,193642,0,193642,COST
06079714302040000,2019,193642,0,193642,COST
06079714302050000,2021,246007,0,246007,COST
06079714302050000,2020,193504,0,193504,COST
06079714302050000,2019,193504,0,193504,COST
06079714302060000,2021,244145,380,244525,COST
06079714302060000,2020,192259,390,192649,COST
06079714302060000,2019,192259,390,192649,COST
06079714302070000,2021,245594,130,245724,COST
06079714302070000,2020,193229,130,193359,COST
06079714302070000,2019,193229,130,193359,COST
06079714302080000,2021,245636,0,245636,COST
06079714302080000,2020,193256,0,193256,COST
06079714302080000,2019,193256,0,193256,COST
06079714302090000,2021,395697,0,395697,COST
06079714302090000,2020,289755,0,289755,COST
06079714302090000,2019,289755,0,289755,COST
06079714401010000,2021,161500,195140,356640,COST
06079714401010000,2020,112086,165620,277706,COST
06079714401010000,2019,112086,165620,277706,COST
06079714401020000,2021,204268,202732,407000,MKT
06079714401020000,2020,136842,189858,326700,MKT
06079714401020000,2019,136842,189858,326700,MKT
06079714401040000,2021,160067,425133,585200,INCOME
06079714401040000,2020,111241,392159,503400,INCOME
06079714401040000,2019,111241,392159,503400,INCOME
06079714401050000,2021,160067,260833,420900,MKT
06079714401050000,2020,111241,232659,343900,MKT
06079714401050000,2019,111241,232659,343900,MKT
06079714401060000,2021,161215,166585,327800,MKT
06079714401060000,2020,111241,79160,190401,COST
06079714401060000,2019,111241,79160,190401,COST
06079714401070000,2021,160067,900,160967,COST
06079714401070000,2020,111241,930,112171,COST
06079714401070000,2019,111241,930,112171,COST
06079714401080000,2021,160067,208490,368557,COST
06079714401080000,2020,111241,148950,260191,COST
06079714401080000,2019,111241,148950,260191,COST
06079714401100000,2021,3271,222990,226261,COST
06079714401100000,2020,3625,191760,195385,COST
06079714401100000,2019,3625,175620,179245,COST
06079714401110000,2021,185499,263370,448869,COST
06079714401110000,2020,126085,213750,339835,COST
06079714401110000,2019,126085,180815,306900,MKT
06079714401130000,2021,159448,420780,580228,COST
06079714401130000,2020,110875,312310,423185,COST
06079714401130000,2019,110875,276110,386985,COST
06079714401140000,2021,212931,233969,446900,INCOME
06079714401140000,2020,141756,220544,362300,INCOME
06079714401140000,2019,141756,220544,362300,INCOME
06079714401160000,2021,159172,2640,161812,COST
06079714401160000,2020,110712,2900,113612,COST
06079714401160000,2019,110712,2900,113612,COST
06079714401170000,2021,159241,0,159241,COST
06079714401170000,2020,110753,0,110753,COST
06079714401170000,2019,110753,0,110753,COST
06079714401180000,2021,159241,0,159241,COST
06079714401180000,2020,110753,0,110753,COST
06079714401180000,2019,110753,0,110753,COST
06079714401190000,2021,159241,0,159241,COST
06079714401190000,2020,110753,0,110753,COST
06079714401190000,2019,110753,0,110753,COST
06079714401200000,2021,154870,147230,302100,MKT
06079714401200000,2020,106830,36490,143320,COST
06079714401200000,2019,106830,36490,143320,COST
06079714401210000,2021,88557,74110,162667,COST
06079714401210000,2020,67280,122320,189600,MKT
06079714401210000,2019,67280,122320,189600,MKT
06079714401220000,2021,77322,71180,148502,COST
06079714401220000,2020,59957,114143,174100,MKT
06079714401220000,2019,59957,114143,174100,MKT
06079714401230000,2021,93209,218291,311500,MKT
06079714401230000,2020,70271,181429,251700,MKT
06079714401230000,2019,70271,181429,251700,MKT
06079714401240000,2021,88557,470,89027,COST
06079714401240000,2020,67280,490,67770,COST
06079714401240000,2019,67280,490,67770,COST
06079714401250000,2021,159241,0,159241,COST
06079714401250000,2020,110753,0,110753,COST
06079714401250000,2019,110753,0,110753,COST
06079714403010000,2021,135735,191465,327200,MKT
06079714403010000,2020,96702,163698,260400,MKT
06079714403010000,2019,96702,163698,260400,MKT
06079714403020000,2021,179017,394283,573300,MKT
06079714403020000,2020,122332,353468,475800,MKT
06079714403020000,2019,122332,353468,475800,MKT
06079714403030000,2021,159379,216921,376300,MKT
06079714403030000,2020,110834,190466,301300,MKT
06079714403030000,2019,110834,190466,301300,MKT
06079714403040000,2021,159379,19060,178439,COST
06079714403040000,2020,110834,19020,129854,COST
06079714403040000,2019,110834,19020,129854,COST
06079714403050000,2021,159379,1620,160999,COST
06079714403050000,2020,110834,1660,112494,COST
06079714403050000,2019,110834,1660,112494,COST
06079714403060000,2021,159379,220921,380300,MKT
06079714403060000,2020,110834,191666,302500,MKT
06079714403060000,2019,110834,191666,302500,MKT
06079714403080000,2021,159379,0,159379,COST
06079714403080000,2020,110834,0,110834,COST
06079714403080000,2019,110834,0,110834,COST
06079714403090000,2021,159379,0,159379,COST
06079714403090000,2020,110834,0,110834,COST
06079714403090000,2019,110834,0,110834,COST
06079714403100000,2021,159379,7220,166599,COST
06079714403100000,2020,110834,7480,118314,COST
06079714403100000,2019,110834,7480,118314,COST
06079714403110000,2021,159379,438221,597600,MKT
06079714403110000,2020,110834,386066,496900,MKT
06079714403110000,2019,110834,386066,496900,MKT
06079714403120000,2021,159379,205490,364869,COST
06079714403120000,2020,110834,174280,285114,COST
06079714403120000,2019,110834,174280,285114,COST
06079714403140000,2021,159379,362121,521500,MKT
06079714403140000,2020,110834,323466,434300,MKT
06079714403140000,2019,110834,323466,434300,MKT
06079714403150000,2021,175258,172642,347900,MKT
06079714403150000,2020,120147,167853,288000,MKT
06079714403150000,2019,120147,167853,288000,MKT
06079714403160000,2021,150551,1770,152321,COST
06079714403160000,2020,105597,1750,107347,COST
06079714403160000,2019,105597,1750,107347,COST
06079714403170000,2021,231137,4150,235287,COST
06079714403170000,2020,151988,4070,156058,COST
06079714403170000,2019,151988,4070,156058,COST
06079714403180000,2021,231178,510,231688,COST
06079714403180000,2020,152011,520,152531,COST
06079714403180000,2019,152011,520,152531,COST
06079714403190000,2021,231096,1290,232386,COST
06079714403190000,2020,151965,1300,153265,COST
06079714403190000,2019,151965,1300,153265,COST
06079714403200000,2021,211863,0,211863,COST
06079714403200000,2020,141152,0,141152,COST
06079714403200000,2019,141152,0,141152,COST
06079714403220000,2021,266149,0,266149,COST
06079714403220000,2020,171333,0,171333,COST
06079714403220000,2019,171333,0,171333,COST
06079714403230000,2021,231096,138630,369726,COST
06079714403230000,2020,151965,121830,273795,COST
06079714403230000,2019,151965,121830,273795,COST
06079714403280000,2021,117525,410,117935,COST
06079714403280000,2020,85564,400,85964,COST
06079714403280000,2019,85564,400,85964,COST
06079714404010000,2021,156177,123923,280100,MKT
06079714404010000,2020,107739,30650,138389,COST
06079714404010000,2019,107739,30650,138389,COST
06079714404020000,2021,160630,221870,382500,MKT
06079714404020000,2020,110834,144710,255544,COST
06079714404020000,2019,110834,144710,255544,COST
06079714404040000,2021,213254,250,213504,COST
06079714404040000,2020,141939,260,142199,COST
06079714404040000,2019,141939,260,142199,COST
06079714404060000,2021,213254,630,213884,COST
06079714404060000,2020,141939,600,142539,COST
06079714404060000,2019,141939,600,142539,COST
06079714404080000,2021,213254,67100,280354,COST
06079714404080000,2020,141939,103961,245900,MKT
06079714404080000,2019,141939,103961,245900,MKT
06079714404100000,2021,213208,80100,293308,COST
06079714404100000,2020,141913,134987,276900,MKT
06079714404100000,2019,141913,134987,276900,MKT
06079714404120000,2021,267065,0,267065,COST
06079714404120000,2020,171834,0,171834,COST
06079714404120000,2019,171834,0,171834,COST
06079714404140000,2021,186614,12570,199184,COST
06079714404140000,2020,126728,12620,139348,COST
06079714404140000,2019,126728,12620,139348,COST
06079714404150000,2021,160688,177112,337800,MKT
06079714404150000,2020,110875,106420,217295,COST
06079714404150000,2019,110875,156940,267815,COST
06079714404160000,2021,159379,184121,343500,MKT
06079714404160000,2020,110834,164966,275800,MKT
06079714404160000,2019,110834,164966,275800,MKT
06079714404170000,2021,159379,283321,442700,MKT
06079714404170000,2020,110834,209066,319900,MKT
06079714404170000,2019,110834,209066,319900,MKT
06079714404180000,2021,159379,191521,350900,MKT
06079714404180000,2020,110834,160466,271300,MKT
06079714404180000,2019,110834,160466,271300,MKT
06079714404190000,2021,159379,1220,160599,COST
06079714404190000,2020,110834,1260,112094,COST
06079714404190000,2019,110834,1260,112094,COST
06079714404200000,2021,159379,170990,330369,COST
06079714404200000,2020,110834,161766,272600,MKT
06079714404200000,2019,110834,161766,272600,MKT
06079714404210000,2021,159379,157870,317249,COST
06079714404210000,2020,110834,134400,245234,COST
06079714404210000,2019,110834,134400,245234,COST
06079714404220000,2021,160630,130170,290800,MKT
06079714404220000,2020,110834,46250,157084,COST
06079714404220000,2019,110834,46250,157084,COST
06079714404230000,2021,159379,450,159829,COST
06079714404230000,2020,110834,460,111294,COST
06079714404230000,2019,110834,460,111294,COST
06079714404240000,2021,159448,214852,374300,MKT
06079714404240000,2020,110875,176525,287400,MKT
06079714404240000,2019,110875,176525,287400,MKT
06079714404250000,2021,159448,385452,544900,MKT
06079714404250000,2020,110875,324125,435000,MKT
06079714404250000,2019,110875,324125,435000,MKT
06079714404260000,2021,159448,212752,372200,MKT
06079714404260000,2020,110875,175225,286100,MKT
06079714404260000,2019,110875,175225,286100,MKT
06079714404280000,2021,209846,240154,450000,MKT
06079714404280000,2020,140010,196010,336020,COST
06079714404280000,2019,140010,196010,336020,COST
06079714405060000,2021,750786,539100,1289886,COST
06079714405060000,2020,801807,580710,1382517,COST
06079714405060000,2019,801807,580710,1382517,COST
06079714405120000,2021,161364,0,161364,COST
06079714405120000,2020,112006,0,112006,COST
06079714405120000,2019,112006,0,112006,COST
06079714405160000,2021,317235,0,317235,COST
06079714405160000,2020,198892,0,198892,COST
06079714405160000,2019,198892,0,198892,COST
06079714405200000,2021,214542,68620,283162,COST
06079714405200000,2020,142666,118734,261400,MKT
06079714405200000,2019,142666,118734,261400,MKT
06079714405260000,2021,171259,23010,194269,COST
06079714405260000,2020,117814,23520,141334,COST
06079714405260000,2019,117814,23520,141334,COST
06079714405280000,2021,466128,0,466128,COST
06079714405280000,2020,464494,0,464494,COST
06079714405280000,2019,464494,0,464494,COST
06079714405300000,2021,414346,0,414346,COST
06079714405300000,2020,429767,0,429767,COST
06079714405300000,2019,429767,0,429767,COST
06079714405350000,2021,497973,2151300,2649273,COST
06079714405350000,2020,156289,2096070,2252359,COST
06079714405350000,2019,156289,2096070,2252359,COST
06079714405600000,2021,1216787,1556160,2772947,COST
06079714405600000,2020,281815,1544500,1826315,COST
06079714405600000,2019,281815,1544500,1826315,COST
06079714405850000,2021,393301,240,393541,COST
06079714405850000,2020,238731,290,239021,COST
06079714405850000,2019,238731,290,239021,COST
06079714408050000,2021,326491,133660,460151,COST
06079714408050000,2020,246099,117201,363300,MKT
06079714408050000,2019,246099,117201,363300,MKT
06079714408080000,2021,306926,208740,515666,COST
06079714408080000,2020,233514,152886,386400,MKT
06079714408080000,2019,233514,152886,386400,MKT
06079714408120000,2021,256349,496830,753179,COST
06079714408120000,2020,165960,436460,602420,COST
06079714408120000,2019,165960,436460,602420,COST
06079714408160000,2021,101967,2060,104027,COST
06079714408160000,2020,63823,2100,65923,COST
06079714408160000,2019,63823,2100,65923,COST
06079714408240000,2021,278536,435210,713746,COST
06079714408240000,2020,192998,202110,395108,COST
06079714408240000,2019,192998,202110,395108,COST
06079714408250000,2021,235741,1770,237511,COST
06079714408250000,2020,154556,1710,156266,COST
06079714408250000,2019,154556,1710,156266,COST
06079714408280000,2021,250973,143570,394543,COST
06079714408280000,2020,162998,173902,336900,MKT
06079714408280000,2019,162998,173902,336900,MKT
06079714408300000,2021,205731,13470,219201,COST
06079714408300000,2020,137674,13690,151364,COST
06079714408300000,2019,137674,13690,151364,COST
06079714409120000,2021,159448,0,159448,COST
06079714409120000,2020,110875,0,110875,COST
06079714409120000,2019,110875,0,110875,COST
06079714409130000,2021,159379,12650,172029,COST
06079714409130000,2020,110834,13040,123874,COST
06079714409130000,2019,110834,13040,123874,COST
06079714409140000,2021,160688,464210,624898,COST
06079714409140000,2020,110875,219700,330575,COST
06079714409140000,2019,110875,219700,330575,COST
06079714409150000,2021,159448,187652,347100,MKT
06079714409150000,2020,110875,158125,269000,MKT
06079714409150000,2019,110875,158125,269000,MKT
06079714409160000,2021,157710,198130,355840,COST
06079714409160000,2020,109848,167780,277628,COST
06079714409160000,2019,109848,167780,277628,COST
06079714409170000,2021,100231,75950,176181,COST
06079714409170000,2020,74743,134857,209600,MKT
06079714409170000,2019,74743,134857,209600,MKT
06079714409180000,2021,134608,204792,339400,MKT
06079714409180000,2020,96019,184781,280800,MKT
06079714409180000,2019,96019,184781,280800,MKT
06079714409550000,2021,159379,246421,405800,MKT
06079714409550000,2020,110834,208466,319300,MKT
06079714409550000,2019,110834,208466,319300,MKT
06079714409570000,2021,159379,212621,372000,MKT
06079714409570000,2020,110834,190766,301600,MKT
06079714409570000,2019,110834,190766,301600,MKT
06079714409590000,2021,159379,335121,494500,MKT
06079714409590000,2020,110834,286166,397000,MKT
06079714409590000,2019,110834,286166,397000,MKT
06079714409610000,2021,160630,453210,613840,COST
06079714409610000,2020,110834,213730,324564,COST
06079714409610000,2019,110834,213730,324564,COST
06079714409630000,2021,159379,382080,541459,COST
06079714409630000,2020,110834,336450,447284,COST
06079714409630000,2019,110834,336450,447284,COST
06079714409650000,2021,159379,0,159379,COST
06079714409650000,2020,110834,0,110834,COST
06079714409650000,2019,110834,0,110834,COST
06079714410010000,2021,188434,0,188434,COST
06079714410010000,2020,127777,0,127777,COST
06079714410010000,2019,127777,0,127777,COST
06079714410020000,2021,182784,0,182784,COST
06079714410020000,2020,124515,0,124515,COST
06079714410020000,2019,124515,0,124515,COST
06079714410030000,2021,133644,0,133644,COST
06079714410030000,2020,95435,0,95435,COST
06079714410030000,2019,95435,0,95435,COST
06079714410040000,2021,92708,0,92708,COST
06079714410040000,2020,58865,0,58865,COST
06079714410040000,2019,58865,0,58865,COST
06079714410050000,2021,97424,0,97424,COST
06079714410050000,2020,72961,0,72961,COST
06079714410050000,2019,72961,0,72961,COST
06079714411230000,2021,170002,7470,177472,COST
06079714411230000,2020,117079,7280,124359,COST
06079714411230000,2019,117079,7280,124359,COST
06079714412140000,2021,128487,316213,444700,MKT
06079714412140000,2020,92297,274503,366800,MKT
06079714412140000,2019,92297,274503,366800,MKT
06079714413010000,2021,95820,18150,113970,COST
06079714413010000,2020,60540,18020,78560,COST
06079714413010000,2019,60540,18020,78560,COST
06079714413040000,2021,85531,0,85531,COST
06079714413040000,2020,65322,0,65322,COST
06079714413040000,2019,65322,0,65322,COST
06079714413070000,2021,114527,152873,267400,MKT
06079714413070000,2020,83706,141894,225600,MKT
06079714413070000,2019,83706,141894,225600,MKT
06079714413080000,2021,92708,0,92708,COST
06079714413080000,2020,58865,0,58865,COST
06079714413080000,2019,58865,0,58865,COST
06079714413090000,2021,92708,0,92708,COST
06079714413090000,2020,58865,0,58865,COST
06079714413090000,2019,58865,0,58865,COST
06079714413150000,2021,240537,117020,357557,COST
06079714413150000,2020,157223,135977,293200,MKT
06079714413150000,2019,157223,135977,293200,MKT
06079715101020000,2021,255793,0,255793,COST
06079715101020000,2020,163901,0,163901,COST
06079715101020000,2019,163901,0,163901,COST
06079715101500000,2021,145945,1040530,1186475,COST
06079715101500000,2020,6214,916940,923154,COST
06079715101500000,2019,6214,916940,923154,COST
06079715101551001,2021,88,0,88,COST
06079715101551001,2020,100,0,100,COST
06079715101551001,2019,100,0,100,COST
06079715101551002,2021,1167,0,1167,COST
06079715101551002,2020,5222,0,5222,COST
06079715101551002,2019,5222,0,5222,COST
06079715101600000,2021,370484,702230,1072714,COST
06079715101600000,2020,272663,525110,797773,COST
06079715101600000,2019,272663,525110,797773,COST
06079715102010000,2021,961136,510500,1471636,COST
06079715102010000,2020,653652,446160,1099812,COST
06079715102010000,2019,653652,446160,1099812,COST
06079715102030000,2021,146048,316160,462208,COST
06079715102030000,2020,115606,285010,400616,COST
06079715102030000,2019,115606,285010,400616,COST
06079715102040000,2021,330145,38160,368305,COST
06079715102040000,2020,214218,32510,246728,COST
06079715102040000,2019,214218,32510,246728,COST
06079716101050000,2021,145121,275470,420591,COST
06079716101050000,2020,114743,238480,353223,COST
06079716101050000,2019,114743,238480,353223,COST
06079716101100000,2021,145162,499670,644832,COST
06079716101100000,2020,114781,433590,548371,COST
06079716101100000,2019,114781,433590,548371,COST
06079716101140000,2021,298034,210866,508900,MKT
06079716101140000,2020,180647,270253,450900,MKT
06079716101140000,2019,180647,270253,450900,MKT
06079716101150000,2021,145089,438090,583179,COST
06079716101150000,2020,114713,387220,501933,COST
06079716101150000,2019,114713,387220,501933,COST
06079716101200000,2021,431809,393891,825700,MKT
06079716101200000,2020,228730,384100,612830,COST
06079716101200000,2019,228730,341610,570340,COST
06079716102050000,2021,145198,1179802,1325000,OVR
06079716102050000,2020,114815,1251190,1366005,COST
06079716102050000,2019,114815,1251190,1366005,COST
06079716103050000,2021,145226,604020,749246,COST
06079716103050000,2020,114841,519220,634061,COST
06079716103050000,2019,114841,398160,513001,COST
06079716201100000,2021,145078,453670,598748,COST
06079716201100000,2020,114704,395240,509944,COST
06079716201100000,2019,114704,395240,509944,COST
06079716201150000,2021,145081,670500,815581,COST
06079716201150000,2020,3592,601810,605402,COST
06079716201150000,2019,3592,601810,605402,COST
06079716202050000,2021,289001,501010,790011,COST
06079716202050000,2020,114683,98640,213323,COST
06079716202050000,2019,114683,98640,213323,COST
06079716202100000,2021,145059,654690,799749,COST
06079716202100000,2020,114685,570710,685395,COST
06079716202100000,2019,114685,570710,685395,COST
06079716202150000,2021,145119,422320,567439,COST
06079716202150000,2020,114741,364890,479631,COST
06079716202150000,2019,114741,364890,479631,COST
06079716202200000,2021,145055,1328220,1473275,COST
06079716202200000,2020,114681,1145900,1260581,COST
06079716202200000,2019,114681,1145900,1260581,COST
06079716202250000,2021,1642,0,1642,COST
06079716202250000,2020,1528,0,1528,COST
06079716202250000,2019,1528,0,1528,COST
06079716203050000,2021,145410,594340,739750,COST
06079716203050000,2020,115012,525400,640412,COST
06079716203050000,2019,115012,525400,640412,COST
06079716301050000,2021,145117,799160,944277,COST
06079716301050000,2020,114740,714930,829670,COST
06079716301050000,2019,114740,703200,817940,COST
06079716301100000,2021,145464,712120,857584,COST
06079716301100000,2020,115062,624270,739332,COST
06079716301100000,2019,115062,624270,739332,COST
06079716301250000,2021,1518,0,1518,COST
06079716301250000,2020,1412,0,1412,COST
06079716301250000,2019,1412,0,1412,COST
06079716301300000,2021,145105,934260,1079365,COST
06079716301300000,2020,114728,884470,999198,OVR
06079716301300000,2019,114728,884470,999198,COST
06079716302050000,2021,145053,971920,1116973,COST
06079716302050000,2020,114680,889470,1004150,COST
06079716302050000,2019,114680,889470,1004150,COST
06079716302100000,2021,145053,523150,668203,COST
06079716302100000,2020,114680,462690,577370,COST
06079716302100000,2019,114680,462690,577370,COST
06079716302150000,2021,145053,930250,1075303,COST
06079716302150000,2020,114680,823980,938660,COST
06079716302150000,2019,114680,857490,972170,COST
06079716401050000,2021,145053,960740,1105793,COST
06079716401050000,2020,114680,735640,850320,OVR
06079716401050000,2019,114680,585010,699690,COST
06079716401100000,2021,145053,581940,726993,COST
06079716401100000,2020,114680,505790,620470,COST
06079716401100000,2019,114680,505790,620470,COST
06079716401150000,2021,145053,1273920,1418973,COST
06079716401150000,2020,114680,1110440,1225120,COST
06079716401150000,2019,114680,1110440,1225120,COST
06079716402050000,2021,145070,648340,793410,COST
06079716402050000,2020,114696,576100,690796,COST
06079716402050000,2019,114696,576100,690796,COST
06079716402100000,2021,145139,821560,966699,COST
06079716402100000,2020,114760,733740,848500,COST
06079716402100000,2019,114760,733740,848500,COST
06079716402150000,2021,145296,684290,829586,COST
06079716402150000,2020,114906,599630,714536,COST
06079716402150000,2019,114906,599630,714536,COST
06079716402200000,2021,145082,1140860,1285942,COST
06079716402200000,2020,114707,1007920,1122627,COST
06079716402200000,2019,114707,1007920,1122627,COST
06079717101010000,2021,188198,23110,211308,COST
06079717101010000,2020,251029,23220,274249,COST
06079717101010000,2019,251029,23220,274249,COST
06079717101200000,2021,135429,51810,187239,COST
06079717101200000,2020,109344,45740,155084,COST
06079717101200000,2019,109344,45740,155084,COST
06079717201010000,2021,1958,220690,222648,COST
06079717201010000,2020,2241,114860,117101,COST
06079717201010000,2019,2241,114860,117101,COST
06079717201030000,2021,7771,0,7771,COST
06079717201030000,2020,8188,0,8188,COST
06079717201030000,2019,8188,0,8188,COST
06079717201050000,2021,4464,0,4464,COST
06079717201050000,2020,4643,0,4643,COST
06079717201050000,2019,4643,0,4643,COST
06079717201100000,2021,42795,393000,435795,COST
06079717201100000,2020,57773,367010,424783,COST
06079717201100000,2019,57773,367010,424783,COST
06079717201300000,2021,51716,1010,52726,COST
06079717201300000,2020,65870,960,66830,COST
06079717201300000,2019,65870,960,66830,COST
06079717304010000,2021,1581,158750,160331,COST
06079717304010000,2020,1472,164120,165592,COST
06079717304010000,2019,1472,164120,165592,COST
06079717304050000,2021,1553,2110530,2112083,COST
06079717304050000,2020,1447,2168000,2169447,COST
06079717304050000,2019,1447,2168000,2169447,COST
06079717304150000,2021,6843,348300,355143,COST
06079717304150000,2020,6777,303800,310577,COST
06079717304150000,2019,6777,303800,310577,COST
06079717304600000,2021,166,0,166,COST
06079717304600000,2020,154,0,154,COST
06079717304600000,2019,154,0,154,COST
06079717304630000,2021,238,0,238,COST
06079717304630000,2020,221,0,221,COST
06079717304630000,2019,221,0,221,COST
06079717401100000,2021,6748,204560,211308,COST
06079717401100000,2020,114758,178020,292778,COST
06079717401100000,2019,12161,177530,189691,COST
06079717401200000,2021,4318,3297400,3301718,COST
06079717401200000,2020,4427,2991190,2995617,COST
06079717401200000,2019,4427,2991190,2995617,COST
06079717401400000,2021,3249,912220,915469,COST
06079717401400000,2020,3432,801380,804812,COST
06079717401400000,2019,3432,801380,804812,COST
06079717401510000,2021,2790,509780,512570,COST
06079717401510000,2020,3005,478400,481405,COST
06079717401510000,2019,3005,482350,485355,COST
06079717401650000,2021,3624,7194970,7198594,COST
06079717401650000,2020,3781,6129220,6133001,COST
06079717401650000,2019,3781,6129220,6133001,COST
06079718101010000,2021,36327,538540,574867,COST
06079718101010000,2020,32167,469200,501367,COST
06079718101010000,2019,32167,469200,501367,COST
06079718101020000,2021,115913,576890,692803,COST
06079718101020000,2020,103023,513210,616233,COST
06079718101020000,2019,103023,513210,616233,COST
06079718201020000,2021,129397,0,129397,COST
06079718201020000,2020,135350,0,135350,COST
06079718201020000,2019,135350,0,135350,COST
06079718201100000,2021,287980,0,287980,COST
06079718201100000,2020,225216,0,225216,COST
06079718201100000,2019,225216,0,225216,COST
06079718201200000,2021,1991,0,1991,COST
06079718201200000,2020,1853,0,1853,COST
06079718201200000,2019,1853,0,1853,COST
06079718201300000,2021,100368,644340,744708,COST
06079718201300000,2020,115532,576350,691882,COST
06079718201300000,2019,115532,576350,691882,COST
06079718301020000,2021,43881,200970,244851,COST
06079718301020000,2020,46041,181710,227751,COST
06079718301020000,2019,46041,181710,227751,COST
06079718305010000,2021,105,0,105,COST
06079718305010000,2020,98,0,98,COST
06079718305010000,2019,98,0,98,COST
06079718401040000,2021,67678,209000,276678,COST
06079718401040000,2020,86681,186230,272911,COST
06079718401040000,2019,86681,186230,272911,COST
06079718401100000,2021,63006,0,63006,COST
06079718401100000,2020,81208,0,81208,COST
06079718401100000,2019,81208,0,81208,COST
06079719101010000,2021,92593,610,93203,COST
06079719101010000,2020,102474,1180,103654,COST
06079719101010000,2019,102474,1180,103654,COST
06079719201010000,2021,70590,0,70590,COST
06079719201010000,2020,73481,0,73481,COST
06079719201010000,2019,73481,0,73481,COST
06079720101030000,2021,113283,1014740,1128023,COST
06079720101030000,2020,103233,965890,1069123,COST
06079720101030000,2019,103233,965890,1069123,COST
06079720201010000,2021,44756,0,44756,COST
06079720201010000,2020,48479,62580,111059,COST
06079720201010000,2019,48479,62580,111059,COST
06079720201400000,2021,292976,41110,334086,COST
06079720201400000,2020,178689,0,178689,COST
06079720201400000,2019,178689,0,178689,COST
06079720301010000,2021,11144,0,11144,COST
06079720301010000,2020,10374,0,10374,COST
06079720301010000,2019,10374,0,10374,COST
06079720401010000,2021,12273,7280,19553,COST
06079720401010000,2020,11425,6000,17425,COST
06079720401010000,2019,11425,6000,17425,COST
06079721101010000,2021,49481,0,49481,COST
06079721101010000,2020,56095,0,56095,COST
06079721101010000,2019,56095,0,56095,COST
06079721201050000,2021,118,0,118,COST
06079721201050000,2020,110,0,110,COST
06079721201050000,2019,110,0,110,COST
06079721301010000,2021,21913,0,21913,COST
06079721301010000,2020,20397,0,20397,COST
06079721301010000,2019,20397,0,20397,COST
06079722101010000,2021,258267,1910660,2168927,COST
06079722101010000,2020,341214,1845380,2186594,COST
06079722101010000,2019,341214,1845380,2186594,COST
06079722101020000,2021,17506,161660,179166,COST
06079722101020000,2020,19998,143310,163308,COST
06079722101020000,2019,19998,143310,163308,COST
06079722101200000,2021,2231,0,2231,COST
06079722101200000,2020,2076,0,2076,COST
06079722101200000,2019,2076,0,2076,COST
06079723103010000,2021,104181,0,104181,COST
06079723103010000,2020,107178,0,107178,COST
06079723103010000,2019,107178,0,107178,COST
06079723105010000,2021,174590,298010,472600,MKT
06079723105010000,2020,119758,256642,376400,MKT
06079723105010000,2019,119758,256642,376400,MKT
06079723105030000,2021,158547,297953,456500,MKT
06079723105030000,2020,110343,261557,371900,MKT
06079723105030000,2019,110343,261557,371900,MKT
06079723105050000,2021,159033,320650,479683,COST
06079723105050000,2020,110630,191470,302100,MKT
06079723105050000,2019,110630,191470,302100,MKT
06079723105070000,2021,160136,291564,451700,MKT
06079723105070000,2020,111281,250119,361400,MKT
06079723105070000,2019,111281,250119,361400,MKT
06079723105090000,2021,159724,197490,357214,COST
06079723105090000,2020,111038,176962,288000,MKT
06079723105090000,2019,111038,176962,288000,MKT
06079723105130000,2021,159999,227001,387000,MKT
06079723105130000,2020,111200,189800,301000,MKT
06079723105130000,2019,111200,189800,301000,MKT
06079723105150000,2021,162176,230624,392800,MKT
06079723105150000,2020,112484,194516,307000,MKT
06079723105150000,2019,112484,194516,307000,MKT
06079723105170000,2021,159448,202910,362358,COST
06079723105170000,2020,110875,182030,292905,COST
06079723105170000,2019,110875,182030,292905,COST
06079723105190000,2021,147190,197210,344400,MKT
06079723105190000,2020,101493,117840,219333,COST
06079723105190000,2019,101493,117840,219333,COST
06079723105230000,2021,154224,253876,408100,MKT
06079723105230000,2020,107782,222318,330100,MKT
06079723105230000,2019,107782,222318,330100,MKT
06079723105240000,2021,159448,306452,465900,MKT
06079723105240000,2020,110875,277325,388200,MKT
06079723105240000,2019,110875,277325,388200,MKT
06079723105250000,2021,159861,277539,437400,MKT
06079723105250000,2020,111119,195081,306200,MKT
06079723105250000,2019,111119,195081,306200,MKT
06079723105270000,2021,159448,323952,483400,MKT
06079723105270000,2020,110875,279825,390700,MKT
06079723105270000,2019,110875,279825,390700,MKT
06079723105290000,2021,159448,321452,480900,MKT
06079723105290000,2020,110875,270625,381500,MKT
06079723105290000,2019,110875,270625,381500,MKT
06079723105310000,2021,159448,468860,628308,COST
06079723105310000,2020,110875,386325,497200,MKT
06079723105310000,2019,110875,386325,497200,MKT
06079723105330000,2021,159448,235952,395400,MKT
06079723105330000,2020,110875,194725,305600,MKT
06079723105330000,2019,110875,194725,305600,MKT
06079723105360000,2021,159448,281652,441100,MKT
06079723105360000,2020,110875,254625,365500,MKT
06079723105360000,2019,110875,254625,365500,MKT
06079723105390000,2021,159448,245752,405200,MKT
06079723105390000,2020,110875,227125,338000,MKT
06079723105390000,2019,110875,227125,338000,MKT
06079723105430000,2021,158756,615244,774000,INCOME
06079723105430000,2020,110466,567434,677900,INCOME
06079723105430000,2019,110466,567434,677900,INCOME
06079723105450000,2021,158756,0,158756,COST
06079723105450000,2020,110466,0,110466,COST
06079723105450000,2019,110466,0,110466,COST
06079723105470000,2021,159103,456997,616100,MKT
06079723105470000,2020,110671,399329,510000,MKT
06079723105470000,2019,110671,365429,476100,MKT
06079723105500000,2021,157359,473241,630600,INCOME
06079723105500000,2020,109640,422960,532600,INCOME
06079723105500000,2019,109640,422960,532600,INCOME
06079723105530000,2021,157359,433541,590900,INCOME
06079723105530000,2020,109640,422960,532600,INCOME
06079723105530000,2019,109640,422960,532600,INCOME
06079723105550000,2021,157359,391741,549100,INCOME
06079723105550000,2020,109640,422960,532600,INCOME
06079723105550000,2019,109640,422960,532600,INCOME
06079723106180000,2021,159999,151101,311100,MKT
06079723106180000,2020,111200,135100,246300,MKT
06079723106180000,2019,111200,135100,246300,MKT
06079723106190000,2021,229008,240392,469400,INCOME
06079723106190000,2020,229235,147365,376600,INCOME
06079723106190000,2019,229235,147365,376600,INCOME
06079723106200000,2021,169749,167851,337600,MKT
06079723106200000,2020,116931,148569,265500,MKT
06079723106200000,2019,116931,148569,265500,MKT
06079723108011001,2021,31556,0,31556,COST
06079723108011001,2020,23382,0,23382,COST
06079723108011001,2019,23382,0,23382,COST
06079723108011002,2021,149662,259470,409132,COST
06079723108011002,2020,102017,182980,284997,COST
06079723108011002,2019,102017,182980,284997,COST
06079723108020000,2021,165290,857240,1022530,COST
06079723108020000,2020,138035,605400,743435,COST
06079723108020000,2019,138035,605400,743435,COST
06079723108021001,2021,29400,0,29400,COST
06079723108021001,2020,22018,0,22018,COST
06079723108021001,2019,22018,0,22018,COST
06079723108021002,2021,120523,418750,539273,COST
06079723108021002,2020,87414,348570,435984,COST
06079723108021002,2019,87414,348570,435984,COST
06079723108031001,2021,25779,0,25779,COST
06079723108031001,2020,19691,0,19691,COST
06079723108031001,2019,19691,0,19691,COST
06079723108031002,2021,142887,300600,443487,COST
06079723108031002,2020,101013,247730,348743,COST
06079723108031002,2019,101013,247730,348743,COST
06079723108041001,2021,24986,0,24986,COST
06079723108041001,2020,19176,0,19176,COST
06079723108041001,2019,19176,0,19176,COST
06079723108041002,2021,138456,280560,419016,COST
06079723108041002,2020,98346,240650,338996,COST
06079723108041002,2019,98346,240650,338996,COST
06079723108050000,2021,326491,915410,1241901,COST
06079723108050000,2020,246099,650990,897089,COST
06079723108050000,2019,246099,650990,897089,COST
06079723108070000,2021,326491,0,326491,COST
06079723108070000,2020,246099,0,246099,COST
06079723108070000,2019,246099,0,246099,COST
06079723108101001,2021,121572,226028,347600,MKT
06079723108101001,2020,83706,132040,215746,COST
06079723108101001,2019,83706,132040,215746,COST
06079723108101002,2021,34904,0,34904,COST
06079723108101002,2020,25473,0,25473,COST
06079723108101002,2019,25473,0,25473,COST
06079723109011001,2021,34323,0,34323,COST
06079723109011001,2020,25112,0,25112,COST
06079723109011001,2019,25112,0,25112,COST
06079723109011002,2021,116467,152390,268857,COST
06079723109011002,2020,84909,126740,211649,OVR
06079723109011002,2019,84909,126740,211649,COST
06079723109020000,2021,159379,223021,382400,MKT
06079723109020000,2020,110834,179966,290800,OVR
06079723109020000,2019,110834,179966,290800,MKT
06079723109030000,2021,159379,288950,448329,COST
06079723109030000,2020,110834,256680,367514,COST
06079723109030000,2019,110834,256680,367514,COST
06079723109040000,2021,159379,299421,458800,MKT
06079723109040000,2020,110834,53840,164674,COST
06079723109040000,2019,110834,0,110834,COST
06079723109060000,2021,213254,378890,592144,COST
06079723109060000,2020,141939,321840,463779,COST
06079723109060000,2019,141939,321840,463779,COST
06079723109070000,2021,159448,183160,342608,COST
06079723109070000,2020,110875,160560,271435,COST
06079723109070000,2019,110875,160560,271435,COST
06079723109080000,2021,159448,0,159448,COST
06079723109080000,2020,110875,0,110875,COST
06079723109080000,2019,110875,0,110875,COST
06079723109090000,2021,159448,296652,456100,INCOME
06079723109090000,2020,110875,326225,437100,INCOME
06079723109090000,2019,110875,257660,368535,COST
06079723109100000,2021,159448,0,159448,COST
06079723109100000,2020,110875,0,110875,COST
06079723109100000,2019,110875,0,110875,COST
06079723109110000,2021,159379,254121,413500,MKT
06079723109110000,2020,110834,222466,333300,MKT
06079723109110000,2019,110834,222466,333300,MKT
06079723109350000,2021,159379,695880,855259,COST
06079723109350000,2020,110834,589900,700734,COST
06079723109350000,2019,110834,589900,700734,COST
06079723109370000,2021,159379,232421,391800,MKT
06079723109370000,2020,110834,190666,301500,MKT
06079723109370000,2019,110834,190666,301500,MKT
06079723109390000,2021,159379,257321,416700,MKT
06079723109390000,2020,110834,213066,323900,MKT
06079723109390000,2019,110834,213066,323900,MKT
06079723109410000,2021,159379,232421,391800,MKT
06079723109410000,2020,110834,190666,301500,MKT
06079723109410000,2019,110834,190666,301500,MKT
06079723109430000,2021,159379,260021,419400,MKT
06079723109430000,2020,110834,210766,321600,MKT
06079723109430000,2019,110834,210766,321600,MKT
06079723109450000,2021,159379,0,159379,COST
06079723109450000,2020,110834,0,110834,COST
06079723109450000,2019,110834,0,110834,COST
06079723109470000,2021,159379,173680,333059,COST
06079723109470000,2020,110834,150280,261114,COST
06079723109470000,2019,110834,150280,261114,COST
06079723109490000,2021,159379,337821,497200,MKT
06079723109490000,2020,110834,199410,310244,COST
06079723109490000,2019,110834,199410,310244,COST
06079723109510000,2021,159379,321321,480700,MKT
06079723109510000,2020,110834,239930,350764,COST
06079723109510000,2019,110834,239930,350764,COST
06079723109530000,2021,160630,154570,315200,MKT
06079723109530000,2020,110834,83440,194274,COST
06079723109530000,2019,110834,83440,194274,COST
06079723110010000,2021,79349,0,79349,COST
06079723110010000,2020,61289,0,61289,COST
06079723110010000,2019,61289,0,61289,COST
06079723110011001,2021,33861,4950,38811,COST
06079723110011001,2020,24825,4840,29665,COST
06079723110011001,2019,24825,4840,29665,COST
06079723110011002,2021,122829,191540,314369,COST
06079723110011002,2020,88833,164610,253443,COST
06079723110011002,2019,88833,164610,253443,COST
06079723110020000,2021,214999,347801,562800,INCOME
06079723110020000,2020,142925,397675,540600,INCOME
06079723110020000,2019,142925,397675,540600,INCOME
06079723110040000,2021,232560,480640,713200,INCOME
06079723110040000,2020,232686,389614,622300,INCOME
06079723110040000,2019,232686,389614,622300,INCOME
06079723110050000,2021,164578,281780,446358,COST
06079723110050000,2020,113898,242180,356078,COST
06079723110050000,2019,113898,242180,356078,COST
06079723110060000,2021,159793,235307,395100,MKT
06079723110060000,2020,111079,201421,312500,MKT
06079723110060000,2019,111079,201421,312500,MKT
06079723110070000,2021,157710,189280,346990,COST
06079723110070000,2020,109848,161890,271738,COST
06079723110070000,2019,109848,161890,271738,COST
06079723110080000,2021,158686,165514,324200,MKT
06079723110080000,2020,110425,151775,262200,MKT
06079723110080000,2019,110425,151775,262200,MKT
06079723110090000,2021,158408,180492,338900,MKT
06079723110090000,2020,110261,154539,264800,MKT
06079723110090000,2019,110261,154539,264800,MKT
06079723110100000,2021,229307,319493,548800,INCOME
06079723110100000,2020,229525,220375,449900,INCOME
06079723110100000,2019,229525,220375,449900,INCOME
06079723110110000,2021,159379,53590,212969,COST
06079723110110000,2020,110834,45910,156744,COST
06079723110110000,2019,110834,45910,156744,COST
06079723110140000,2021,159448,177452,336900,MKT
06079723110140000,2020,110875,157925,268800,MKT
06079723110140000,2019,110875,157925,268800,MKT
06079723110150000,2021,159448,0,159448,COST
06079723110150000,2020,110875,0,110875,COST
06079723110150000,2019,110875,0,110875,COST
06079723110160000,2021,205324,34050,239374,COST
06079723110160000,2020,141939,16810,158749,COST
06079723110160000,2019,141939,16810,158749,COST
06079723110170000,2021,159379,145090,304469,COST
06079723110170000,2020,110834,177666,288500,MKT
06079723110170000,2019,110834,177666,288500,MKT
06079723110180000,2021,159379,0,159379,COST
06079723110180000,2020,110834,0,110834,COST
06079723110180000,2019,110834,0,110834,COST
06079723110190000,2021,159379,196121,355500,MKT
06079723110190000,2020,110834,160466,271300,MKT
06079723110190000,2019,110834,160466,271300,MKT
06079723110200000,2021,159379,208521,367900,MKT
06079723110200000,2020,110834,177066,287900,MKT
06079723110200000,2019,110834,177066,287900,MKT
06079723110210000,2021,159379,1010,160389,COST
06079723110210000,2020,110834,1030,111864,COST
06079723110210000,2019,110834,1030,111864,COST
06079723110220000,2021,159448,0,159448,COST
06079723110220000,2020,110875,0,110875,COST
06079723110220000,2019,110875,0,110875,COST
06079723111010000,2021,154512,237588,392100,MKT
06079723111010000,2020,107953,198747,306700,MKT
06079723111010000,2019,107953,198747,306700,MKT
06079723111020000,2021,159448,154710,314158,COST
06079723111020000,2020,110875,137330,248205,COST
06079723111020000,2019,110875,137330,248205,COST
06079723111030000,2021,159448,325552,485000,MKT
06079723111030000,2020,110875,288725,399600,MKT
06079723111030000,2019,110875,288725,399600,MKT
06079723111040000,2021,159448,253252,412700,MKT
06079723111040000,2020,110875,210025,320900,MKT
06079723111040000,2019,110875,210025,320900,MKT
06079723111050000,2021,159448,146480,305928,COST
06079723111050000,2020,110875,165625,276500,MKT
06079723111050000,2019,110875,165625,276500,MKT
06079723111060000,2021,158756,247944,406700,MKT
06079723111060000,2020,110466,217034,327500,MKT
06079723111060000,2019,110466,217034,327500,MKT
06079723111070000,2021,159448,275952,435400,MKT
06079723111070000,2020,110875,225525,336400,MKT
06079723111070000,2019,110875,225525,336400,MKT
06079723111080000,2021,159448,500,159948,COST
06079723111080000,2020,110875,540,111415,COST
06079723111080000,2019,110875,540,111415,COST
06079723111090000,2021,160688,171712,332400,MKT
06079723111090000,2020,110875,112600,223475,COST
06079723111090000,2019,110875,112600,223475,COST
06079723111100000,2021,160688,176712,337400,MKT
06079723111100000,2020,110875,77930,188805,COST
06079723111100000,2019,110875,77930,188805,COST
06079723111110000,2021,159448,254430,413878,COST
06079723111110000,2020,110875,221680,332555,COST
06079723111110000,2019,110875,221680,332555,COST
06079723111120000,2021,159448,288552,448000,MKT
06079723111120000,2020,110875,263225,374100,MKT
06079723111120000,2019,110875,263225,374100,MKT
06079723111130000,2021,159448,0,159448,COST
06079723111130000,2020,110875,0,110875,COST
06079723111130000,2019,110875,0,110875,COST
06079723111150000,2021,213254,8520,221774,COST
06079723111150000,2020,141939,8760,150699,COST
06079723111150000,2019,141939,8760,150699,COST
06079723111160000,2021,159655,162245,321900,MKT
06079723111160000,2020,110997,144003,255000,MKT
06079723111160000,2019,110997,133903,244900,MKT
06079723111180000,2021,212375,331525,543900,MKT
06079723111180000,2020,141441,281160,422601,COST
06079723111180000,2019,141441,281160,422601,COST
06079723111190000,2021,157499,22680,180179,COST
06079723111190000,2020,109723,22880,132603,COST
06079723111190000,2019,109723,22880,132603,COST
06079723111200000,2021,161906,12870,174776,COST
06079723111200000,2020,112325,12580,124905,COST
06079723111200000,2019,112325,12580,124905,COST
06079723111210000,2021,157990,108810,266800,COST
06079723111210000,2020,110013,92000,202013,COST
06079723111210000,2019,110013,92000,202013,COST
06079723111220000,2021,167460,147840,315300,MKT
06079723111220000,2020,115584,90220,205804,COST
06079723111220000,2019,115584,90220,205804,COST
06079723111240000,2021,144243,261557,405800,MKT
06079723111240000,2020,101827,241673,343500,MKT
06079723111240000,2019,101827,241673,343500,MKT
06079723111250000,2021,149801,213699,363500,MKT
06079723111250000,2020,105150,190950,296100,MKT
06079723111250000,2019,105150,190950,296100,MKT
06079723111260000,2021,168733,224167,392900,MKT
06079723111260000,2020,116336,204164,320500,MKT
06079723111260000,2019,116336,204164,320500,MKT
06079723111270000,2021,167900,170800,338700,MKT
06079723111270000,2020,115848,161652,277500,MKT
06079723111270000,2019,115848,161652,277500,MKT
06079723111280000,2021,167643,152910,320553,COST
06079723111280000,2020,115697,171903,287600,MKT
06079723111280000,2019,115697,171903,287600,MKT
06079723111290000,2021,151518,173682,325200,MKT
06079723111290000,2020,106173,124327,230500,MKT
06079723111290000,2019,106173,124327,230500,MKT
06079723111300000,2021,117103,0,117103,COST
06079723111300000,2020,85303,0,85303,COST
06079723111300000,2019,85303,0,85303,COST
06079723111310000,2021,146638,205162,351800,MKT
06079723111310000,2020,101109,123420,224529,COST
06079723111310000,2019,101109,123420,224529,COST
06079723111320000,2021,159448,286252,445700,MKT
06079723111320000,2020,110875,236225,347100,MKT
06079723111320000,2019,110875,236225,347100,MKT
06079723111330000,2021,159448,300152,459600,MKT
06079723111330000,2020,110875,263025,373900,MKT
06079723111330000,2019,110875,263025,373900,MKT
06079723111350000,2021,159448,262052,421500,MKT
06079723111350000,2020,110875,212225,323100,MKT
06079723111350000,2019,110875,212225,323100,MKT
06079723111360000,2021,159448,227780,387228,COST
06079723111360000,2020,110875,199290,310165,COST
06079723111360000,2019,110875,199290,310165,COST
06079723111370000,2021,160688,161412,322100,MKT
06079723111370000,2020,110875,91700,202575,COST
06079723111370000,2019,110875,91700,202575,COST
06079723111380000,2021,159448,275852,435300,MKT
06079723111380000,2020,110875,252825,363700,OVR
06079723111380000,2019,110875,252825,363700,MKT
06079723111390000,2021,159448,270052,429500,MKT
06079723111390000,2020,110875,244225,355100,MKT
06079723111390000,2019,110875,244225,355100,MKT
06079723111400000,2021,159448,204560,364008,COST
06079723111400000,2020,110875,180640,291515,COST
06079723111400000,2019,110875,180640,291515,COST
06079723111410000,2021,154224,297376,451600,MKT
06079723111410000,2020,107782,250218,358000,MKT
06079723111410000,2019,107782,250218,358000,MKT
06079723201050000,2021,81241,0,81241,COST
06079723201050000,2020,83499,0,83499,COST
06079723201050000,2019,83499,0,83499,COST
06079723201100000,2021,1105,0,1105,COST
06079723201100000,2020,1029,0,1029,COST
06079723201100000,2019,1029,0,1029,COST
06079723201150000,2021,1795,0,1795,COST
06079723201150000,2020,1672,0,1672,COST
06079723201150000,2019,1672,0,1672,COST
06079723201200000,2021,42,0,42,COST
06079723201200000,2020,39,0,39,COST
06079723201200000,2019,39,0,39,COST
06079723201302000,2021,8361,0,8361,COST
06079723201302000,2020,10684,0,10684,COST
06079723201302000,2019,10684,0,10684,COST
06079723202010000,2021,6603,545360,551963,COST
06079723202010000,2020,7374,404890,412264,COST
06079723202010000,2019,7374,307520,314894,COST
06079723202021001,2021,2382,0,2382,COST
06079723202021001,2020,2222,0,2222,COST
06079723202021001,2019,2222,0,2222,COST
06079723202021002,2021,3313,274010,277323,COST
06079723202021002,2020,3491,234980,238471,COST
06079723202021002,2019,3491,234980,238471,COST
06079723202050000,2021,270,0,270,COST
06079723202050000,2020,252,0,252,COST
06079723202050000,2019,252,0,252,COST
06079723202100000,2021,528,0,528,COST
06079723202100000,2020,493,0,493,COST
06079723202100000,2019,493,0,493,COST
06079723202150000,2021,195432,393830,589262,COST
06079723202150000,2020,220832,244810,465642,COST
06079723202150000,2019,220832,217830,438662,COST
06079723301010000,2021,161500,114680,276180,COST
06079723301010000,2020,112086,97320,209406,COST
06079723301010000,2019,112086,97320,209406,COST
06079723301020000,2021,459612,305590,765202,COST
06079723301020000,2020,329056,225960,555016,COST
06079723301020000,2019,329056,225960,555016,COST
06079723301030000,2021,161500,378400,539900,MKT
06079723301030000,2020,112086,342314,454400,MKT
06079723301030000,2019,112086,342314,454400,MKT
06079723301040000,2021,464452,776970,1241422,COST
06079723301040000,2020,331997,546760,878757,COST
06079723301040000,2019,331997,546760,878757,COST
06079723301050000,2021,246305,0,246305,COST
06079723301050000,2020,160419,0,160419,COST
06079723301050000,2019,160419,0,160419,COST
06079723301070000,2021,145816,0,145816,COST
06079723301070000,2020,102770,0,102770,COST
06079723301070000,2019,102770,0,102770,COST
06079723301080000,2021,150700,386700,537400,COST
06079723301080000,2020,105686,324014,429700,MKT
06079723301080000,2019,105686,324014,429700,MKT
06079723301090000,2021,324730,3349770,3674500,INCOME
06079723301090000,2020,321769,1921570,2243339,COST
06079723301090000,2019,321769,1220731,1542500,INCOME
06079723301100000,2021,150849,438351,589200,MKT
06079723301100000,2020,105775,362825,468600,MKT
06079723301100000,2019,105775,362825,468600,MKT
06079723301150000,2021,159448,280952,440400,MKT
06079723301150000,2020,110875,248325,359200,MKT
06079723301150000,2019,110875,248325,359200,MKT
06079723301250000,2021,328542,0,328542,COST
06079723301250000,2020,247411,0,247411,COST
06079723301250000,2019,247411,0,247411,COST
06079723302010000,2021,470368,684470,1154838,COST
06079723302010000,2020,428997,488340,917337,COST
06079723302010000,2019,428997,488340,917337,COST
06079723302050000,2021,153313,322630,475943,COST
06079723302050000,2020,151557,254343,405900,MKT
06079723302050000,2019,151557,254343,405900,MKT
06079723302100000,2021,292580,0,292580,COST
06079723302100000,2020,286618,0,286618,COST
06079723302100000,2019,286618,0,286618,COST
06079723302150000,2021,300840,273870,574710,COST
06079723302150000,2020,293477,193180,486657,COST
06079723302150000,2019,293477,193180,486657,COST
06079723302200000,2021,449015,780330,1229345,COST
06079723302200000,2020,412396,552800,965196,COST
06079723302200000,2019,412396,407520,819916,COST
06079723302250000,2021,189445,0,189445,COST
06079723302250000,2020,181402,0,181402,COST
06079723302250000,2019,181402,0,181402,COST
06079723302300000,2021,274833,0,274833,COST
06079723302300000,2020,248830,0,248830,COST
06079723302300000,2019,248830,0,248830,COST
06079723302350000,2021,380159,2603541,2983700,INCOME
06079723302350000,2020,246027,2607873,2853900,INCOME
06079723302350000,2019,246027,2070420,2316447,COST
06079723302400000,2021,33386,0,33386,COST
06079723302400000,2020,15034,0,15034,COST
06079723302400000,2019,15034,0,15034,COST
06079723303390000,2021,86982,0,86982,COST
06079723303390000,2020,66263,0,66263,COST
06079723303390000,2019,66263,0,66263,COST
06079723303400000,2021,157289,342511,499800,MKT
06079723303400000,2020,109598,320602,430200,MKT
06079723303400000,2019,109598,320602,430200,MKT
06079723304010000,2021,3310,0,3310,COST
06079723304010000,2020,4356,0,4356,COST
06079723304010000,2019,4356,0,4356,COST
06079723305101001,2021,3081,0,3081,COST
06079723305101001,2020,3742,0,3742,COST
06079723305101001,2019,3742,0,3742,COST
06079723305101002,2021,33485,0,33485,COST
06079723305101002,2020,40997,0,40997,COST
06079723305101002,2019,40997,0,40997,COST
06079723401016500,2021,37209,0,37209,COST
06079723401016500,2020,27281,0,27281,COST
06079723401016500,2019,27281,0,27281,COST
06079723401050000,2021,38,0,38,COST
06079723401050000,2020,36,0,36,COST
06079723401050000,2019,36,0,36,COST
06079723401100000,2021,52,0,52,COST
06079723401100000,2020,48,0,48,COST
06079723401100000,2019,48,0,48,COST
06079723401150000,2021,54,0,54,COST
06079723401150000,2020,50,0,50,COST
06079723401150000,2019,50,0,50,COST
06079723401200000,2021,57,0,57,COST
06079723401200000,2020,53,0,53,COST
06079723401200000,2019,53,0,53,COST
06079723401250000,2021,208,0,208,COST
06079723401250000,2020,194,0,194,COST
06079723401250000,2019,194,0,194,COST
06079723401300000,2021,117,0,117,COST
06079723401300000,2020,109,0,109,COST
06079723401300000,2019,109,0,109,COST
06079723401350000,2021,129,0,129,COST
06079723401350000,2020,120,0,120,COST
06079723401350000,2019,120,0,120,COST
06079723401400000,2021,37,0,37,COST
06079723401400000,2020,34,0,34,COST
06079723401400000,2019,34,0,34,COST
06079723401436500,2021,65318,0,65318,COST
06079723401436500,2020,54620,0,54620,COST
06079723401436500,2019,54620,0,54620,COST
06079723401450000,2021,37,0,37,COST
06079723401450000,2020,34,0,34,COST
06079723401450000,2019,34,0,34,COST
06079723401500000,2021,41,0,41,COST
06079723401500000,2020,38,0,38,COST
06079723401500000,2019,38,0,38,COST
06079723401550000,2021,51,0,51,COST
06079723401550000,2020,47,0,47,COST
06079723401550000,2019,47,0,47,COST
06079723401600000,2021,52,0,52,COST
06079723401600000,2020,48,0,48,COST
06079723401600000,2019,48,0,48,COST
06079723401656500,2021,60245,0,60245,COST
06079723401656500,2020,49434,0,49434,COST
06079723401656500,2019,49434,0,49434,COST
06079723401676500,2021,63569,0,63569,COST
06079723401676500,2020,52821,0,52821,COST
06079723401676500,2019,52821,0,52821,COST
06079723403020000,2021,229605,981095,1210700,INCOME
06079723403020000,2020,110774,945626,1056400,INCOME
06079723403020000,2019,110774,945626,1056400,INCOME
06079723403030000,2021,159379,0,159379,COST
06079723403030000,2020,110834,0,110834,COST
06079723403030000,2019,110834,0,110834,COST
06079723403040000,2021,159448,290052,449500,MKT
06079723403040000,2020,110875,262525,373400,MKT
06079723403040000,2019,110875,262525,373400,MKT
06079723403050000,2021,159448,255952,415400,MKT
06079723403050000,2020,110875,207825,318700,MKT
06079723403050000,2019,110875,207825,318700,MKT
06079723403060000,2021,159448,249052,408500,MKT
06079723403060000,2020,110875,211225,322100,MKT
06079723403060000,2019,110875,208725,319600,MKT
06079723403070000,2021,159448,389452,548900,MKT
06079723403070000,2020,110875,315025,425900,OVR
06079723403070000,2019,110875,315025,425900,MKT
06079723403080000,2021,159448,346552,506000,MKT
06079723403080000,2020,110875,304225,415100,MKT
06079723403080000,2019,110875,304225,415100,MKT
06079723403090000,2021,159448,242352,401800,MKT
06079723403090000,2020,110875,203625,314500,MKT
06079723403090000,2019,110875,203625,314500,MKT
06079723403100000,2021,159448,291652,451100,MKT
06079723403100000,2020,110875,248625,359500,MKT
06079723403100000,2019,110875,248625,359500,MKT
06079723403110000,2021,159448,241152,400600,MKT
06079723403110000,2020,110875,200425,311300,MKT
06079723403110000,2019,110875,200425,311300,MKT
06079723403120000,2021,159448,275760,435208,COST
06079723403120000,2020,110875,237630,348505,COST
06079723403120000,2019,110875,237630,348505,COST
06079723403130000,2021,159448,293452,452900,MKT
06079723403130000,2020,110875,254825,365700,MKT
06079723403130000,2019,110875,254825,365700,MKT
06079723403140000,2021,159448,254852,414300,MKT
06079723403140000,2020,110875,214125,325000,MKT
06079723403140000,2019,110875,214125,325000,MKT
06079723403150000,2021,159448,327052,486500,MKT
06079723403150000,2020,110875,277825,388700,OVR
06079723403150000,2019,110875,277825,388700,MKT
06079723403160000,2021,159448,327052,486500,MKT
06079723403160000,2020,110875,278525,389400,MKT
06079723403160000,2019,110875,278525,389400,MKT
06079723403170000,2021,154512,247888,402400,MKT
06079723403170000,2020,107953,206747,314700,MKT
06079723403170000,2019,107953,206747,314700,MKT
06079723403180000,2021,154512,321388,475900,MKT
06079723403180000,2020,107953,274947,382900,MKT
06079723403180000,2019,107953,274947,382900,MKT
06079723403190000,2021,159448,387352,546800,MKT
06079723403190000,2020,110875,324925,435800,MKT
06079723403190000,2019,110875,324925,435800,MKT
06079723403200000,2021,159448,264252,423700,MKT
06079723403200000,2020,110875,235425,346300,MKT
06079723403200000,2019,110875,235425,346300,MKT
06079723403220000,2021,159448,261752,421200,MKT
06079723403220000,2020,110875,218425,329300,MKT
06079723403220000,2019,110875,218425,329300,MKT
06079723403230000,2021,159448,459952,619400,MKT
06079723403230000,2020,110875,366925,477800,OVR
06079723403230000,2019,110875,366925,477800,MKT
06079723403240000,2021,154224,574076,728300,MKT
06079723403240000,2020,107782,451418,559200,MKT
06079723403240000,2019,107782,404418,512200,MKT
06079723403250000,2021,159448,205552,365000,MKT
06079723403250000,2020,110875,181025,291900,MKT
06079723403250000,2019,110875,181025,291900,MKT
06079723403270000,2021,159448,239452,398900,MKT
06079723403270000,2020,110875,197625,308500,MKT
06079723403270000,2019,110875,197625,308500,MKT
06079723403280000,2021,159448,293652,453100,MKT
06079723403280000,2020,110875,260125,371000,OVR
06079723403280000,2019,110875,260125,371000,MKT
06079723403290000,2021,159448,316052,475500,MKT
06079723403290000,2020,110875,272425,383300,MKT
06079723403290000,2019,110875,272425,383300,MKT
06079723403300000,2021,159448,289952,449400,MKT
06079723403300000,2020,110875,257725,368600,MKT
06079723403300000,2019,110875,270925,381800,MKT
06079723403310000,2021,159448,358152,517600,MKT
06079723403310000,2020,110875,224525,335400,MKT
06079723403310000,2019,110875,224525,335400,MKT
06079723403320000,2021,159448,289052,448500,MKT
06079723403320000,2020,110875,249225,360100,MKT
06079723403320000,2019,110875,249225,360100,MKT
06079723403330000,2021,159448,270952,430400,MKT
06079723403330000,2020,110875,237425,348300,MKT
06079723403330000,2019,110875,237425,348300,MKT
06079723403350000,2021,159448,289252,448700,MKT
06079723403350000,2020,110875,244125,355000,OVR
06079723403350000,2019,110875,244125,355000,MKT
06079723403360000,2021,159448,352352,511800,MKT
06079723403360000,2020,110875,309225,420100,MKT
06079723403360000,2019,110875,309225,420100,MKT
06079723405010000,2021,207083,0,207083,COST
06079723405010000,2020,138442,0,138442,COST
06079723405010000,2019,138442,197858,336300,MKT
06079723405600000,2021,711,0,711,COST
06079723405600000,2020,662,0,662,COST
06079723405600000,2019,662,0,662,COST
06079723405650000,2021,1930,0,1930,COST
06079723405650000,2020,1796,0,1796,COST
06079723405650000,2019,1796,0,1796,COST
06079723406010000,2021,154224,0,154224,COST
06079723406010000,2020,107782,0,107782,COST
06079723406010000,2019,107782,0,107782,COST
06079723406020000,2021,159448,20880,180328,COST
06079723406020000,2020,110875,21170,132045,COST
06079723406020000,2019,110875,21170,132045,COST
06079723406040000,2021,199674,259126,458800,MKT
06079723406040000,2020,138004,248930,386934,COST
06079723406040000,2019,138004,180890,318894,COST
06079723407010000,2021,285547,171853,457400,MKT
06079723407010000,2020,197894,60300,258194,COST
06079723407010000,2019,197894,60300,258194,COST
06079723407060000,2021,155945,0,155945,COST
06079723407060000,2020,108802,0,108802,COST
06079723407060000,2019,108802,0,108802,COST
06079723407080000,2021,161500,202700,364200,MKT
06079723407080000,2020,112086,184414,296500,MKT
06079723407080000,2019,112086,184414,296500,MKT
06079723425050000,2021,222040,49740,271780,COST
06079723425050000,2020,186411,39389,225800,INCOME
06079723425050000,2019,186411,39389,225800,INCOME
06079723425100000,2021,232056,493750,725806,COST
06079723425100000,2020,196838,443750,640588,COST
06079723425100000,2019,196838,443750,640588,COST
06079723426010000,2021,133945,478355,612300,MKT
06079723426010000,2020,91499,437301,528800,MKT
06079723426010000,2019,91499,437301,528800,MKT
06079723426030000,2021,134570,358130,492700,MKT
06079723426030000,2020,91960,332540,424500,MKT
06079723426030000,2019,91960,332540,424500,MKT
06079723426050000,2021,133788,312212,446000,MKT
06079723426050000,2020,91383,296417,387800,MKT
06079723426050000,2019,91383,291617,383000,MKT
06079723426070000,2021,133945,443855,577800,MKT
06079723426070000,2020,91499,422301,513800,MKT
06079723426070000,2019,91499,422301,513800,MKT
06079723426090000,2021,133788,468112,601900,MKT
06079723426090000,2020,91383,433717,525100,MKT
06079723426090000,2019,91383,433717,525100,MKT
06079723426110000,2021,134414,298086,432500,MKT
06079723426110000,2020,91845,298855,390700,MKT
06079723426110000,2019,91845,298855,390700,MKT
06079723426130000,2021,134258,365542,499800,MKT
06079723426130000,2020,91730,321370,413100,MKT
06079723426130000,2019,91730,321370,413100,MKT
06079723426150000,2021,134102,348798,482900,MKT
06079723426150000,2020,91614,323086,414700,MKT
06079723426150000,2019,91614,323086,414700,MKT
06079723426170000,2021,133630,358370,492000,MKT
06079723426170000,2020,91267,314233,405500,MKT
06079723426170000,2019,91267,314233,405500,MKT
06079723426190000,2021,132997,357203,490200,MKT
06079723426190000,2020,90800,326300,417100,MKT
06079723426190000,2019,90800,326300,417100,MKT
06079723426210000,2021,133945,413455,547400,MKT
06079723426210000,2020,91499,363501,455000,MKT
06079723426210000,2019,91499,363501,455000,MKT
06079723426230000,2021,132837,310863,443700,MKT
06079723426230000,2020,90682,292918,383600,MKT
06079723426230000,2019,90682,286818,377500,MKT
06079723426250000,2021,133788,419312,553100,MKT
06079723426250000,2020,91383,384717,476100,MKT
06079723426250000,2019,91383,384717,476100,MKT
06079723426270000,2021,133788,404512,538300,MKT
06079723426270000,2020,91383,368617,460000,MKT
06079723426270000,2019,91383,368617,460000,MKT
06079723426290000,2021,133630,377370,511000,MKT
06079723426290000,2020,91267,343233,434500,MKT
06079723426290000,2019,91267,343233,434500,MKT
06079723426310000,2021,134102,615598,749700,MKT
06079723426310000,2020,91614,528786,620400,MKT
06079723426310000,2019,91614,528786,620400,MKT
06079723426330000,2021,134102,421698,555800,MKT
06079723426330000,2020,91614,375686,467300,MKT
06079723426330000,2019,91614,375686,467300,MKT
06079723426350000,2021,133788,340912,474700,MKT
06079723426350000,2020,91383,309517,400900,MKT
06079723426350000,2019,91383,309517,400900,MKT
06079723426370000,2021,133473,268327,401800,MKT
06079723426370000,2020,91151,258349,349500,MKT
06079723426370000,2019,91151,258349,349500,MKT
06079723426396500,2021,86786,0,86786,COST
06079723426396500,2020,77554,0,77554,COST
06079723426396500,2019,77554,0,77554,COST
06079724101020000,2021,174011,122630,296641,COST
06079724101020000,2020,174916,105970,280886,COST
06079724101020000,2019,174916,105970,280886,COST
06079724101150000,2021,1758,0,1758,COST
06079724101150000,2020,1636,0,1636,COST
06079724101150000,2019,1636,0,1636,COST
06079724101250000,2021,165,0,165,COST
06079724101250000,2020,155,0,155,COST
06079724101250000,2019,155,0,155,COST
06079724101350000,2021,24113,0,24113,COST
06079724101350000,2020,32615,0,32615,COST
06079724101350000,2019,32615,0,32615,COST
06079724101450000,2021,268,0,268,COST
06079724101450000,2020,344,0,344,COST
06079724101450000,2019,344,0,344,COST
06079724101650000,2021,63665,1581450,1645115,COST
06079724101650000,2020,84816,1346480,1431296,COST
06079724101650000,2019,84816,1346480,1431296,COST
06079724201010000,2021,8486,0,8486,COST
06079724201010000,2020,7900,0,7900,COST
06079724201010000,2019,7900,0,7900,COST
06079724201100000,2021,107,0,107,COST
06079724201100000,2020,99,0,99,COST
06079724201100000,2019,99,0,99,COST
06079724201200000,2021,374,0,374,COST
06079724201200000,2020,348,0,348,COST
06079724201200000,2019,348,0,348,COST
06079724201301001,2021,836,0,836,COST
06079724201301001,2020,778,0,778,COST
06079724201301001,2019,778,0,778,COST
06079724201301002,2021,93,0,93,COST
06079724201301002,2020,86,0,86,COST
06079724201301002,2019,86,0,86,COST
06079724202150000,2021,215,0,215,COST
06079724202150000,2020,200,0,200,COST
06079724202150000,2019,200,0,200,COST
06079724202200000,2021,54,0,54,COST
06079724202200000,2020,50,0,50,COST
06079724202200000,2019,50,0,50,COST
06079724301100000,2021,1107,0,1107,COST
06079724301100000,2020,1030,0,1030,COST
06079724301100000,2019,1030,0,1030,COST
06079724301200000,2021,1164,0,1164,COST
06079724301200000,2020,1084,0,1084,COST
06079724301200000,2019,1084,0,1084,COST
06079724301210000,2021,437224,195380,632604,COST
06079724301210000,2020,328046,168330,496376,COST
06079724301210000,2019,328046,168330,496376,COST
06079724302010000,2021,136712,443588,580300,MKT
06079724302010000,2020,93540,408360,501900,MKT
06079724302010000,2019,93540,408360,501900,MKT
06079724302030000,2021,142484,346216,488700,MKT
06079724302030000,2020,97810,315790,413600,MKT
06079724302030000,2019,97810,315790,413600,MKT
06079724302050000,2021,142484,394916,537400,MKT
06079724302050000,2020,97810,383290,481100,MKT
06079724302050000,2019,97810,383290,481100,MKT
06079724302070000,2021,135343,480457,615800,MKT
06079724302070000,2020,92530,441370,533900,MKT
06079724302070000,2019,92530,440470,533000,MKT
06079724302090000,2021,157870,258330,416200,MKT
06079724302090000,2020,91383,233817,325200,OVR
06079724302090000,2019,91383,233817,325200,MKT
06079724302110000,2021,156748,377852,534600,MKT
06079724302110000,2020,90682,335718,426400,MKT
06079724302110000,2019,90682,335718,426400,MKT
06079724302130000,2021,143386,635580,778966,COST
06079724302130000,2020,82368,545110,627478,COST
06079724302130000,2019,82368,545110,627478,COST
06079724302150000,2021,184310,589690,774000,MKT
06079724302150000,2020,108006,491994,600000,MKT
06079724302150000,2019,108006,491994,600000,MKT
06079724302170000,2021,133314,315986,449300,MKT
06079724302170000,2020,91034,296466,387500,MKT
06079724302170000,2019,91034,296466,387500,MKT
06079724302190000,2021,137012,326088,463100,MKT
06079724302190000,2020,93762,301638,395400,MKT
06079724302190000,2019,93762,301638,395400,MKT
06079724302210000,2021,131385,437615,569000,MKT
06079724302210000,2020,89613,402387,492000,MKT
06079724302210000,2019,89613,402387,492000,MKT
06079724302230000,2021,132997,405903,538900,MKT
06079724302230000,2020,90800,382700,473500,MKT
06079724302230000,2019,90800,385400,476200,MKT
06079724302250000,2021,132517,482183,614700,MKT
06079724302250000,2020,90447,436553,527000,MKT
06079724302250000,2019,90447,436553,527000,MKT
06079724302270000,2021,131548,421052,552600,MKT
06079724302270000,2020,89733,393467,483200,MKT
06079724302270000,2019,89733,393467,483200,MKT
06079724302290000,2021,132837,425563,558400,MKT
06079724302290000,2020,90682,383018,473700,MKT
06079724302290000,2019,90682,383018,473700,MKT
06079724303010000,2021,157870,399330,557200,MKT
06079724303010000,2020,91383,365717,457100,MKT
06079724303010000,2019,91383,365717,457100,MKT
06079724303030000,2021,157870,415830,573700,MKT
06079724303030000,2020,91383,397417,488800,MKT
06079724303030000,2019,91383,397417,488800,MKT
06079724303050000,2021,158792,412208,571000,MKT
06079724303050000,2020,91960,382940,474900,MKT
06079724303050000,2019,91960,382940,474900,MKT
06079724303070000,2021,158425,319175,477600,MKT
06079724303070000,2020,91730,294070,385800,MKT
06079724303070000,2019,91730,250970,342700,MKT
06079724303090000,2021,157870,455930,613800,MKT
06079724303090000,2020,91383,412617,504000,MKT
06079724303090000,2019,91383,412617,504000,MKT
06079724303110000,2021,157498,284402,441900,MKT
06079724303110000,2020,91151,274249,365400,MKT
06079724303110000,2019,91151,274249,365400,MKT
06079724303130000,2021,156748,306552,463300,MKT
06079724303130000,2020,90682,288218,378900,MKT
06079724303130000,2019,90682,288218,378900,MKT
06079724303150000,2021,157124,260176,417300,MKT
06079724303150000,2020,90917,248483,339400,MKT
06079724303150000,2019,90917,248483,339400,MKT
06079724303170000,2021,156559,342741,499300,MKT
06079724303170000,2020,90565,339535,430100,MKT
06079724303170000,2019,90565,339535,430100,MKT
06079724303190000,2021,157311,290789,448100,MKT
06079724303190000,2020,91034,291266,382300,MKT
06079724303190000,2019,91034,291266,382300,MKT
06079724303210000,2021,156748,309452,466200,MKT
06079724303210000,2020,90682,289918,380600,MKT
06079724303210000,2019,90682,289918,380600,MKT
06079724303230000,2021,156748,276152,432900,MKT
06079724303230000,2020,90682,268718,359400,MKT
06079724303230000,2019,90682,268718,359400,MKT
06079724303250000,2021,136712,404388,541100,MKT
06079724303250000,2020,93540,367860,461400,MKT
06079724303250000,2019,93540,0,93540,COST
06079724303270000,2021,135343,293157,428500,MKT
06079724303270000,2020,92530,278170,370700,MKT
06079724303270000,2019,92530,278170,370700,MKT
06079724303290000,2021,134102,385398,519500,MKT
06079724303290000,2020,91614,346386,438000,MKT
06079724303290000,2019,91614,346386,438000,MKT
06079724303310000,2021,133473,324627,458100,MKT
06079724303310000,2020,91151,296849,388000,MKT
06079724303310000,2019,91151,296849,388000,MKT
06079724303330000,2021,133630,307570,441200,MKT
06079724303330000,2020,91267,292333,383600,MKT
06079724303330000,2019,91267,292333,383600,MKT
06079724303350000,2021,133945,309855,443800,MKT
06079724303350000,2020,91499,263901,355400,OVR
06079724303350000,2019,91499,263901,355400,MKT
06079724303370000,2021,134258,354842,489100,MKT
06079724303370000,2020,91730,319170,410900,MKT
06079724303370000,2019,91730,319170,410900,MKT
06079724303390000,2021,134570,361230,495800,MKT
06079724303390000,2020,91960,320940,412900,MKT
06079724303390000,2019,91960,320940,412900,MKT
06079724303410000,2021,133788,355512,489300,MKT
06079724303410000,2020,91383,333717,425100,MKT
06079724303410000,2019,91383,333717,425100,MKT
06079724303430000,2021,134725,404575,539300,MKT
06079724303430000,2020,92074,361126,453200,MKT
06079724303430000,2019,92074,361126,453200,MKT
06079724304010000,2021,132034,308766,440800,MKT
06079724304010000,2020,90091,293509,383600,MKT
06079724304010000,2019,90091,293509,383600,MKT
06079724304030000,2021,133473,327527,461000,MKT
06079724304030000,2020,91151,313049,404200,MKT
06079724304030000,2019,91151,313049,404200,MKT
06079724304050000,2021,133473,373627,507100,MKT
06079724304050000,2020,91151,361149,452300,MKT
06079724304050000,2019,91151,361149,452300,MKT
06079724304070000,2021,133473,321227,454700,MKT
06079724304070000,2020,91151,275049,366200,MKT
06079724304070000,2019,91151,275049,366200,MKT
06079724304090000,2021,131058,348242,479300,MKT
06079724304090000,2020,89372,324828,414200,MKT
06079724304090000,2019,89372,324828,414200,MKT
06079724304110000,2021,137012,423888,560900,MKT
06079724304110000,2020,93762,389138,482900,MKT
06079724304110000,2019,93762,389138,482900,MKT
06079724304130000,2021,171650,1000820,1172470,COST
06079724304130000,2020,100021,854280,954301,COST
06079724304130000,2019,100021,854280,954301,COST
06079724304150000,2021,171650,527750,699400,MKT
06079724304150000,2020,100021,436679,536700,MKT
06079724304150000,2019,100021,436679,536700,MKT
06079724304170000,2021,161674,483126,644800,MKT
06079724304170000,2020,93762,443938,537700,MKT
06079724304170000,2019,93762,443938,537700,MKT
06079724304190000,2021,131058,469142,600200,MKT
06079724304190000,2020,89372,438428,527800,MKT
06079724304190000,2019,89372,438428,527800,MKT
06079724304210000,2021,133473,425227,558700,MKT
06079724304210000,2020,91151,385949,477100,MKT
06079724304210000,2019,91151,385949,477100,MKT
06079724304230000,2021,133473,372827,506300,MKT
06079724304230000,2020,91151,354749,445900,MKT
06079724304230000,2019,91151,354749,445900,MKT
06079724304250000,2021,133473,375927,509400,MKT
06079724304250000,2020,91151,359949,451100,MKT
06079724304250000,2019,91151,359949,451100,MKT
06079724304270000,2021,134880,371320,506200,MKT
06079724304270000,2020,92188,316012,408200,MKT
06079724304270000,2019,92188,316012,408200,MKT
06079724305016500,2021,1484,0,1484,COST
06079724305016500,2020,1381,0,1381,COST
06079724305016500,2019,1381,0,1381,COST
06079724305030000,2021,145599,0,145599,COST
06079724305030000,2020,100120,0,100120,COST
06079724305030000,2019,100120,0,100120,COST
06079724305040000,2021,133473,409927,543400,MKT
06079724305040000,2020,91151,405249,496400,MKT
06079724305040000,2019,91151,405249,496400,MKT
06079724305050000,2021,133473,411227,544700,MKT
06079724305050000,2020,91151,395349,486500,MKT
06079724305050000,2019,91151,395349,486500,MKT
06079724305070000,2021,133473,457427,590900,MKT
06079724305070000,2020,91151,418349,509500,MKT
06079724305070000,2019,91151,418349,509500,MKT
06079724305090000,2021,131058,451242,582300,MKT
06079724305090000,2020,89372,425728,515100,MKT
06079724305090000,2019,89372,425728,515100,MKT
06079724305110000,2021,161674,464926,626600,MKT
06079724305110000,2020,93762,415738,509500,MKT
06079724305110000,2019,93762,415738,509500,MKT
06079724305130000,2021,171650,570150,741800,MKT
06079724305130000,2020,100021,508479,608500,MKT
06079724305130000,2019,100021,508479,608500,MKT
06079724305150000,2021,171650,537350,709000,MKT
06079724305150000,2020,100021,447179,547200,MKT
06079724305150000,2019,100021,447179,547200,MKT
06079724305170000,2021,137012,501588,638600,MKT
06079724305170000,2020,93762,457238,551000,MKT
06079724305170000,2019,93762,457238,551000,MKT
06079724305190000,2021,131058,509342,640400,MKT
06079724305190000,2020,89372,486228,575600,MKT
06079724305190000,2019,89372,486228,575600,MKT
06079724305210000,2021,133473,321827,455300,MKT
06079724305210000,2020,91151,301349,392500,MKT
06079724305210000,2019,91151,301349,392500,MKT
06079724305230000,2021,133473,310127,443600,MKT
06079724305230000,2020,91151,293649,384800,MKT
06079724305230000,2019,91151,293649,384800,MKT
06079724305250000,2021,158237,416263,574500,MKT
06079724305250000,2020,109531,398169,507700,MKT
06079724305250000,2019,109531,396469,506000,MKT
06079724306010000,2021,146127,445073,591200,MKT
06079724306010000,2020,100512,400988,501500,MKT
06079724306010000,2019,100512,400988,501500,MKT
06079724306030000,2021,133473,318727,452200,MKT
06079724306030000,2020,91151,294449,385600,MKT
06079724306030000,2019,91151,294449,385600,MKT
06079724306050000,2021,133473,502027,635500,MKT
06079724306050000,2020,91151,420349,511500,MKT
06079724306050000,2019,91151,420349,511500,MKT
06079724306070000,2021,133473,419927,553400,MKT
06079724306070000,2020,91151,347049,438200,OVR
06079724306070000,2019,91151,347049,438200,MKT
06079724306090000,2021,131058,360742,491800,MKT
06079724306090000,2020,89372,351728,441100,MKT
06079724306090000,2019,89372,351728,441100,MKT
06079724306110000,2021,161674,520326,682000,MKT
06079724306110000,2020,93762,441838,535600,MKT
06079724306110000,2019,93762,441838,535600,MKT
06079724306130000,2021,171650,425550,597200,MKT
06079724306130000,2020,100021,383179,483200,MKT
06079724306130000,2019,100021,383179,483200,MKT
06079724306150000,2021,171650,590150,761800,MKT
06079724306150000,2020,100021,479979,580000,OVR
06079724306150000,2019,100021,479979,580000,OVR
06079724306170000,2021,137012,538488,675500,MKT
06079724306170000,2020,93762,488238,582000,MKT
06079724306170000,2019,93762,488238,582000,MKT
06079724306190000,2021,131058,407942,539000,MKT
06079724306190000,2020,89372,379628,469000,MKT
06079724306190000,2019,89372,379628,469000,MKT
06079724306210000,2021,133473,354527,488000,MKT
06079724306210000,2020,91151,321949,413100,MKT
06079724306210000,2019,91151,321949,413100,MKT
06079724306230000,2021,133473,541927,675400,MKT
06079724306230000,2020,91151,474749,565900,MKT
06079724306230000,2019,91151,474749,565900,MKT
06079724306250000,2021,158572,517128,675700,MKT
06079724306250000,2020,109781,474919,584700,MKT
06079724306250000,2019,109781,474919,584700,MKT
06079724401010000,2021,146651,504549,651200,MKT
06079724401010000,2020,100901,463799,564700,MKT
06079724401010000,2019,100901,457199,558100,MKT
06079724401030000,2021,133473,381427,514900,MKT
06079724401030000,2020,91151,343949,435100,MKT
06079724401030000,2019,91151,343949,435100,MKT
06079724401050000,2021,133473,429727,563200,MKT
06079724401050000,2020,91151,381749,472900,MKT
06079724401050000,2019,91151,381749,472900,MKT
06079724401070000,2021,131058,364942,496000,MKT
06079724401070000,2020,89372,354428,443800,MKT
06079724401070000,2019,89372,354428,443800,MKT
06079724401090000,2021,137012,413088,550100,MKT
06079724401090000,2020,93762,376238,470000,MKT
06079724401090000,2019,93762,376238,470000,MKT
06079724401110000,2021,171650,680050,851700,MKT
06079724401110000,2020,100021,632960,732981,COST
06079724401110000,2019,100021,632960,732981,COST
06079724401130000,2021,162379,0,162379,COST
06079724401130000,2020,94203,0,94203,COST
06079724401130000,2019,94203,0,94203,COST
06079724401150000,2021,155034,639666,794700,MRA
06079724401150000,2020,89613,530287,619900,MKT
06079724401150000,2019,89613,530287,619900,MKT
06079724401170000,2021,154648,459752,614400,MKT
06079724401170000,2020,89372,413028,502400,MKT
06079724401170000,2019,89372,413028,502400,MKT
06079724401190000,2021,133473,436327,569800,MKT
06079724401190000,2020,91151,388749,479900,MKT
06079724401190000,2019,91151,388749,479900,MKT
06079724401200000,2021,18259,0,18259,COST
06079724401200000,2020,24758,0,24758,COST
06079724401200000,2019,24758,0,24758,COST
06079724401210000,2021,133473,408327,541800,MKT
06079724401210000,2020,91151,359249,450400,MKT
06079724401210000,2019,91151,359249,450400,MKT
06079724401230000,2021,135035,445865,580900,MKT
06079724401230000,2020,92302,414798,507100,MKT
06079724401230000,2019,92302,414798,507100,MKT
06079724402010000,2021,129732,552468,682200,MKT
06079724402010000,2020,88397,491603,580000,MKT
06079724402010000,2019,88397,491603,580000,MKT
06079724402030000,2021,136107,362693,498800,MKT
06079724402030000,2020,93094,318806,411900,MKT
06079724402030000,2019,93094,318806,411900,MKT
06079724402050000,2021,167967,374433,542400,MKT
06079724402050000,2020,97707,375493,473200,MKT
06079724402050000,2019,97707,375493,473200,MKT
06079724402070000,2021,169428,437772,607200,MKT
06079724402070000,2020,98624,350976,449600,OVR
06079724402070000,2019,98624,350976,449600,MKT
06079724402090000,2021,129732,412068,541800,MKT
06079724402090000,2020,88397,396103,484500,MKT
06079724402090000,2019,88397,396103,484500,MKT
06079724403010000,2021,159523,463777,623300,MKT
06079724403010000,2020,92416,390984,483400,MKT
06079724403010000,2019,92416,390984,483400,MKT
06079724403030000,2021,164113,367687,531800,MKT
06079724403030000,2020,95290,296110,391400,MKT
06079724403030000,2019,95290,296110,391400,MKT
06079724403050000,2021,166314,465386,631700,MKT
06079724403050000,2020,96669,403531,500200,MKT
06079724403050000,2019,96669,403531,500200,MKT
06079724403070000,2021,177844,366656,544500,MKT
06079724403070000,2020,103922,349578,453500,MKT
06079724403070000,2019,103922,349578,453500,MKT
06079724403090000,2021,159127,312173,471300,MKT
06079724403090000,2020,110196,293704,403900,MKT
06079724403090000,2019,110196,293704,403900,MKT
06079724403110000,2021,156881,367019,523900,MKT
06079724403110000,2020,108518,326782,435300,MKT
06079724403110000,2019,108518,326782,435300,MKT
06079724403130000,2021,139079,455021,594100,MKT
06079724403130000,2020,95290,424910,520200,MKT
06079724403130000,2019,95290,424910,520200,MKT
06079724403150000,2021,140375,293225,433600,MKT
06079724403150000,2020,96249,281751,378000,MKT
06079724403150000,2019,96249,281751,378000,MKT
06079724404010000,2021,145599,379001,524600,MKT
06079724404010000,2020,100120,338180,438300,MKT
06079724404010000,2019,100120,338180,438300,MKT
06079724404030000,2021,139079,402721,541800,MKT
06079724404030000,2020,95290,372910,468200,MKT
06079724404030000,2019,95290,377710,473000,MKT
06079724404050000,2021,135035,385365,520400,MKT
06079724404050000,2020,92302,340898,433200,MKT
06079724404050000,2019,92302,340898,433200,MKT
06079724404070000,2021,139224,394676,533900,MKT
06079724404070000,2020,95397,353603,449000,MKT
06079724404070000,2019,95397,353603,449000,MKT
06079724404090000,2021,142206,411994,554200,MKT
06079724404090000,2020,97604,380796,478400,MKT
06079724404090000,2019,97604,380796,478400,MKT
06079724404110000,2021,142206,544394,686600,MKT
06079724404110000,2020,97604,477296,574900,MKT
06079724404110000,2019,97604,477296,574900,MKT
06079724404130000,2021,137012,278688,415700,MKT
06079724404130000,2020,93762,283338,377100,MKT
06079724404130000,2019,93762,283338,377100,MKT
06079724404150000,2021,135035,432065,567100,MKT
06079724404150000,2020,92302,403598,495900,MKT
06079724404150000,2019,92302,403598,495900,MKT
06079724404170000,2021,139079,411621,550700,MKT
06079724404170000,2020,95290,330710,426000,MKT
06079724404170000,2019,95290,330710,426000,MKT
06079724404190000,2021,153027,675073,828100,MKT
06079724404190000,2020,105644,617880,723524,COST
06079724404190000,2019,105644,617880,723524,COST
06079724405010000,2021,134880,437020,571900,MKT
06079724405010000,2020,92188,404312,496500,MKT
06079724405010000,2019,92188,404312,496500,MKT
06079724405030000,2021,133473,406827,540300,MKT
06079724405030000,2020,91151,392949,484100,OVR
06079724405030000,2019,91151,392949,484100,MKT
06079724405050000,2021,133473,393927,527400,MKT
06079724405050000,2020,91151,368349,459500,MKT
06079724405050000,2019,91151,368349,459500,MKT
06079724405070000,2021,131058,439342,570400,MKT
06079724405070000,2020,89372,405828,495200,MKT
06079724405070000,2019,89372,294728,384100,MKT
06079724405090000,2021,134880,356820,491700,MKT
06079724405090000,2020,92188,341112,433300,MKT
06079724405090000,2019,92188,341112,433300,MKT
06079724405110000,2021,137905,558595,696500,MKT
06079724405110000,2020,94422,502678,597100,MKT
06079724405110000,2019,94422,502678,597100,MKT
06079724405130000,2021,146389,494811,641200,MKT
06079724405130000,2020,100707,465193,565900,OVR
06079724405130000,2019,100707,465193,565900,MKT
06079724405150000,2021,138787,409113,547900,MKT
06079724405150000,2020,95074,393826,488900,MKT
06079724405150000,2019,95074,398626,493700,MKT
06079724405170000,2021,132034,369966,502000,MKT
06079724405170000,2020,90091,337009,427100,MKT
06079724405170000,2019,90091,337009,427100,MKT
06079724405190000,2021,134414,381286,515700,MKT
06079724405190000,2020,91845,336855,428700,MKT
06079724405190000,2019,91845,336855,428700,MKT
06079724405210000,2021,134414,457086,591500,MKT
06079724405210000,2020,91845,415355,507200,MKT
06079724405210000,2019,91845,415355,507200,MKT
06079724405230000,2021,135802,488998,624800,MKT
06079724405230000,2020,92869,468131,561000,MKT
06079724405230000,2019,92869,468131,561000,MKT
06079724406010000,2021,135802,305498,441300,MKT
06079724406010000,2020,92869,283431,376300,MKT
06079724406010000,2019,92869,283431,376300,MKT
06079724406030000,2021,134414,429686,564100,MKT
06079724406030000,2020,91845,392055,483900,MKT
06079724406030000,2019,91845,392055,483900,MKT
06079724406050000,2021,134414,342286,476700,MKT
06079724406050000,2020,91845,294155,386000,MKT
06079724406050000,2019,91845,294155,386000,MKT
06079724406070000,2021,132034,343566,475600,MKT
06079724406070000,2020,90091,299209,389300,MKT
06079724406070000,2019,90091,299209,389300,MKT
06079724406090000,2021,138787,467613,606400,MKT
06079724406090000,2020,95074,421326,516400,MKT
06079724406090000,2019,95074,393126,488200,MKT
06079724406110000,2021,146389,728570,874959,COST
06079724406110000,2020,100707,630250,730957,COST
06079724406110000,2019,100707,630250,730957,COST
06079724406130000,2021,145466,429234,574700,MKT
06079724406130000,2020,100021,400079,500100,MKT
06079724406130000,2019,100021,400079,500100,MKT
06079724406150000,2021,137012,382888,519900,MKT
06079724406150000,2020,93762,366138,459900,MKT
06079724406150000,2019,93762,366138,459900,MKT
06079724406170000,2021,131058,438642,569700,MKT
06079724406170000,2020,89372,405428,494800,MKT
06079724406170000,2019,89372,405428,494800,MKT
06079724406190000,2021,133473,401627,535100,MKT
06079724406190000,2020,91151,338449,429600,MKT
06079724406190000,2019,91151,338449,429600,MKT
06079724406210000,2021,133473,383827,517300,MKT
06079724406210000,2020,91151,349549,440700,MKT
06079724406210000,2019,91151,349549,440700,MKT
06079724406230000,2021,134880,405320,540200,MKT
06079724406230000,2020,92188,348312,440500,MKT
06079724406230000,2019,92188,348312,440500,MKT
06079725101030000,2021,5422,636500,641922,COST
06079725101030000,2020,19133,540050,559183,COST
06079725101030000,2019,19133,540050,559183,COST
06079725101200000,2021,36517,0,36517,COST
06079725101200000,2020,47386,0,47386,COST
06079725101200000,2019,45911,0,45911,COST
06079725101400000,2021,334387,99080,433467,COST
06079725101400000,2020,252789,86710,339499,COST
06079725101400000,2019,252789,86710,339499,COST
06079725101450000,2021,344730,0,344730,COST
06079725101450000,2020,259416,0,259416,COST
06079725101450000,2019,259416,0,259416,COST
06079725101500000,2021,302933,471667,774600,MKT
06079725101500000,2020,232442,486820,719262,COST
06079725101500000,2019,232442,486820,719262,COST
06079725101550000,2021,283002,564970,847972,COST
06079725101550000,2020,219386,449400,668786,COST
06079725101550000,2019,219386,449400,668786,COST
06079725101600000,2021,382372,352228,734600,MKT
06079725101600000,2020,283288,376770,660058,COST
06079725101600000,2019,283288,376770,660058,COST
06079725101800000,2021,223820,7630,231450,COST
06079725101800000,2020,286978,7360,294338,COST
06079725101800000,2019,286978,7360,294338,COST
06079725105010000,2021,388005,221890,609895,COST
06079725105010000,2020,333522,179770,513292,COST
06079725105010000,2019,333522,179770,513292,COST
06079725202010000,2021,134880,418620,553500,MKT
06079725202010000,2020,92188,373912,466100,MKT
06079725202010000,2019,92188,373912,466100,MKT
06079725202020000,2021,133473,387627,521100,MKT
06079725202020000,2020,91151,360049,451200,MKT
06079725202020000,2019,91151,360049,451200,MKT
06079725202030000,2021,217988,267612,485600,MKT
06079725202030000,2020,204371,184729,389100,MKT
06079725202030000,2019,204371,184729,389100,MKT
06079725202050000,2021,133473,399827,533300,MKT
06079725202050000,2020,91151,355349,446500,MKT
06079725202050000,2019,91151,355349,446500,MKT
06079725202070000,2021,131058,437242,568300,MKT
06079725202070000,2020,89372,402428,491800,MKT
06079725202070000,2019,89372,402428,491800,MKT
06079725202090000,2021,137012,335080,472092,COST
06079725202090000,2020,93762,288538,382300,MKT
06079725202090000,2019,93762,288538,382300,MKT
06079725202110000,2021,171650,333750,505400,MKT
06079725202110000,2020,100021,315179,415200,MKT
06079725202110000,2019,100021,315179,415200,MKT
06079725202130000,2021,171650,466250,637900,MKT
06079725202130000,2020,100021,439279,539300,MKT
06079725202130000,2019,100021,439279,539300,MKT
06079725202150000,2021,137012,289788,426800,MKT
06079725202150000,2020,93762,263438,357200,MKT
06079725202150000,2019,93762,263438,357200,MKT
06079725202170000,2021,131058,319742,450800,MKT
06079725202170000,2020,89372,300528,389900,MKT
06079725202170000,2019,89372,300528,389900,MKT
06079725202190000,2021,133473,276427,409900,MKT
06079725202190000,2020,91151,267649,358800,MKT
06079725202190000,2019,91151,267649,358800,MKT
06079725202210000,2021,133473,498560,632033,COST
06079725202210000,2020,91151,504249,595400,MKT
06079725202210000,2019,91151,504249,595400,MKT
06079725202230000,2021,134880,348720,483600,MKT
06079725202230000,2020,92188,337012,429200,MKT
06079725202230000,2019,92188,337012,429200,MKT
06079725203010000,2021,134880,294420,429300,MKT
06079725203010000,2020,92188,285512,377700,MKT
06079725203010000,2019,92188,285512,377700,MKT
06079725203030000,2021,133473,314527,448000,MKT
06079725203030000,2020,91151,295449,386600,MKT
06079725203030000,2019,91151,295449,386600,MKT
06079725203050000,2021,133473,360627,494100,MKT
06079725203050000,2020,91151,363149,454300,OVR
06079725203050000,2019,91151,363149,454300,MKT
06079725203070000,2021,131058,332642,463700,MKT
06079725203070000,2020,89372,275128,364500,MKT
06079725203070000,2019,89372,275128,364500,MKT
06079725203090000,2021,137012,358088,495100,MKT
06079725203090000,2020,93762,323038,416800,MKT
06079725203090000,2019,93762,323038,416800,MKT
06079725203110000,2021,171650,438550,610200,MKT
06079725203110000,2020,100021,371979,472000,MKT
06079725203110000,2019,100021,371979,472000,MKT
06079725203130000,2021,171650,300550,472200,MKT
06079725203130000,2020,100021,279979,380000,MKT
06079725203130000,2019,100021,279979,380000,MKT
06079725203150000,2021,161674,408426,570100,MKT
06079725203150000,2020,93762,394238,488000,OVR
06079725203150000,2019,93762,394238,488000,MKT
06079725203170000,2021,154648,395752,550400,MKT
06079725203170000,2020,89372,359728,449100,MKT
06079725203170000,2019,89372,359728,449100,MKT
06079725203190000,2021,157498,264102,421600,MKT
06079725203190000,2020,91151,225949,317100,MKT
06079725203190000,2019,91151,225949,317100,MKT
06079725203210000,2021,157498,333202,490700,MKT
06079725203210000,2020,91151,302049,393200,MKT
06079725203210000,2019,91151,302049,393200,MKT
06079725203230000,2021,159158,414442,573600,MKT
06079725203230000,2020,92188,388112,480300,MKT
06079725203230000,2019,92188,388112,480300,MKT
06079725204010000,2021,152907,310393,463300,MKT
06079725204010000,2020,105554,295146,400700,MKT
06079725204010000,2019,105554,295146,400700,MKT
06079725204030000,2021,145995,393705,539700,MKT
06079725204030000,2020,100414,349686,450100,MKT
06079725204030000,2019,100414,349686,450100,MKT
06079725204050000,2021,131058,295042,426100,MKT
06079725204050000,2020,89372,282728,372100,MKT
06079725204050000,2019,89372,282728,372100,MKT
06079725204070000,2021,133473,297927,431400,MKT
06079725204070000,2020,91151,284949,376100,MKT
06079725204070000,2019,91151,284949,376100,MKT
06079725204090000,2021,133473,297727,431200,MKT
06079725204090000,2020,91151,278049,369200,MKT
06079725204090000,2019,91151,278049,369200,MKT
06079725204110000,2021,134880,509520,644400,MKT
06079725204110000,2020,92188,462612,554800,MKT
06079725204110000,2019,92188,416512,508700,MKT
06079725204130000,2021,159158,498342,657500,MKT
06079725204130000,2020,92188,454812,547000,MKT
06079725204130000,2019,92188,454812,547000,MKT
06079725204150000,2021,157498,292202,449700,MKT
06079725204150000,2020,91151,280049,371200,MKT
06079725204150000,2019,91151,280049,371200,MKT
06079725204170000,2021,157498,354602,512100,MKT
06079725204170000,2020,91151,326449,417600,MKT
06079725204170000,2019,91151,326449,417600,MKT
06079725204190000,2021,154648,292152,446800,MKT
06079725204190000,2020,89372,281528,370900,MKT
06079725204190000,2019,89372,281528,370900,MKT
06079725204210000,2021,158609,291891,450500,MKT
06079725204210000,2020,91845,280655,372500,MKT
06079725204210000,2019,91845,280655,372500,MKT
06079725204230000,2021,176817,366483,543300,MKT
06079725204230000,2020,103275,352625,455900,MKT
06079725204230000,2019,103275,352625,455900,MKT
06079725205010000,2021,149595,407305,556900,MKT
06079725205010000,2020,103089,375211,478300,MKT
06079725205010000,2019,103089,375211,478300,MKT
06079725205030000,2021,136410,410490,546900,MKT
06079725205030000,2020,93317,362483,455800,MKT
06079725205030000,2019,93317,362483,455800,MKT
06079725205050000,2021,131221,296379,427600,MKT
06079725205050000,2020,89492,278908,368400,MKT
06079725205050000,2019,89492,278908,368400,MKT
06079725205070000,2021,133473,490327,623800,MKT
06079725205070000,2020,91151,439149,530300,MKT
06079725205070000,2019,91151,439149,530300,MKT
06079725205090000,2021,134880,371420,506300,MKT
06079725205090000,2020,92188,352312,444500,MKT
06079725205090000,2019,92188,352312,444500,MKT
06079725205110000,2021,134880,369120,504000,MKT
06079725205110000,2020,92188,342512,434700,MKT
06079725205110000,2019,92188,342512,434700,MKT
06079725205130000,2021,133473,298127,431600,MKT
06079725205130000,2020,91151,281249,372400,MKT
06079725205130000,2019,91151,281249,372400,MKT
06079725205150000,2021,131221,384479,515700,MKT
06079725205150000,2020,89492,363108,452600,MKT
06079725205150000,2019,89492,363108,452600,MKT
06079725205170000,2021,139658,0,139658,COST
06079725205170000,2020,95718,0,95718,COST
06079725205170000,2019,95718,0,95718,COST
06079725205190000,2021,219763,372520,592283,COST
06079725205190000,2020,156133,390567,546700,MKT
06079725205190000,2019,156133,390567,546700,MKT
06079725206010000,2021,133788,460912,594700,MKT
06079725206010000,2020,91383,413717,505100,MKT
06079725206010000,2019,91383,413717,505100,MKT
06079725206030000,2021,137757,442543,580300,MKT
06079725206030000,2020,94313,405487,499800,MKT
06079725206030000,2019,94313,405487,499800,MKT
06079725206050000,2021,131221,446379,577600,MKT
06079725206050000,2020,89492,403608,493100,MKT
06079725206050000,2019,89492,403608,493100,MKT
06079725206070000,2021,137311,322289,459600,MKT
06079725206070000,2020,93983,303917,397900,MKT
06079725206070000,2019,93983,303917,397900,MKT
06079725206090000,2021,134880,305020,439900,MKT
06079725206090000,2020,92188,287612,379800,MKT
06079725206090000,2019,92188,287612,379800,MKT
06079725206110000,2021,131058,392842,523900,MKT
06079725206110000,2020,89372,350228,439600,MKT
06079725206110000,2019,89372,350228,439600,MKT
06079725206130000,2021,137311,362989,500300,MKT
06079725206130000,2020,93983,337617,431600,MKT
06079725206130000,2019,93983,337617,431600,MKT
06079725206150000,2021,133788,465612,599400,MKT
06079725206150000,2020,91383,441117,532500,MKT
06079725206150000,2019,91383,424717,516100,MKT
06079725207010000,2021,100280,0,100280,COST
06079725207010000,2020,92690,0,92690,COST
06079725207010000,2019,92690,0,92690,COST
06079725207036500,2021,51640,0,51640,COST
06079725207036500,2020,36016,0,36016,COST
06079725207036500,2019,36016,0,36016,COST
06079725207050000,2021,151208,0,151208,COST
06079725207050000,2020,104289,0,104289,COST
06079725207050000,2019,104289,0,104289,COST
06079725207070000,2021,199101,114440,313541,COST
06079725207070000,2020,162947,106700,269647,COST
06079725207070000,2019,162947,106700,269647,COST
06079725207096500,2021,56571,0,56571,COST
06079725207096500,2020,37357,0,37357,COST
06079725207096500,2019,37357,0,37357,COST
06079725207116500,2021,52419,0,52419,COST
06079725207116500,2020,34407,0,34407,COST
06079725207116500,2019,34407,0,34407,COST
06079725208010000,2021,135649,400351,536000,MKT
06079725208010000,2020,87191,371209,458400,MKT
06079725208010000,2019,87191,371209,458400,MKT
06079725208030000,2021,133473,429527,563000,MKT
06079725208030000,2020,85682,409118,494800,MKT
06079725208030000,2019,85682,409118,494800,MKT
06079725208050000,2021,131058,432242,563300,MKT
06079725208050000,2020,84010,380990,465000,MKT
06079725208050000,2019,84010,380990,465000,MKT
06079725208070000,2021,135496,453304,588800,MKT
06079725208070000,2020,87084,384016,471100,MKT
06079725208070000,2019,87084,384016,471100,MKT
06079725208090000,2021,133945,427655,561600,MKT
06079725208090000,2020,86009,402391,488400,MKT
06079725208090000,2019,86009,402391,488400,MKT
06079725208110000,2021,146912,514488,661400,MKT
06079725208110000,2020,95029,485571,580600,MKT
06079725208110000,2019,95029,485571,580600,MKT
06079725208130000,2021,137012,377088,514100,MKT
06079725208130000,2020,88136,336764,424900,MKT
06079725208130000,2019,88136,336764,424900,MKT
06079725208150000,2021,131058,483042,614100,MKT
06079725208150000,2020,84010,443590,527600,MKT
06079725208150000,2019,84010,443590,527600,MKT
06079725208170000,2021,155618,440382,596000,MKT
06079725208170000,2020,101121,418679,519800,MKT
06079725208170000,2019,101121,418679,519800,MKT
06079725208196500,2021,90671,0,90671,COST
06079725208196500,2020,62158,0,62158,COST
06079725208196500,2019,62158,0,62158,COST
06079725208216500,2021,46682,0,46682,COST
06079725208216500,2020,30361,0,30361,COST
06079725208216500,2019,30361,0,30361,COST
06079725209010000,2021,149343,512757,662100,MKT
06079725209010000,2020,96728,469572,566300,MKT
06079725209010000,2019,96728,469572,566300,MKT
06079725209030000,2021,133473,381627,515100,MKT
06079725209030000,2020,85682,337418,423100,OVR
06079725209030000,2019,85682,337418,423100,MKT
06079725209050000,2021,133473,482227,615700,MKT
06079725209050000,2020,85682,445018,530700,MKT
06079725209050000,2019,85682,445018,530700,MKT
06079725209070000,2021,131058,375342,506400,MKT
06079725209070000,2020,84010,345990,430000,MKT
06079725209070000,2019,84010,345990,430000,MKT
06079725209090000,2021,134414,456486,590900,MKT
06079725209090000,2020,86334,422166,508500,MKT
06079725209090000,2019,86334,418466,504800,MKT
06079725209110000,2021,139514,397186,536700,MKT
06079725209110000,2020,89874,390426,480300,OVR
06079725209110000,2019,89874,390426,480300,MKT
06079725209130000,2021,155965,414735,570700,MKT
06079725209130000,2020,101364,368736,470100,MKT
06079725209130000,2019,101364,368736,470100,MKT
06079725209150000,2021,161674,467726,629400,MKT
06079725209150000,2020,88136,425764,513900,MKT
06079725209150000,2019,88136,422764,510900,MKT
06079725209170000,2021,154648,623852,778500,MKT
06079725209170000,2020,84010,537390,621400,MKT
06079725209170000,2019,84010,537390,621400,MKT
06079725209190000,2021,157498,412202,569700,MKT
06079725209190000,2020,85682,350018,435700,MKT
06079725209190000,2019,85682,350018,435700,MKT
06079725209210000,2021,157498,429702,587200,MKT
06079725209210000,2020,85682,389418,475100,MKT
06079725209210000,2019,85682,381918,467600,MKT
06079725209230000,2021,158425,433475,591900,MKT
06079725209230000,2020,86226,0,86226,COST
06079725209230000,2019,86226,0,86226,COST
06079725209256500,2021,37803,0,37803,COST
06079725209256500,2020,24178,0,24178,COST
06079725209256500,2019,24178,0,24178,COST
06079725210016500,2021,72263,0,72263,COST
06079725210016500,2020,48655,0,48655,COST
06079725210016500,2019,48655,0,48655,COST
06079725210030000,2021,146912,513688,660600,MKT
06079725210030000,2020,95029,471171,566200,MKT
06079725210030000,2019,95029,471171,566200,MKT
06079725210050000,2021,133473,427427,560900,MKT
06079725210050000,2020,85682,399018,484700,MKT
06079725210050000,2019,85682,399018,484700,MKT
06079725210070000,2021,133473,485327,618800,MKT
06079725210070000,2020,85682,445418,531100,MKT
06079725210070000,2019,85682,445418,531100,MKT
06079725210090000,2021,133473,508727,642200,MKT
06079725210090000,2020,85682,465918,551600,OVR
06079725210090000,2019,85682,465918,551600,MKT
06079725210110000,2021,133473,489527,623000,MKT
06079725210110000,2020,85682,437218,522900,MKT
06079725210110000,2019,85682,437218,522900,MKT
06079725210130000,2021,133473,435027,568500,MKT
06079725210130000,2020,85682,399918,485600,MKT
06079725210130000,2019,85682,399918,485600,MKT
06079725210150000,2021,131058,441342,572400,MKT
06079725210150000,2020,84010,393690,477700,MKT
06079725210150000,2019,84010,393690,477700,MKT
06079725210170000,2021,133945,504355,638300,MKT
06079725210170000,2020,86009,448091,534100,MKT
06079725210170000,2019,86009,448091,534100,MKT
06079725210190000,2021,133788,368712,502500,MKT
06079725210190000,2020,85900,342900,428800,MKT
06079725210190000,2019,85900,337000,422900,MKT
06079725210210000,2021,119070,449430,568500,MKT
06079725210210000,2020,88032,415968,504000,MKT
06079725210210000,2019,88032,415968,504000,MKT
06079725210230000,2021,119461,474739,594200,MKT
06079725210230000,2020,88344,434756,523100,MKT
06079725210230000,2019,88344,434756,523100,MKT
06079725210250000,2021,131058,440642,571700,MKT
06079725210250000,2020,84010,406790,490800,MKT
06079725210250000,2019,84010,406790,490800,MKT
06079725210270000,2021,133473,384927,518400,MKT
06079725210270000,2020,85682,347218,432900,MKT
06079725210270000,2019,85682,347218,432900,MKT
06079725210290000,2021,133473,734440,867913,COST
06079725210290000,2020,85682,563018,648700,MKT
06079725210290000,2019,85682,563018,648700,MKT
06079725210310000,2021,133473,437827,571300,MKT
06079725210310000,2020,85682,389418,475100,MKT
06079725210310000,2019,85682,389418,475100,MKT
06079725210330000,2021,133473,420427,553900,MKT
06079725210330000,2020,85682,378818,464500,MKT
06079725210330000,2019,85682,378818,464500,MKT
06079725210350000,2021,162060,536440,698500,MKT
06079725210350000,2020,105647,448353,554000,MKT
06079725210350000,2019,105647,448353,554000,MKT
06079725211010000,2021,156767,564133,720900,MKT
06079725211010000,2020,101927,495273,597200,MKT
06079725211010000,2019,101927,495273,597200,MKT
06079725211030000,2021,133473,499027,632500,MKT
06079725211030000,2020,85682,439518,525200,MKT
06079725211030000,2019,85682,439518,525200,MKT
06079725211050000,2021,133473,312827,446300,MKT
06079725211050000,2020,85682,296318,382000,MKT
06079725211050000,2019,85682,296318,382000,MKT
06079725211070000,2021,133473,504327,637800,MKT
06079725211070000,2020,85682,460118,545800,MKT
06079725211070000,2019,85682,460118,545800,MKT
06079725211090000,2021,133473,419527,553000,MKT
06079725211090000,2020,85682,394418,480100,MKT
06079725211090000,2019,85682,394418,480100,MKT
06079725211110000,2021,131058,354542,485600,MKT
06079725211110000,2020,84010,293190,377200,MKT
06079725211110000,2019,84010,293190,377200,MKT
06079725211130000,2021,119461,390339,509800,MKT
06079725211130000,2020,88344,334956,423300,MKT
06079725211130000,2019,88344,334956,423300,MKT
06079725211150000,2021,119070,426830,545900,MKT
06079725211150000,2020,88032,375668,463700,MKT
06079725211150000,2019,88032,375668,463700,MKT
06079725211170000,2021,119070,406830,525900,MKT
06079725211170000,2020,88032,386168,474200,MKT
06079725211170000,2019,88032,386168,474200,MKT
06079725211190000,2021,119461,380339,499800,MKT
06079725211190000,2020,88344,0,88344,COST
06079725211190000,2019,88344,0,88344,COST
06079725211210000,2021,131058,404342,535400,MKT
06079725211210000,2020,84010,366890,450900,MKT
06079725211210000,2019,84010,366890,450900,MKT
06079725211230000,2021,133473,379627,513100,MKT
06079725211230000,2020,85682,348218,433900,MKT
06079725211230000,2019,85682,348218,433900,MKT
06079725211250000,2021,133473,384127,517600,MKT
06079725211250000,2020,85682,351618,437300,MKT
06079725211250000,2019,85682,351618,437300,MKT
06079725211270000,2021,133473,452427,585900,MKT
06079725211270000,2020,85682,412918,498600,MKT
06079725211270000,2019,85682,412918,498600,MKT
06079725211290000,2021,133473,432827,566300,MKT
06079725211290000,2020,85682,414018,499700,OVR
06079725211290000,2019,85682,414018,499700,MKT
06079725211310000,2021,146520,415680,562200,MKT
06079725211310000,2020,94756,383244,478000,MKT
06079725211310000,2019,94756,383244,478000,MKT
06079725212010000,2021,140089,434711,574800,MKT
06079725212010000,2020,90275,420825,511100,MKT
06079725212010000,2019,90275,420825,511100,MKT
06079725212030000,2021,133473,411127,544600,MKT
06079725212030000,2020,85682,363518,449200,MKT
06079725212030000,2019,85682,363518,449200,MKT
06079725212050000,2021,133473,406727,540200,MKT
06079725212050000,2020,85682,364818,450500,MKT
06079725212050000,2019,85682,364818,450500,MKT
06079725212070000,2021,133473,404427,537900,MKT
06079725212070000,2020,85682,339518,425200,MKT
06079725212070000,2019,85682,339518,425200,MKT
06079725212090000,2021,133473,455427,588900,MKT
06079725212090000,2020,85682,416518,502200,MKT
06079725212090000,2019,85682,416518,502200,MKT
06079725212110000,2021,131058,396042,527100,MKT
06079725212110000,2020,84010,342490,426500,MKT
06079725212110000,2019,84010,342490,426500,MKT
06079725212130000,2021,119461,586639,706100,MKT
06079725212130000,2020,88344,523420,611764,OVR
06079725212130000,2019,88344,523420,611764,COST
06079725212150000,2021,119070,427830,546900,MKT
06079725212150000,2020,88032,400568,488600,MKT
06079725212150000,2019,88032,400568,488600,MKT
06079725212170000,2021,119070,442230,561300,MKT
06079725212170000,2020,88032,423168,511200,MKT
06079725212170000,2019,88032,406568,494600,MKT
06079725212190000,2021,137311,422189,559500,MKT
06079725212190000,2020,88344,374956,463300,MKT
06079725212190000,2019,88344,332356,420700,MKT
06079725212210000,2021,131058,470942,602000,MKT
06079725212210000,2020,84010,443890,527900,MKT
06079725212210000,2019,84010,443890,527900,MKT
06079725212230000,2021,133473,465427,598900,MKT
06079725212230000,2020,85682,425618,511300,MKT
06079725212230000,2019,85682,425618,511300,MKT
06079725212250000,2021,133473,594527,728000,MKT
06079725212250000,2020,85682,533518,619200,MKT
06079725212250000,2019,85682,533518,619200,MKT
06079725212270000,2021,133473,520627,654100,MKT
06079725212270000,2020,85682,462118,547800,MKT
06079725212270000,2019,85682,462118,547800,MKT
06079725212290000,2021,156080,523720,679800,MKT
06079725212290000,2020,101445,481155,582600,MKT
06079725212290000,2019,101445,481155,582600,MKT
06079725301010000,2021,2768,0,2768,COST
06079725301010000,2020,2576,0,2576,COST
06079725301010000,2019,2576,0,2576,COST
06079725302010000,2021,291407,0,291407,COST
06079725302010000,2020,261521,0,261521,COST
06079725302010000,2019,261521,0,261521,COST
06079725401010000,2021,28475,580650,609125,COST
06079725401010000,2020,36317,433700,470017,COST
06079725401010000,2019,36317,433700,470017,COST
06079725401100000,2021,22148,1308470,1330618,COST
06079725401100000,2020,27704,1149300,1177004,COST
06079725401100000,2019,27704,1149300,1177004,COST
06079725401200000,2021,2669,0,2669,COST
06079725401250000,2021,2121,0,2121,COST
06079725401300000,2021,1847,0,1847,COST
06079726101010000,2021,378584,296616,675200,MKT
06079726101010000,2020,326631,234690,561321,OVR
06079726101010000,2019,326631,234690,561321,COST
06079726101150000,2021,3431,0,3431,COST
06079726101150000,2020,3193,0,3193,COST
06079726101150000,2019,3193,0,3193,COST
06079726102010000,2021,157498,371302,528800,MKT
06079726102010000,2020,91151,341949,433100,MKT
06079726102010000,2019,91151,333549,424700,MKT
06079726102030000,2021,157498,334902,492400,MKT
06079726102030000,2020,91151,310949,402100,MKT
06079726102030000,2019,91151,310949,402100,MKT
06079726102050000,2021,158055,409645,567700,MKT
06079726102050000,2020,91499,369501,461000,MKT
06079726102050000,2019,91499,369501,461000,MKT
06079726102070000,2021,158792,332208,491000,MKT
06079726102070000,2020,91960,307740,399700,MKT
06079726102070000,2019,91960,307740,399700,MKT
06079726102090000,2021,157870,396730,554600,MKT
06079726102090000,2020,91383,360117,451500,MKT
06079726102090000,2019,91383,360117,451500,MKT
06079726102110000,2021,158425,315675,474100,MKT
06079726102110000,2020,91730,261770,353500,MKT
06079726102110000,2019,91730,261770,353500,MKT
06079726102130000,2021,133473,294727,428200,MKT
06079726102130000,2020,91151,270549,361700,MKT
06079726102130000,2019,91151,274949,366100,MKT
06079726102150000,2021,134414,429086,563500,MKT
06079726102150000,2020,91845,332155,424000,MKT
06079726102150000,2019,91845,332155,424000,MKT
06079726102170000,2021,134258,326642,460900,MKT
06079726102170000,2020,91730,280170,371900,MKT
06079726102170000,2019,91730,280170,371900,MKT
06079726102190000,2021,133473,289627,423100,MKT
06079726102190000,2020,91151,266849,358000,MKT
06079726102190000,2019,91151,266849,358000,MKT
06079726102210000,2021,133630,251070,384700,MKT
06079726102210000,2020,91267,241333,332600,MKT
06079726102210000,2019,91267,241333,332600,MKT
06079726102230000,2021,133630,355170,488800,MKT
06079726102230000,2020,91267,324433,415700,MKT
06079726102230000,2019,91267,324433,415700,MKT
06079726103010000,2021,133630,290470,424100,MKT
06079726103010000,2020,91267,275133,366400,MKT
06079726103010000,2019,91267,275133,366400,MKT
06079726103030000,2021,133630,263270,396900,MKT
06079726103030000,2020,91267,254033,345300,MKT
06079726103030000,2019,91267,254033,345300,MKT
06079726103050000,2021,133788,436012,569800,MKT
06079726103050000,2020,91383,374617,466000,MKT
06079726103050000,2019,91383,374617,466000,MKT
06079726103070000,2021,133945,446055,580000,MKT
06079726103070000,2020,91499,426401,517900,MKT
06079726103070000,2019,91499,426401,517900,MKT
06079726103090000,2021,133630,325570,459200,MKT
06079726103090000,2020,91267,298633,389900,MKT
06079726103090000,2019,91267,300133,391400,MKT
06079726103110000,2021,133473,453427,586900,MKT
06079726103110000,2020,91151,412849,504000,MKT
06079726103110000,2019,91151,412849,504000,MKT
06079726103130000,2021,136410,421590,558000,MKT
06079726103130000,2020,93317,375283,468600,MKT
06079726103130000,2019,93317,375283,468600,MKT
06079726103150000,2021,133473,426827,560300,MKT
06079726103150000,2020,91151,388849,480000,MKT
06079726103150000,2019,91151,388849,480000,MKT
06079726103170000,2021,133473,323127,456600,MKT
06079726103170000,2020,91151,302049,393200,MKT
06079726103170000,2019,91151,302049,393200,MKT
06079726104016500,2021,151400,0,151400,COST
06079726104016500,2020,114995,0,114995,COST
06079726104016500,2019,114995,0,114995,COST
06079726201020000,2021,202943,0,202943,COST
06079726201020000,2020,258861,0,258861,COST
06079726201020000,2019,258861,0,258861,COST
06079726201100000,2021,3754,0,3754,COST
06079726201100000,2020,3496,0,3496,COST
06079726201100000,2019,3496,0,3496,COST
06079726201150000,2021,7652,0,7652,COST
06079726201150000,2020,8834,0,8834,COST
06079726201150000,2019,8834,0,8834,COST
06079726201200000,2021,3101,0,3101,COST
06079726201200000,2020,3344,0,3344,COST
06079726201200000,2019,3344,0,3344,COST
06079726201400000,2021,3413,0,3413,COST
06079726201400000,2020,3776,0,3776,COST
06079726201400000,2019,3776,0,3776,COST
06079726301010000,2021,70318,143720,214038,COST
06079726301010000,2020,85273,101920,187193,COST
06079726301010000,2019,85273,101920,187193,COST
06079726301020000,2021,569908,450310,1020218,COST
06079726301020000,2020,407238,314610,721848,COST
06079726301020000,2019,407238,314610,721848,COST
06079726301050000,2021,1752,0,1752,COST
06079726301050000,2020,1630,0,1630,COST
06079726301050000,2019,1630,0,1630,COST
06079726301180000,2021,1754,0,1754,COST
06079726301180000,2020,1632,0,1632,COST
06079726301180000,2019,1632,0,1632,COST
06079726301300000,2021,1751,0,1751,COST
06079726301300000,2020,1630,0,1630,COST
06079726301300000,2019,1630,0,1630,COST
06079726401020000,2021,145620,322860,468480,COST
06079726401020000,2020,145072,280390,425462,COST
06079726401020000,2019,145072,280390,425462,COST
06079726401040000,2021,193039,286361,479400,MKT
06079726401040000,2020,184322,217678,402000,MKT
06079726401040000,2019,184322,217678,402000,MKT
06079726401230000,2021,217100,1360,218460,COST
06079726401230000,2020,203663,1410,205073,COST
06079726401230000,2019,203663,1410,205073,COST
06079726401260000,2021,516174,68226,584400,INCOME
06079726401260000,2020,301046,246054,547100,INCOME
06079726401260000,2019,301046,246054,547100,INCOME
06079726401550000,2021,574029,1641450,2215479,COST
06079726401550000,2020,323380,1285850,1609230,COST
06079726401550000,2019,323380,1285850,1609230,COST
06079727101010000,2021,102115,388960,491075,COST
06079727101010000,2020,102853,284560,387413,COST
06079727101010000,2019,102853,284560,387413,COST
06079727201010000,2021,19096,0,19096,COST
06079727201010000,2020,12939,0,12939,COST
06079727201010000,2019,12939,0,12939,COST
06079728101010000,2021,15245,0,15245,COST
06079728101010000,2020,11770,0,11770,COST
06079728101010000,2019,11770,0,11770,COST
06079728201010000,2021,82989,351590,434579,COST
06079728201010000,2020,85496,321130,406626,COST
06079728201010000,2019,85496,321130,406626,COST
06079729101010000,2021,111586,0,111586,COST
06079729101010000,2020,114587,0,114587,COST
06079729101010000,2019,114587,0,114587,COST
06079729201010000,2021,144000,25570,169570,COST
06079729201010000,2020,113700,25180,138880,COST
06079729201010000,2019,113700,25180,138880,COST
06079729201020000,2021,144000,16030,160030,COST
06079729201020000,2020,113700,16450,130150,COST
06079729201020000,2019,113700,16450,130150,COST
06079729201030000,2021,144482,16140,160622,COST
06079729201030000,2020,113942,14020,127962,COST
06079729201030000,2019,113942,14020,127962,COST
06079729201040000,2021,144000,0,144000,COST
06079729201040000,2020,113700,0,113700,COST
06079729201040000,2019,113700,0,113700,COST
06079730101010000,2021,5218,0,5218,COST
06079730101010000,2020,4892,0,4892,COST
06079730101010000,2019,4892,0,4892,COST
06079730101160000,2021,192635,0,192635,COST
06079730101160000,2020,136835,0,136835,COST
06079730101160000,2019,136835,0,136835,COST
06079730101200000,2021,6562,0,6562,COST
06079730101200000,2020,6310,0,6310,COST
06079730101200000,2019,6310,0,6310,COST
06079730201010000,2021,4948,0,4948,COST
06079730201010000,2020,4617,0,4617,COST
06079730201010000,2019,4617,0,4617,COST
06079730301010000,2021,64058,0,64058,COST
06079730301010000,2020,61671,0,61671,COST
06079730301010000,2019,61671,0,61671,COST
06079731101010000,2021,94553,0,94553,COST
06079731101010000,2020,94416,0,94416,COST
06079731101010000,2019,94416,0,94416,COST
06079732101010000,2021,52763,0,52763,COST
06079732101010000,2020,55559,0,55559,COST
06079732101010000,2019,55559,0,55559,COST
06079732102010000,2021,53318,0,53318,COST
06079732102010000,2020,56113,0,56113,COST
06079732102010000,2019,56023,0,56023,COST
06079732301010000,2021,46492,0,46492,COST
06079732301010000,2020,48671,0,48671,COST
06079732401010000,2021,63737,0,63737,COST
06079732401010000,2020,67058,0,67058,COST
06079732401010000,2019,115216,0,115216,COST
06079733101020000,2021,84024,25660,109684,COST
06079733101020000,2020,88551,24660,113211,COST
06079733101020000,2019,88551,24660,113211,COST
06079733101100000,2021,4970,424970,429940,COST
06079733101100000,2020,5029,376290,381319,COST
06079733101100000,2019,5029,376290,381319,COST
06079733101200000,2021,1717,0,1717,COST
06079733101200000,2020,1597,0,1597,COST
06079733101200000,2019,1597,0,1597,COST
06079733102107000,2021,271904,0,271904,COST
06079733102107000,2020,110881,0,110881,COST
06079733102107000,2019,110881,0,110881,COST
06079733102140000,2021,240998,204480,445478,COST
06079733102140000,2020,157802,180810,338612,COST
06079733102140000,2019,157802,180810,338612,COST
06079733102180000,2021,283050,0,283050,COST
06079733102180000,2020,174812,0,174812,COST
06079733102180000,2019,174812,0,174812,COST
06079733102200000,2021,36796,626570,663366,COST
06079733102200000,2020,39006,543630,582636,COST
06079733102200000,2019,39006,543630,582636,COST
06079733104010000,2021,145079,417030,562109,COST
06079733104010000,2020,114704,367790,482494,COST
06079733104010000,2019,114704,367790,482494,COST
06079733104200000,2021,145078,440600,585678,COST
06079733104200000,2020,114704,412640,527344,COST
06079733104200000,2019,114704,412640,527344,COST
06079733106010000,2021,145054,484480,629534,COST
06079733106010000,2020,114681,416420,531101,COST
06079733106010000,2019,114681,416420,531101,COST
06079733106200000,2021,9353,751680,761033,COST
06079733106200000,2020,9996,661970,671966,COST
06079733106200000,2019,9996,661970,671966,COST
06079733201010000,2021,15559,329040,344599,COST
06079733201010000,2020,16525,292450,308975,COST
06079733201010000,2019,16525,292450,308975,COST
06079733201300000,2021,2138,0,2138,COST
06079733201300000,2020,2397,0,2397,COST
06079733201300000,2019,2397,0,2397,COST
06079733301010000,2021,2214,0,2214,COST
06079733301010000,2020,2060,0,2060,COST
06079733301010000,2019,2060,0,2060,COST
06079733301100000,2021,2214,0,2214,COST
06079733301100000,2020,2060,0,2060,COST
06079733301100000,2019,2060,0,2060,COST
06079733402100000,2021,288997,257030,546027,COST
06079733402100000,2020,228328,227720,456048,COST
06079733402100000,2019,228328,227720,456048,COST
06079733402250000,2021,145615,294840,440455,COST
06079733402250000,2020,115203,253440,368643,COST
06079733402250000,2019,115203,253440,368643,COST
06079733402400000,2021,145599,363600,509199,COST
06079733402400000,2020,115188,319170,434358,COST
06079733402400000,2019,115188,319170,434358,COST
06079733404010000,2021,9772,348460,358232,COST
06079733404010000,2020,11630,314410,326040,COST
06079733404010000,2019,11630,314410,326040,COST
06079733404200000,2021,17950,151970,169920,COST
06079733404200000,2020,21311,134930,156241,COST
06079733404200000,2019,21311,134930,156241,COST
06079734101010000,2021,78216,5300,83516,COST
06079734101010000,2020,21060,5100,26160,COST
06079734101010000,2019,21060,5100,26160,COST
06079734101100000,2021,2015,176090,178105,COST
06079734101100000,2020,2283,149890,152173,COST
06079734101100000,2019,2283,149890,152173,COST
06079734101150000,2021,379298,284630,663928,COST
06079734101150000,2020,327154,238540,565694,COST
06079734101150000,2019,327154,238540,565694,COST
06079734101200000,2021,384185,421515,805700,MKT
06079734101200000,2020,330731,317730,648461,COST
06079734101200000,2019,330731,317730,648461,COST
06079734101550000,2021,1541,0,1541,COST
06079734101550000,2020,1434,0,1434,COST
06079734101550000,2019,1434,0,1434,COST
06079734102010000,2021,145160,217470,362630,COST
06079734102010000,2020,144780,187290,332070,COST
06079734102010000,2019,144780,187290,332070,COST
06079734102040000,2021,79176,160180,239356,COST
06079734102040000,2020,88635,143510,232145,COST
06079734102040000,2019,88635,143510,232145,COST
06079734102070000,2021,3348,452790,456138,COST
06079734102070000,2020,337923,385160,723083,COST
06079734102070000,2019,337923,373590,711513,COST
06079734201010000,2021,144618,237860,382478,COST
06079734201010000,2020,144275,209340,353615,COST
06079734201010000,2019,144275,209340,353615,COST
06079734201100000,2021,144379,313320,457699,COST
06079734201100000,2020,144052,262890,406942,COST
06079734201100000,2019,144052,198930,342982,COST
06079734202100000,2021,3956,389300,393256,COST
06079734202100000,2020,3006,320830,323836,COST
06079734202100000,2019,3006,320830,323836,COST
06079734202201000,2021,2283,0,2283,COST
06079734202201000,2020,72548,0,72548,COST
06079734202201000,2019,72548,0,72548,COST
06079734202201001,2021,340,0,340,COST
06079734202201001,2020,251,0,251,COST
06079734202201001,2019,251,0,251,COST
06079734301200000,2021,20799,0,20799,COST
06079734301200000,2020,23093,0,23093,COST
06079734301200000,2019,23093,0,23093,COST
06079734301400000,2021,22715,0,22715,COST
06079734301400000,2020,23988,0,23988,COST
06079734301400000,2019,23988,0,23988,COST
06079734401010000,2021,5197,0,5197,COST
06079734401010000,2020,4836,0,4836,COST
06079734401010000,2019,4836,0,4836,COST
06079734401100000,2021,1458,0,1458,COST
06079734401100000,2020,1357,0,1357,COST
06079734401100000,2019,1357,0,1357,COST
06079735101010000,2021,542067,0,542067,COST
06079735101010000,2020,454906,0,454906,COST
06079735101010000,2019,454906,0,454906,COST
06079735101020000,2021,79189,3510,82699,COST
06079735101020000,2020,104860,3400,108260,COST
06079735101020000,2019,104860,3400,108260,COST
06079735101030000,2021,62133,2880,65013,COST
06079735101030000,2020,51672,3080,54752,COST
06079735101030000,2019,51672,3080,54752,COST
06079735101050000,2021,1500,0,1500,COST
06079735101050000,2020,1396,0,1396,COST
06079735101050000,2019,1396,0,1396,COST
06079735101070000,2021,6273,280730,287003,COST
06079735101070000,2020,6478,221230,227708,COST
06079735101070000,2019,6478,221230,227708,COST
06079735101090000,2021,297033,354640,651673,COST
06079735101090000,2020,209060,328740,537800,COST
06079735101090000,2019,209060,328740,537800,COST
06079735101110000,2021,264338,287862,552200,MKT
06079735101110000,2020,240736,243164,483900,MKT
06079735101110000,2019,240736,243164,483900,MKT
06079735101160000,2021,257696,0,257696,COST
06079735101160000,2020,235587,0,235587,COST
06079735101160000,2019,235587,0,235587,COST
06079735201010000,2021,213318,236682,450000,MKT
06079735201010000,2020,200645,173055,373700,MKT
06079735201010000,2019,200645,173055,373700,MKT
06079735201100000,2021,199620,0,199620,COST
06079735201100000,2020,179197,0,179197,COST
06079735201100000,2019,179197,0,179197,COST
06079735201150000,2021,4771,0,4771,COST
06079735201150000,2020,4440,0,4440,COST
06079735201150000,2019,4440,0,4440,COST
06079735301010000,2021,172239,474780,647019,COST
06079735301010000,2020,182877,337160,520037,COST
06079735301010000,2019,182877,337160,520037,COST
06079735301100000,2021,1110,0,1110,COST
06079735301100000,2020,1033,0,1033,COST
06079735301100000,2019,1033,0,1033,COST
06079735301200000,2021,1136,0,1136,COST
06079735301200000,2020,1057,0,1057,COST
06079735301200000,2019,1057,0,1057,COST
06079736101010000,2021,112161,0,112161,COST
06079736101010000,2020,133331,0,133331,COST
06079736101010000,2019,133331,0,133331,COST
06079736101020000,2021,501309,432591,933900,MKT
06079736101020000,2020,414612,270700,685312,COST
06079736101020000,2019,414612,270700,685312,COST
06079736201300000,2021,84358,0,84358,COST
06079736201300000,2020,110607,0,110607,COST
06079736201300000,2019,110607,0,110607,COST
06079736306010000,2021,145101,964290,1109391,COST
06079736306010000,2020,144725,831230,975955,COST
06079736306010000,2019,144725,831230,975955,COST
06079736312010000,2021,17972,1347520,1365492,COST
06079736312010000,2020,23585,1173130,1196715,COST
06079736312010000,2019,23585,1173130,1196715,COST
06079736348010000,2021,145088,391200,536288,COST
06079736348010000,2020,144712,337370,482082,COST
06079736348010000,2019,144712,337370,482082,COST
06079736354010000,2021,145088,420280,565368,COST
06079736354010000,2020,144712,352110,496822,COST
06079736354010000,2019,144712,352110,496822,COST
06079736360010000,2021,145065,330970,476035,COST
06079736360010000,2020,144691,288010,432701,COST
06079736360010000,2019,144691,288010,432701,COST
06079736366010000,2021,145073,854300,999373,COST
06079736366010000,2020,144699,764050,908749,COST
06079736366010000,2019,144699,764050,908749,COST
06079736390010000,2021,2072,0,2072,COST
06079736390010000,2020,1050,0,1050,COST
06079736390010000,2019,1050,0,1050,COST
06079736401010000,2021,145239,2357110,2502349,COST
06079736401010000,2020,144853,2021310,2166163,COST
06079736401010000,2019,144853,1876180,2021033,COST
06079736406010000,2021,1223,0,1223,COST
06079736406010000,2020,1138,0,1138,COST
06079736406010000,2019,1138,0,1138,COST
06079736412010000,2021,145151,807120,952271,COST
06079736412010000,2020,144771,708600,853371,COST
06079736412010000,2019,144771,708600,853371,COST
06079736418010000,2021,6595,1023230,1029825,COST
06079736418010000,2020,6579,872240,878819,COST
06079736418010000,2019,6579,872240,878819,COST
06079736424010000,2021,9395,655930,665325,COST
06079736424010000,2020,9116,542510,551626,COST
06079736424010000,2019,9116,542510,551626,COST
06079736454010000,2021,283002,402398,685400,MKT
06079736454010000,2020,144784,379890,524674,COST
06079736454010000,2019,144784,334470,479254,COST
06079736460010000,2021,145167,737310,882477,COST
06079736460010000,2020,144786,651110,795896,COST
06079736460010000,2019,144786,651110,795896,COST
06079736466010000,2021,145438,1000630,1146068,COST
06079736466010000,2020,145039,851660,996699,COST
06079736466010000,2019,145039,851660,996699,COST
06079736472010000,2021,145193,686010,831203,COST
06079736472010000,2020,144810,594270,739080,COST
06079736472010000,2019,144810,594270,739080,COST
06079801101010000,2021,946332,991710,1938042,COST
06079801101010000,2020,783976,958790,1742766,COST
06079801101010000,2019,783976,958790,1742766,COST
06079801101030000,2021,3093346,10892654,13986000,INCOME
06079801101030000,2020,1302133,10939967,12242100,INCOME
06079801101030000,2019,1302133,10939967,12242100,INCOME
06079801101050000,2021,755284,260816,1016100,INCOME
06079801101050000,2020,711787,220830,932617,COST
06079801101050000,2019,711787,220830,932617,COST
06079801101090000,2021,2955360,8664640,11620000,INCOME
06079801101090000,2020,1276926,9053974,10330900,INCOME
06079801101090000,2019,1276926,9053974,10330900,INCOME
06079801101110000,2021,1850697,6918103,8768800,INCOME
06079801101110000,2020,1044929,6358471,7403400,INCOME
06079801101110000,2019,1044929,6358471,7403400,INCOME
06079801102010000,2021,624898,267302,892200,INCOME
06079801102010000,2020,656287,93213,749500,INCOME
06079801102010000,2019,656287,93213,749500,INCOME
06079801102070000,2021,1910404,5867196,7777600,INCOME
06079801102070000,2020,1059239,5976061,7035300,INCOME
06079801102070000,2019,1059239,5976061,7035300,INCOME
06079801103010000,2021,2243441,2645359,4888800,INCOME
06079801103010000,2020,1134724,3681476,4816200,INCOME
06079801103010000,2019,1134724,3681476,4816200,INCOME
06079801103030000,2021,2305489,9008511,11314000,INCOME
06079801103030000,2020,1148064,9585136,10733200,INCOME
06079801103030000,2019,1148064,9585136,10733200,INCOME
06079801103070000,2021,2282215,0,2282215,COST
06079801103070000,2020,1247205,0,1247205,COST
06079801103070000,2019,1247205,0,1247205,COST
06079801103097000,2021,1814229,69360,1883589,COST
06079801103097000,2020,1214817,68870,1283687,COST
06079801103097000,2019,1214817,68870,1283687,COST
06079801104010000,2021,671528,0,671528,COST
06079801104010000,2020,676835,0,676835,COST
06079801104010000,2019,676835,0,676835,COST
06079801106010000,2021,7663167,0,7663167,COST
06079801106010000,2020,4071594,0,4071594,COST
06079801106010000,2019,4071594,0,4071594,COST
06079801180020000,2021,485759,809841,1295600,INCOME
06079801180020000,2020,346928,590572,937500,INCOME
06079801180020000,2019,346928,590572,937500,INCOME
06079801180026500,2021,307210,0,307210,COST
06079801180026500,2020,227601,0,227601,COST
06079801180026500,2019,227601,0,227601,COST
06079801192010000,2021,716064,774150,1490214,COST
06079801192010000,2020,311224,494210,805434,COST
06079801192010000,2019,311224,494210,805434,COST
06079801192030000,2021,751280,0,751280,COST
06079801192030000,2020,681873,0,681873,COST
06079801192030000,2019,681873,0,681873,COST
06079801192050000,2021,799728,3181172,3980900,INCOME
06079801192050000,2020,700374,2815926,3516300,INCOME
06079801192050000,2019,700374,2815926,3516300,INCOME
06079801192070000,2021,1138120,341980,1480100,INCOME
06079801192070000,2020,694785,614815,1309600,INCOME
06079801192070000,2019,694785,614815,1309600,INCOME
06079801192110000,2021,1471797,2965103,4436900,INCOME
06079801192110000,2020,775682,3119718,3895400,INCOME
06079801192110000,2019,775682,3119718,3895400,INCOME
06079801192130000,2021,1147287,206813,1354100,INCOME
06079801192130000,2020,697177,546523,1243700,INCOME
06079801192130000,2019,697177,546523,1243700,INCOME
06079801194010000,2021,578877,1836723,2415600,INCOME
06079801194010000,2020,284122,1925678,2209800,INCOME
06079801194010000,2019,284122,1925678,2209800,INCOME
06079801194030000,2021,870921,1429679,2300600,INCOME
06079801194030000,2020,338452,1701348,2039800,INCOME
06079801194030000,2019,338452,1701348,2039800,INCOME
06079801194050000,2021,1348233,746967,2095200,INCOME
06079801194050000,2020,348073,1861227,2209300,INCOME
06079801194050000,2019,348073,1861227,2209300,INCOME
06079801194090000,2021,575947,917350,1493297,COST
06079801194090000,2020,283505,812095,1095600,INCOME
06079801194090000,2019,283505,812095,1095600,INCOME
06079801194150000,2021,1207279,0,1207279,COST
06079801194150000,2020,949445,0,949445,COST
06079801194150000,2019,949445,0,949445,COST
06079801195010000,2021,1378096,4833504,6211600,INCOME
06079801195010000,2020,754128,5183772,5937900,INCOME
06079801195010000,2019,754128,5183772,5937900,INCOME
06079801195040000,2021,1535916,1972484,3508400,INCOME
06079801195040000,2020,789982,2419418,3209400,INCOME
06079801195040000,2019,789982,2419418,3209400,INCOME
06079801195080000,2021,387894,0,387894,COST
06079801195080000,2020,273987,0,273987,COST
06079801195080000,2019,273987,0,273987,COST
06079801197010000,2021,257158,688742,945900,INCOME
06079801197010000,2020,178011,512589,690600,INCOME
06079801197010000,2019,178011,512589,690600,INCOME
06079801197030000,2021,255051,467949,723000,INCOME
06079801197030000,2020,176480,450020,626500,INCOME
06079801197030000,2019,176480,450020,626500,INCOME
06079801197060000,2021,255406,748794,1004200,INCOME
06079801197060000,2020,176738,683262,860000,INCOME
06079801197060000,2019,176738,683262,860000,INCOME
06079801197100000,2021,255051,228049,483100,INCOME
06079801197100000,2020,176480,233520,410000,INCOME
06079801197100000,2019,176480,233520,410000,INCOME
06079801197130000,2021,230800,1069300,1300100,INCOME
06079801197130000,2020,158918,918082,1077000,INCOME
06079801197130000,2019,158918,918082,1077000,INCOME
06079801197150000,2021,241190,0,241190,COST
06079801197150000,2020,166432,0,166432,COST
06079801197150000,2019,166432,0,166432,COST
06079801198010000,2021,536491,0,536491,COST
06079801198010000,2020,275017,0,275017,COST
06079801198010000,2019,275017,0,275017,COST
06079801198030000,2021,297816,122550,420366,COST
06079801198030000,2020,207647,134653,342300,INCOME
06079801198030000,2019,207647,134653,342300,INCOME
06079801198067000,2021,384808,0,384808,COST
06079801198067000,2020,271701,0,271701,COST
06079801198067000,2019,271701,0,271701,COST
06079801198090000,2021,467497,1109803,1577300,INCOME
06079801198090000,2020,333257,1179490,1512747,COST
06079801198090000,2019,333257,1179490,1512747,COST
06079801198120000,2021,479079,820521,1299600,INCOME
06079801198120000,2020,341924,780076,1122000,INCOME
06079801198120000,2019,341924,780076,1122000,INCOME
06079801198187000,2021,195902,10780,206682,COST
06079801198187000,2020,133807,10600,144407,COST
06079801198187000,2019,133807,10600,144407,COST
06079801198210000,2021,255058,208042,463100,INCOME
06079801198210000,2020,176485,184115,360600,INCOME
06079801198210000,2019,176485,184115,360600,INCOME
06079801198230000,2021,252939,220061,473000,INCOME
06079801198230000,2020,174947,178453,353400,INCOME
06079801198230000,2019,174947,178453,353400,INCOME
06079801198307000,2021,543409,18470,561879,COST
06079801198307000,2020,390246,20220,410466,COST
06079801198307000,2019,390246,20220,410466,COST
06079801198330000,2021,264137,305920,570057,COST
06079801198330000,2020,183082,294820,477902,COST
06079801198330000,2019,183082,294820,477902,COST
06079801198360000,2021,260702,283580,544282,COST
06079801198360000,2020,180585,263100,443685,COST
06079801198360000,2019,180585,263100,443685,COST
06079801201010000,2021,669054,0,669054,COST
06079801201010000,2020,585587,0,585587,COST
06079801201010000,2019,585587,0,585587,COST
06079801201040000,2021,2495933,4490050,6985983,COST
06079801201040000,2020,1370539,4270910,5641449,COST
06079801201040000,2019,775359,4270910,5046269,COST
06079801201070000,2021,196114,281570,477684,COST
06079801201070000,2020,163299,251300,414599,OVR
06079801201070000,2019,163299,251300,414599,COST
06079801201090000,2021,894,0,894,COST
06079801201090000,2020,832,0,832,COST
06079801201090000,2019,832,0,832,COST
06079801202150000,2021,2940,0,2940,COST
06079801202150000,2020,2729,0,2729,COST
06079801202150000,2019,2729,0,2729,COST
06079801202250000,2021,5122754,4692446,9815200,INCOME
06079801202250000,2020,1713762,7975038,9688800,INCOME
06079801202250000,2019,1713762,7975038,9688800,INCOME
06079801202350000,2021,1799,0,1799,COST
06079801202350000,2020,1675,0,1675,COST
06079801202350000,2019,1675,0,1675,COST
06079801202550000,2021,4810492,9546210,14356702,COST
06079801202550000,2020,1668206,9297080,10965286,COST
06079801202550000,2019,1668206,9297080,10965286,COST
06079801202600000,2021,822939,778120,1601059,COST
06079801202600000,2020,782994,754430,1537424,COST
06079801202600000,2019,782994,754430,1537424,COST
06079801203010000,2021,818424,432076,1250500,INCOME
06079801203010000,2020,748047,1069580,1817627,COST
06079801203010000,2019,748047,1069580,1817627,COST
06079801203110000,2021,3564,0,3564,COST
06079801203110000,2020,3308,0,3308,COST
06079801203110000,2019,3308,0,3308,COST
06079801203216500,2021,396966,0,396966,COST
06079801203216500,2020,434,0,434,COST
06079801203216500,2019,434,0,434,COST
06079801203217000,2021,1754479,0,1754479,COST
06079801203217000,2020,6990,0,6990,COST
06079801203217000,2019,6990,0,6990,COST
06079801204010000,2021,1871454,5530346,7401800,INCOME
06079801204010000,2020,1113293,5430600,6543893,COST
06079801204010000,2019,1113293,5430600,6543893,COST
06079801204030000,2021,481511,838489,1320000,INCOME
06079801204030000,2020,326148,669252,995400,INCOME
06079801204030000,2019,326148,669252,995400,INCOME
06079801204057000,2021,467875,19050,486925,COST
06079801204057000,2020,322159,20500,342659,COST
06079801204057000,2019,322159,20500,342659,COST
06079801204070000,2021,469138,1042462,1511600,INCOME
06079801204070000,2020,322531,1122469,1445000,INCOME
06079801204070000,2019,322531,0,322531,COST
06079801204090000,2021,479704,1031896,1511600,INCOME
06079801204090000,2020,325624,1119376,1445000,INCOME
06079801204090000,2019,325624,741070,1066694,COST
06079801205010000,2021,78,0,78,COST
06079801205010000,2020,73,0,73,COST
06079801205010000,2019,73,0,73,COST
06079801205030000,2021,66,0,66,COST
06079801205030000,2020,61,0,61,COST
06079801205030000,2019,61,0,61,COST
06079801205050000,2021,91,0,91,COST
06079801205050000,2020,84,0,84,COST
06079801205050000,2019,84,0,84,COST
06079801265010000,2021,890312,1186630,2076942,COST
06079801265010000,2020,809838,1156880,1966718,COST
06079801265010000,2019,809838,1156880,1966718,COST
06079801265040000,2021,827111,343640,1170751,COST
06079801265040000,2020,784692,318410,1103102,COST
06079801265040000,2019,784692,318410,1103102,COST
06079801265100000,2021,1151342,1448558,2599900,INCOME
06079801265100000,2020,904132,1173568,2077700,INCOME
06079801265100000,2019,904132,1173568,2077700,INCOME
06079801265160000,2021,1034043,967257,2001300,INCOME
06079801265160000,2020,707060,1165240,1872300,INCOME
06079801265160000,2019,707060,1165240,1872300,INCOME
06079801265200000,2021,838849,250770,1089619,COST
06079801265200000,2020,789443,251010,1040453,COST
06079801265200000,2019,789443,251010,1040453,COST
06079801265250000,2021,926808,2591870,3518678,COST
06079801265250000,2020,715611,2250550,2966161,COST
06079801265250000,2019,715611,2250550,2966161,COST
06079801265270000,2021,671531,4313260,4984791,COST
06079801265270000,2020,722715,3747970,4470685,COST
06079801265270000,2019,722715,3747970,4470685,COST
06079801265280000,2021,747966,587920,1335886,COST
06079801265280000,2020,751600,556230,1307830,COST
06079801265280000,2019,751600,556230,1307830,COST
06079801265290000,2021,1071495,5914180,6985675,COST
06079801265290000,2020,992058,5118920,6110978,COST
06079801265290000,2019,992058,5118920,6110978,COST
06079801265300000,2021,2880229,5295271,8175500,INCOME
06079801265300000,2020,1339130,5148570,6487700,INCOME
06079801265300000,2019,1339130,5148570,6487700,INCOME
06079801265316500,2021,168482,0,168482,COST
06079801265316500,2020,217023,0,217023,COST
06079801265316500,2019,217023,0,217023,COST
06079801265420000,2021,803321,529080,1332401,COST
06079801265420000,2020,774943,433057,1208000,INCOME
06079801265420000,2019,774943,433057,1208000,INCOME
06079801265440000,2021,1398175,1906125,3304300,INCOME
06079801265440000,2020,982582,1727418,2710000,INCOME
06079801265440000,2019,982582,1727418,2710000,INCOME
06079801265540000,2021,821214,542090,1363304,COST
06079801265540000,2020,782290,535170,1317460,COST
06079801265540000,2019,782290,535170,1317460,COST
06079801265560000,2021,901477,1189223,2090700,INCOME
06079801265560000,2020,814173,847827,1662000,INCOME
06079801265560000,2019,814173,847827,1662000,INCOME
06079801265600000,2021,2107329,6650971,8758300,INCOME
06079801265600000,2020,1171369,5790831,6962200,INCOME
06079801265600000,2019,1171369,5790831,6962200,INCOME
06079801298040000,2021,456102,191050,647152,COST
06079801298040000,2020,256542,178440,434982,COST
06079801298040000,2019,256542,178440,434982,COST
06079801301040900,2021,250343,317920,568263,COST
06079801301040900,2020,207233,158967,366200,OVR
06079801301040900,2019,207233,158967,366200,OVR
06079801301050000,2021,139199,0,139199,COST
06079801301050000,2020,125767,0,125767,COST
06079801301050000,2019,125767,0,125767,COST
06079801301060000,2021,139199,0,139199,COST
06079801301060000,2020,125767,0,125767,COST
06079801301060000,2019,125767,0,125767,COST
06079801301080000,2021,648160,490040,1138200,INCOME
06079801301080000,2020,191106,928994,1120100,INCOME
06079801301080000,2019,191106,928994,1120100,INCOME
06079801301100000,2021,201314,235086,436400,MKT
06079801301100000,2020,161050,185150,346200,MKT
06079801301100000,2019,161050,185150,346200,MKT
06079801301110000,2021,171248,0,171248,COST
06079801301110000,2020,133569,0,133569,COST
06079801301110000,2019,133569,0,133569,COST
06079801301120000,2021,174110,0,174110,COST
06079801301120000,2020,136154,0,136154,COST
06079801301120000,2019,136154,0,136154,COST
06079801301150000,2021,171970,301630,473600,MKT
06079801301150000,2020,134220,213980,348200,MKT
06079801301150000,2019,134220,213980,348200,MKT
06079801301160000,2021,249540,396960,646500,MKT
06079801301160000,2020,206464,408050,614514,COST
06079801301160000,2019,206464,408050,614514,COST
06079801301170000,2021,164790,264510,429300,MKT
06079801301170000,2020,127760,226840,354600,MKT
06079801301170000,2019,127760,226840,354600,MKT
06079801301180000,2021,164790,361410,526200,MKT
06079801301180000,2020,127760,323940,451700,MKT
06079801301180000,2019,127760,323940,451700,MKT
06079801301190000,2021,164790,287310,452100,MKT
06079801301190000,2020,127760,269940,397700,OVR
06079801301190000,2019,127760,269940,397700,MKT
06079801301200000,2021,160835,317065,477900,MKT
06079801301200000,2020,124220,264580,388800,MKT
06079801301200000,2019,124220,269580,393800,MKT
06079801301210000,2021,162914,0,162914,COST
06079801301210000,2020,126079,0,126079,COST
06079801301210000,2019,126079,0,126079,COST
06079801301220000,2021,182903,340797,523700,MKT
06079801301220000,2020,144139,326461,470600,MKT
06079801301220000,2019,144139,326461,470600,MKT
06079801301230000,2021,183619,278081,461700,MKT
06079801301230000,2020,144792,240508,385300,MKT
06079801301230000,2019,144792,240508,385300,MKT
06079801301240000,2021,162204,326696,488900,MKT
06079801301240000,2020,125444,285956,411400,MKT
06079801301240000,2019,125444,285956,411400,MKT
06079801301250000,2021,162204,401690,563894,COST
06079801301250000,2020,125444,396960,522404,COST
06079801301250000,2019,125444,396960,522404,COST
06079801301260000,2021,164149,360151,524300,MKT
06079801301260000,2020,127185,311715,438900,MKT
06079801301260000,2019,127185,311715,438900,MKT
06079801301270000,2021,164149,276251,440400,MKT
06079801301270000,2020,127185,260615,387800,MKT
06079801301270000,2019,127185,260615,387800,MKT
06079801301280000,2021,164149,427451,591600,MKT
06079801301280000,2020,127185,336715,463900,MKT
06079801301280000,2019,127185,336715,463900,MKT
06079801301290000,2021,164149,358651,522800,MKT
06079801301290000,2020,127185,319115,446300,MKT
06079801301290000,2019,127185,319115,446300,MKT
06079801301307000,2021,442758,7100,449858,COST
06079801301307000,2020,128122,6870,134992,COST
06079801301307000,2019,128122,6870,134992,COST
06079801301310000,2021,141682,0,141682,COST
06079801301310000,2020,128122,0,128122,COST
06079801301310000,2019,128122,0,128122,COST
06079801301320000,2021,141682,0,141682,COST
06079801301320000,2020,128122,0,128122,COST
06079801301320000,2019,128122,0,128122,COST
06079801301330000,2021,132827,11210,144037,COST
06079801301330000,2020,128122,10850,138972,COST
06079801301330000,2019,128122,10850,138972,COST
06079801301350000,2021,483737,0,483737,COST
06079801301350000,2020,140591,0,140591,COST
06079801301350000,2019,140591,0,140591,COST
06079801301370000,2021,165112,270788,435900,MKT
06079801301370000,2020,128048,276352,404400,MKT
06079801301370000,2019,128048,276352,404400,MKT
06079801302010000,2021,166766,347834,514600,MKT
06079801302010000,2020,129534,313566,443100,MKT
06079801302010000,2019,129534,313566,443100,MKT
06079801302020000,2021,166766,369834,536600,MKT
06079801302020000,2020,129534,303266,432800,MKT
06079801302020000,2019,129534,303266,432800,MKT
06079801302030000,2021,166766,346434,513200,MKT
06079801302030000,2020,129534,286366,415900,MKT
06079801302030000,2019,129534,286366,415900,MKT
06079801302040000,2021,166766,341634,508400,MKT
06079801302040000,2020,129534,283566,413100,MKT
06079801302040000,2019,129534,283566,413100,MKT
06079801302050000,2021,166766,400034,566800,MKT
06079801302050000,2020,129534,393366,522900,MKT
06079801302050000,2019,129534,388166,517700,MKT
06079801302060000,2021,166766,341834,508600,MKT
06079801302060000,2020,129534,289166,418700,MKT
06079801302060000,2019,129534,289166,418700,MKT
06079801302070000,2021,166766,283134,449900,MKT
06079801302070000,2020,129534,244566,374100,MKT
06079801302070000,2019,129534,244566,374100,MKT
06079801302080000,2021,166766,308234,475000,MKT
06079801302080000,2020,129534,277866,407400,MKT
06079801302080000,2019,129534,277866,407400,MKT
06079801302100000,2021,172123,222477,394600,MKT
06079801302100000,2020,134359,177341,311700,MKT
06079801302100000,2019,134359,177341,311700,MKT
06079801302120000,2021,182596,330104,512700,MKT
06079801302120000,2020,143859,296641,440500,MKT
06079801302120000,2019,143859,296641,440500,MKT
06079801302140000,2021,673360,680940,1354300,INCOME
06079801302140000,2020,650627,629630,1280257,COST
06079801302140000,2019,650627,629630,1280257,COST
06079801302160000,2021,464940,698240,1163180,COST
06079801302160000,2020,555171,211480,766651,COST
06079801302160000,2019,555171,211480,766651,COST
06079801302187000,2021,720061,321110,1041171,COST
06079801302187000,2020,669588,0,669588,COST
06079801302187000,2019,683271,489229,1172500,INCOME
06079801302200000,2021,427473,0,427473,COST
06079801302200000,2020,535545,0,535545,COST
06079801302200000,2019,683271,77700,760971,COST
06079801302220000,2021,381054,0,381054,COST
06079801302220000,2020,509813,0,509813,COST
06079801302240000,2021,316072,0,316072,COST
06079801302240000,2020,470572,0,470572,COST
06079801303010000,2021,227384,320360,547744,COST
06079801303010000,2020,277180,324260,601440,COST
06079801303010000,2019,277180,324260,601440,COST
06079801303040000,2021,247721,117010,364731,COST
06079801303040000,2020,204724,116750,321474,COST
06079801303040000,2019,204724,116750,321474,COST
06079801303100000,2021,227384,223630,451014,COST
06079801303100000,2020,277180,225250,502430,COST
06079801303100000,2019,277180,225250,502430,COST
06079801303280000,2021,230577,274223,504800,MKT
06079801303280000,2020,188426,241474,429900,MKT
06079801303280000,2019,188426,241474,429900,MKT
06079801303300000,2021,174110,338090,512200,MKT
06079801303300000,2020,136154,263740,399894,COST
06079801303300000,2019,136154,263740,399894,COST
06079801303310000,2021,174580,0,174580,COST
06079801303310000,2020,136580,0,136580,COST
06079801303310000,2019,136580,0,136580,COST
06079801303320000,2021,230577,228610,459187,COST
06079801303320000,2020,188426,232250,420676,COST
06079801303320000,2019,188426,232250,420676,COST
06079801303340000,2021,214080,274420,488500,MKT
06079801303340000,2020,172921,217479,390400,MKT
06079801303340000,2019,172921,217479,390400,MKT
06079801303360000,2021,204039,369361,573400,MKT
06079801303360000,2020,163575,279325,442900,MKT
06079801303360000,2019,163575,279325,442900,MKT
06079801303370000,2021,182503,252470,434973,COST
06079801303370000,2020,143775,260750,404525,COST
06079801303370000,2019,143775,260750,404525,COST
06079801303380000,2021,239348,274652,514000,MKT
06079801303380000,2020,196741,229159,425900,MKT
06079801303380000,2019,196741,229159,425900,MKT
06079801303400000,2021,2474737,728380,3203117,COST
06079801303400000,2020,1365541,952259,2317800,INCOME
06079801303400000,2019,1365541,952259,2317800,INCOME
06079801303460000,2021,464643,934957,1399600,INCOME
06079801303460000,2020,586959,459941,1046900,INCOME
06079801303460000,2019,586959,459941,1046900,INCOME
06079801304060000,2021,1060312,1666488,2726800,INCOME
06079801304060000,2020,790320,877110,1667430,COST
06079801304060000,2019,790320,877110,1667430,COST
06079801304070000,2021,271167,170620,441787,COST
06079801304070000,2020,440674,150450,591124,COST
06079801304070000,2019,440674,150450,591124,COST
06079801304080000,2021,271167,435833,707000,INCOME
06079801304080000,2020,440674,295126,735800,INCOME
06079801304080000,2019,440674,295126,735800,INCOME
06079801304090000,2021,271167,0,271167,COST
06079801304090000,2020,440674,0,440674,COST
06079801304090000,2019,440674,0,440674,COST
06079801304100000,2021,271167,6020,277187,COST
06079801304100000,2020,440674,5800,446474,COST
06079801304100000,2019,440674,5800,446474,COST
06079801304110000,2021,271321,356379,627700,INCOME
06079801304110000,2020,440781,131460,572241,COST
06079801304110000,2019,440781,131460,572241,COST
06079801304120000,2021,322442,327658,650100,INCOME
06079801304120000,2020,474611,115689,590300,INCOME
06079801304120000,2019,474611,115689,590300,INCOME
06079801304140000,2021,322442,7810,330252,COST
06079801304140000,2020,474611,7560,482171,COST
06079801304140000,2019,474611,7560,482171,COST
06079801304160000,2021,322442,415658,738100,INCOME
06079801304160000,2020,474611,218989,693600,INCOME
06079801304160000,2019,474611,218989,693600,INCOME
06079801306110000,2021,1371322,1285578,2656900,INCOME
06079801306110000,2020,1002704,1591496,2594200,INCOME
06079801306110000,2019,1002704,1591496,2594200,INCOME
06079801306130000,2021,535098,0,535098,COST
06079801306130000,2020,589622,0,589622,COST
06079801306130000,2019,589622,0,589622,COST
06079801306150000,2021,271167,0,271167,COST
06079801306150000,2020,440674,0,440674,COST
06079801306150000,2019,440674,0,440674,COST
06079801307010000,2021,858028,552700,1410728,COST
06079801307010000,2020,721807,531270,1253077,COST
06079801307010000,2019,721807,531270,1253077,COST
06079801307040000,2021,545287,0,545287,COST
06079801307040000,2020,594406,0,594406,COST
06079801307040000,2019,594406,0,594406,COST
06079801307070000,2021,963778,3476222,4440000,INCOME
06079801307070000,2020,758654,3262146,4020800,INCOME
06079801307070000,2019,758654,3262146,4020800,INCOME
06079801307170000,2021,289829,0,289829,COST
06079801307170000,2020,537256,0,537256,COST
06079801307170000,2019,537256,0,537256,COST
06079801307250000,2021,113527,0,113527,COST
06079801307250000,2020,303480,0,303480,COST
06079801307250000,2019,303480,0,303480,COST
06079801308010000,2021,556949,3051370,3608319,COST
06079801308010000,2020,599818,0,599818,COST
06079801308010000,2019,602375,100020,702395,COST
06079801308030000,2021,360180,232420,592600,INCOME
06079801308030000,2020,497656,169610,667266,COST
06079801308030000,2019,497656,169610,667266,COST
06079801308060000,2021,545287,529813,1075100,INCOME
06079801308060000,2020,594406,446894,1041300,INCOME
06079801308060000,2019,594406,446894,1041300,INCOME
06079801308080000,2021,360180,117990,478170,COST
06079801308080000,2020,497656,113200,610856,COST
06079801308080000,2019,497656,113200,610856,COST
06079801308090000,2021,371553,0,371553,COST
06079801308090000,2020,504328,0,504328,COST
06079801308090000,2019,504328,0,504328,COST
06079801308100000,2021,553941,889459,1443400,INCOME
06079801308100000,2020,598429,820580,1419009,COST
06079801308100000,2019,598429,820580,1419009,COST
06079801308120000,2021,14,0,14,COST
06079801308120000,2020,13,0,13,COST
06079801308120000,2019,13,0,13,COST
06079801308140000,2021,12,0,12,COST
06079801308140000,2020,12,0,12,COST
06079801308140000,2019,12,0,12,COST
06079801308160000,2021,12,0,12,COST
06079801308160000,2020,12,0,12,COST
06079801308160000,2019,12,0,12,COST
06079801308180000,2021,12,0,12,COST
06079801308180000,2020,12,0,12,COST
06079801308180000,2019,12,0,12,COST
06079801308200000,2021,12,0,12,COST
06079801308200000,2020,12,0,12,COST
06079801308200000,2019,12,0,12,COST
06079801308220000,2021,12,0,12,COST
06079801308220000,2020,12,0,12,COST
06079801308220000,2019,12,0,12,COST
06079801308240000,2021,12,0,12,COST
06079801308240000,2020,12,0,12,COST
06079801308240000,2019,12,0,12,COST
06079801308260000,2021,12,0,12,COST
06079801308260000,2020,12,0,12,COST
06079801308260000,2019,12,0,12,COST
06079801308280000,2021,12,0,12,COST
06079801308280000,2020,11,0,11,COST
06079801308280000,2019,11,0,11,COST
06079801350010000,2021,3299170,7335430,10634600,INCOME
06079801350010000,2020,1946396,5211404,7157800,INCOME
06079801350010000,2019,1946396,5211404,7157800,INCOME
06079801352037000,2021,1522860,80430,1603290,COST
06079801352037000,2020,1019204,83930,1103134,COST
06079801352037000,2019,1019204,83930,1103134,COST
06079801354017000,2021,256856,0,256856,COST
06079801354017000,2020,193493,0,193493,COST
06079801354017000,2019,193493,0,193493,COST
06079801355010000,2021,446579,2940610,3387189,COST
06079801355010000,2020,1027190,2960310,3987500,INCOME
06079801355010000,2019,1027190,2960310,3987500,INCOME
06079801356017000,2021,212916,0,212916,COST
06079801356017000,2020,155746,0,155746,COST
06079801356017000,2019,155746,0,155746,COST
06079801357030000,2021,103502,186698,290200,MKT
06079801357030000,2020,79690,152710,232400,OVR
06079801357030000,2019,79690,152710,232400,MKT
06079801358010000,2021,113306,218994,332300,MKT
06079801358010000,2020,82728,184372,267100,MKT
06079801358010000,2019,82728,184372,267100,MKT
06079801358030000,2021,102344,289856,392200,MKT
06079801358030000,2020,73542,286358,359900,MKT
06079801358030000,2019,73542,286358,359900,MKT
06079801358050000,2021,103424,254076,357500,MKT
06079801358050000,2020,74441,214859,289300,MKT
06079801358050000,2019,74441,214859,289300,MKT
06079801358070000,2021,108565,292735,401300,MKT
06079801358070000,2020,78737,274863,353600,MKT
06079801358070000,2019,78737,274863,353600,MKT
06079801358090000,2021,105507,277993,383500,MKT
06079801358090000,2020,76178,246722,322900,MKT
06079801358090000,2019,76178,244522,320700,MKT
06079801358110000,2021,106492,267408,373900,MKT
06079801358110000,2020,77001,244599,321600,MKT
06079801358110000,2019,77001,244599,321600,MKT
06079801358130000,2021,107454,280446,387900,MKT
06079801358130000,2020,77806,281894,359700,MKT
06079801358130000,2019,77806,281894,359700,MKT
06079801358150000,2021,108413,282587,391000,MKT
06079801358150000,2020,78610,279590,358200,MKT
06079801358150000,2019,78610,279590,358200,MKT
06079801358170000,2021,110061,275839,385900,MKT
06079801358170000,2020,79994,249406,329400,MKT
06079801358170000,2019,79994,251206,331200,MKT
06079801358190000,2021,119587,279113,398700,MKT
06079801358190000,2020,88056,252744,340800,MKT
06079801358190000,2019,88056,252744,340800,MKT
06079801358210000,2021,107551,285449,393000,MKT
06079801358210000,2020,77887,281013,358900,MKT
06079801358210000,2019,77887,281013,358900,MKT
06079801358230000,2021,107551,288249,395800,MKT
06079801358230000,2020,77887,288213,366100,MKT
06079801358230000,2019,77887,288213,366100,MKT
06079801358250000,2021,107551,280749,388300,MKT
06079801358250000,2020,77887,277413,355300,MKT
06079801358250000,2019,77887,277413,355300,MKT
06079801358270000,2021,107551,285449,393000,MKT
06079801358270000,2020,77887,284613,362500,MKT
06079801358270000,2019,77887,284613,362500,MKT
06079801358290000,2021,137314,254186,391500,MKT
06079801358290000,2020,103322,220378,323700,MKT
06079801358290000,2019,103322,220378,323700,MKT
06079801358316500,2021,69101,0,69101,COST
06079801358316500,2020,56385,0,56385,COST
06079801358316500,2019,56385,0,56385,COST
06079801358330000,2021,110794,319306,430100,MKT
06079801358330000,2020,80610,270490,351100,MKT
06079801358330000,2019,80610,270490,351100,MKT
06079801358350000,2021,111015,321585,432600,MKT
06079801358350000,2020,80796,273104,353900,MKT
06079801358350000,2019,80796,273104,353900,MKT
06079801358370000,2021,111956,296844,408800,MKT
06079801358370000,2020,81589,244758,326347,OVR
06079801358370000,2019,81589,244758,326347,OVR
06079801358390000,2021,112886,268714,381600,MKT
06079801358390000,2020,82373,223427,305800,MKT
06079801358390000,2019,82373,223427,305800,MKT
06079801358410000,2021,132446,346154,478600,MKT
06079801358410000,2020,99097,367003,466100,MKT
06079801358410000,2019,99097,367003,466100,MKT
06079801358430000,2021,120301,497899,618200,MKT
06079801358430000,2020,88664,493136,581800,OVR
06079801358430000,2019,88664,493136,581800,MKT
06079801358450000,2021,116119,505681,621800,MKT
06079801358450000,2020,85108,495192,580300,MKT
06079801358450000,2019,85108,578192,663300,MKT
06079801358470000,2021,117009,325991,443000,MKT
06079801358470000,2020,85863,273637,359500,MKT
06079801358470000,2019,85863,273637,359500,MKT
06079801358490000,2021,117881,317419,435300,MKT
06079801358490000,2020,86603,302297,388900,MKT
06079801358490000,2019,86603,302297,388900,MKT
06079801358510000,2021,126384,344516,470900,MKT
06079801358510000,2020,93870,313130,407000,MKT
06079801358510000,2019,93870,313130,407000,MKT
06079801359010000,2021,127553,279247,406800,MKT
06079801359010000,2020,94875,256025,350900,MKT
06079801359010000,2019,94875,256025,350900,MKT
06079801359035001,2021,101613,252087,353700,MKT
06079801359035001,2020,73031,252169,325200,MKT
06079801359035001,2019,73031,252169,325200,MKT
06079801359055002,2021,101613,255287,356900,MKT
06079801359055002,2020,73031,256469,329500,MKT
06079801359055002,2019,73031,255369,328400,MKT
06079801359075001,2021,101613,250787,352400,MKT
06079801359075001,2020,73031,252169,325200,MKT
06079801359075001,2019,73031,252169,325200,MKT
06079801359095002,2021,104910,254090,359000,MKT
06079801359095002,2020,75779,255421,331200,MKT
06079801359095002,2019,75779,255421,331200,MKT
06079801359115001,2021,103835,258765,362600,MKT
06079801359115001,2020,74882,242118,317000,MKT
06079801359115001,2019,74882,237918,312800,MKT
06079801359135002,2021,82695,254505,337200,MKT
06079801359135002,2020,57546,242554,300100,MKT
06079801359135002,2019,57546,242554,300100,MKT
06079801359155003,2021,82695,254505,337200,MKT
06079801359155003,2020,57546,242554,300100,MKT
06079801359155003,2019,57546,242554,300100,MKT
06079801359175004,2021,101613,245287,346900,MKT
06079801359175004,2020,73031,244969,318000,MKT
06079801359175004,2019,73031,244969,318000,MKT
06079801359190000,2021,115670,296630,412300,MKT
06079801359190000,2020,84728,297072,381800,MKT
06079801359190000,2019,84728,297072,381800,MKT
06079801359210000,2021,129156,380444,509600,MKT
06079801359210000,2020,96255,414345,510600,MKT
06079801359210000,2019,96255,414345,510600,MKT
06079801360016500,2021,84227,0,84227,COST
06079801360016500,2020,70893,0,70893,COST
06079801360016500,2019,70893,0,70893,COST
06079801360030000,2021,310101,0,310101,COST
06079801360030000,2020,493602,0,493602,COST
06079801360030000,2019,493602,0,493602,COST
06079801360050000,2021,755328,2865872,3621200,INCOME
06079801360050000,2020,722775,1781225,2504000,INCOME
06079801360050000,2019,722775,1781225,2504000,INCOME
06079801360070000,2021,508059,417541,925600,INCOME
06079801360070000,2020,609855,274990,884845,COST
06079801360070000,2019,609855,274990,884845,COST
06079801360090000,2021,927383,0,927383,COST
06079801360090000,2020,665000,0,665000,OVR
06079801360090000,2019,665000,0,665000,OVR
06079801361010000,2021,1039322,3005678,4045000,INCOME
06079801361010000,2020,760974,3121126,3882100,INCOME
06079801361010000,2019,760974,3121126,3882100,INCOME
06079801361026500,2021,534831,45870,580701,COST
06079801361026500,2020,287660,47750,335410,COST
06079801361026500,2019,287660,47750,335410,COST
06079801361036500,2021,85950,0,85950,COST
06079801361036500,2020,72573,0,72573,COST
06079801361036500,2019,72573,0,72573,COST
06079801361057000,2021,1573874,0,1573874,COST
06079801361057000,2020,909018,0,909018,COST
06079801361057000,2019,909018,0,909018,COST
06079801361077000,2021,1770158,1840,1771998,COST
06079801361077000,2020,955956,1900,957856,COST
06079801361077000,2019,955956,1900,957856,COST
06079801361086500,2021,64996,0,64996,COST
06079801361086500,2020,52529,0,52529,COST
06079801361086500,2019,52529,0,52529,COST
06079801361090000,2021,1270320,934580,2204900,INCOME
06079801361090000,2020,829294,644006,1473300,INCOME
06079801361090000,2019,829294,644006,1473300,INCOME
06079801361106500,2021,626954,80850,707804,COST
06079801361106500,2020,307926,84170,392096,COST
06079801361106500,2019,307926,84170,392096,COST
06079801361110000,2021,279278,1125522,1404800,INCOME
06079801361110000,2020,118066,1056520,1174586,COST
06079801361110000,2019,118066,0,118066,COST
06079801361130000,2021,116016,338784,454800,MKT
06079801361130000,2020,85021,358579,443600,MKT
06079801361130000,2019,85021,358579,443600,MKT
06079801361155001,2021,98402,263998,362400,MKT
06079801361155001,2020,70368,252332,322700,MKT
06079801361155001,2019,70368,252332,322700,MKT
06079801361175002,2021,98402,272398,370800,MKT
06079801361175002,2020,70368,256032,326400,MKT
06079801361175002,2019,70368,256032,326400,MKT
06079801361190000,2021,100557,321243,421800,MKT
06079801361190000,2020,72059,281841,353900,MKT
06079801361190000,2019,72059,281841,353900,MKT
06079801361210000,2021,118975,321125,440100,MKT
06079801361210000,2020,87535,282365,369900,MKT
06079801361210000,2019,87535,282365,369900,MKT
06079801361235001,2021,96568,260732,357300,MKT
06079801361235001,2020,68854,248746,317600,MKT
06079801361235001,2019,68854,248746,317600,MKT
06079801361255002,2021,99952,261348,361300,MKT
06079801361255002,2020,71652,249548,321200,MKT
06079801361255002,2019,71652,249548,321200,MKT
06079801361270000,2021,151774,0,151774,COST
06079801361270000,2020,116009,0,116009,COST
06079801361270000,2019,116009,0,116009,COST
06079801361290000,2021,106551,0,106551,COST
06079801361290000,2020,77050,0,77050,COST
06079801361290000,2019,77050,0,77050,COST
06079801361315001,2021,97675,300125,397800,MKT
06079801361315001,2020,69767,299733,369500,MKT
06079801361315001,2019,69767,299733,369500,MKT
06079801361335002,2021,97641,308859,406500,MKT
06079801361335002,2020,69740,286260,356000,MKT
06079801361335002,2019,69740,286260,356000,MKT
06079801361350000,2021,115079,275921,391000,MKT
06079801361350000,2020,84228,248472,332700,MKT
06079801361350000,2019,84228,248472,332700,MKT
06079801361370000,2021,272154,1132646,1404800,INCOME
06079801361370000,2020,115711,1056520,1172231,COST
06079801361370000,2019,115711,0,115711,COST
06079801361450000,2021,1019175,3378825,4398000,INCOME
06079801361450000,2020,754619,3467881,4222500,INCOME
06079801361450000,2019,754619,3467881,4222500,INCOME
06079801362010000,2021,115410,322690,438100,MKT
06079801362010000,2020,84508,273192,357700,MKT
06079801362010000,2019,84508,273192,357700,MKT
06079801362030000,2021,106296,329604,435900,MKT
06079801362030000,2020,76837,278163,355000,MKT
06079801362030000,2019,76837,278163,355000,MKT
06079801362050000,2021,107154,329646,436800,MKT
06079801362050000,2020,77555,278245,355800,MKT
06079801362050000,2019,77555,278245,355800,MKT
06079801362070000,2021,107125,327275,434400,MKT
06079801362070000,2020,77531,277969,355500,MKT
06079801362070000,2019,77531,277969,355500,MKT
06079801362090000,2021,107086,320314,427400,MKT
06079801362090000,2020,77498,270002,347500,MKT
06079801362090000,2019,77498,270002,347500,MKT
06079801362110000,2021,107048,291552,398600,MKT
06079801362110000,2020,77466,291434,368900,MKT
06079801362110000,2019,77466,291434,368900,MKT
06079801362130000,2021,107009,290391,397400,MKT
06079801362130000,2020,77433,290067,367500,MKT
06079801362130000,2019,77433,290067,367500,MKT
06079801362150000,2021,106980,319720,426700,MKT
06079801362150000,2020,77409,274391,351800,MKT
06079801362150000,2019,77409,274391,351800,MKT
06079801362170000,2021,106941,284559,391500,MKT
06079801362170000,2020,77376,284424,361800,MKT
06079801362170000,2019,77376,284424,361800,MKT
06079801362195001,2021,97597,290103,387700,MKT
06079801362195001,2020,69703,266597,336300,MKT
06079801362195001,2019,69703,266597,336300,MKT
06079801362215002,2021,97564,291336,388900,MKT
06079801362215002,2020,69675,268725,338400,MKT
06079801362215002,2019,69675,268725,338400,MKT
06079801362235001,2021,97542,289558,387100,MKT
06079801362235001,2020,69657,284543,354200,MKT
06079801362235001,2019,69657,284543,354200,MKT
06079801362255002,2021,97519,289581,387100,MKT
06079801362255002,2020,69639,284561,354200,MKT
06079801362255002,2019,69639,284561,354200,MKT
06079801362275001,2021,97486,288814,386300,MKT
06079801362275001,2020,69611,246089,315700,MKT
06079801362275001,2019,69611,246089,315700,MKT
06079801362295002,2021,104450,288850,393300,MKT
06079801362295002,2020,75395,246105,321500,MKT
06079801362295002,2019,75395,246105,321500,MKT
06079801362310000,2021,123966,304234,428200,MKT
06079801362310000,2020,91796,257404,349200,MKT
06079801362310000,2019,91796,257404,349200,MKT
06079801362335001,2021,97386,302714,400100,MKT
06079801362335001,2020,69528,260672,330200,MKT
06079801362335001,2019,69528,260672,330200,MKT
06079801362355002,2021,97353,290447,387800,MKT
06079801362355002,2020,69501,264999,334500,MKT
06079801362355002,2019,69501,264999,334500,MKT
06079801362375001,2021,95316,297284,392600,MKT
06079801362375001,2020,67822,255278,323100,MKT
06079801362375001,2019,67822,255278,323100,MKT
06079801362395002,2021,101435,301165,402600,MKT
06079801362395002,2020,72883,258817,331700,MKT
06079801362395002,2019,72883,258817,331700,MKT
06079801362415001,2021,102009,251891,353900,MKT
06079801362415001,2020,73361,219339,292700,MKT
06079801362415001,2019,73361,219339,292700,MKT
06079801362435002,2021,98249,237251,335500,MKT
06079801362435002,2020,70241,222059,292300,MKT
06079801362435002,2019,70241,222059,292300,MKT
06079801362450000,2021,130077,374923,505000,MKT
06079801362450000,2020,97050,404350,501400,MKT
06079801362450000,2019,97050,404350,501400,MKT
06079801362475001,2021,102279,252021,354300,MKT
06079801362475001,2020,73585,239715,313300,OVR
06079801362475001,2019,73585,239715,313300,MKT
06079801362495002,2021,83006,235694,318700,MKT
06079801362495002,2020,57797,235103,292900,OVR
06079801362495002,2019,57797,235103,292900,MKT
06079801362515003,2021,84454,235746,320200,MKT
06079801362515003,2020,58964,235136,294100,OVR
06079801362515003,2019,58964,235136,294100,MKT
06079801362535004,2021,108688,252012,360700,MKT
06079801362535004,2020,78944,238256,317200,MKT
06079801362535004,2019,78944,238256,317200,MKT
06079801362550000,2021,157101,414699,571800,MKT
06079801362550000,2020,120731,346369,467100,MKT
06079801362550000,2019,120731,346369,467100,MKT
06079801362575001,2021,102113,297087,399200,MKT
06079801362575001,2020,73447,268453,341900,MKT
06079801362575001,2019,73447,268453,341900,MKT
06079801362595002,2021,104641,295759,400400,MKT
06079801362595002,2020,75554,267146,342700,MKT
06079801362595002,2019,75554,267146,342700,MKT
06079801362610000,2021,129178,309922,439100,MKT
06079801362610000,2020,96274,305326,401600,MKT
06079801362610000,2019,96274,298926,395200,MKT
06079801362635001,2021,100134,261466,361600,MKT
06079801362635001,2020,71803,249497,321300,MKT
06079801362635001,2019,71803,249497,321300,MKT
06079801362655002,2021,100134,262066,362200,MKT
06079801362655002,2020,71803,252297,324100,OVR
06079801362655002,2019,71803,252297,324100,MKT
06079801362670000,2021,125284,278616,403900,MKT
06079801362670000,2020,92925,255475,348400,MKT
06079801362670000,2019,92925,255475,348400,MKT
06079801363010000,2021,131542,359258,490800,MKT
06079801363010000,2020,98315,369385,467700,MKT
06079801363010000,2019,98315,369385,467700,MKT
06079801363030000,2021,104900,281200,386100,MKT
06079801363030000,2020,75671,238429,314100,MKT
06079801363030000,2019,75671,238429,314100,MKT
06079801363040000,2021,100461,316439,416900,MKT
06079801363040000,2020,71980,256020,328000,MKT
06079801363040000,2019,71980,256020,328000,MKT
06079801363050000,2021,100461,280739,381200,MKT
06079801363050000,2020,71980,276120,348100,MKT
06079801363050000,2019,71980,276120,348100,MKT
06079801363070000,2021,100461,270839,371300,MKT
06079801363070000,2020,71980,264720,336700,MKT
06079801363070000,2019,71980,264720,336700,MKT
06079801363090000,2021,100461,229639,330100,MKT
06079801363090000,2020,71980,194920,266900,OVR
06079801363090000,2019,71980,194920,266900,MKT
06079801363110000,2021,100461,279139,379600,MKT
06079801363110000,2020,71980,236220,308200,MKT
06079801363110000,2019,71980,236220,308200,MKT
06079801363130000,2021,100472,284028,384500,MKT
06079801363130000,2020,71988,240912,312900,MKT
06079801363130000,2019,71988,240912,312900,MKT
06079801363150000,2021,105438,324862,430300,MKT
06079801363150000,2020,76120,281980,358100,MKT
06079801363150000,2019,76120,281980,358100,MKT
06079801363170000,2021,100493,316507,417000,MKT
06079801363170000,2020,72006,268494,340500,MKT
06079801363170000,2019,72006,268494,340500,MKT
06079801363190000,2021,97797,339103,436900,MKT
06079801363190000,2020,69776,295124,364900,MKT
06079801363190000,2019,69776,295124,364900,MKT
06079801363210000,2021,126665,339635,466300,MKT
06079801363210000,2020,94111,307089,401200,MKT
06079801363210000,2019,94111,307089,401200,MKT
06079801363235001,2021,113684,260416,374100,MKT
06079801363235001,2020,83157,256943,340100,MKT
06079801363235001,2019,83157,256943,340100,MKT
06079801363255002,2021,80082,228518,308600,MKT
06079801363255002,2020,55448,209552,265000,MKT
06079801363255002,2019,55448,209552,265000,MKT
06079801363275003,2021,80082,228518,308600,MKT
06079801363275003,2020,55448,209552,265000,MKT
06079801363275003,2019,55448,209552,265000,MKT
06079801363295004,2021,118782,260418,379200,MKT
06079801363295004,2020,87485,256915,344400,MKT
06079801363295004,2019,87485,256915,344400,MKT
06079801363315001,2021,106761,267739,374500,MKT
06079801363315001,2020,77327,258773,336100,MKT
06079801363315001,2019,77327,258773,336100,MKT
06079801363335002,2021,77461,228139,305600,MKT
06079801363335002,2020,53354,210546,263900,MKT
06079801363335002,2019,53354,210546,263900,MKT
06079801363355003,2021,77508,228192,305700,MKT
06079801363355003,2020,53392,210508,263900,MKT
06079801363355003,2019,53392,210508,263900,MKT
06079801363375004,2021,95236,285764,381000,MKT
06079801363375004,2020,67756,284944,352700,MKT
06079801363375004,2019,67756,284944,352700,MKT
