id,year,land,building,total,method
06080030101010000,2021,758346,0,758346,COST
06080030101010000,2020,409461,0,409461,COST
06080030101010000,2019,409461,0,409461,COST
06080031401010000,2021,79737,0,79737,COST
06080031401010000,2020,42974,0,42974,COST
06080031401010000,2019,42974,0,42974,COST
06080032301050000,2021,53972,0,53972,COST
06080032301050000,2020,29080,0,29080,COST
06080032301050000,2019,29080,0,29080,COST
06080032401150000,2021,17249,0,17249,COST
06080032401150000,2020,9294,0,9294,COST
06080032401150000,2019,9294,0,9294,COST
06080033101010000,2021,65048,436590,501638,COST
06080033101010000,2020,45937,401920,447857,COST
06080033101010000,2019,45937,401920,447857,COST
06080033101050000,2021,65048,503960,569008,COST
06080033101050000,2020,45937,428210,474147,COST
06080033101050000,2019,45937,428210,474147,COST
06080033101100000,2021,65048,524140,589188,COST
06080033101100000,2020,45937,449880,495817,COST
06080033101100000,2019,45937,449880,495817,COST
06080033101150000,2021,65048,874020,939068,COST
06080033101150000,2020,45937,754860,800797,COST
06080033101150000,2019,45937,754860,800797,COST
06080033101200000,2021,64571,703690,768261,COST
06080033101200000,2020,45677,615430,661107,COST
06080033101200000,2019,45677,615430,661107,COST
06080033101250000,2021,64872,215710,280582,COST
06080033101250000,2020,45841,189080,234921,COST
06080033101250000,2019,45841,189080,234921,COST
06080033101300000,2021,65054,572450,637504,COST
06080033101300000,2020,45940,491500,537440,COST
06080033101300000,2019,45940,491500,537440,COST
06080033101350000,2021,65048,564460,629508,COST
06080033101350000,2020,45937,488080,534017,COST
06080033101350000,2019,45937,488080,534017,COST
06080033201010000,2021,65417,573300,638717,COST
06080033201010000,2020,46135,477580,523715,COST
06080033201010000,2019,46135,391610,437745,COST
06080033201050000,2021,65054,650960,716014,COST
06080033201050000,2020,45940,479800,525740,COST
06080033201050000,2019,45940,479800,525740,COST
06080033201100000,2021,64947,277440,342387,COST
06080033201100000,2020,45882,239520,285402,COST
06080033201100000,2019,45882,239520,285402,COST
06080033201150000,2021,11114,0,11114,COST
06080033201150000,2020,5999,0,5999,COST
06080033201150000,2019,5999,0,5999,COST
06080033201200000,2021,11107,0,11107,COST
06080033201200000,2020,5995,0,5995,COST
06080033201200000,2019,5995,0,5995,COST
06080033201250000,2021,11099,0,11099,COST
06080033201250000,2020,5990,0,5990,COST
06080033201250000,2019,5990,0,5990,COST
06080033201300000,2021,10888,0,10888,COST
06080033201300000,2020,5873,0,5873,COST
06080033201300000,2019,5873,0,5873,COST
06080033201350000,2021,10628,0,10628,COST
06080033201350000,2020,5734,0,5734,COST
06080033201350000,2019,5734,0,5734,COST
06080033301010000,2021,60467,0,60467,COST
06080033301010000,2020,32601,0,32601,COST
06080033301010000,2019,32601,0,32601,COST
06080033401010000,2021,107180,0,107180,COST
06080033401010000,2020,57832,0,57832,COST
06080033401010000,2019,57832,0,57832,COST
06080034101010000,2021,218821,0,218821,COST
06080034101010000,2020,176269,0,176269,COST
06080034101010000,2019,176269,0,176269,COST
06080034102050000,2021,211298,335602,546900,MKT
06080034102050000,2020,169638,273462,443100,MKT
06080034102050000,2019,169638,273462,443100,MKT
06080034102100000,2021,211271,641410,852681,COST
06080034102100000,2020,169613,544930,714543,COST
06080034102100000,2019,169613,544930,714543,COST
06080034102150000,2021,210966,343534,554500,MKT
06080034102150000,2020,169345,308755,478100,MKT
06080034102150000,2019,169345,308755,478100,MKT
06080034102200000,2021,211123,511000,722123,COST
06080034102200000,2020,169483,347317,516800,MKT
06080034102200000,2019,169483,347317,516800,MKT
06080034102210000,2021,238944,311856,550800,MKT
06080034102210000,2020,194116,270984,465100,MKT
06080034102210000,2019,194116,270984,465100,MKT
06080034102230000,2021,608,0,608,COST
06080034102230000,2020,566,0,566,COST
06080034102230000,2019,566,0,566,COST
06080034102250000,2021,56036,189350,245386,COST
06080034102250000,2020,41673,166610,208283,COST
06080034102250000,2019,41673,166610,208283,COST
06080034102300000,2021,210531,345169,555700,MKT
06080034102300000,2020,168962,260538,429500,MKT
06080034102300000,2019,168962,260538,429500,MKT
06080034102350000,2021,210624,0,210624,COST
06080034102350000,2020,169044,0,169044,COST
06080034102350000,2019,169044,0,169044,COST
06080034102400000,2021,64257,436880,501137,COST
06080034102400000,2020,45518,373680,419198,COST
06080034102400000,2019,45518,373680,419198,COST
06080034260010000,2021,1116,0,1116,COST
06080034260010000,2020,1039,0,1039,COST
06080034260010000,2019,1039,0,1039,COST
06080034260130000,2021,55557,1170760,1226317,COST
06080034260130000,2020,41228,1002430,1043658,COST
06080034260130000,2019,41228,1002430,1043658,COST
06080034301160000,2021,110002,775960,885962,COST
06080034301160000,2020,81420,667480,748900,COST
06080034301160000,2019,81420,667480,748900,COST
06080034301200000,2021,66224,409510,475734,COST
06080034301200000,2020,46580,335900,382480,OVR
06080034301200000,2019,46580,335900,382480,COST
06080034301250000,2021,9447,0,9447,COST
06080034301250000,2020,5126,0,5126,COST
06080034301250000,2019,5126,0,5126,COST
06080034301300000,2021,55552,352660,408212,COST
06080034301300000,2020,41223,303790,345013,COST
06080034301300000,2019,41223,303790,345013,COST
06080034301350000,2021,55552,887370,942922,COST
06080034301350000,2020,41223,764620,805843,COST
06080034301350000,2019,41223,764620,805843,COST
06080034301400000,2021,55552,682330,737882,COST
06080034301400000,2020,41223,576140,617363,COST
06080034301400000,2019,41223,576140,617363,COST
06080034301450000,2021,1107,0,1107,COST
06080034301450000,2020,1031,0,1031,COST
06080034301450000,2019,1031,0,1031,COST
06080034301500000,2021,1108,0,1108,COST
06080034301500000,2020,1031,0,1031,COST
06080034301500000,2019,1031,0,1031,COST
06080034301550000,2021,55552,384970,440522,COST
06080034301550000,2020,41223,329640,370863,COST
06080034301550000,2019,41223,329640,370863,COST
06080034301600000,2021,62454,228110,290564,COST
06080034301600000,2020,44788,189640,234428,COST
06080034301600000,2019,44788,189640,234428,COST
06080034301650000,2021,55552,288650,344202,COST
06080034301650000,2020,41223,249680,290903,COST
06080034301650000,2019,41223,249680,290903,COST
06080034301700000,2021,8454,0,8454,COST
06080034301700000,2020,4607,0,4607,COST
06080034301700000,2019,4607,0,4607,COST
06080034301750000,2021,55556,162000,217556,COST
06080034301750000,2020,41227,139210,180437,COST
06080034301750000,2019,41227,139210,180437,COST
06080034301800000,2021,64308,109520,173828,COST
06080034301800000,2020,45570,97180,142750,COST
06080034301800000,2019,45570,97180,142750,COST
06080034401010000,2021,64061,649010,713071,COST
06080034401010000,2020,45397,555610,601007,COST
06080034401010000,2019,45397,555610,601007,COST
06080034406010000,2021,9618,0,9618,COST
06080034406010000,2020,5181,0,5181,COST
06080034406010000,2019,5181,0,5181,COST
06080034412010000,2021,63658,292140,355798,COST
06080034412010000,2020,45177,252750,297927,COST
06080034412010000,2019,45177,252750,297927,COST
06080034448010000,2021,19183,0,19183,COST
06080034448010000,2020,10332,0,10332,COST
06080034448010000,2019,10332,0,10332,COST
06080034460010000,2021,9633,0,9633,COST
06080034460010000,2020,5883,0,5883,COST
06080034460010000,2019,5883,0,5883,COST
06080035101030000,2021,133625,858920,992545,COST
06080035101030000,2020,72102,731450,803552,COST
06080035101030000,2019,218682,731450,950132,COST
06080035101050000,2021,367316,0,367316,COST
06080035101050000,2020,122436,0,122436,COST
06080035101050000,2019,122436,0,122436,COST
06080035101070000,2021,267001,1196350,1463351,COST
06080035101070000,2020,218682,1007600,1226282,COST
06080035101070000,2019,218682,742160,960842,COST
06080035101090000,2021,150987,0,150987,COST
06080035101090000,2020,2778,0,2778,COST
06080035101090000,2019,2778,0,2778,COST
06080035101110000,2021,151072,0,151072,COST
06080035101110000,2020,2465,0,2465,COST
06080035101110000,2019,2465,0,2465,COST
06080035101130000,2021,164,0,164,COST
06080035101130000,2020,2421,0,2421,COST
06080035101130000,2019,2421,0,2421,COST
06080035101150000,2021,558,0,558,COST
06080035101150000,2020,1945,0,1945,COST
06080035101150000,2019,1945,0,1945,COST
06080035101170000,2021,266908,0,266908,COST
06080035101170000,2020,218598,0,218598,COST
06080035101170000,2019,2418,0,2418,COST
06080035101190000,2021,4496,0,4496,COST
06080035101190000,2020,2419,0,2419,COST
06080035101190000,2019,2419,0,2419,COST
06080035101210000,2021,4492,0,4492,COST
06080035101210000,2020,2417,0,2417,COST
06080035101210000,2019,2417,0,2417,COST
06080035101230000,2021,557,0,557,COST
06080035101230000,2020,519,0,519,COST
06080035101230000,2019,519,0,519,COST
06080035101260000,2021,266885,0,266885,COST
06080035101260000,2020,122796,0,122796,COST
06080035101260000,2019,122796,0,122796,COST
06080035101270000,2021,266896,0,266896,COST
06080035101270000,2020,218588,0,218588,COST
06080035101270000,2019,218588,0,218588,COST
06080035101290000,2021,558,0,558,COST
06080035101290000,2020,519,0,519,COST
06080035101290000,2019,218672,0,218672,COST
06080035101310000,2021,150769,0,150769,COST
06080035101310000,2020,3023,0,3023,COST
06080035101310000,2019,3023,0,3023,COST
06080035101330000,2021,557,0,557,COST
06080035101330000,2020,519,0,519,COST
06080035101330000,2019,519,0,519,COST
06080035101350000,2021,629,0,629,COST
06080035101350000,2020,2416,0,2416,COST
06080035101350000,2019,2416,0,2416,COST
06080035101400000,2021,150809,43340,194149,COST
06080035101400000,2020,906,39950,40856,COST
06080035101400000,2019,906,39950,40856,COST
06080035201010000,2021,557,0,557,COST
06080035201010000,2020,518,0,518,COST
06080035201010000,2019,518,0,518,COST
06080035201070000,2021,101423,417480,518903,COST
06080035201070000,2020,76248,375980,452228,COST
06080035201070000,2019,76248,375980,452228,COST
06080035201100000,2021,555,0,555,COST
06080035201100000,2020,516,0,516,COST
06080035201100000,2019,516,0,516,COST
06080035201750000,2021,267270,0,267270,COST
06080035201750000,2020,218923,0,218923,COST
06080035201750000,2019,218923,0,218923,COST
06080035201800000,2021,267165,193840,461005,COST
06080035201800000,2020,218829,169710,388539,COST
06080035201800000,2019,218829,169710,388539,COST
06080035202100000,2021,217936,381790,599726,COST
06080035202100000,2020,175488,331270,506758,COST
06080035202100000,2019,175488,331270,506758,COST
06080035301010000,2021,77629,259630,337259,COST
06080035301010000,2020,56774,225120,281894,COST
06080035301010000,2019,56774,225120,281894,COST
06080035301100000,2021,217243,287640,504883,COST
06080035301100000,2020,174876,248524,423400,MKT
06080035301100000,2019,174876,248524,423400,MKT
06080035301110000,2021,219085,0,219085,COST
06080035301110000,2020,176503,0,176503,COST
06080035301110000,2019,176503,0,176503,COST
06080035301200000,2021,224557,383543,608100,MKT
06080035301200000,2020,181341,323759,505100,MKT
06080035301200000,2019,181341,323759,505100,MKT
06080035301300000,2021,223211,453189,676400,MKT
06080035301300000,2020,180150,322050,502200,MKT
06080035301300000,2019,180150,322050,502200,MKT
06080035301400000,2021,221265,398935,620200,MKT
06080035301400000,2020,178429,310771,489200,MKT
06080035301400000,2019,178429,314171,492600,MKT
06080035301480000,2021,281320,148200,429520,COST
06080035301480000,2020,231571,122400,353971,COST
06080035301480000,2019,231571,237170,468741,COST
06080035301560000,2021,267106,0,267106,COST
06080035301560000,2020,218776,0,218776,COST
06080035301560000,2019,218776,0,218776,COST
06080035301640000,2021,179172,0,179172,COST
06080035301640000,2020,521,0,521,COST
06080035301640000,2019,521,0,521,COST
06080035324010000,2021,77448,374100,451548,COST
06080035324010000,2020,56606,306320,362926,COST
06080035324010000,2019,56606,306320,362926,COST
06080035401010000,2021,369795,682640,1052435,COST
06080035401010000,2020,219550,568650,788200,COST
06080035401010000,2019,219550,379720,599270,COST
06080035401050000,2021,267572,455090,722662,COST
06080035401050000,2020,219195,380410,599605,COST
06080035401050000,2019,219195,0,219195,COST
06080035401100000,2021,266721,0,266721,COST
06080035401100000,2020,218431,0,218431,COST
06080035401100000,2019,218431,0,218431,COST
06080035401150000,2021,267165,316235,583400,MKT
06080035401150000,2020,218829,227171,446000,MKT
06080035401150000,2019,218829,227171,446000,MKT
06080035401200000,2021,267118,276090,543208,COST
06080035401200000,2020,218787,224213,443000,OVR
06080035401200000,2019,218787,224213,443000,MKT
06080035401350000,2021,267235,0,267235,COST
06080035401350000,2020,218892,0,218892,COST
06080035401350000,2019,218892,0,218892,COST
06080035401400000,2021,267060,497640,764700,MKT
06080035401400000,2020,218735,435970,654705,COST
06080035401400000,2019,218735,435970,654705,COST
06080035401450000,2021,700,0,700,COST
06080035401450000,2020,651,0,651,COST
06080035401450000,2019,651,0,651,COST
06080035401470000,2021,269195,576354,845549,MRA
06080035401470000,2020,72111,666120,738231,COST
06080035401470000,2019,72111,666550,738661,COST
06080035401500000,2021,560,0,560,COST
06080035401500000,2020,521,0,521,COST
06080035401500000,2019,521,0,521,COST
06080035401550000,2021,265995,0,265995,COST
06080035401550000,2020,122348,0,122348,COST
06080035401550000,2019,122348,0,122348,COST
06080035401600000,2021,563,0,563,COST
06080035401600000,2020,524,0,524,COST
06080035401600000,2019,524,0,524,COST
06080035401620000,2021,266288,417300,683588,COST
06080035401620000,2020,218042,309658,527700,MKT
06080035401620000,2019,218042,309658,527700,MKT
06080035401650000,2021,565,0,565,COST
06080035401650000,2020,525,0,525,COST
06080035401650000,2019,525,0,525,COST
06080035401700000,2021,266978,0,266978,COST
06080035401700000,2020,212519,0,212519,COST
06080035401700000,2019,212519,0,212519,COST
06080035401750000,2021,368510,613390,981900,MKT
06080035401750000,2020,212570,425330,637900,MKT
06080035401750000,2019,212570,425330,637900,MKT
06080035401800000,2021,268640,0,268640,COST
06080035401800000,2020,220154,0,220154,COST
06080035401800000,2019,220154,0,220154,COST
06080035401850000,2021,262805,0,262805,COST
06080035401850000,2020,214918,0,214918,COST
06080035401850000,2019,214918,0,214918,COST
06080036101010000,2021,170797,0,170797,COST
06080036101010000,2020,103718,0,103718,COST
06080036101010000,2019,103718,0,103718,COST
06089801101010000,2021,41320,1780,43100,COST
06089801101010000,2020,42687,1720,44407,COST
06089801101010000,2019,42687,1720,44407,COST
06089801401010000,2021,10147,0,10147,COST
06089801401010000,2020,9437,0,9437,COST
06089801401010000,2019,9437,0,9437,COST
06089802101010000,2021,4349,0,4349,COST
06089802101010000,2020,4050,0,4050,COST
06089802101010000,2019,4050,0,4050,COST
06089802301010000,2021,27124,0,27124,COST
06089802301010000,2020,26962,0,26962,COST
06089802301010000,2019,26962,0,26962,COST
06089803101010000,2021,19045,0,19045,COST
06089803101010000,2020,17736,0,17736,COST
06089803101010000,2019,17736,0,17736,COST
06089804101050000,2021,6427,0,6427,COST
06089804101050000,2020,5991,0,5991,COST
06089804101050000,2019,5991,0,5991,COST
06089804101400000,2021,1068,0,1068,COST
06089804101400000,2020,996,0,996,COST
06089804101400000,2019,996,0,996,COST
06089804201010000,2021,9476,0,9476,COST
06089804201010000,2020,8818,0,8818,COST
06089804201010000,2019,8818,0,8818,COST
06089804401010000,2021,2377,0,2377,COST
06089804401010000,2020,2213,0,2213,COST
06089804401010000,2019,2213,0,2213,COST
06089805101010000,2021,18374,0,18374,COST
06089805101010000,2020,17120,0,17120,COST
06089805101010000,2019,17120,0,17120,COST
06089810102010000,2021,11897,26940,38837,COST
06089810102010000,2020,11083,27930,39013,COST
06089810102010000,2019,11083,27930,39013,COST
06089810201010000,2021,10465,0,10465,COST
06089810201010000,2020,9750,0,9750,COST
06089810201010000,2019,9750,0,9750,COST
06089810301150000,2021,3401,208700,212101,COST
06089810301150000,2020,3574,165560,169134,COST
06089810301150000,2019,3574,165560,169134,COST
06089811101010000,2021,119609,0,119609,COST
06089811101010000,2020,124984,0,124984,COST
06089811101010000,2019,124984,0,124984,COST
06089812102010000,2021,5995,3680,9675,COST
06089812102010000,2020,5574,3680,9254,COST
06089812102010000,2019,5574,3680,9254,COST
06089812201010000,2021,47109,0,47109,COST
06089812201010000,2020,48487,0,48487,COST
06089812201010000,2019,48487,0,48487,COST
06089813101010000,2021,88128,0,88128,COST
06089813101010000,2020,90661,0,90661,COST
06089813101010000,2019,90661,0,90661,COST
06089814101010000,2021,136422,2780,139202,COST
06089814101010000,2020,142961,2680,145641,COST
06089814101010000,2019,142961,2680,145641,COST
06089815101010000,2021,2981,0,2981,COST
06089815101010000,2020,2777,0,2777,COST
06089815101010000,2019,2777,0,2777,COST
06089815101150000,2021,1401,0,1401,COST
06089815101150000,2020,1306,0,1306,COST
06089815101150000,2019,1306,0,1306,COST
06089815201010000,2021,13088,0,13088,COST
06089815201010000,2020,12195,0,12195,COST
06089815201010000,2019,12195,0,12195,COST
06089815301050000,2021,5805,0,5805,COST
06089815301050000,2020,5409,0,5409,COST
06089815301050000,2019,5409,0,5409,COST
06090001101010000,2021,208149,0,208149,COST
06090001101010000,2020,219284,0,219284,COST
06090001101010000,2019,219284,0,219284,COST
06090002201010000,2021,8677,0,8677,COST
06090002201010000,2020,8070,0,8070,COST
06090002201010000,2019,8070,0,8070,COST
06090002301020000,2021,258482,0,258482,COST
06090002301020000,2020,271684,0,271684,COST
06090002301020000,2019,271684,0,271684,COST
06090003101010000,2021,19556,0,19556,COST
06090003101010000,2020,18180,0,18180,COST
06090003101010000,2019,18180,0,18180,COST
06090003401010000,2021,3253,62710,65963,COST
06090003401010000,2020,3023,57610,60633,COST
06090003401010000,2019,3023,57610,60633,COST
06090004101010000,2021,19797,0,19797,COST
06090004101010000,2020,18406,0,18406,COST
06090004101010000,2019,18406,0,18406,COST
06090004401010000,2021,2505,0,2505,COST
06090004401010000,2020,2330,0,2330,COST
06090004401010000,2019,2330,0,2330,COST
06090005101010000,2021,124011,136789,260800,MKT
06090005101010000,2020,108869,41620,150489,COST
06090005101010000,2019,108869,41620,150489,COST
06090005101050000,2021,124007,115793,239800,MKT
06090005101050000,2020,108854,73760,182614,COST
06090005101050000,2019,108854,73760,182614,COST
06090005101200000,2021,76152,10400,86552,COST
06090005101200000,2020,23279,11160,34439,COST
06090005101200000,2019,23279,11160,34439,COST
06090005101300000,2021,150847,275153,426000,MKT
06090005101300000,2020,108306,176760,285066,COST
06090005101300000,2019,108306,176760,285066,COST
06090005101400000,2021,150847,305953,456800,MKT
06090005101400000,2020,108306,210550,318856,COST
06090005101400000,2019,108306,210550,318856,COST
06090005101500000,2021,150847,359553,510400,MKT
06090005101500000,2020,108306,273994,382300,MKT
06090005101500000,2019,108306,273994,382300,MKT
06090005101600000,2021,61600,203880,265480,COST
06090005101600000,2020,108306,127880,236186,COST
06090005101600000,2019,108306,127880,236186,COST
06090005101700000,2021,2191,0,2191,COST
06090005101700000,2020,2039,0,2039,COST
06090005101700000,2019,2039,0,2039,COST
06090005201020000,2021,122772,290028,412800,MKT
06090005201020000,2020,67918,217882,285800,MKT
06090005201020000,2019,67918,217882,285800,MKT
06090005201050000,2021,6000,0,6000,COST
06090005201050000,2020,5995,0,5995,COST
06090005201050000,2019,5995,0,5995,COST
06090005202010000,2021,62652,382670,445322,COST
06090005202010000,2020,23279,251810,275089,COST
06090005202010000,2019,23279,251810,275089,COST
06090005202200000,2021,71497,0,71497,COST
06090005202200000,2020,64039,0,64039,COST
06090005202200000,2019,64039,0,64039,COST
06090005212010000,2021,62652,199160,261812,COST
06090005212010000,2020,23279,124050,147329,COST
06090005212010000,2019,23279,124050,147329,COST
06090005212450000,2021,77231,86420,163651,COST
06090005212450000,2020,24283,70620,94903,COST
06090005212450000,2019,24283,70620,94903,COST
06090005301010000,2021,891,0,891,COST
06090005301010000,2020,829,0,829,COST
06090005301010000,2019,829,0,829,COST
06090005301100000,2021,1555,0,1555,COST
06090005301100000,2020,1447,0,1447,COST
06090005301100000,2019,1447,0,1447,COST
06090005301150000,2021,1477,0,1477,COST
06090005301150000,2020,1377,0,1377,COST
06090005301150000,2019,1377,0,1377,COST
06090005301400000,2021,77101,0,77101,COST
06090005301400000,2020,24162,0,24162,COST
06090005301400000,2019,24162,0,24162,COST
06090005350010000,2021,76207,94320,170527,COST
06090005350010000,2020,23331,101030,124361,COST
06090005350010000,2019,23331,101030,124361,COST
06090005401010000,2021,7812,543000,550812,COST
06090005401010000,2020,7667,365050,372717,COST
06090005401010000,2019,7667,365050,372717,COST
06090006101010000,2021,75209,9190,84399,COST
06090006101010000,2020,80120,8910,89030,COST
06090006101010000,2019,80120,8910,89030,COST
06090006101050000,2021,66770,155150,221920,COST
06090006101050000,2020,27112,96230,123342,COST
06090006101050000,2019,27112,96230,123342,COST
06090006201010000,2021,48062,0,48062,COST
06090006201010000,2020,41702,0,41702,COST
06090006201010000,2019,41702,0,41702,COST
06090006301020000,2021,104588,43590,148178,COST
06090006301020000,2020,95154,5750,100904,COST
06090006301020000,2019,95154,5750,100904,COST
06090006401010000,2021,11031,270870,281901,COST
06090006401010000,2020,13383,220050,233433,COST
06090006401010000,2019,13383,220050,233433,COST
06090006401400000,2021,31573,0,31573,COST
06090006401400000,2020,39417,0,39417,COST
06090006401400000,2019,39417,0,39417,COST
06090006412010000,2021,2219,0,2219,COST
06090006412010000,2020,2065,0,2065,COST
06090006412010000,2019,2065,0,2065,COST
06090007101010000,2021,10807,0,10807,COST
06090007101010000,2020,10059,0,10059,COST
06090007101010000,2019,10059,0,10059,COST
06090007112010000,2021,9175,0,9175,COST
06090007112010000,2020,8532,0,8532,COST
06090007112010000,2019,8532,0,8532,COST
06090007202010000,2021,5939,31080,37019,COST
06090007202010000,2020,5532,32060,37592,COST
06090007202010000,2019,5532,32060,37592,COST
06090007301010000,2021,168583,281317,449900,MKT
06090007301010000,2020,139330,189700,329030,COST
06090007301010000,2019,139330,189700,329030,COST
06090007412010000,2021,76705,220780,297485,COST
06090007412010000,2020,23794,184790,208584,COST
06090007412010000,2019,23794,184790,208584,COST
06090008101010000,2021,12861,0,12861,COST
06090008101010000,2020,11960,0,11960,COST
06090008101010000,2019,11960,0,11960,COST
06090008201050000,2021,3382,0,3382,COST
06090008201050000,2020,3141,0,3141,COST
06090008201050000,2019,3141,0,3141,COST
06090008301010000,2021,4991,0,4991,COST
06090008301010000,2020,4644,0,4644,COST
06090008301010000,2019,4644,0,4644,COST
06090009101010000,2021,23256,0,23256,COST
06090009101010000,2020,21623,0,21623,COST
06090009101010000,2019,21623,0,21623,COST
06090010104010000,2021,91925,32750,124675,COST
06090010104010000,2020,35257,31920,67177,COST
06090010104010000,2019,35257,31920,67177,COST
06090010105010000,2021,92209,0,92209,COST
06090010105010000,2020,35504,0,35504,COST
06090010105010000,2019,35504,0,35504,COST
06090010201010000,2021,11833,0,11833,COST
06090010201010000,2020,11008,0,11008,COST
06090010201010000,2019,11008,0,11008,COST
06090010401010000,2021,11939,0,11939,COST
06090010401010000,2020,11106,0,11106,COST
06090010401010000,2019,11106,0,11106,COST
06090012101010000,2021,27602,0,27602,COST
06090012101010000,2020,26387,0,26387,COST
06090012101010000,2019,26387,0,26387,COST
06090013101010000,2021,144476,0,144476,COST
06090013101010000,2020,151884,0,151884,COST
06090013101010000,2019,151884,0,151884,COST
06090014101500000,2021,1684,0,1684,COST
06090014101500000,2020,1567,0,1567,COST
06090014101500000,2019,1567,0,1567,COST
06090015101010000,2021,11761,0,11761,COST
06090015101010000,2020,10937,0,10937,COST
06090015101010000,2019,10937,0,10937,COST
06090015301010000,2021,11636,0,11636,COST
06090015301010000,2020,10824,0,10824,COST
06090015301010000,2019,10824,0,10824,COST
06090016201010000,2021,18185,0,18185,COST
06090016201010000,2020,16923,0,16923,COST
06090016201010000,2019,16923,0,16923,COST
06090016401010000,2021,5915,0,5915,COST
06090016401010000,2020,5503,0,5503,COST
06090016401010000,2019,5503,0,5503,COST
06090017101010000,2021,22973,0,22973,COST
06090017101010000,2020,21365,0,21365,COST
06090017101010000,2019,21365,0,21365,COST
06090018101010000,2021,39365,0,39365,COST
06090018101010000,2020,41119,0,41119,COST
06090018101010000,2019,41119,0,41119,COST
06090018201010000,2021,92801,568240,661041,COST
06090018201010000,2020,102273,463910,566183,COST
06090018201010000,2019,102273,463910,566183,COST
06090019101010000,2021,203012,0,203012,COST
06090019101010000,2020,258649,0,258649,COST
06090019101010000,2019,258649,0,258649,COST
06090020101010000,2021,12394,0,12394,COST
06090020101010000,2020,11524,0,11524,COST
06090020101010000,2019,11524,0,11524,COST
06090020301010000,2021,6738,0,6738,COST
06090020301010000,2020,6265,0,6265,COST
06090020301010000,2019,6265,0,6265,COST
06090020401010000,2021,6405,0,6405,COST
06090020401010000,2020,5954,0,5954,COST
06090020401010000,2019,5954,0,5954,COST
06090021101010000,2021,25802,0,25802,COST
06090021101010000,2020,24006,0,24006,COST
06090021101010000,2019,24006,0,24006,COST
06090022101010000,2021,28486,0,28486,COST
06090022101010000,2020,26494,0,26494,COST
06090022101010000,2019,26494,0,26494,COST
06090022301100000,2021,2237,0,2237,COST
06090022301100000,2020,2084,0,2084,COST
06090022301100000,2019,2084,0,2084,COST
06090023101010000,2021,23745,0,23745,COST
06090023101010000,2020,22093,0,22093,COST
06090023101010000,2019,22093,0,22093,COST
06090023201010000,2021,26511,0,26511,COST
06090023201010000,2020,24655,0,24655,COST
06090023201010000,2019,24655,0,24655,COST
06090024101010000,2021,56269,0,56269,COST
06090024101010000,2020,58808,0,58808,COST
06090024101010000,2019,58808,0,58808,COST
06090024301010000,2021,12138,0,12138,COST
06090024301010000,2020,11294,0,11294,COST
06090024301010000,2019,11294,0,11294,COST
06090025101010000,2021,26868,0,26868,COST
06090025101010000,2020,24996,0,24996,COST
06090025101010000,2019,24996,0,24996,COST
06090026101010000,2021,30186,0,30186,COST
06090026101010000,2020,28069,0,28069,COST
06090026101010000,2019,28069,0,28069,COST
06090027101010000,2021,28917,0,28917,COST
06090027101010000,2020,26901,0,26901,COST
06090027101010000,2019,26901,0,26901,COST
06090028101010000,2021,26475,0,26475,COST
06090028101010000,2020,24628,0,24628,COST
06090028101010000,2019,24628,0,24628,COST
06090029101010000,2021,27417,0,27417,COST
06090029101010000,2020,25493,0,25493,COST
06090029101010000,2019,25493,0,25493,COST
06090033101010000,2021,18364,0,18364,COST
06090033101010000,2020,17088,0,17088,COST
06090033101010000,2019,17088,0,17088,COST
06090033401010000,2021,42940,0,42940,COST
06090033401010000,2020,45171,0,45171,COST
06090033401010000,2019,45171,0,45171,COST
06090034101010000,2021,76133,0,76133,COST
06090034101010000,2020,79616,0,79616,COST
06090034101010000,2019,79616,0,79616,COST
06090034201010000,2021,7119,0,7119,COST
06090034201010000,2020,6620,0,6620,COST
06090034201010000,2019,6620,0,6620,COST
06090035101010000,2021,26924,0,26924,COST
06090035101010000,2020,25043,0,25043,COST
06090035101010000,2019,25043,0,25043,COST
06090036101010000,2021,23637,0,23637,COST
06090036101010000,2020,22011,0,22011,COST
06090036101010000,2019,22011,0,22011,COST
06090101101010000,2021,81450,10320,91770,COST
06090101101010000,2020,85938,9960,95898,COST
06090101101010000,2019,85938,9960,95898,COST
06090101101200000,2021,253722,0,253722,COST
06090101101200000,2020,223994,0,223994,COST
06090101101200000,2019,223994,0,223994,COST
06090101301010000,2021,145630,0,145630,COST
06090101301010000,2020,126821,0,126821,COST
06090101301010000,2019,126821,0,126821,COST
06090102101010000,2021,274017,14170,288187,COST
06090102101010000,2020,236585,13600,250185,COST
06090102101010000,2019,236585,13600,250185,COST
06090102201010000,2021,156835,0,156835,COST
06090102201010000,2020,135376,0,135376,COST
06090102201010000,2019,135376,0,135376,COST
06090102301050000,2021,25132,0,25132,COST
06090102301050000,2020,33168,0,33168,COST
06090102301050000,2019,33168,0,33168,COST
06090103101010000,2021,88212,600,88812,COST
06090103101010000,2020,118534,580,119114,COST
06090103101010000,2019,118534,580,119114,COST
06090103401010000,2021,53367,0,53367,COST
06090103401010000,2020,71631,0,71631,COST
06090103401010000,2019,71631,0,71631,COST
06090104101010000,2021,92289,397040,489329,COST
06090104101010000,2020,102489,324550,427039,COST
06090104101010000,2019,102489,324550,427039,COST
06090104201010000,2021,31060,0,31060,COST
06090104201010000,2020,28869,0,28869,COST
06090104201010000,2019,28869,0,28869,COST
06090105201010000,2021,56646,956780,1013426,COST
06090105201010000,2020,53115,778310,831425,COST
06090105201010000,2019,53115,778310,831425,COST
06090105201100000,2021,6458,0,6458,COST
06090105201100000,2020,6003,0,6003,COST
06090105201100000,2019,6003,0,6003,COST
06090105403010000,2021,122241,0,122241,COST
06090105403010000,2020,67256,0,67256,COST
06090105403010000,2019,67256,0,67256,COST
06090106101010000,2021,24361,0,24361,COST
06090106101010000,2020,22673,0,22673,COST
06090106101010000,2019,22673,0,22673,COST
06090107101011001,2021,2526,0,2526,COST
06090107101011001,2020,2348,0,2348,COST
06090107101011001,2019,2348,0,2348,COST
06090107101011002,2021,20924,0,20924,COST
06090107101011002,2020,19504,0,19504,COST
06090107101011002,2019,19504,0,19504,COST
06090108101010000,2021,29990,0,29990,COST
06090108101010000,2020,31995,0,31995,COST
06090108101010000,2019,31995,0,31995,COST
06090108301010000,2021,93372,0,93372,COST
06090108301010000,2020,132943,0,132943,COST
06090108301010000,2019,132943,0,132943,COST
06090108301020000,2021,88342,0,88342,COST
06090108301020000,2020,32219,0,32219,COST
06090108301020000,2019,32219,0,32219,COST
06090109101010000,2021,74632,0,74632,COST
06090109101010000,2020,97642,0,97642,COST
06090109101010000,2019,97642,0,97642,COST
06090109201010000,2021,105040,0,105040,COST
06090109201010000,2020,139621,0,139621,COST
06090109201010000,2019,139621,0,139621,COST
06090110101010000,2021,79039,0,79039,COST
06090110101010000,2020,113645,0,113645,COST
06090110101010000,2019,113645,0,113645,COST
06090110201010000,2021,84678,59150,143828,COST
06090110201010000,2020,101282,60440,161722,COST
06090110201010000,2019,101282,60440,161722,COST
06090110201020000,2021,61681,292220,353901,COST
06090110201020000,2020,78267,231250,309517,COST
06090110201020000,2019,78267,231250,309517,COST
06090110401010000,2021,7378,0,7378,COST
06090110401010000,2020,6160,0,6160,COST
06090110401010000,2019,6160,0,6160,COST
06090111101010000,2021,254382,289340,543722,COST
06090111101010000,2020,226112,267550,493662,COST
06090111101010000,2019,226112,267550,493662,COST
06090111202011001,2021,139,0,139,COST
06090111202011001,2020,129,0,129,COST
06090111202011001,2019,129,0,129,COST
06090111202011002,2021,81858,258290,340148,COST
06090111202011002,2020,28589,205490,234079,COST
06090111202011002,2019,28589,205490,234079,COST
06090111301010000,2021,3694,0,3694,COST
06090111301010000,2020,3439,0,3439,COST
06090111301010000,2019,3439,0,3439,COST
06090112101010000,2021,39668,0,39668,COST
06090112101010000,2020,41773,0,41773,COST
06090112101010000,2019,41773,0,41773,COST
06090112201010000,2021,102691,0,102691,COST
06090112201010000,2020,108935,0,108935,COST
06090112201010000,2019,108935,0,108935,COST
06090112401010000,2021,125440,10680,136120,COST
06090112401010000,2020,132609,10270,142879,COST
06090112401010000,2019,132609,10270,142879,COST
06090113101010000,2021,74484,13010,87494,COST
06090113101010000,2020,78603,12750,91353,COST
06090113101010000,2019,78603,12750,91353,COST
06090113201010000,2021,54121,75110,129231,COST
06090113201010000,2020,57203,68830,126033,COST
06090113201010000,2019,57203,50570,107773,COST
06090113301010000,2021,74880,0,74880,COST
06090113301010000,2020,79008,0,79008,COST
06090113301010000,2019,79008,0,79008,COST
06090113401010000,2021,79260,0,79260,COST
06090113401010000,2020,83619,0,83619,COST
06090113401010000,2019,83619,0,83619,COST
06090113401150000,2021,433,0,433,COST
06090113401150000,2020,455,0,455,COST
06090113401150000,2019,455,0,455,COST
06090114101010000,2021,176829,0,176829,COST
06090114101010000,2020,182373,0,182373,COST
06090114101010000,2019,182373,0,182373,COST
06090114201010000,2021,2465,0,2465,COST
06090114201010000,2020,2297,0,2297,COST
06090114201010000,2019,2297,0,2297,COST
06090114301010000,2021,2867,0,2867,COST
06090114301010000,2020,2712,0,2712,COST
06090114301010000,2019,2712,0,2712,COST
06090115101010000,2021,5872,0,5872,COST
06090115101010000,2020,5474,0,5474,COST
06090115101010000,2019,5474,0,5474,COST
06090115201010000,2021,80304,0,80304,COST
06090115201010000,2020,101467,0,101467,COST
06090115201010000,2019,101467,0,101467,COST
06090115204010000,2021,112171,219929,332100,MKT
06090115204010000,2020,102837,153680,256517,COST
06090115204010000,2019,102837,147463,250300,MKT
06090115301010000,2021,11643,0,11643,COST
06090115301010000,2020,10839,0,10839,COST
06090115301010000,2019,10839,0,10839,COST
06090115301030000,2021,93355,5560,98915,COST
06090115301030000,2020,36511,5680,42191,COST
06090115301030000,2019,36511,5680,42191,COST
06090116101010000,2021,111169,163550,274719,COST
06090116101010000,2020,125502,129610,255112,COST
06090116101010000,2019,125502,129610,255112,COST
06090116201010000,2021,6055,0,6055,COST
06090116201010000,2020,5649,0,5649,COST
06090116201010000,2019,5649,0,5649,COST
06090117101021001,2021,2983,0,2983,COST
06090117101021001,2020,2775,0,2775,COST
06090117101021001,2019,2775,0,2775,COST
06090117101021002,2021,44240,244040,288280,COST
06090117101021002,2020,42360,191290,233650,COST
06090117101021002,2019,42360,191290,233650,COST
06090118101010000,2021,22423,0,22423,COST
06090118101010000,2020,20896,0,20896,COST
06090118101010000,2019,20896,0,20896,COST
06090119101011001,2021,4550,0,4550,COST
06090119101011001,2020,4231,0,4231,COST
06090119101011001,2019,4231,0,4231,COST
06090119101011002,2021,104920,0,104920,COST
06090119101011002,2020,109754,0,109754,COST
06090119101011002,2019,109754,0,109754,COST
06090120101010000,2021,11752,0,11752,COST
06090120101010000,2020,10930,0,10930,COST
06090120101010000,2019,10930,0,10930,COST
06090120201010000,2021,96312,1354240,1450552,COST
06090120201010000,2020,24824,1050780,1075604,COST
06090120201010000,2019,24824,1050780,1075604,COST
06090120301010000,2021,19008,13980,32988,COST
06090120301010000,2020,17673,13060,30733,COST
06090120301010000,2019,17673,13060,30733,COST
06090120401010000,2021,14501,0,14501,COST
06090120401010000,2020,13492,0,13492,COST
06090120401010000,2019,13492,0,13492,COST
06090121401010000,2021,371989,121400,493389,COST
06090121401010000,2020,483108,100250,583358,COST
06090121401010000,2019,483108,100250,583358,COST
06090122101010000,2021,69377,41310,110687,COST
06090122101010000,2020,86347,39800,126147,COST
06090122101010000,2019,86347,39800,126147,COST
06090122201010000,2021,76654,152446,229100,MKT
06090122201010000,2020,23359,169241,192600,MKT
06090122201010000,2019,23359,169241,192600,MKT
06090123101010000,2021,99759,0,99759,COST
06090123101010000,2020,105039,0,105039,COST
06090123101010000,2019,105039,0,105039,COST
06090123301010000,2021,25229,0,25229,COST
06090123301010000,2020,20283,0,20283,COST
06090123301010000,2019,20283,0,20283,COST
06090124101010000,2021,106572,36250,142822,COST
06090124101010000,2020,112118,34950,147068,COST
06090124101010000,2019,112118,34950,147068,COST
06090124101020000,2021,69363,510,69873,COST
06090124101020000,2020,73189,540,73729,COST
06090124101020000,2019,73189,540,73729,COST
06090124301010000,2021,106022,0,106022,COST
06090124301010000,2020,111826,0,111826,COST
06090124301010000,2019,111826,0,111826,COST
06090125101010000,2021,291310,0,291310,COST
06090125101010000,2020,307018,0,307018,COST
06090125101010000,2019,307018,0,307018,COST
06090126101010000,2021,149058,0,149058,COST
06090126101010000,2020,157155,0,157155,COST
06090126101010000,2019,157155,0,157155,COST
06090126201010000,2021,100359,0,100359,COST
06090126201010000,2020,105024,0,105024,COST
06090126201010000,2019,105024,0,105024,COST
06090127101010000,2021,59807,0,59807,COST
06090127101010000,2020,77609,0,77609,COST
06090127101010000,2019,77609,0,77609,COST
06090127301010000,2021,10001,66510,76511,COST
06090127301010000,2020,9728,58320,68048,COST
06090127301010000,2019,9728,58320,68048,COST
06090127301500000,2021,9594,311970,321564,COST
06090127301500000,2020,9350,257310,266660,COST
06090127301500000,2019,9350,257310,266660,COST
06090128101010000,2021,83542,277450,360992,COST
06090128101010000,2020,30157,222940,253097,COST
06090128101010000,2019,30157,222940,253097,COST
06090128142070000,2021,42401,0,42401,COST
06090128142070000,2020,59301,0,59301,COST
06090128142070000,2019,59301,0,59301,COST
06090128201010000,2021,43533,0,43533,COST
06090128201010000,2020,55305,0,55305,COST
06090128201010000,2019,55305,0,55305,COST
06090128301010000,2021,20676,580,21256,COST
06090128301010000,2020,21656,550,22206,COST
06090128301010000,2019,21656,550,22206,COST
06090129101010000,2021,140799,207220,348019,COST
06090129101010000,2020,209882,165020,374902,COST
06090129101010000,2019,209882,165020,374902,COST
06090129201010000,2021,11826,0,11826,COST
06090129201010000,2020,10997,0,10997,COST
06090129201010000,2019,10997,0,10997,COST
06090129301010000,2021,8647,0,8647,COST
06090129301010000,2020,8043,0,8043,COST
06090129301010000,2019,8043,0,8043,COST
06090129301030000,2021,284,0,284,COST
06090129301030000,2020,264,0,264,COST
06090129301030000,2019,264,0,264,COST
06090130101010000,2021,10764,0,10764,COST
06090130101010000,2020,10009,0,10009,COST
06090130101010000,2019,10009,0,10009,COST
06090130101150000,2021,15748,0,15748,COST
06090130101150000,2020,16005,0,16005,COST
06090130101150000,2019,16005,0,16005,COST
06090130301010000,2021,10589,0,10589,COST
06090130301010000,2020,9861,0,9861,COST
06090130301010000,2019,9861,0,9861,COST
06090131101010000,2021,5372,0,5372,COST
06090131101010000,2020,4995,0,4995,COST
06090131101010000,2019,4995,0,4995,COST
06090131201020000,2021,183634,0,183634,COST
06090131201020000,2020,192634,0,192634,COST
06090131201020000,2019,192634,0,192634,COST
06090132101010000,2021,110817,3060,113877,COST
06090132101010000,2020,159047,3400,162447,COST
06090132101010000,2019,159047,3400,162447,COST
06090132101020000,2021,103758,33340,137098,COST
06090132101020000,2020,136167,0,136167,COST
06090132101020000,2019,136167,0,136167,COST
06090132201010000,2021,9314,0,9314,COST
06090132201010000,2020,8661,0,8661,COST
06090132201010000,2019,8661,0,8661,COST
06090133101010000,2021,11928,610,12538,COST
06090133101010000,2020,11117,580,11697,COST
06090133101010000,2019,11117,580,11697,COST
06090133201100000,2021,95,0,95,COST
06090133201100000,2020,89,0,89,COST
06090133201100000,2019,89,0,89,COST
06090133301200000,2021,16212,158120,174332,COST
06090133301200000,2020,20696,160450,181146,COST
06090133301200000,2019,20696,160450,181146,COST
06090133401200000,2021,14309,0,14309,COST
06090133401200000,2020,14459,0,14459,COST
06090133401200000,2019,14459,0,14459,COST
06090134101010000,2021,30973,0,30973,COST
06090134101010000,2020,29533,0,29533,COST
06090134101010000,2019,29533,0,29533,COST
06090134301010000,2021,57628,0,57628,COST
06090134301010000,2020,60543,0,60543,COST
06090134301010000,2019,60543,0,60543,COST
06090135101010000,2021,297292,54680,351972,COST
06090135101010000,2020,313260,53370,366630,COST
06090135101010000,2019,313260,53370,366630,COST
06090136101010000,2021,298320,33010,331330,COST
06090136101010000,2020,314601,33340,347941,COST
06090136101010000,2019,314601,33340,347941,COST
06090201101020000,2021,128085,335090,463175,COST
06090201101020000,2020,111667,301560,413227,COST
06090201101020000,2019,111667,301560,413227,COST
06090201101040000,2021,151544,206150,357694,COST
06090201101040000,2020,132067,186440,318507,COST
06090201101040000,2019,132067,186440,318507,COST
06090201101050000,2021,91730,237030,328760,COST
06090201101050000,2020,81680,252420,334100,MKT
06090201101050000,2019,81680,252420,334100,MKT
06090201101060000,2021,2638,6670,9308,COST
06090201101060000,2020,2863,6640,9503,COST
06090201101060000,2019,2863,6640,9503,COST
06090201101070000,2021,192849,186851,379700,MKT
06090201101070000,2020,136835,219365,356200,MKT
06090201101070000,2019,136835,219365,356200,MKT
06090201260400000,2021,156225,216275,372500,MKT
06090201260400000,2020,118218,207082,325300,MKT
06090201260400000,2019,118218,207082,325300,MKT
06090201301010000,2021,103,323670,323773,COST
06090201301010000,2020,96,324820,324916,COST
06090201301010000,2019,96,324820,324916,COST
06090201401010000,2021,110059,0,110059,COST
06090201401010000,2020,80064,0,80064,COST
06090201401010000,2019,80064,0,80064,COST
06090201401100000,2021,204183,0,204183,COST
06090201401100000,2020,142370,0,142370,COST
06090201401100000,2019,142370,0,142370,COST
06090201401200000,2021,33336,0,33336,COST
06090201401200000,2020,29241,0,29241,COST
06090201401200000,2019,29241,0,29241,COST
06090202101010000,2021,80376,0,80376,COST
06090202101010000,2020,107742,0,107742,COST
06090202101010000,2019,107742,0,107742,COST
06090202101030000,2021,147700,0,147700,COST
06090202101030000,2020,113700,0,113700,COST
06090202101030000,2019,113700,0,113700,COST
06090202101040000,2021,133901,183899,317800,MKT
06090202101040000,2020,106214,205586,311800,MKT
06090202101040000,2019,106214,205586,311800,MKT
06090202101050000,2021,149487,233713,383200,MKT
06090202101050000,2020,113088,250712,363800,MKT
06090202101050000,2019,113088,250712,363800,MKT
06090202101060000,2021,133568,233532,367100,MKT
06090202101060000,2020,106030,224370,330400,MKT
06090202101060000,2019,106030,224370,330400,MKT
06090202101150000,2021,10336,398870,409206,COST
06090202101150000,2020,11861,38550,50411,COST
06090202101150000,2019,11861,38550,50411,COST
06090202201010000,2021,89254,211090,300344,COST
06090202201010000,2020,119367,188690,308057,COST
06090202201010000,2019,119367,188690,308057,COST
06090202201030000,2021,225412,13500,238912,COST
06090202201030000,2020,152492,11070,163562,COST
06090202201030000,2019,152492,11070,163562,COST
06090202201040000,2021,134892,138508,273400,MKT
06090202201040000,2020,106759,94770,201529,COST
06090202201040000,2019,106759,94770,201529,COST
06090202201050000,2021,135547,338653,474200,MKT
06090202201050000,2020,107119,287081,394200,MKT
06090202201050000,2019,107119,287081,394200,MKT
06090202201070000,2021,121100,169300,290400,MKT
06090202201070000,2020,114153,71410,185563,COST
06090202201070000,2019,114153,71410,185563,COST
06090202202050000,2021,106407,0,106407,COST
06090202202050000,2020,92284,0,92284,COST
06090202202050000,2019,92284,0,92284,COST
06090202202150000,2021,38995,0,38995,COST
06090202202150000,2020,50246,0,50246,COST
06090202202150000,2019,50246,0,50246,COST
06090202401010000,2021,66969,0,66969,COST
06090202401010000,2020,89691,0,89691,COST
06090202401010000,2019,89691,0,89691,COST
06090202401200000,2021,49621,0,49621,COST
06090202401200000,2020,64498,0,64498,COST
06090202401200000,2019,64498,0,64498,COST
06090203101020000,2021,168571,463370,631941,COST
06090203101020000,2020,216954,420380,637334,COST
06090203101020000,2019,216954,420380,637334,COST
06090203101030000,2021,218689,186011,404700,MKT
06090203101030000,2020,149320,219580,368900,OVR
06090203101030000,2019,149320,219580,368900,MKT
06090203101050000,2021,147700,268560,416260,COST
06090203101050000,2020,113700,280100,393800,MKT
06090203101050000,2019,113700,280100,393800,MKT
06090203101070000,2021,251265,201190,452455,COST
06090203101070000,2020,164434,168120,332554,COST
06090203101070000,2019,164434,168120,332554,COST
06090203101100000,2021,2072,0,2072,COST
06090203101100000,2020,1928,0,1928,COST
06090203101100000,2019,1928,0,1928,COST
06090203201010000,2021,153346,1109070,1262416,COST
06090203201010000,2020,133603,1081810,1215413,COST
06090203201010000,2019,133603,1081810,1215413,COST
06090203201040000,2021,148820,250040,398860,COST
06090203201040000,2020,114742,224170,338912,COST
06090203201040000,2019,114742,224170,338912,COST
06090203301010000,2021,53507,0,53507,COST
06090203301010000,2020,46443,0,46443,COST
06090203301010000,2019,46443,0,46443,COST
06090203301200000,2021,21380,0,21380,COST
06090203301200000,2020,27518,0,27518,COST
06090203301200000,2019,27518,0,27518,COST
06090203401010000,2021,4436,0,4436,COST
06090203401010000,2020,4128,0,4128,COST
06090203401010000,2019,4128,0,4128,COST
06090204102010000,2021,155461,0,155461,COST
06090204102010000,2020,171965,0,171965,COST
06090204102010000,2019,171965,0,171965,COST
06090204201010000,2021,82534,1133090,1215624,COST
06090204201010000,2020,108574,1070790,1179364,COST
06090204201010000,2019,108574,1070790,1179364,COST
06090204201400000,2021,233,0,233,COST
06090204201400000,2020,269,0,269,COST
06090204201400000,2019,269,0,269,COST
06090204301010000,2021,60508,0,60508,COST
06090204301010000,2020,63845,0,63845,COST
06090204301010000,2019,63845,0,63845,COST
06090204401030000,2021,134495,12390,146885,COST
06090204401030000,2020,116761,12010,128771,COST
06090204401030000,2019,116761,12010,128771,COST
06090205101010000,2021,94993,29700,124693,COST
06090205101010000,2020,99877,28540,128417,COST
06090205101010000,2019,99877,28540,128417,COST
06090205201010000,2021,282730,0,282730,COST
06090205201010000,2020,387400,0,387400,COST
06090205201010000,2019,387400,0,387400,COST
06090206101010000,2021,216114,0,216114,COST
06090206101010000,2020,227652,0,227652,COST
06090206101010000,2019,227652,0,227652,COST
06090207101010000,2021,258409,0,258409,COST
06090207101010000,2020,350103,0,350103,COST
06090207101010000,2019,350103,0,350103,COST
06090207101030000,2021,68990,2510,71500,COST
06090207101030000,2020,72770,2430,75200,COST
06090207101030000,2019,72770,2430,75200,COST
06090207301010000,2021,68016,0,68016,COST
06090207301010000,2020,71767,0,71767,COST
06090207301010000,2019,71767,0,71767,COST
06090208101010000,2021,387259,0,387259,COST
06090208101010000,2020,502135,0,502135,COST
06090208101010000,2019,502135,0,502135,COST
06090209101010000,2021,116445,0,116445,COST
06090209101010000,2020,122816,0,122816,COST
06090209101010000,2019,122816,0,122816,COST
06090209301010000,2021,136709,0,136709,COST
06090209301010000,2020,185215,0,185215,COST
06090209301010000,2019,185215,0,185215,COST
06090209401010000,2021,128421,4680,133101,COST
06090209401010000,2020,175090,4520,179610,COST
06090209401010000,2019,175090,4520,179610,COST
06090210101010000,2021,142366,316460,458826,COST
06090210101010000,2020,183069,289000,472069,COST
06090210101010000,2019,183069,289000,472069,COST
06090210101020000,2021,122424,227476,349900,MKT
06090210101020000,2020,99807,221393,321200,MKT
06090210101020000,2019,99807,221393,321200,MKT
06090210101030000,2021,14725,387150,401875,COST
06090210101030000,2020,18640,375430,394070,COST
06090210101030000,2019,18640,375430,394070,COST
06090210101040000,2021,129824,0,129824,COST
06090210101040000,2020,167337,0,167337,COST
06090210101040000,2019,167337,0,167337,COST
06090210101060000,2021,120760,540560,661320,COST
06090210101060000,2020,103763,498360,602123,COST
06090210101060000,2019,103763,498360,602123,COST
06090210301010000,2021,136762,224238,361000,MKT
06090210301010000,2020,130000,175700,305700,COST
06090210301010000,2019,130000,175700,305700,COST
06090210301040000,2021,109690,207530,317220,COST
06090210301040000,2020,140394,194850,335244,COST
06090210301040000,2019,140394,194850,335244,COST
06090210302010000,2021,248271,424829,673100,MKT
06090210302010000,2020,163071,415429,578500,MKT
06090210302010000,2019,163071,415429,578500,MKT
06090210401010000,2021,16155,0,16155,COST
06090210401010000,2020,14050,0,14050,COST
06090210401010000,2019,14050,0,14050,COST
06090210415200000,2021,147700,247200,394900,MKT
06090210415200000,2020,113700,250700,364400,MKT
06090210415200000,2019,113700,250700,364400,MKT
06090211101010000,2021,128970,321580,450550,COST
06090211101010000,2020,103483,279800,383283,COST
06090211101010000,2019,103483,279800,383283,COST
06090211101020000,2021,7223,152140,159363,COST
06090211101020000,2020,207092,137160,344252,COST
06090211101020000,2019,207092,137160,344252,COST
06090211101030000,2021,109549,298720,408269,COST
06090211101030000,2020,92395,259510,351905,COST
06090211101030000,2019,92395,259510,351905,COST
06090211101040000,2021,131072,479790,610862,COST
06090211101040000,2020,169351,421920,591271,COST
06090211101040000,2019,169351,421920,591271,COST
06090211101050000,2021,170221,428550,598771,COST
06090211101050000,2020,125475,384870,510345,COST
06090211101050000,2019,125475,384870,510345,COST
06090211101060000,2021,128249,143051,271300,MKT
06090211101060000,2020,82179,151021,233200,MKT
06090211101060000,2019,82179,151021,233200,MKT
06090211101090000,2021,119005,0,119005,COST
06090211101090000,2020,76928,0,76928,COST
06090211101090000,2019,76928,0,76928,COST
06090211101100000,2021,118246,0,118246,COST
06090211101100000,2020,76494,0,76494,COST
06090211101100000,2019,76494,0,76494,COST
06090211101120000,2021,281630,939750,1221380,COST
06090211101120000,2020,164559,882100,1046659,COST
06090211101120000,2019,164559,882100,1046659,COST
06090211201010000,2021,83486,0,83486,COST
06090211201010000,2020,110229,0,110229,COST
06090211201010000,2019,110229,0,110229,COST
06090211201020000,2021,168333,158760,327093,COST
06090211201020000,2020,104478,191222,295700,MKT
06090211201020000,2019,104478,191222,295700,MKT
06090211201030000,2021,54853,197747,252600,MKT
06090211201030000,2020,38830,199270,238100,MKT
06090211201030000,2019,38830,199270,238100,MKT
06090211201040000,2021,128754,69360,198114,COST
06090211201040000,2020,82464,67020,149484,COST
06090211201040000,2019,82464,67020,149484,COST
06090211201050000,2021,168231,149180,317411,COST
06090211201050000,2020,104422,153140,257562,COST
06090211201050000,2019,104422,153140,257562,COST
06090211201062000,2021,107631,0,107631,COST
06090211201062000,2020,70400,0,70400,COST
06090211201062000,2019,70400,0,70400,COST
06090211201070000,2021,113121,0,113121,COST
06090211201070000,2020,94477,0,94477,COST
06090211201070000,2019,94477,0,94477,COST
06090211201090000,2021,100110,265180,365290,COST
06090211201090000,2020,66039,244920,310959,COST
06090211201090000,2019,66039,244920,310959,COST
06090211301010000,2021,114493,0,114493,COST
06090211301010000,2020,147379,0,147379,COST
06090211301010000,2019,147379,0,147379,COST
06090211302010000,2021,1107,0,1107,COST
06090211302010000,2020,1030,0,1030,COST
06090211302010000,2019,1030,0,1030,COST
06090211401010000,2021,108568,0,108568,COST
06090211401010000,2020,97376,0,97376,COST
06090211401010000,2019,97376,0,97376,COST
06090211401100000,2021,3771,449970,453741,COST
06090211401100000,2020,114822,395010,509832,COST
06090211401100000,2019,1173,0,1173,COST
06090211403100000,2021,77317,0,77317,COST
06090211403100000,2020,52572,0,52572,COST
06090211403100000,2019,52572,0,52572,COST
06090212101010000,2021,193617,348250,541867,COST
06090212101010000,2020,168322,235330,403652,COST
06090212101010000,2019,168322,235330,403652,COST
06090212101020000,2021,139964,295330,435294,COST
06090212101020000,2020,191935,265770,457705,COST
06090212101020000,2019,191935,265770,457705,COST
06090212101030000,2021,135047,69370,204417,COST
06090212101030000,2020,122303,62990,185293,COST
06090212101030000,2019,122303,62990,185293,COST
06090212101040000,2021,324211,1602289,1926500,INCOME
06090212101040000,2020,196271,1398029,1594300,INCOME
06090212101040000,2019,196271,1398029,1594300,INCOME
06090212301620000,2021,155124,672570,827694,COST
06090212301620000,2020,127312,619970,747282,COST
06090212301620000,2019,113700,524920,638620,COST
06090213101030000,2021,298747,107310,406057,COST
06090213101030000,2020,173356,116760,290116,COST
06090213101030000,2019,173356,116760,290116,COST
06090213101040000,2021,133009,140130,273139,COST
06090213101040000,2020,116963,149530,266493,COST
06090213101040000,2019,116963,149530,266493,COST
06090213101070000,2021,124168,212032,336200,MKT
06090213101070000,2020,79866,190834,270700,MKT
06090213101070000,2019,79866,190834,270700,MKT
06090213101100000,2021,185323,423377,608700,INCOME
06090213101100000,2020,113733,424867,538600,INCOME
06090213101100000,2019,113733,424867,538600,INCOME
06090213101300000,2021,132699,222101,354800,MKT
06090213101300000,2020,84691,236509,321200,MKT
06090213101300000,2019,84691,236509,321200,MKT
06090213101310000,2021,88547,216053,304600,MKT
06090213101310000,2020,59258,208842,268100,MKT
06090213101310000,2019,59258,208842,268100,MKT
06090213101320000,2021,184914,107390,292304,COST
06090213101320000,2020,113512,149488,263000,MKT
06090213101320000,2019,113512,149488,263000,MKT
06090213101340000,2021,197309,166320,363629,COST
06090213101340000,2020,120202,215698,335900,OVR
06090213101340000,2019,120202,215698,335900,MKT
06090213101350000,2021,97805,136395,234200,MKT
06090213101350000,2020,64695,132005,196700,MKT
06090213101350000,2019,64695,132005,196700,MKT
06090213101390000,2021,148800,293500,442300,MKT
06090213101390000,2020,93700,331600,425300,MKT
06090213101390000,2019,93700,331600,425300,MKT
06090213101400000,2021,226384,1476630,1703014,COST
06090213101400000,2020,135709,1473170,1608879,COST
06090213101400000,2019,135709,1473170,1608879,COST
06090213101410000,2021,94092,167108,261200,MKT
06090213101410000,2020,62522,143478,206000,MKT
06090213101410000,2019,62522,143478,206000,MKT
06090213101420000,2021,107345,201455,308800,MKT
06090213101420000,2020,70235,189765,260000,MKT
06090213101420000,2019,70235,189765,260000,MKT
06090213101420900,2021,102299,221901,324200,MKT
06090213101420900,2020,67312,201988,269300,MKT
06090213101420900,2019,67312,201988,269300,MKT
06090213101440000,2021,192221,0,192221,COST
06090213101440000,2020,117462,0,117462,COST
06090213101440000,2019,117462,0,117462,COST
06090213101450000,2021,180767,121160,301927,COST
06090213101450000,2020,140189,130040,270229,COST
06090213101450000,2019,140189,130040,270229,COST
06090213101460000,2021,102192,183508,285700,MKT
06090213101460000,2020,67250,157150,224400,MKT
06090213101460000,2019,67250,157150,224400,MKT
06090213101470000,2021,142309,169091,311400,MKT
06090213101470000,2020,90083,129317,219400,MKT
06090213101470000,2019,90083,129317,219400,MKT
06090213101480000,2021,148800,167000,315800,MKT
06090213101480000,2020,93700,166100,259800,MKT
06090213101480000,2019,93700,166100,259800,MKT
06090213101490000,2021,11,0,11,COST
06090213101490000,2020,11,0,11,COST
06090213101490000,2019,11,0,11,COST
06090213101500000,2021,155556,186644,342200,MKT
06090213101500000,2020,97446,182454,279900,MKT
06090213101500000,2019,97446,182454,279900,MKT
06090213101510000,2021,105093,510,105603,COST
06090213101510000,2020,68932,11400,80332,COST
06090213101510000,2019,68932,11400,80332,COST
06090213101520000,2021,175655,122010,297665,COST
06090213101520000,2020,108479,153721,262200,MKT
06090213101520000,2019,108479,153721,262200,MKT
06090213101540000,2021,188126,202974,391100,MKT
06090213101540000,2020,115250,213950,329200,MKT
06090213101540000,2019,115250,213950,329200,MKT
06090213101550000,2021,342454,122930,465384,COST
06090213101550000,2020,195562,133520,329082,COST
06090213101550000,2019,195562,133520,329082,COST
06090213103610000,2021,239681,0,239681,COST
06090213103610000,2020,142722,0,142722,COST
06090213103610000,2019,142722,0,142722,COST
06090213201330000,2021,100110,278390,378500,MKT
06090213201330000,2020,66039,256361,322400,MKT
06090213201330000,2019,66039,256361,322400,MKT
06090213202010000,2021,102299,215201,317500,MKT
06090213202010000,2020,67312,187388,254700,MKT
06090213202010000,2019,67312,187388,254700,MKT
06090213202030000,2021,113604,232096,345700,MKT
06090213202030000,2020,73837,207263,281100,MKT
06090213202030000,2019,73837,207263,281100,MKT
06090213202050000,2021,113604,197896,311500,MKT
06090213202050000,2020,73837,185163,259000,MKT
06090213202050000,2019,73837,185163,259000,MKT
06090213202060000,2021,101218,181082,282300,MKT
06090213202060000,2020,66684,167916,234600,MKT
06090213202060000,2019,66684,167916,234600,MKT
06090213202070000,2021,107345,232055,339400,MKT
06090213202070000,2020,70235,211165,281400,MKT
06090213202070000,2019,70235,211165,281400,MKT
06090213202080000,2021,107345,171755,279100,MKT
06090213202080000,2020,70235,210965,281200,MKT
06090213202080000,2019,70235,210965,281200,MKT
06090213202100000,2021,98857,21960,120817,COST
06090213202100000,2020,65309,215030,280339,COST
06090213202100000,2019,65309,215030,280339,COST
06090213202110000,2021,107345,173155,280500,MKT
06090213202110000,2020,70235,189965,260200,MKT
06090213202110000,2019,70235,189965,260200,MKT
06090213202120000,2021,76284,0,76284,COST
06090213202120000,2020,51952,0,51952,COST
06090213202120000,2019,51952,0,51952,COST
06090213202130000,2021,130851,179049,309900,INCOME
06090213202130000,2020,83649,191251,274900,INCOME
06090213202130000,2019,83649,191251,274900,INCOME
06090213202140000,2021,77317,0,77317,COST
06090213202140000,2020,52572,0,52572,COST
06090213202140000,2019,52572,0,52572,COST
06090213202150000,2021,74114,120270,194384,COST
06090213202150000,2020,50645,117755,168400,INCOME
06090213202150000,2019,50645,117755,168400,INCOME
06090213202160000,2021,95367,251633,347000,MKT
06090213202160000,2020,63269,254231,317500,MKT
06090213202160000,2019,63269,254231,317500,MKT
06090213202180000,2021,78320,138580,216900,MKT
06090213202180000,2020,53174,139526,192700,MKT
06090213202180000,2019,53174,139526,192700,MKT
06090213202190000,2021,98973,157127,256100,MKT
06090213202190000,2020,65376,190124,255500,MKT
06090213202190000,2019,65376,190124,255500,MKT
06090213202360000,2021,207609,126420,334029,COST
06090213202360000,2020,125724,146376,272100,MKT
06090213202360000,2019,125724,146376,272100,MKT
06090213202486500,2021,70379,27590,97969,COST
06090213202486500,2020,39485,26840,66325,COST
06090213202486500,2019,39485,26840,66325,COST
06090213202756500,2021,62961,0,62961,COST
06090213202756500,2020,35788,0,35788,COST
06090213202756500,2019,35788,0,35788,COST
06090213202950000,2021,85607,0,85607,COST
06090213202950000,2020,57518,0,57518,COST
06090213202950000,2019,57518,0,57518,COST
06090213203010000,2021,174577,366423,541000,MKT
06090213203010000,2020,101406,389894,491300,MKT
06090213203010000,2019,101406,389894,491300,MKT
06090213203030000,2021,168146,378754,546900,MKT
06090213203030000,2020,98101,421999,520100,MKT
06090213203030000,2019,98101,421999,520100,MKT
06090213203050000,2021,168146,331454,499600,MKT
06090213203050000,2020,98101,375399,473500,MKT
06090213203050000,2019,98101,375399,473500,MKT
06090213203070000,2021,168146,447554,615700,MKT
06090213203070000,2020,98101,478799,576900,MKT
06090213203070000,2019,98101,478799,576900,MKT
06090213203097000,2021,346656,0,346656,COST
06090213203097000,2020,44679,0,44679,COST
06090213203097000,2019,44679,0,44679,COST
06090213203110000,2021,170154,483680,653834,COST
06090213203110000,2020,99135,526270,625405,COST
06090213203110000,2019,99135,526270,625405,COST
06090213203130000,2021,169458,0,169458,COST
06090213203130000,2020,98776,0,98776,COST
06090213203130000,2019,98776,0,98776,COST
06090213203150000,2021,169157,0,169157,COST
06090213203150000,2020,98622,0,98622,COST
06090213203150000,2019,98622,0,98622,COST
06090213203170000,2021,168956,0,168956,COST
06090213203170000,2020,98518,0,98518,COST
06090213203170000,2019,98518,0,98518,COST
06090213203195001,2021,85010,277890,362900,MKT
06090213203195001,2020,40188,272012,312200,MKT
06090213203195001,2019,98570,0,98570,COST
06090213203205002,2021,84047,261453,345500,MKT
06090213203205002,2020,39953,270847,310800,MKT
06090213203210000,2021,168552,324448,493000,MKT
06090213203210000,2020,98310,320090,418400,MKT
06090213203210000,2019,98310,320090,418400,MKT
06090213203230000,2021,168552,290248,458800,MKT
06090213203230000,2020,98310,300190,398500,MKT
06090213203230000,2019,98310,300190,398500,MKT
06090213203250000,2021,168552,238648,407200,MKT
06090213203250000,2020,98310,262990,361300,MKT
06090213203250000,2019,98310,262990,361300,MKT
06090213203270000,2021,175042,351958,527000,MKT
06090213203270000,2020,101644,374256,475900,MKT
06090213203270000,2019,101644,374256,475900,MKT
06090213204010000,2021,168349,311751,480100,MKT
06090213204010000,2020,98206,338394,436600,MKT
06090213204010000,2019,98206,338394,436600,MKT
06090213204030000,2021,168349,292451,460800,MKT
06090213204030000,2020,98206,274294,372500,OVR
06090213204030000,2019,98206,274294,372500,MKT
06090213204050000,2021,168349,280851,449200,MKT
06090213204050000,2020,98206,305294,403500,MKT
06090213204050000,2019,98206,305294,403500,MKT
06090213204070000,2021,168349,376151,544500,MKT
06090213204070000,2020,98206,407594,505800,MKT
06090213204070000,2019,98206,407594,505800,MKT
06090213204090000,2021,168349,361851,530200,MKT
06090213204090000,2020,98206,299958,398164,OVR
06090213204090000,2019,98206,398994,497200,MKT
06090213204110000,2021,169558,411742,581300,MKT
06090213204110000,2020,98828,434372,533200,MKT
06090213204110000,2019,98828,434372,533200,MKT
06090213204130000,2021,168146,235854,404000,INCOME
06090213204130000,2020,98101,270099,368200,INCOME
06090213204130000,2019,98101,270099,368200,INCOME
06090213204150000,2021,168349,295651,464000,MKT
06090213204150000,2020,98206,307894,406100,MKT
06090213204150000,2019,98206,307894,406100,MKT
06090213204170000,2021,168349,305351,473700,MKT
06090213204170000,2020,98206,321794,420000,MKT
06090213204170000,2019,98206,321794,420000,MKT
06090213204190000,2021,168349,271351,439700,MKT
06090213204190000,2020,98206,311694,409900,MKT
06090213204190000,2019,98206,311694,409900,MKT
06090213204210000,2021,168349,0,168349,COST
06090213204210000,2020,98206,0,98206,COST
06090213204210000,2019,98206,0,98206,COST
06090213204230000,2021,168349,261551,429900,MKT
06090213204230000,2020,98206,279894,378100,MKT
06090213204230000,2019,98206,279894,378100,MKT
06090213204250000,2021,168349,331751,500100,MKT
06090213204250000,2020,98206,366594,464800,MKT
06090213204250000,2019,98206,366594,464800,MKT
06090213205480000,2021,184600,8272070,8456670,COST
06090213205480000,2020,113754,7958970,8072724,COST
06090213205480000,2019,113754,7958970,8072724,COST
06090213205550000,2021,101218,180382,281600,MKT
06090213205550000,2020,66684,134716,201400,MKT
06090213205550000,2019,66684,134716,201400,MKT
06090213205680000,2021,165019,329530,494549,COST
06090213205680000,2020,102495,204470,306965,COST
06090213205680000,2019,102495,204470,306965,COST
06090213205710000,2021,160257,226543,386800,MKT
06090213205710000,2020,99879,142730,242609,COST
06090213205710000,2019,99879,142730,242609,COST
06090213206010000,2021,175412,361788,537200,MKT
06090213206010000,2020,101834,376466,478300,MKT
06090213206010000,2019,101834,376466,478300,MKT
06090213206030000,2021,168552,357048,525600,MKT
06090213206030000,2020,98310,385809,484119,MRA
06090213206030000,2019,98310,385809,484119,MRA
06090213206050000,2021,168146,375754,543900,MKT
06090213206050000,2020,98101,383499,481600,MKT
06090213206050000,2019,98101,383499,481600,MKT
06090213206070000,2021,168146,385554,553700,MKT
06090213206070000,2020,98101,401899,500000,MKT
06090213206070000,2019,98101,401899,500000,MKT
06090213206090000,2021,168146,390454,558600,MKT
06090213206090000,2020,98101,406399,504500,MKT
06090213206090000,2019,98101,406399,504500,MKT
06090213206110000,2021,168146,461154,629300,MKT
06090213206110000,2020,98101,486899,585000,MKT
06090213206110000,2019,98101,486899,585000,MKT
06090213206130000,2021,168146,316954,485100,MKT
06090213206130000,2020,98101,325099,423200,MKT
06090213206130000,2019,98101,325099,423200,MKT
06090213206150000,2021,168146,261754,429900,MKT
06090213206150000,2020,98101,279199,377300,MKT
06090213206150000,2019,98101,279199,377300,MKT
06090213206170000,2021,168552,299848,468400,MKT
06090213206170000,2020,98310,332490,430800,MKT
06090213206170000,2019,98310,332490,430800,MKT
06090213206190000,2021,182045,309355,491400,MKT
06090213206190000,2020,105225,324675,429900,MKT
06090213206190000,2019,105225,324675,429900,MKT
06090213207010000,2021,180676,675770,856446,COST
06090213207010000,2020,104527,733520,838047,COST
06090213207010000,2019,104527,733520,838047,COST
06090213207030000,2021,178755,349145,527900,MKT
06090213207030000,2020,103545,362355,465900,MKT
06090213207030000,2019,103545,362355,465900,MKT
06090213207050000,2021,177147,341053,518200,MKT
06090213207050000,2020,102723,363877,466600,MKT
06090213207050000,2019,102723,363877,466600,MKT
06090213207070000,2021,170154,372146,542300,MKT
06090213207070000,2020,99135,377265,476400,MKT
06090213207070000,2019,99135,377265,476400,MKT
06090213207090000,2021,170253,422347,592600,MKT
06090213207090000,2020,99186,437714,536900,MKT
06090213207090000,2019,99186,437714,536900,MKT
06090213207110000,2021,170253,699080,869333,COST
06090213207110000,2020,99186,750280,849466,COST
06090213207110000,2019,99186,750280,849466,COST
06090213207130000,2021,177687,402113,579800,MKT
06090213207130000,2020,102999,374601,477600,MKT
06090213207130000,2019,102999,374601,477600,MKT
06090213207150000,2021,177776,562163,739939,MRA
06090213207150000,2020,103045,578003,681048,MRA
06090213207150000,2019,103045,578003,681048,MRA
06090213207170000,2021,173258,720550,893808,COST
06090213207170000,2020,100729,778890,879619,COST
06090213207170000,2019,100729,778890,879619,COST
06090213208010000,2021,172782,0,172782,COST
06090213208010000,2020,100485,0,100485,COST
06090213208010000,2019,100485,0,100485,COST
06090213208030000,2021,172877,0,172877,COST
06090213208030000,2020,100534,0,100534,COST
06090213208030000,2019,100534,0,100534,COST
06090213208050000,2021,175412,302788,478200,MKT
06090213208050000,2020,101834,334666,436500,MKT
06090213208050000,2019,101834,334666,436500,MKT
06090213208070000,2021,175042,375958,551000,MKT
06090213208070000,2020,101644,401156,502800,MKT
06090213208070000,2019,101644,401156,502800,MKT
06090213208090000,2021,176330,100690,277020,COST
06090213208090000,2020,102304,111170,213474,COST
06090213208090000,2019,102304,107350,209654,COST
06090213208110000,2021,168552,348548,517100,MKT
06090213208110000,2020,98310,370190,468500,MKT
06090213208110000,2019,98310,376290,474600,MKT
06090213208130000,2021,168754,363246,532000,MKT
06090213208130000,2020,98415,338385,436800,MKT
06090213208130000,2019,98415,338385,436800,MKT
06090213208150000,2021,174202,291098,465300,MKT
06090213208150000,2020,101214,312586,413800,MKT
06090213208150000,2019,101214,312586,413800,MKT
06090213208170000,2021,174390,364610,539000,MKT
06090213208170000,2020,101310,367190,468500,MKT
06090213208170000,2019,101310,367190,468500,MKT
06090213208190000,2021,174202,245898,420100,MKT
06090213208190000,2020,101214,270686,371900,MKT
06090213208190000,2019,101214,270686,371900,MKT
06090213208210000,2021,174202,437898,612100,MKT
06090213208210000,2020,101214,463986,565200,MKT
06090213208210000,2019,101214,463986,565200,MKT
06090213208230000,2021,174202,329198,503400,MKT
06090213208230000,2020,101214,361986,463200,MKT
06090213208230000,2019,101214,361986,463200,MKT
06090213261050000,2021,17460,0,17460,COST
06090213261050000,2020,15180,0,15180,COST
06090213261050000,2019,15180,0,15180,COST
06090213261250000,2021,18652,0,18652,COST
06090213261250000,2020,16191,0,16191,COST
06090213261250000,2019,16191,0,16191,COST
06090213261500000,2021,18644,0,18644,COST
06090213261500000,2020,16184,0,16184,COST
06090213261500000,2019,16184,0,16184,COST
06090213301010000,2021,226384,184800,411184,COST
06090213301010000,2020,135709,230691,366400,MKT
06090213301010000,2019,135709,230691,366400,MKT
06090213301030000,2021,110128,156072,266200,MKT
06090213301030000,2020,71839,181961,253800,MKT
06090213301030000,2019,71839,181961,253800,MKT
06090213301050000,2021,120637,223363,344000,MKT
06090213301050000,2020,77858,217042,294900,MKT
06090213301050000,2019,77858,217042,294900,MKT
06090213301060000,2021,112758,180142,292900,MKT
06090213301060000,2020,73352,191848,265200,MKT
06090213301060000,2019,73352,191848,265200,MKT
06090213301070000,2021,124100,177700,301800,MKT
06090213301070000,2020,79828,202872,282700,MKT
06090213301070000,2019,79828,202872,282700,MKT
06090213301080000,2021,94222,235478,329700,MKT
06090213301080000,2020,62598,239802,302400,MKT
06090213301080000,2019,62598,239802,302400,MKT
06090213301090000,2021,136938,273362,410300,INCOME
06090213301090000,2020,87075,252225,339300,INCOME
06090213301090000,2019,87075,252225,339300,INCOME
06090213301100000,2021,106865,261390,368255,COST
06090213301100000,2020,69957,280920,350877,COST
06090213301100000,2019,64556,201944,266500,MKT
06090213301110000,2021,122784,178016,300800,MKT
06090213301110000,2020,79080,184220,263300,MKT
06090213301110000,2019,79080,184220,263300,MKT
06090213301120000,2021,98973,79900,178873,COST
06090213301120000,2020,65376,87150,152526,COST
06090213301120000,2019,65376,87150,152526,COST
06090213301130000,2021,128122,250178,378300,MKT
06090213301130000,2020,82107,259993,342100,MKT
06090213301130000,2019,82107,259993,342100,MKT
06090213301130900,2021,116138,0,116138,COST
06090213301130900,2020,75289,0,75289,COST
06090213301130900,2019,79000,146900,225900,MKT
06090213301160000,2021,106379,0,106379,COST
06090213301160000,2020,69677,0,69677,COST
06090213301160000,2019,69677,0,69677,COST
06090213301170000,2021,85446,184254,269700,MKT
06090213301170000,2020,57422,183078,240500,MKT
06090213301170000,2019,57422,183078,240500,MKT
06090213301180000,2021,85446,224454,309900,MKT
06090213301180000,2020,57422,207478,264900,MKT
06090213301180000,2019,57422,207478,264900,MKT
06090213301190000,2021,106379,17990,124369,COST
06090213301190000,2020,69677,17250,86927,COST
06090213301190000,2019,69677,17250,86927,COST
06090213301200000,2021,106379,285321,391700,MKT
06090213301200000,2020,69677,264923,334600,MKT
06090213301200000,2019,69677,264923,334600,MKT
06090213301210000,2021,106379,316721,423100,MKT
06090213301210000,2020,69677,335123,404800,MKT
06090213301210000,2019,69677,335123,404800,MKT
06090213301220000,2021,106379,210521,316900,MKT
06090213301220000,2020,69677,229023,298700,MKT
06090213301220000,2019,69677,229023,298700,MKT
06090213301230000,2021,111897,233103,345000,MKT
06090213301230000,2020,72857,229643,302500,MKT
06090213301230000,2019,72857,229643,302500,MKT
06090213301230900,2021,138553,0,138553,COST
06090213301230900,2020,87980,0,87980,COST
06090213301230900,2019,87980,0,87980,COST
06090213301240000,2021,110487,250013,360500,MKT
06090213301240000,2020,72046,258254,330300,MKT
06090213301240000,2019,72046,258254,330300,MKT
06090213301250000,2021,110397,189503,299900,MKT
06090213301250000,2020,71995,171605,243600,MKT
06090213301250000,2019,71995,171605,243600,MKT
06090213301260000,2021,118322,205278,323600,MKT
06090213301260000,2020,76538,188362,264900,MKT
06090213301260000,2019,76538,188362,264900,MKT
06090213301280000,2021,131333,274315,405648,MRA
06090213301280000,2020,83786,222050,305836,COST
06090213301280000,2019,83786,222050,305836,COST
06090213301350000,2021,103250,179650,282900,MKT
06090213301350000,2020,67864,169936,237800,MKT
06090213301350000,2019,67864,169936,237800,MKT
06090213301360000,2021,103354,255746,359100,MKT
06090213301360000,2020,67924,247876,315800,MKT
06090213301360000,2019,67924,187476,255400,MKT
06090213301370000,2021,171550,215250,386800,MKT
06090213301370000,2020,106238,231962,338200,MKT
06090213301370000,2019,106238,231962,338200,MKT
06090213301390000,2021,251601,3319140,3570741,COST
06090213301390000,2020,166936,3229350,3396286,COST
06090213301390000,2019,166936,3229350,3396286,COST
06090213301400000,2021,106379,243921,350300,MKT
06090213301400000,2020,69677,234523,304200,MKT
06090213301400000,2019,69677,234523,304200,MKT
06090213301410000,2021,180132,191968,372100,MKT
06090213301410000,2020,110916,193384,304300,MKT
06090213301410000,2019,110916,193384,304300,MKT
06090213301420000,2021,119902,205298,325200,MKT
06090213301420000,2020,77439,193261,270700,MKT
06090213301420000,2019,77439,193261,270700,MKT
06090213301430000,2021,104588,219912,324500,MKT
06090213301430000,2020,68640,198260,266900,MKT
06090213301430000,2019,68640,198260,266900,MKT
06090213301440000,2021,106379,196421,302800,MKT
06090213301440000,2020,69677,213123,282800,MKT
06090213301440000,2019,69677,213123,282800,MKT
06090213301450000,2021,106379,235821,342200,MKT
06090213301450000,2020,69677,227223,296900,MKT
06090213301450000,2019,69677,227223,296900,MKT
06090213301460000,2021,106379,296321,402700,MKT
06090213301460000,2020,69677,262423,332100,MKT
06090213301460000,2019,69677,262423,332100,MKT
06090213301470000,2021,106379,231221,337600,MKT
06090213301470000,2020,69677,209823,279500,MKT
06090213301470000,2019,69677,209823,279500,MKT
06090213301480000,2021,118551,259649,378200,MKT
06090213301480000,2020,76668,282932,359600,MKT
06090213301480000,2019,76668,282932,359600,MKT
06090213301490000,2021,137156,306244,443400,MKT
06090213301490000,2020,87197,333403,420600,MKT
06090213301490000,2019,87197,333403,420600,MKT
06090213301500000,2021,139761,119360,259121,COST
06090213301500000,2020,88658,53790,142448,COST
06090213301500000,2019,88658,53790,142448,COST
06090213301510000,2021,156845,212555,369400,MKT
06090213301510000,2020,98158,213642,311800,MKT
06090213301510000,2019,98158,213642,311800,MKT
06090213301520000,2021,95617,325083,420700,MKT
06090213301520000,2020,63416,357484,420900,MKT
06090213301520000,2019,63416,357484,420900,MKT
06090213301530000,2021,117630,150070,267700,MKT
06090213301530000,2020,76143,156057,232200,MKT
06090213301530000,2019,76143,156057,232200,MKT
06090213301540000,2021,124168,238232,362400,MKT
06090213301540000,2020,79866,244734,324600,MKT
06090213301540000,2019,79866,244734,324600,MKT
06090213301550000,2021,144612,304288,448900,MKT
06090213301550000,2020,91368,313232,404600,MKT
06090213301550000,2019,91368,282732,374100,MKT
06090213301560000,2021,113351,282749,396100,MKT
06090213301560000,2020,73692,304608,378300,MKT
06090213301560000,2019,73692,304608,378300,MKT
06090213301570000,2021,244610,0,244610,COST
06090213301570000,2020,145310,0,145310,COST
06090213301570000,2019,145310,0,145310,COST
06090213301570900,2021,151101,360099,511200,MKT
06090213301570900,2020,94978,379222,474200,MKT
06090213301570900,2019,94978,379222,474200,MKT
06090213301580000,2021,121074,329026,450100,MKT
06090213301580000,2020,78107,336993,415100,MKT
06090213301580000,2019,78107,336993,415100,MKT
06090213301590000,2021,128754,293746,422500,MKT
06090213301590000,2020,82464,322036,404500,MKT
06090213301590000,2019,82464,322036,404500,MKT
06090213301600000,2021,127931,210769,338700,MKT
06090213301600000,2020,81999,224301,306300,MKT
06090213301600000,2019,81999,224301,306300,MKT
06090213301610000,2021,159198,259702,418900,MKT
06090213301610000,2020,99457,297743,397200,MKT
06090213301610000,2019,99457,297743,397200,MKT
06090213301620000,2021,129812,256688,386500,MKT
06090213301620000,2020,83063,281037,364100,MKT
06090213301620000,2019,83063,281037,364100,MKT
06090213301630000,2021,277885,250180,528065,COST
06090213301630000,2020,162625,262310,424935,COST
06090213301630000,2019,162625,262310,424935,COST
06090213301680000,2021,100110,0,100110,COST
06090213301680000,2020,66039,0,66039,COST
06090213301680000,2019,66039,0,66039,COST
06090213301700000,2021,117630,261470,379100,MKT
06090213301700000,2020,76143,270757,346900,MKT
06090213301700000,2019,76143,270757,346900,MKT
06090213301710000,2021,1198,0,1198,COST
06090213301710000,2020,1115,0,1115,COST
06090213301710000,2019,1115,0,1115,COST
06090213301815001,2021,37776,192624,230400,MKT
06090213301815001,2020,24548,171052,195600,MKT
06090213301815001,2019,24548,171052,195600,MKT
06090213301825002,2021,51723,191777,243500,MKT
06090213301825002,2020,31208,169790,200998,COST
06090213301825002,2019,31208,169790,200998,COST
06090213301835001,2021,33064,236036,269100,MKT
06090213301835001,2020,22172,236110,258282,OVR
06090213301835001,2019,22172,236110,258282,COST
06090213301845002,2021,30702,226598,257300,MKT
06090213301845002,2020,20952,211848,232800,MKT
06090213301845002,2019,20952,211848,232800,MKT
06090213301855001,2021,30568,224232,254800,MKT
06090213301855001,2020,20882,197018,217900,MKT
06090213301855001,2019,20882,197018,217900,MKT
06090213301865002,2021,30568,222232,252800,MKT
06090213301865002,2020,20882,194918,215800,MKT
06090213301865002,2019,20882,194218,215100,MKT
06090213301875001,2021,30568,216432,247000,MKT
06090213301875001,2020,20882,189218,210100,MKT
06090213301875001,2019,20882,189218,210100,MKT
06090213301885002,2021,30568,207232,237800,MKT
06090213301885002,2020,20882,189218,210100,MKT
06090213301885002,2019,20882,189218,210100,MKT
06090213301890000,2021,185350,42650,228000,INCOME
06090213301890000,2020,113748,58552,172300,INCOME
06090213301890000,2019,113748,58552,172300,INCOME
06090213302010000,2021,113267,256533,369800,MKT
06090213302010000,2020,73644,252656,326300,MKT
06090213302010000,2019,73644,252656,326300,MKT
06090213302020000,2021,113351,0,113351,COST
06090213302020000,2020,73692,0,73692,COST
06090213302020000,2019,73692,0,73692,COST
06090213302030000,2021,17561,0,17561,COST
06090213302030000,2020,12342,0,12342,COST
06090213302030000,2019,12342,0,12342,COST
06090213302040000,2021,113267,208033,321300,MKT
06090213302040000,2020,73644,200056,273700,MKT
06090213302040000,2019,73644,200056,273700,MKT
06090213302050000,2021,113267,196933,310200,MKT
06090213302050000,2020,73644,180556,254200,MKT
06090213302050000,2019,73644,180556,254200,MKT
06090213302060000,2021,93702,230098,323800,MKT
06090213302060000,2020,62293,248207,310500,MKT
06090213302060000,2019,62293,248207,310500,MKT
06090213302100000,2021,205171,1810990,2016161,COST
06090213302100000,2020,124420,1704450,1828870,COST
06090213302100000,2019,124420,1704450,1828870,COST
06090213302140000,2021,110038,289862,399900,MKT
06090213302140000,2020,71788,323512,395300,MKT
06090213302140000,2019,71788,323512,395300,MKT
06090213302160000,2021,110038,227362,337400,MKT
06090213302160000,2020,71788,206012,277800,MKT
06090213302160000,2019,71788,206012,277800,MKT
06090213303520000,2021,137481,0,137481,COST
06090213303520000,2020,87380,0,87380,COST
06090213303520000,2019,87380,0,87380,COST
06090213303540000,2021,534,162380,162914,COST
06090213303540000,2020,613,175010,175623,COST
06090213303540000,2019,613,175010,175623,COST
06090213303560000,2021,101218,229682,330900,MKT
06090213303560000,2020,66684,210116,276800,MKT
06090213303560000,2019,66684,210116,276800,MKT
06090213304010000,2021,229321,284390,513711,COST
06090213304010000,2020,137262,306338,443600,MKT
06090213304010000,2019,137262,306338,443600,MKT
06090213305010000,2021,15584,0,15584,COST
06090213305010000,2020,11107,0,11107,COST
06090213305010000,2019,11107,0,11107,COST
06090213305040000,2021,109218,225482,334700,MKT
06090213305040000,2020,71315,208485,279800,MKT
06090213305040000,2019,71315,208485,279800,MKT
06090213305080000,2021,103145,224455,327600,MKT
06090213305080000,2020,67803,210597,278400,MKT
06090213305080000,2019,67803,210597,278400,MKT
06090213305090000,2021,115898,45840,161738,COST
06090213305090000,2020,75152,44910,120062,COST
06090213305090000,2019,75152,44910,120062,COST
06090213305107000,2021,69252,0,69252,COST
06090213305107000,2020,39002,0,39002,COST
06090213305107000,2019,39002,0,39002,COST
06090213305117000,2021,60233,0,60233,COST
06090213305117000,2020,35059,0,35059,COST
06090213305117000,2019,35059,0,35059,COST
06090213305127000,2021,62019,2350,64369,COST
06090213305127000,2020,35850,2440,38290,COST
06090213305127000,2019,35850,2440,38290,COST
06090213305147000,2021,75079,0,75079,COST
06090213305147000,2020,41485,0,41485,COST
06090213305147000,2019,41485,0,41485,COST
06090213305270000,2021,97805,239395,337200,INCOME
06090213305270000,2020,64695,183605,248300,INCOME
06090213305270000,2019,64695,183605,248300,INCOME
06090213305280000,2021,111021,239879,350900,MKT
06090213305280000,2020,72353,239947,312300,MKT
06090213305280000,2019,72353,239947,312300,MKT
06090213305300000,2021,107057,352843,459900,MKT
06090213305300000,2020,70068,338132,408200,MKT
06090213305300000,2019,70068,338132,408200,MKT
06090213305520000,2021,120637,517100,637737,COST
06090213305520000,2020,77858,560600,638458,COST
06090213305520000,2019,77858,455990,533848,OVR
06090213306010000,2021,100667,252633,353300,MKT
06090213306010000,2020,66364,262136,328500,MKT
06090213306010000,2019,66364,262136,328500,MKT
06090213306030000,2021,101218,238182,339400,MKT
06090213306030000,2020,66684,232416,299100,MKT
06090213306030000,2019,66684,232416,299100,MKT
06090213306050000,2021,94092,251108,345200,INCOME
06090213306050000,2020,62522,275778,338300,INCOME
06090213306050000,2019,62522,275778,338300,INCOME
06090213306070000,2021,94092,224308,318400,MKT
06090213306070000,2020,62522,191678,254200,MKT
06090213306070000,2019,62522,191678,254200,MKT
06090213306090000,2021,97805,233595,331400,MKT
06090213306090000,2020,64695,234305,299000,MKT
06090213306090000,2019,64695,234305,299000,MKT
06090213306110000,2021,108291,242209,350500,MKT
06090213306110000,2020,70781,247519,318300,MKT
06090213306110000,2019,70781,247519,318300,MKT
06090213306130000,2021,98393,0,98393,COST
06090213306130000,2020,65038,0,65038,COST
06090213306130000,2019,65038,0,65038,COST
06090213306150000,2021,109947,269353,379300,MKT
06090213306150000,2020,71735,267865,339600,MKT
06090213306150000,2019,71735,267865,339600,MKT
06090213306600000,2021,127931,251469,379400,MKT
06090213306600000,2020,81999,260101,342100,MKT
06090213306600000,2019,81999,260101,342100,MKT
06090213310010000,2021,124737,160663,285400,MKT
06090213310010000,2020,66731,66380,133111,COST
06090213310010000,2019,66731,66140,132871,COST
06090213310030000,2021,110932,245268,356200,MKT
06090213310030000,2020,72302,247598,319900,MKT
06090213310030000,2019,72302,247598,319900,MKT
06090213310050000,2021,111984,0,111984,COST
06090213310050000,2020,60769,0,60769,COST
06090213310050000,2019,60769,0,60769,COST
06090213310070000,2021,112275,201725,314000,MKT
06090213310070000,2020,76379,258010,334389,COST
06090213310070000,2019,76379,258010,334389,COST
06090213310096500,2021,39293,0,39293,COST
06090213310096500,2020,25127,0,25127,COST
06090213310096500,2019,25127,0,25127,COST
06090213310110000,2021,111577,142523,254100,MKT
06090213310110000,2020,60476,85700,146176,COST
06090213310110000,2019,60476,85700,146176,COST
06090213310130000,2021,127067,190433,317500,MKT
06090213310130000,2020,67830,157320,225150,COST
06090213310130000,2019,67830,157320,225150,COST
06090213311010000,2021,110487,18050,128537,COST
06090213311010000,2020,60051,18410,78461,COST
06090213311010000,2019,60051,18410,78461,COST
06090213311030000,2021,103975,220,104195,COST
06090213311030000,2020,56916,210,57126,COST
06090213311030000,2019,56916,210,57126,COST
06090213311050000,2021,109510,180690,290200,MKT
06090213311050000,2020,59486,149300,208786,COST
06090213311050000,2019,59486,149300,208786,COST
06090213311070000,2021,102830,8490,111320,COST
06090213311070000,2020,56362,8670,65032,COST
06090213311070000,2019,56362,8670,65032,COST
06090213311096500,2021,31827,0,31827,COST
06090213311096500,2020,20862,0,20862,COST
06090213311096500,2019,20862,0,20862,COST
06090213311110000,2021,106574,620,107194,COST
06090213311110000,2020,58170,660,58830,COST
06090213311110000,2019,58170,660,58830,COST
06090213311130000,2021,115657,297443,413100,MKT
06090213311130000,2020,75014,236586,311600,MKT
06090213311130000,2019,75014,236586,311600,MKT
06090213311150000,2021,108770,245830,354600,MKT
06090213311150000,2020,59131,202000,261131,COST
06090213311150000,2019,59131,202000,261131,COST
06090213311170000,2021,104166,178434,282600,MKT
06090213311170000,2020,56916,126280,183196,COST
06090213311170000,2019,56916,126280,183196,COST
06090213311190000,2021,104166,185934,290100,MKT
06090213311190000,2020,56916,165130,222046,COST
06090213311190000,2019,56916,165130,222046,COST
06090213311210000,2021,108664,228536,337200,MKT
06090213311210000,2020,70996,231704,302700,MKT
06090213311210000,2019,70996,231704,302700,MKT
06090213311230000,2021,119753,29420,149173,COST
06090213311230000,2020,64476,29570,94046,COST
06090213311230000,2019,64476,29570,94046,COST
06090213311250000,2021,101512,154288,255800,MKT
06090213311250000,2020,55635,109080,164715,COST
06090213311250000,2019,55635,109080,164715,COST
06090213311270000,2021,116589,180311,296900,MKT
06090213311270000,2020,62868,133280,196148,COST
06090213311270000,2019,62868,133280,196148,COST
06090213311290000,2021,104588,1570,106158,COST
06090213311290000,2020,57212,1620,58832,COST
06090213311290000,2019,57212,1620,58832,COST
06090213312010000,2021,98973,161227,260200,MKT
06090213312010000,2020,65376,141724,207100,MKT
06090213312010000,2019,65376,141724,207100,MKT
06090213312020000,2021,98973,207627,306600,MKT
06090213312020000,2020,65376,176424,241800,MKT
06090213312020000,2019,65376,176424,241800,MKT
06090213312040000,2021,107345,240455,347800,MKT
06090213312040000,2020,70235,244065,314300,MKT
06090213312040000,2019,70235,244065,314300,MKT
06090213312060000,2021,107345,240955,348300,MKT
06090213312060000,2020,70235,200265,270500,MKT
06090213312060000,2019,70235,200265,270500,MKT
06090213312080000,2021,115253,206747,322000,MKT
06090213312080000,2020,74783,194517,269300,MKT
06090213312080000,2019,74783,194517,269300,MKT
06090213312110000,2021,103354,179246,282600,MKT
06090213312110000,2020,67924,181976,249900,MKT
06090213312110000,2019,67924,181976,249900,MKT
06090213312120000,2021,103354,229846,333200,MKT
06090213312120000,2020,67924,215976,283900,MKT
06090213312120000,2019,67924,215976,283900,MKT
06090213312130000,2021,102299,158301,260600,MKT
06090213312130000,2020,67312,166788,234100,MKT
06090213312130000,2019,67312,166788,234100,MKT
06090213312140000,2021,102299,259201,361500,MKT
06090213312140000,2020,67312,265288,332600,MKT
06090213312140000,2019,67312,265288,332600,MKT
06090213324020000,2021,90719,368681,459400,MKT
06090213324020000,2020,60539,409280,469819,COST
06090213324020000,2019,60539,409280,469819,COST
06090213324040000,2021,90859,250541,341400,MKT
06090213324040000,2020,60622,256978,317600,MKT
06090213324040000,2019,60622,256978,317600,MKT
06090213324060000,2021,93043,333557,426600,MKT
06090213324060000,2020,61907,353293,415200,MKT
06090213324060000,2019,61907,353293,415200,MKT
06090213324080000,2021,90719,0,90719,COST
06090213324080000,2020,60539,0,60539,COST
06090213324080000,2019,60539,0,60539,COST
06090213324100000,2021,90859,311141,402000,MKT
06090213324100000,2020,60622,329678,390300,MKT
06090213324100000,2019,60622,329678,390300,MKT
06090213324120000,2021,98393,234407,332800,MKT
06090213324120000,2020,65038,244962,310000,MKT
06090213324120000,2019,65038,244962,310000,MKT
06090213325010000,2021,94092,263508,357600,MKT
06090213325010000,2020,62522,274178,336700,MKT
06090213325010000,2019,62522,274178,336700,MKT
06090213325030000,2021,94092,239408,333500,MKT
06090213325030000,2020,62522,243178,305700,MKT
06090213325030000,2019,62522,243178,305700,MKT
06090213328010000,2021,86087,262513,348600,MKT
06090213328010000,2020,57802,264098,321900,MKT
06090213328010000,2019,57802,264098,321900,MKT
06090213328030000,2021,87643,260557,348200,MKT
06090213328030000,2020,58724,261576,320300,MKT
06090213328030000,2019,58724,261576,320300,MKT
06090213328050000,2021,87643,245057,332700,MKT
06090213328050000,2020,58724,244876,303600,MKT
06090213328050000,2019,58724,244876,303600,MKT
06090213328070000,2021,93963,0,93963,COST
06090213328070000,2020,62446,0,62446,COST
06090213328070000,2019,62446,0,62446,COST
06090213328090000,2021,92373,311127,403500,MKT
06090213328090000,2020,61513,285587,347100,MKT
06090213328090000,2019,61513,285587,347100,MKT
06090213328110000,2021,89864,270936,360800,MKT
06090213328110000,2020,60036,273564,333600,MKT
06090213328110000,2019,60036,273564,333600,MKT
06090213330010000,2021,95367,234333,329700,MKT
06090213330010000,2020,63269,243231,306500,MKT
06090213330010000,2019,63269,243231,306500,MKT
06090213330030000,2021,89576,241424,331000,MKT
06090213330030000,2020,59865,245935,305800,MKT
06090213330030000,2019,59865,245935,305800,MKT
06090213330050000,2021,89138,327262,416400,MKT
06090213330050000,2020,59607,304893,364500,MKT
06090213330050000,2019,59607,304893,364500,MKT
06090213330070000,2021,89138,221962,311100,MKT
06090213330070000,2020,59607,227893,287500,MKT
06090213330070000,2019,59607,227893,287500,MKT
06090213330090000,2021,88991,371209,460200,MKT
06090213330090000,2020,59520,381180,440700,MKT
06090213330090000,2019,59520,381180,440700,MKT
06090213330110000,2021,90294,320306,410600,MKT
06090213330110000,2020,60289,307411,367700,MKT
06090213330110000,2019,60289,307411,367700,MKT
06090213330130000,2021,95367,320733,416100,MKT
06090213330130000,2020,63269,343531,406800,MKT
06090213330130000,2019,63269,343531,406800,MKT
06090213333010000,2021,86245,292755,379000,MKT
06090213333010000,2020,57896,290604,348500,MKT
06090213333010000,2019,57896,290604,348500,MKT
06090213333030000,2021,86403,273697,360100,MKT
06090213333030000,2020,57990,267010,325000,MKT
06090213333030000,2019,57990,267010,325000,MKT
06090213333050000,2021,85121,259079,344200,MKT
06090213333050000,2020,57230,263770,321000,MKT
06090213333050000,2019,57230,263770,321000,MKT
06090213333070000,2021,90294,332406,422700,MKT
06090213333070000,2020,60289,342511,402800,MKT
06090213333070000,2019,60289,342511,402800,MKT
06090213333090000,2021,87643,0,87643,COST
06090213333090000,2020,58724,0,58724,COST
06090213333090000,2019,58724,0,58724,COST
06090213333106500,2021,51086,0,51086,COST
06090213333106500,2020,31678,0,31678,COST
06090213333106500,2019,31678,0,31678,COST
06090213333110000,2021,89430,287570,377000,MKT
06090213333110000,2020,59780,293920,353700,MKT
06090213333110000,2019,59780,293920,353700,MKT
06090213333130000,2021,89576,246024,335600,MKT
06090213333130000,2020,59865,237635,297500,MKT
06090213333130000,2019,59865,237635,297500,MKT
06090213333150000,2021,89864,0,89864,COST
06090213333150000,2020,60036,0,60036,COST
06090213333150000,2019,60036,0,60036,COST
06090213333170000,2021,89138,0,89138,COST
06090213333170000,2020,59607,0,59607,COST
06090213333170000,2019,59607,0,59607,COST
06090213333190000,2021,92102,331198,423300,MKT
06090213333190000,2020,61354,352146,413500,MKT
06090213333190000,2019,61354,352146,413500,MKT
06090213333210000,2021,89284,0,89284,COST
06090213333210000,2020,59694,0,59694,COST
06090213333210000,2019,59694,0,59694,COST
06090213333230000,2021,87947,0,87947,COST
06090213333230000,2020,58903,0,58903,COST
06090213333230000,2019,58903,0,58903,COST
06090213333250000,2021,91829,281471,373300,MKT
06090213333250000,2020,61193,294607,355800,MKT
06090213333250000,2019,61193,294607,355800,MKT
06090213335010000,2021,95367,357033,452400,MKT
06090213335010000,2020,63269,366831,430100,MKT
06090213335010000,2019,63269,366831,430100,MKT
06090213335030000,2021,95115,245685,340800,MKT
06090213335030000,2020,63122,257378,320500,MKT
06090213335030000,2019,63122,257378,320500,MKT
06090213335050000,2021,95115,227485,322600,MKT
06090213335050000,2020,63122,235678,298800,MKT
06090213335050000,2019,63122,235678,298800,MKT
06090213335070000,2021,94989,268611,363600,MKT
06090213335070000,2020,63048,276852,339900,MKT
06090213335070000,2019,63048,276852,339900,MKT
06090213335090000,2021,95241,276559,371800,MKT
06090213335090000,2020,63196,286304,349500,MKT
06090213335090000,2019,63196,286304,349500,MKT
06090213335110000,2021,95241,290259,385500,MKT
06090213335110000,2020,63196,295904,359100,MKT
06090213335110000,2019,63196,295904,359100,MKT
06090213335130000,2021,95115,256185,351300,MKT
06090213335130000,2020,63122,255878,319000,MKT
06090213335130000,2019,63122,255878,319000,MKT
06090213335150000,2021,95115,261985,357100,MKT
06090213335150000,2020,63122,268478,331600,MKT
06090213335150000,2019,63122,268478,331600,MKT
06090213335170000,2021,95115,286685,381800,MKT
06090213335170000,2020,63122,289378,352500,MKT
06090213335170000,2019,63122,289378,352500,MKT
06090213335190000,2021,95367,277533,372900,MKT
06090213335190000,2020,63269,272731,336000,MKT
06090213335190000,2019,63269,272731,336000,MKT
06090213401010000,2021,148800,285600,434400,MKT
06090213401010000,2020,93700,347330,441030,COST
06090213401010000,2019,93700,296550,390250,COST
06090213401020000,2021,181966,269534,451500,MKT
06090213401020000,2020,111913,280087,392000,MKT
06090213401020000,2019,111913,280087,392000,MKT
06090213401040000,2021,127051,653450,780501,COST
06090213401040000,2020,173916,660970,834886,COST
06090213401040000,2019,173916,660970,834886,COST
06090213401150000,2021,144275,0,144275,COST
06090213401150000,2020,91180,0,91180,COST
06090213401150000,2019,91180,0,91180,COST
06090213401250000,2021,168231,478869,647100,MKT
06090213401250000,2020,104422,534182,638604,MRA
06090213401250000,2019,104422,534182,638604,MRA
06090213402010000,2021,43772,0,43772,COST
06090213402010000,2020,27639,0,27639,COST
06090213402010000,2019,27639,0,27639,COST
06090214101010000,2021,2756,0,2756,COST
06090214101010000,2020,2565,0,2565,COST
06090214101010000,2019,2565,0,2565,COST
06090214101050000,2021,2041,221260,223301,COST
06090214101050000,2020,10225,0,10225,COST
06090214101050000,2019,10225,0,10225,COST
06090214101100000,2021,27796,0,27796,COST
06090214101100000,2020,11983,0,11983,COST
06090214101100000,2019,11983,0,11983,COST
06090214101150000,2021,28376,0,28376,COST
06090214101150000,2020,22639,0,22639,COST
06090214101150000,2019,22639,0,22639,COST
06090214101340000,2021,2050,169940,171990,COST
06090214101340000,2020,139812,405120,544932,COST
06090214101340000,2019,139812,405120,544932,COST
06090214101360000,2021,108664,129936,238600,MKT
06090214101360000,2020,70996,110104,181100,MKT
06090214101360000,2019,70996,110104,181100,MKT
06090214101370000,2021,89138,145062,234200,MKT
06090214101370000,2020,59607,138693,198300,MKT
06090214101370000,2019,59607,138693,198300,MKT
06090214101390000,2021,142856,481244,624100,INCOME
06090214101390000,2020,90388,448740,539128,COST
06090214101390000,2019,90388,448740,539128,COST
06090214101400000,2021,133629,224271,357900,MKT
06090214101400000,2020,85215,226385,311600,MKT
06090214101400000,2019,85215,226385,311600,MKT
06090214101410000,2021,119902,242198,362100,MKT
06090214101410000,2020,77439,254761,332200,MKT
06090214101410000,2019,77439,254761,332200,MKT
06090214101420000,2021,142209,214091,356300,MKT
06090214101420000,2020,90027,213273,303300,MKT
06090214101420000,2019,90027,213273,303300,MKT
06090214101430000,2021,145091,150909,296000,MKT
06090214101430000,2020,91635,129065,220700,MKT
06090214101430000,2019,91635,129065,220700,MKT
06090214101440000,2021,151014,155886,306900,MKT
06090214101440000,2020,94930,163170,258100,MKT
06090214101440000,2019,94930,163170,258100,MKT
06090214101460000,2021,81883,0,81883,COST
06090214101460000,2020,55304,0,55304,COST
06090214101460000,2019,55304,0,55304,COST
06090214101500000,2021,287219,3901170,4188389,COST
06090214101500000,2020,167438,3719190,3886628,COST
06090214101500000,2019,167438,3719190,3886628,COST
06090214101950000,2021,148800,1133200,1282000,INCOME
06090214101950000,2020,93700,1083700,1177400,INCOME
06090214101950000,2019,93700,1083700,1177400,INCOME
06090214102010000,2021,139239,0,139239,COST
06090214102010000,2020,88365,0,88365,COST
06090214102010000,2019,88365,0,88365,COST
06090214102030000,2021,121793,405207,527000,MKT
06090214102030000,2020,78516,462300,540816,COST
06090214102030000,2019,78516,0,78516,COST
06090214102050000,2021,117553,0,117553,COST
06090214102050000,2020,76098,0,76098,COST
06090214102050000,2019,76098,0,76098,COST
06090214102070000,2021,117553,0,117553,COST
06090214102070000,2020,76098,0,76098,COST
06090214102070000,2019,76098,0,76098,COST
06090214102090000,2021,117553,0,117553,COST
06090214102090000,2020,76098,0,76098,COST
06090214102090000,2019,76098,0,76098,COST
06090214102110000,2021,117553,324380,441933,COST
06090214102110000,2020,76098,0,76098,COST
06090214102110000,2019,76098,0,76098,COST
06090214102130000,2021,117553,0,117553,COST
06090214102130000,2020,76098,0,76098,COST
06090214102130000,2019,76098,0,76098,COST
06090214102150000,2021,117553,0,117553,COST
06090214102150000,2020,76098,0,76098,COST
06090214102150000,2019,76098,0,76098,COST
06090214102170000,2021,117553,465447,583000,MKT
06090214102170000,2020,76098,601060,677158,COST
06090214102170000,2019,76098,0,76098,COST
06090214102190000,2021,124373,581800,706173,COST
06090214102190000,2020,79983,327010,406993,COST
06090214102190000,2019,79983,0,79983,COST
06090214103010000,2021,130548,0,130548,COST
06090214103010000,2020,83478,0,83478,COST
06090214103010000,2019,83478,0,83478,COST
06090214103030000,2021,121864,0,121864,COST
06090214103030000,2020,78557,0,78557,COST
06090214103030000,2019,78557,0,78557,COST
06090214103050000,2021,121001,295910,416911,COST
06090214103050000,2020,78065,0,78065,COST
06090214103050000,2019,78065,0,78065,COST
06090214103070000,2021,121001,0,121001,COST
06090214103070000,2020,78065,0,78065,COST
06090214103070000,2019,78065,0,78065,COST
06090214103090000,2021,121001,369699,490700,MKT
06090214103090000,2020,78065,335810,413875,COST
06090214103090000,2019,78065,0,78065,COST
06090214103110000,2021,121001,0,121001,COST
06090214103110000,2020,78065,0,78065,COST
06090214103110000,2019,78065,0,78065,COST
06090214103130000,2021,121001,367199,488200,MKT
06090214103130000,2020,78065,0,78065,COST
06090214103130000,2019,78065,0,78065,COST
06090214103150000,2021,121001,0,121001,COST
06090214103150000,2020,78065,0,78065,COST
06090214103150000,2019,78065,0,78065,COST
06090214103170000,2021,121001,0,121001,COST
06090214103170000,2020,78065,0,78065,COST
06090214103170000,2019,78065,0,78065,COST
06090214103190000,2021,128375,489825,618200,MKT
06090214103190000,2020,82250,596930,679180,COST
06090214103190000,2019,82250,0,82250,COST
06090214103216500,2021,64900,0,64900,COST
06090214103216500,2020,39130,0,39130,COST
06090214103216500,2019,39130,0,39130,COST
06090214103240000,2021,149650,0,149650,COST
06090214103240000,2020,52,0,52,COST
06090214103240000,2019,94172,0,94172,COST
06090214103300000,2021,150049,0,150049,COST
06090214103300000,2020,53,0,53,COST
06090214103300000,2019,94394,0,94394,COST
06090214104010000,2021,229,0,229,COST
06090214104010000,2020,213,0,213,COST
06090214104010000,2019,213,0,213,COST
06090214105010000,2021,207,0,207,COST
06090214105010000,2020,193,0,193,COST
06090214105010000,2019,193,0,193,COST
06090214201010000,2021,125967,56720,182687,COST
06090214201010000,2020,172226,59420,231646,COST
06090214201010000,2019,172226,59420,231646,COST
06090214201020000,2021,112758,202942,315700,MKT
06090214201020000,2020,73352,183748,257100,MKT
06090214201020000,2019,73352,183748,257100,MKT
06090214201030000,2021,142209,220791,363000,MKT
06090214201030000,2020,90027,173773,263800,MKT
06090214201030000,2019,90027,173773,263800,MKT
06090214201040000,2021,162584,255216,417800,MKT
06090214201040000,2020,101322,279178,380500,MKT
06090214201040000,2019,101322,279178,380500,MKT
06090214201050000,2021,247215,197790,445005,COST
06090214201050000,2020,146675,229025,375700,MKT
06090214201050000,2019,146675,229025,375700,MKT
06090214201060000,2021,151405,198695,350100,MKT
06090214201060000,2020,95146,234054,329200,MKT
06090214201060000,2019,95146,234054,329200,MKT
06090214201070000,2021,288696,347970,636666,COST
06090214201070000,2020,168198,364970,533168,COST
06090214201070000,2019,168198,364970,533168,COST
06090214208010000,2021,142159,23590,165749,COST
06090214208010000,2020,89999,24820,114819,COST
06090214208010000,2019,89999,24820,114819,COST
06090214208020000,2021,109218,217582,326800,MKT
06090214208020000,2020,71315,178685,250000,OVR
06090214208020000,2019,71315,178685,250000,MKT
06090214208030000,2021,97805,213795,311600,MKT
06090214208030000,2020,64695,206805,271500,MKT
06090214208030000,2019,64695,206805,271500,MKT
06090214208040000,2021,98742,250,98992,COST
06090214208040000,2020,65242,260,65502,COST
06090214208040000,2019,65242,260,65502,COST
06090214208050000,2021,97805,135495,233300,MKT
06090214208050000,2020,64695,143105,207800,MKT
06090214208050000,2019,64695,143105,207800,MKT
06090214208070000,2021,108291,182909,291200,MKT
06090214208070000,2020,70781,152419,223200,MKT
06090214208070000,2019,70781,152419,223200,MKT
06090214208090000,2021,135726,86970,222696,COST
06090214208090000,2020,86394,94130,180524,COST
06090214208090000,2019,86394,94130,180524,COST
06090214215012004,2021,87795,0,87795,COST
06090214215012004,2020,58814,0,58814,COST
06090214215012004,2019,58814,0,58814,COST
06090214215022000,2021,100445,0,100445,COST
06090214215022000,2020,66234,0,66234,COST
06090214215022000,2019,66234,0,66234,COST
06090214215032000,2021,90719,0,90719,COST
06090214215032000,2020,60539,0,60539,COST
06090214215032000,2019,60539,0,60539,COST
06090214215042000,2021,107820,0,107820,COST
06090214215042000,2020,70509,0,70509,COST
06090214215042000,2019,70509,0,70509,COST
06090214215052000,2021,95367,0,95367,COST
06090214215052000,2020,63269,0,63269,COST
06090214215052000,2019,63269,0,63269,COST
06090214215062000,2021,78320,0,78320,COST
06090214215062000,2020,53174,0,53174,COST
06090214215062000,2019,53174,0,53174,COST
06090214224010000,2021,177447,321453,498900,MKT
06090214224010000,2020,109455,339045,448500,MKT
06090214224010000,2019,109455,339045,448500,MKT
06090214301010000,2021,43131,0,43131,COST
06090214301010000,2020,392,0,392,COST
06090214301010000,2019,392,0,392,COST
06090214302010000,2021,21718,792210,813928,COST
06090214302010000,2020,30527,844390,874917,COST
06090214302010000,2019,30527,844390,874917,COST
06090214302050000,2021,220742,313410,534152,COST
06090214302050000,2020,132719,336940,469659,COST
06090214302050000,2019,132719,336940,469659,COST
06090214306010000,2021,107345,209655,317000,MKT
06090214306010000,2020,70235,184265,254500,MKT
06090214306010000,2019,70235,184265,254500,MKT
06090214306020000,2021,112758,217842,330600,MKT
06090214306020000,2020,73352,212548,285900,MKT
06090214306020000,2019,73352,212548,285900,MKT
06090214306030000,2021,110128,244872,355000,MKT
06090214306030000,2020,71839,251761,323600,MKT
06090214306030000,2019,71839,251761,323600,MKT
06090214306040000,2021,108291,0,108291,COST
06090214306040000,2020,70781,0,70781,COST
06090214306040000,2019,70781,0,70781,COST
06090214306050000,2021,108291,233809,342100,MKT
06090214306050000,2020,70781,219019,289800,MKT
06090214306050000,2019,70781,219019,289800,MKT
06090214306060000,2021,108291,254109,362400,MKT
06090214306060000,2020,70781,265719,336500,MKT
06090214306060000,2019,70781,265719,336500,MKT
06090214306070000,2021,108291,206709,315000,MKT
06090214306070000,2020,70781,198819,269600,MKT
06090214306070000,2019,70781,198819,269600,MKT
06090214306080000,2021,108291,246509,354800,MKT
06090214306080000,2020,70781,229719,300500,MKT
06090214306080000,2019,70781,229719,300500,MKT
06090214306090000,2021,108291,188909,297200,MKT
06090214306090000,2020,70781,174819,245600,MKT
06090214306090000,2019,70781,174819,245600,MKT
06090214306100000,2021,108291,169109,277400,MKT
06090214306100000,2020,70781,182219,253000,MKT
06090214306100000,2019,70781,172419,243200,MKT
06090214306110000,2021,108291,203409,311700,MKT
06090214306110000,2020,70781,199719,270500,MKT
06090214306110000,2019,70781,199719,270500,MKT
06090214306120000,2021,108291,196409,304700,MKT
06090214306120000,2020,70781,192819,263600,MKT
06090214306120000,2019,70781,192819,263600,MKT
06090214306130000,2021,108291,196009,304300,MKT
06090214306130000,2020,70781,201319,272100,MKT
06090214306130000,2019,70781,201319,272100,MKT
06090214306140000,2021,108291,224209,332500,MKT
06090214306140000,2020,70781,226119,296900,MKT
06090214306140000,2019,70781,226119,296900,MKT
06090214306150000,2021,108291,235009,343300,MKT
06090214306150000,2020,70781,231519,302300,MKT
06090214306150000,2019,70781,231519,302300,MKT
06090214306160000,2021,108291,219309,327600,MKT
06090214306160000,2020,70781,197019,267800,MKT
06090214306160000,2019,70781,196319,267100,MKT
06090214306170000,2021,108291,195309,303600,MKT
06090214306170000,2020,70781,215319,286100,OVR
06090214306170000,2019,70781,215319,286100,MKT
06090214306200000,2021,162584,16310,178894,COST
06090214306200000,2020,101322,16840,118162,COST
06090214306200000,2019,101322,16840,118162,COST
06090214306210000,2021,180997,222103,403100,MKT
06090214306210000,2020,111386,218014,329400,MKT
06090214306210000,2019,111386,218014,329400,MKT
06090214306220000,2021,108395,162005,270400,MKT
06090214306220000,2020,70727,75720,146447,COST
06090214306220000,2019,70727,75720,146447,COST
06090214306230000,2021,107541,72210,179751,COST
06090214306230000,2020,70509,48300,118809,COST
06090214306230000,2019,70509,48300,118809,COST
06090214306250000,2021,108291,0,108291,COST
06090214306250000,2020,70781,0,70781,COST
06090214306250000,2019,70781,0,70781,COST
06090214306260000,2021,121362,164638,286000,MKT
06090214306260000,2020,78271,187329,265600,MKT
06090214306260000,2019,78271,187329,265600,MKT
06090214306280000,2021,291942,181680,473622,COST
06090214306280000,2020,77858,191020,268878,COST
06090214306280000,2019,77858,191020,268878,COST
06090214306290000,2021,160723,0,160723,COST
06090214306290000,2020,100297,0,100297,COST
06090214306290000,2019,100297,0,100297,COST
06090214306320000,2021,217228,153660,370888,COST
06090214306320000,2020,130853,171547,302400,MKT
06090214306320000,2019,130853,171547,302400,MKT
06090214320350000,2021,148845,301355,450200,MKT
06090214320350000,2020,93725,323175,416900,MKT
06090214320350000,2019,93725,323175,416900,MKT
06090214401010000,2021,48761,0,48761,COST
06090215101010000,2021,9352,768780,778132,COST
06090215101010000,2020,10977,733110,744087,COST
06090215101010000,2019,10977,733110,744087,COST
06090215101020000,2021,193589,329510,523099,COST
06090215101020000,2020,137199,318201,455400,MKT
06090215101020000,2019,137199,318201,455400,MKT
06090215101100000,2021,1873,286270,288143,COST
06090215101100000,2020,2150,260200,262350,COST
06090215101100000,2019,2150,260200,262350,COST
06090215101200000,2021,25465,0,25465,COST
06090215101200000,2020,34958,0,34958,COST
06090215101200000,2019,34958,0,34958,COST
06090215201010000,2021,32415,0,32415,COST
06090215201010000,2020,44395,0,44395,COST
06090215201010000,2019,44395,0,44395,COST
06090215301010000,2021,43727,529260,572987,COST
06090215301010000,2020,59470,475760,535230,COST
06090215301010000,2019,59470,475760,535230,COST
06090215401010000,2021,33708,603230,636938,COST
06090215401010000,2020,29747,535030,564777,COST
06090215401010000,2019,29747,535030,564777,COST
06090216101010000,2021,154507,168240,322747,COST
06090216101010000,2020,90186,0,90186,COST
06090216101010000,2019,90186,0,90186,COST
06090216201010000,2021,268351,0,268351,COST
06090216201010000,2020,286719,0,286719,COST
06090216201010000,2019,286719,0,286719,COST
06090217101010000,2021,76844,466550,543394,COST
06090217101010000,2020,23923,379990,403913,COST
06090217101010000,2019,23923,379990,403913,COST
06090217101050000,2021,31658,0,31658,COST
06090217101050000,2020,33403,0,33403,COST
06090217101050000,2019,33403,0,33403,COST
06090217101150000,2021,19151,94930,114081,COST
06090217101150000,2020,20206,32770,52976,COST
06090217101150000,2019,20206,32770,52976,COST
06090217201010000,2021,125146,0,125146,COST
06090217201010000,2020,131958,0,131958,COST
06090217201010000,2019,131958,0,131958,COST
06090217401010000,2021,77937,0,77937,COST
06090217401010000,2020,82235,0,82235,COST
06090217401010000,2019,82235,0,82235,COST
06090218101010000,2021,60157,0,60157,COST
06090218101010000,2020,63400,0,63400,COST
06090218101010000,2019,63400,0,63400,COST
06090218101030000,2021,99609,10030,109639,COST
06090218101030000,2020,105017,9800,114817,COST
06090218101030000,2019,105017,9800,114817,COST
06090218101060000,2021,18757,12910,31667,COST
06090218101060000,2020,19695,12370,32065,COST
06090218101060000,2019,19695,12370,32065,COST
06090218201010000,2021,57408,0,57408,COST
06090218201010000,2020,60542,0,60542,COST
06090218201010000,2019,60542,0,60542,COST
06090219101010000,2021,125007,26540,151547,COST
06090219101010000,2020,131873,25600,157473,COST
06090219101010000,2019,131873,25600,157473,COST
06090219101250000,2021,157644,0,157644,COST
06090219101250000,2020,166263,0,166263,COST
06090219101250000,2019,166263,0,166263,COST
06090220101010000,2021,62677,0,62677,COST
06090220101010000,2020,66124,0,66124,COST
06090220101010000,2019,66124,0,66124,COST
06090220201010000,2021,97113,0,97113,COST
06090220201010000,2020,102482,0,102482,COST
06090220201010000,2019,102482,0,102482,COST
06090220301010000,2021,62487,0,62487,COST
06090220301010000,2020,65790,0,65790,COST
06090220301010000,2019,65790,0,65790,COST
06090220401010000,2021,58852,310940,369792,COST
06090220401010000,2020,62056,253020,315076,COST
06090220401010000,2019,62056,253020,315076,COST
06090221101010000,2021,7777,0,7777,COST
06090221101010000,2020,7238,0,7238,COST
06090221101010000,2019,7238,0,7238,COST
06090221104010000,2021,1113,0,1113,COST
06090221104010000,2020,1036,0,1036,COST
06090221104010000,2019,1036,0,1036,COST
06090221104100000,2021,324,0,324,COST
06090221104100000,2020,341,0,341,COST
06090221104100000,2019,341,0,341,COST
06090221201010000,2021,7857,16250,24107,COST
06090221201010000,2020,7312,15690,23002,COST
06090221201010000,2019,7312,15690,23002,COST
06090221204010000,2021,1125,0,1125,COST
06090221204010000,2020,1047,0,1047,COST
06090221204010000,2019,1047,0,1047,COST
06090221301010000,2021,89624,0,89624,COST
06090221301010000,2020,94114,0,94114,COST
06090221301010000,2019,94114,0,94114,COST
06090222101010000,2021,21115,0,21115,COST
06090222101010000,2020,23421,0,23421,COST
06090222101010000,2019,23421,0,23421,COST
06090222101040000,2021,66916,417190,484106,COST
06090222101040000,2020,89722,374260,463982,COST
06090222101040000,2019,31851,374260,406111,COST
06090222201010000,2021,136268,0,136268,COST
06090222201010000,2020,186394,0,186394,COST
06090222201010000,2019,246759,0,246759,COST
06090222201300000,2021,441157,0,441157,COST
06090222201300000,2020,383937,0,383937,COST
06090222201300000,2019,383937,0,383937,COST
06090222301010000,2021,3446,343070,346516,COST
06090222301010000,2020,3616,304760,308376,COST
06090222301010000,2019,3616,304760,308376,COST
06090222401010000,2021,2033,0,2033,COST
06090222401010000,2020,1887,0,1887,COST
06090222401010000,2019,1887,0,1887,COST
06090222401020000,2021,350531,231310,581841,COST
06090222401020000,2020,204373,206800,411173,COST
06090222401020000,2019,204373,206800,411173,COST
06090222401030000,2021,243434,161766,405200,MKT
06090222401030000,2020,158661,132720,291381,COST
06090222401030000,2019,158661,132720,291381,COST
06090223101010000,2021,374842,53120,427962,COST
06090223101010000,2020,504405,50740,555145,COST
06090223101010000,2019,504405,50740,555145,COST
06090223101020000,2021,358603,0,358603,COST
06090223101020000,2020,210505,0,210505,COST
06090223101020000,2019,210505,0,210505,COST
06090223401010000,2021,2013,121220,123233,COST
06090223401010000,2020,2281,107570,109851,COST
06090223401010000,2019,2281,107570,109851,COST
06090224101010000,2021,164627,697580,862207,COST
06090224101010000,2020,226243,621570,847813,COST
06090224101010000,2019,226243,668990,895233,COST
06090224101020000,2021,148800,0,148800,COST
06090224101020000,2020,93700,0,93700,COST
06090224101020000,2019,93700,0,93700,COST
06090224101030000,2021,322632,173570,496202,COST
06090224101030000,2020,185535,185410,370945,COST
06090224101030000,2019,185535,185410,370945,COST
06090224101040000,2021,152605,52980,205585,COST
06090224101040000,2020,95812,99688,195500,INCOME
06090224101040000,2019,95812,99688,195500,INCOME
06090224104010000,2021,281257,819210,1100467,COST
06090224104010000,2020,384047,797540,1181587,COST
06090224104010000,2019,384047,797540,1181587,COST
06090224104100000,2021,153752,326748,480500,MKT
06090224104100000,2020,116915,331885,448800,MKT
06090224104100000,2019,116915,331885,448800,MKT
06090224201010000,2021,120637,244563,365200,MKT
06090224201010000,2020,77858,260442,338300,MKT
06090224201010000,2019,77858,260442,338300,MKT
06090224201020000,2021,128691,225009,353700,MKT
06090224201020000,2020,82429,228271,310700,MKT
06090224201020000,2019,82429,228271,310700,MKT
06090224201030000,2021,122149,250451,372600,MKT
06090224201030000,2020,78719,267081,345800,MKT
06090224201030000,2019,78719,267081,345800,MKT
06090224201040000,2021,133917,384283,518200,MKT
06090224201040000,2020,85377,380523,465900,MKT
06090224201040000,2019,85377,380523,465900,MKT
06090224201050000,2021,129379,210621,340000,MKT
06090224201050000,2020,82818,207782,290600,MKT
06090224201050000,2019,82818,207782,290600,MKT
06090224201060000,2021,129751,369349,499100,MKT
06090224201060000,2020,83028,368772,451800,OVR
06090224201060000,2019,83028,368772,451800,MKT
06090224201070000,2021,132346,244954,377300,MKT
06090224201070000,2020,84492,250608,335100,MKT
06090224201070000,2019,84492,250608,335100,MKT
06090224201080000,2021,130730,295970,426700,MKT
06090224201080000,2020,83581,321719,405300,MKT
06090224201080000,2019,83581,321719,405300,MKT
06090224202020000,2021,148800,210100,358900,MKT
06090224202020000,2020,93700,217300,311000,MKT
06090224202020000,2019,93700,217300,311000,MKT
06090224204010000,2021,115253,140970,256223,COST
06090224204010000,2020,74783,152090,226873,COST
06090224204010000,2019,74783,152090,226873,COST
06090224204020000,2021,128817,204983,333800,MKT
06090224204020000,2020,82500,199200,281700,MKT
06090224204020000,2019,82500,199200,281700,MKT
06090224204030000,2021,133514,207986,341500,MKT
06090224204030000,2020,85150,213350,298500,MKT
06090224204030000,2019,85150,213350,298500,MKT
06090224204040000,2021,122784,271716,394500,MKT
06090224204040000,2020,79080,284020,363100,MKT
06090224204040000,2019,79080,284020,363100,MKT
06090224204050000,2021,122994,253506,376500,MKT
06090224204050000,2020,79199,274701,353900,MKT
06090224204050000,2019,79199,274701,353900,MKT
06090224210010000,2021,107153,217447,324600,MKT
06090224210010000,2020,70124,222276,292400,MKT
06090224210010000,2019,70124,222276,292400,MKT
06090224210020000,2021,103872,306828,410700,MKT
06090224210020000,2020,68225,318375,386600,MKT
06090224210020000,2019,68225,318375,386600,MKT
06090224210030000,2021,101327,262373,363700,MKT
06090224210030000,2020,66747,263253,330000,MKT
06090224210030000,2019,66747,263253,330000,MKT
06090224210040000,2021,118399,280301,398700,MKT
06090224210040000,2020,76582,294818,371400,MKT
06090224210040000,2019,76582,294818,371400,MKT
06090224210050000,2021,124168,261232,385400,MKT
06090224210050000,2020,79866,261134,341000,MKT
06090224210050000,2019,79866,261134,341000,MKT
06090224210060000,2021,112501,290599,403100,MKT
06090224210060000,2020,73204,286696,359900,MKT
06090224210060000,2019,73204,286696,359900,MKT
06090224210070000,2021,97567,264733,362300,MKT
06090224210070000,2020,64556,261544,326100,MKT
06090224210070000,2019,64556,261544,326100,MKT
06090224210080000,2021,97567,255733,353300,MKT
06090224210080000,2020,64556,264944,329500,MKT
06090224210080000,2019,64556,254344,318900,MKT
06090224210090000,2021,97805,250795,348600,MKT
06090224210090000,2020,64695,250905,315600,MKT
06090224210090000,2019,64695,250905,315600,MKT
06090224210100000,2021,96967,286033,383000,MKT
06090224210100000,2020,64206,284294,348500,MKT
06090224210100000,2019,64206,284294,348500,MKT
06090224210110000,2021,96967,292333,389300,MKT
06090224210110000,2020,64206,296094,360300,MKT
06090224210110000,2019,64206,296094,360300,MKT
06090224210120000,2021,100778,261622,362400,MKT
06090224210120000,2020,66428,273072,339500,MKT
06090224210120000,2019,66428,273072,339500,MKT
06090224210130000,2021,104487,286813,391300,MKT
06090224210130000,2020,68581,274819,343400,MKT
06090224210130000,2019,68581,273219,341800,MKT
06090224210140000,2021,108850,292550,401400,MKT
06090224210140000,2020,71103,308897,380000,MKT
06090224210140000,2019,71103,308897,380000,MKT
06090224210150000,2021,128375,244525,372900,MKT
06090224210150000,2020,82250,207810,290060,OVR
06090224210150000,2019,82250,207810,290060,COST
06090224210160000,2021,93702,237898,331600,MKT
06090224210160000,2020,62293,237407,299700,MKT
06090224210160000,2019,62293,237407,299700,MKT
06090224210170000,2021,92238,275862,368100,MKT
06090224210170000,2020,61433,293567,355000,MKT
06090224210170000,2019,61433,293567,355000,MKT
06090224210180000,2021,92238,197262,289500,MKT
06090224210180000,2020,61433,169767,231200,MKT
06090224210180000,2019,61433,169767,231200,MKT
06090224210190000,2021,97088,335712,432800,MKT
06090224210190000,2020,64276,367124,431400,MKT
06090224210190000,2019,64276,364424,428700,MKT
06090224210200000,2021,109947,403753,513700,MKT
06090224210200000,2020,71735,434770,506505,COST
06090224210200000,2019,71735,434770,506505,COST
06090224210210000,2021,113183,328317,441500,MKT
06090224210210000,2020,73596,333804,407400,MKT
06090224210210000,2019,73596,333804,407400,MKT
06090224210220000,2021,116535,264865,381400,MKT
06090224210220000,2020,75517,274983,350500,MKT
06090224210220000,2019,75517,274983,350500,MKT
06090224210230000,2021,96359,311841,408200,MKT
06090224210230000,2020,63850,295150,359000,MKT
06090224210230000,2019,63850,295150,359000,MKT
06090224210240000,2021,95115,261485,356600,MKT
06090224210240000,2020,63122,258478,321600,MKT
06090224210240000,2019,63122,258478,321600,MKT
06090224210250000,2021,93176,0,93176,COST
06090224210250000,2020,61984,0,61984,COST
06090224210250000,2019,61984,0,61984,COST
06090224210260000,2021,91417,228883,320300,MKT
06090224210260000,2020,60950,233550,294500,MKT
06090224210260000,2019,60950,233550,294500,MKT
06090224210270000,2021,91692,227708,319400,MKT
06090224210270000,2020,61112,238088,299200,MKT
06090224210270000,2019,61112,238088,299200,MKT
06090224210280000,2021,100667,250233,350900,MKT
06090224210280000,2020,66364,255536,321900,MKT
06090224210280000,2019,66364,255536,321900,MKT
06090224210290000,2021,105193,274707,379900,MKT
06090224210290000,2020,68990,291510,360500,MKT
06090224210290000,2019,68990,291510,360500,MKT
06090224215010000,2021,98626,240474,339100,MKT
06090224215010000,2020,65174,250426,315600,MKT
06090224215010000,2019,65174,250426,315600,MKT
06090224215020000,2021,94350,240250,334600,MKT
06090224215020000,2020,62674,244526,307200,MKT
06090224215020000,2019,62674,244526,307200,MKT
06090224215030000,2021,94479,261121,355600,MKT
06090224215030000,2020,62749,258451,321200,MKT
06090224215030000,2019,62749,258451,321200,MKT
06090224215040000,2021,94735,0,94735,COST
06090224215040000,2020,62899,0,62899,COST
06090224215040000,2019,62899,0,62899,COST
06090224215050000,2021,99997,215203,315200,MKT
06090224215050000,2020,65973,212527,278500,MKT
06090224215050000,2019,65973,212527,278500,MKT
06090224220010000,2021,97805,245995,343800,MKT
06090224220010000,2020,64695,244005,308700,MKT
06090224220010000,2019,64695,244005,308700,MKT
06090224220020000,2021,96604,0,96604,COST
06090224220020000,2020,63993,0,63993,COST
06090224220020000,2019,63993,0,63993,COST
06090224220030000,2021,95866,245834,341700,MKT
06090224220030000,2020,63561,238639,302200,MKT
06090224220030000,2019,63561,238639,302200,MKT
06090224220040000,2021,95367,0,95367,COST
06090224220040000,2020,63269,0,63269,COST
06090224220040000,2019,63269,0,63269,COST
06090224220050000,2021,95241,287459,382700,MKT
06090224220050000,2020,63196,298204,361400,MKT
06090224220050000,2019,63196,298204,361400,MKT
06090224220060000,2021,95241,217459,312700,MKT
06090224220060000,2020,63196,213004,276200,MKT
06090224220060000,2019,63196,213004,276200,MKT
06090224220070000,2021,95241,300759,396000,MKT
06090224220070000,2020,63196,319404,382600,MKT
06090224220070000,2019,63196,319404,382600,MKT
06090224220080000,2021,103666,287134,390800,MKT
06090224220080000,2020,68105,311495,379600,MKT
06090224220080000,2019,68105,306595,374700,MKT
06090224230010000,2021,10226,610,10836,COST
06090224230010000,2020,13155,590,13745,COST
06090224230010000,2019,13155,590,13745,COST
06090224230050000,2021,349,14910,15259,COST
06090224230050000,2020,325,14810,15135,COST
06090224230050000,2019,325,14810,15135,COST
06090224301010000,2021,2249,163170,165419,COST
06090224301010000,2020,2665,175070,177735,COST
06090224301010000,2019,2665,175070,177735,COST
06090225101010000,2021,100372,0,100372,COST
06090225101010000,2020,129316,0,129316,COST
06090225101010000,2019,129316,0,129316,COST
06090225101020000,2021,104117,451670,555787,COST
06090225101020000,2020,117861,404190,522051,COST
06090225101020000,2019,117861,404190,522051,COST
06090225201010000,2021,129550,3150,132700,COST
06090225201010000,2020,173426,3040,176466,COST
06090225201010000,2019,173426,3040,176466,COST
06090225301010000,2021,144535,136860,281395,COST
06090225301010000,2020,185519,121260,306779,COST
06090225301010000,2019,185519,121260,306779,COST
06090225302010000,2021,120423,0,120423,COST
06090225302010000,2020,162836,0,162836,COST
06090225302010000,2019,162836,0,162836,COST
06090226101010000,2021,31969,26690,58659,COST
06090226101010000,2020,40500,25770,66270,COST
06090226101010000,2019,40500,25770,66270,COST
06090226101020000,2021,178109,0,178109,COST
06090226101020000,2020,165874,0,165874,COST
06090226101020000,2019,165874,0,165874,COST
06090226101030000,2021,7444,16130,23574,COST
06090226101030000,2020,9468,15540,25008,COST
06090226101030000,2019,9468,15540,25008,COST
06090226101040000,2021,97986,281414,379400,MKT
06090226101040000,2020,113395,250505,363900,MKT
06090226101040000,2019,113395,250505,363900,MKT
06090226102010000,2021,204516,560984,765500,MKT
06090226102010000,2020,181132,502668,683800,MKT
06090226102010000,2019,181132,502668,683800,MKT
06090226110010000,2021,98400,0,98400,COST
06090226110010000,2020,113700,0,113700,COST
06090226110010000,2019,113700,0,113700,COST
06090226201010000,2021,157058,5150,162208,COST
06090226201010000,2020,213261,5220,218481,COST
06090226201010000,2019,213261,5220,218481,COST
06090226302010000,2021,104596,630190,734786,COST
06090226302010000,2020,119466,549300,668766,COST
06090226302010000,2019,119466,549300,668766,COST
06090226302100000,2021,98400,367600,466000,MKT
06090226302100000,2020,113700,297000,410700,MKT
06090226302100000,2019,113700,297000,410700,MKT
06090226302150000,2021,4512,0,4512,COST
06090226302150000,2020,4199,0,4199,COST
06090226302150000,2019,4199,0,4199,COST
06090226302200000,2021,3983,0,3983,COST
06090226302200000,2020,3706,0,3706,COST
06090226302200000,2019,3706,0,3706,COST
06090227101010000,2021,100037,177770,277807,COST
06090227101010000,2020,115223,155790,271013,COST
06090227101010000,2019,115223,155790,271013,COST
06090227101020000,2021,145286,95950,241236,COST
06090227101020000,2020,145705,85060,230765,COST
06090227101020000,2019,145705,85060,230765,COST
06090227101040000,2021,102534,40160,142694,COST
06090227101040000,2020,116718,35480,152198,COST
06090227101040000,2019,116718,35480,152198,COST
06090227101100000,2021,100016,202930,302946,COST
06090227101100000,2020,115204,22110,137314,COST
06090227101100000,2019,115204,22110,137314,COST
06090227102010000,2021,138746,0,138746,COST
06090227102010000,2020,190051,0,190051,COST
06090227102010000,2019,190051,0,190051,COST
06090227102050000,2021,1109,9070,10179,COST
06090227102050000,2020,1032,9140,10172,COST
06090227102050000,2019,1032,9140,10172,COST
06090227120010000,2021,34198,0,34198,COST
06090227120010000,2020,57924,0,57924,COST
06090227120010000,2019,57924,0,57924,COST
06090227120120000,2021,99510,216640,316150,COST
06090227120120000,2020,114733,190720,305453,COST
06090227120120000,2019,114733,190720,305453,COST
06090227120360000,2021,150340,261360,411700,MKT
06090227120360000,2020,156133,185760,341893,COST
06090227120360000,2019,156133,185760,341893,COST
06090227178010000,2021,189265,328635,517900,MKT
06090227178010000,2020,172414,269386,441800,MKT
06090227178010000,2019,172414,269386,441800,MKT
06090227201010000,2021,149400,332900,482300,MKT
06090227201010000,2020,137217,264883,402100,MKT
06090227201010000,2019,137217,264883,402100,MKT
06090227201020000,2021,67120,231100,298220,COST
06090227201020000,2020,89127,229973,319100,MKT
06090227201020000,2019,89127,229973,319100,MKT
06090227201250000,2021,30745,1256920,1287665,COST
06090227201250000,2020,39861,1172450,1212311,COST
06090227201250000,2019,39861,1172450,1212311,COST
06090227301010000,2021,258699,607010,865709,COST
06090227301010000,2020,210359,523730,734089,COST
06090227301010000,2019,210359,523730,734089,COST
06090227301250000,2021,18339,0,18339,COST
06090227301250000,2020,19318,0,19318,COST
06090227301250000,2019,19318,0,19318,COST
06090227466010000,2021,169901,253599,423500,MKT
06090227466010000,2020,171239,228660,399899,COST
06090227466010000,2019,171239,228660,399899,COST
06090227466150000,2021,11490,0,11490,COST
06090227466150000,2020,12091,0,12091,COST
06090227466150000,2019,12091,0,12091,COST
06090228101010000,2021,156964,11900,168864,COST
06090228101010000,2020,164200,12200,176400,COST
06090228101010000,2019,164200,12200,176400,COST
06090229101010000,2021,74719,0,74719,COST
06090229101010000,2020,78811,0,78811,COST
06090229101010000,2019,78811,0,78811,COST
06090229201010000,2021,65523,0,65523,COST
06090229201010000,2020,68955,0,68955,COST
06090229201010000,2019,68955,0,68955,COST
06090229301010000,2021,67662,0,67662,COST
06090229301010000,2020,71322,0,71322,COST
06090229301010000,2019,71322,0,71322,COST
06090229401010000,2021,36159,0,36159,COST
06090229401010000,2020,37744,0,37744,COST
06090229401010000,2019,37744,0,37744,COST
06090230101010000,2021,202886,0,202886,COST
06090230101010000,2020,213817,0,213817,COST
06090230101010000,2019,213817,0,213817,COST
06090230301010000,2021,67966,0,67966,COST
06090230301010000,2020,71649,0,71649,COST
06090230301010000,2019,71649,0,71649,COST
06090231101010000,2021,263474,12290,275764,COST
06090231101010000,2020,277620,11870,289490,COST
06090231101010000,2019,277620,11870,289490,COST
06090232101010000,2021,124500,0,124500,COST
06090232101010000,2020,131151,0,131151,COST
06090232101010000,2019,131151,0,131151,COST
06090232201010000,2021,125583,0,125583,COST
06090232201010000,2020,132139,0,132139,COST
06090232201010000,2019,132139,0,132139,COST
06090233201010000,2021,151589,1047070,1198659,COST
06090233201010000,2020,174464,848400,1022864,COST
06090233201010000,2019,174464,848400,1022864,COST
06090233401010000,2021,22626,0,22626,COST
06090233401010000,2020,23602,0,23602,COST
06090233401010000,2019,23602,0,23602,COST
06090234101010000,2021,279431,18440,297871,COST
06090234101010000,2020,330042,17820,347862,COST
06090234101010000,2019,330042,17820,347862,COST
06090234101450000,2021,9111,122470,131581,COST
06090234101450000,2020,11190,112040,123230,COST
06090234101450000,2019,11190,112040,123230,COST
06090235101010000,2021,57818,4650,62468,COST
06090235101010000,2020,78276,4860,83136,COST
06090235101010000,2019,78276,4860,83136,COST
06090235101220000,2021,194275,345400,539675,COST
06090235101220000,2020,175305,307640,482945,COST
06090235101220000,2019,175305,307640,482945,COST
06090235101260000,2021,179574,254026,433600,MKT
06090235101260000,2020,166742,278582,445324,MRA
06090235101260000,2019,166742,278582,445324,MRA
06090235101290000,2021,159177,761640,920817,COST
06090235101290000,2020,163014,453780,616794,COST
06090235101290000,2019,163014,447010,610024,COST
06090235201010000,2021,99458,501540,600998,COST
06090235201010000,2020,114684,422910,537594,COST
06090235201010000,2019,114684,422910,537594,COST
06090235201020000,2021,180133,162250,342383,COST
06090235201020000,2020,207541,141980,349521,COST
06090235201020000,2019,207541,141980,349521,COST
06090235201030000,2021,98400,228300,326700,MKT
06090235201030000,2020,113700,184200,297900,MKT
06090235201030000,2019,113700,184200,297900,MKT
06090235201040000,2021,98441,13360,111801,COST
06090235201040000,2020,113730,13860,127590,COST
06090235201040000,2019,113730,13860,127590,COST
06090235201060000,2021,213683,377250,590933,COST
06090235201060000,2020,186258,332200,518458,COST
06090235201060000,2019,186258,332200,518458,COST
06090235201100000,2021,118308,248692,367000,MKT
06090235201100000,2020,127847,245553,373400,MKT
06090235201100000,2019,127847,245553,373400,MKT
06090235202010000,2021,8481,729610,738091,COST
06090235202010000,2020,9089,649250,658339,COST
06090235202010000,2019,9089,649250,658339,COST
06090235202020000,2021,235529,384171,619700,MKT
06090235202020000,2020,198163,312050,510213,COST
06090235202020000,2019,198163,312050,510213,COST
06090235202040000,2021,280271,580929,861200,MKT
06090235202040000,2020,221360,512115,733475,OVR
06090235202040000,2019,221360,512115,733475,OVR
06090235202070000,2021,279716,658120,937836,COST
06090235202070000,2020,221081,579900,800981,COST
06090235202070000,2019,221081,579900,800981,COST
06090235202090000,2021,236097,0,236097,COST
06090235202090000,2020,198467,0,198467,COST
06090235202090000,2019,198467,0,198467,COST
06090235202100000,2021,99454,1709010,1808464,COST
06090235202100000,2020,114681,1511580,1626261,COST
06090235202100000,2019,114681,1511580,1626261,COST
06090235202150000,2021,15413,0,15413,COST
06090235202150000,2020,21796,0,21796,COST
06090235202150000,2019,21796,0,21796,COST
06090235202200000,2021,98951,968760,1067711,COST
06090235202200000,2020,114212,867130,981342,COST
06090235202200000,2019,114212,867130,981342,COST
06090235202220000,2021,537,0,537,COST
06090235202220000,2020,499,0,499,COST
06090235202220000,2019,499,0,499,COST
06090235202250000,2021,14887,0,14887,COST
06090235202250000,2020,20001,0,20001,COST
06090235202250000,2019,20001,0,20001,COST
06090235202300000,2021,18267,0,18267,COST
06090235202300000,2020,25249,0,25249,COST
06090235202300000,2019,25249,0,25249,COST
06090235202350000,2021,14832,0,14832,COST
06090235202350000,2020,20873,0,20873,COST
06090235202350000,2019,20873,0,20873,COST
06090235401010000,2021,22254,0,22254,COST
06090235401010000,2020,27819,0,27819,COST
06090235401010000,2019,27819,0,27819,COST
06090236101010000,2021,595913,2852210,3448123,COST
06090236101010000,2020,702803,2819360,3522163,COST
06090236101010000,2019,702803,2819360,3522163,COST
06090236301010000,2021,138306,402894,541200,MKT
06090236301010000,2020,141209,341591,482800,MKT
06090236301010000,2019,141209,341591,482800,MKT
06090301101040000,2021,841424,712076,1553500,INCOME
06090301101040000,2020,861820,546880,1408700,INCOME
06090301101040000,2019,861820,546880,1408700,INCOME
06090301101050000,2021,379143,128657,507800,INCOME
06090301101050000,2020,248736,130864,379600,INCOME
06090301101050000,2019,248736,130864,379600,INCOME
06090301101200000,2021,263879,366320,630199,COST
06090301101200000,2020,141379,425121,566500,INCOME
06090301101200000,2019,141379,425121,566500,INCOME
06090301102030000,2021,321999,432200,754199,COST
06090301102030000,2020,106193,412240,518433,COST
06090301102030000,2019,106193,412240,518433,COST
06090301102050000,2021,525877,788430,1314307,COST
06090301102050000,2020,156552,753580,910132,COST
06090301102050000,2019,156552,753580,910132,COST
06090301103010000,2021,83283,205917,289200,MKT
06090301103010000,2020,75391,194609,270000,MKT
06090301103010000,2019,75391,194609,270000,MKT
06090301103050000,2021,87962,219338,307300,MKT
06090301103050000,2020,81937,203763,285700,MKT
06090301103050000,2019,81937,203763,285700,MKT
06090301103080000,2021,97066,233834,330900,MKT
06090301103080000,2020,95199,230501,325700,MKT
06090301103080000,2019,95199,230501,325700,MKT
06090301103100000,2021,86393,215807,302200,MKT
06090301103100000,2020,79721,222279,302000,MKT
06090301103100000,2019,79721,222279,302000,MKT
06090301103120000,2021,80562,149038,229600,MKT
06090301103120000,2020,71671,145829,217500,MKT
06090301103120000,2019,71671,145829,217500,MKT
06090301103140000,2021,80562,249238,329800,MKT
06090301103140000,2020,71671,209829,281500,MKT
06090301103140000,2019,71671,209829,281500,MKT
06090301103160000,2021,81835,231365,313200,MKT
06090301103160000,2020,73403,197697,271100,MKT
06090301103160000,2019,73403,197697,271100,MKT
06090301103220000,2021,83283,238400,321683,COST
06090301103220000,2020,75391,206509,281900,MKT
06090301103220000,2019,75391,206509,281900,MKT
06090301104070000,2021,528481,714620,1243101,COST
06090301104070000,2020,157165,605420,762585,COST
06090301104070000,2019,157165,605420,762585,COST
06090301104100000,2021,107618,211082,318700,MKT
06090301104100000,2020,63506,200394,263900,MKT
06090301104100000,2019,63506,200394,263900,MKT
06090301105010000,2021,3399244,0,3399244,COST
06090301105010000,2020,25120998,0,25120998,COST
06090301105010000,2019,25120998,0,25120998,COST
06090301106010000,2021,6726,0,6726,COST
06090301106010000,2020,6264,0,6264,COST
06090301106010000,2019,6264,0,6264,COST
06090301107010000,2021,925001,0,925001,COST
06090301107010000,2020,163566,0,163566,COST
06090301107010000,2019,163566,0,163566,COST
06090301110010000,2021,87314,122086,209400,MKT
06090301110010000,2020,81019,119181,200200,MKT
06090301110010000,2019,81019,119181,200200,MKT
06090301110050000,2021,77698,222202,299900,MKT
06090301110050000,2020,67826,188774,256600,MKT
06090301110050000,2019,67826,188774,256600,MKT
06090301110070000,2021,77698,142002,219700,MKT
06090301110070000,2020,67826,142174,210000,MKT
06090301110070000,2019,67826,142174,210000,MKT
06090301110090000,2021,77698,184902,262600,MKT
06090301110090000,2020,67826,170274,238100,MKT
06090301110090000,2019,67826,170274,238100,MKT
06090301110110000,2021,77698,195702,273400,MKT
06090301110110000,2020,67826,180474,248300,MKT
06090301110110000,2019,67826,180474,248300,MKT
06090301110130000,2021,78624,226776,305400,MKT
06090301110130000,2020,69061,196539,265600,MKT
06090301110130000,2019,69061,196539,265600,MKT
06090301110140000,2021,77358,200042,277400,MKT
06090301110140000,2020,67375,169525,236900,MKT
06090301110140000,2019,67375,169525,236900,MKT
06090301110150000,2021,77358,342170,419528,COST
06090301110150000,2020,67375,296625,364000,MKT
06090301110150000,2019,67375,296625,364000,MKT
06090301110160000,2021,77358,261742,339100,MKT
06090301110160000,2020,67375,244425,311800,MKT
06090301110160000,2019,67375,244425,311800,MKT
06090301110180000,2021,91544,134956,226500,MKT
06090301110180000,2020,87072,141928,229000,MKT
06090301110180000,2019,87072,141928,229000,MKT
06090301110190000,2021,77358,212242,289600,MKT
06090301110190000,2020,67375,176025,243400,MKT
06090301110190000,2019,67375,176025,243400,MKT
06090301110210000,2021,91544,174850,266394,COST
06090301110210000,2020,87072,166750,253822,COST
06090301110210000,2019,87072,166750,253822,COST
06090301111010000,2021,97066,274510,371576,COST
06090301111010000,2020,95199,284401,379600,MKT
06090301111010000,2019,95199,284401,379600,MKT
06090301111050000,2021,77698,147002,224700,MKT
06090301111050000,2020,67826,149774,217600,MKT
06090301111050000,2019,67826,149774,217600,MKT
06090301111070000,2021,77698,207902,285600,MKT
06090301111070000,2020,67826,198874,266700,MKT
06090301111070000,2019,67826,198874,266700,MKT
06090301111090000,2021,77698,135102,212800,MKT
06090301111090000,2020,67826,142874,210700,MKT
06090301111090000,2019,67826,142874,210700,MKT
06090301111110000,2021,76297,232003,308300,MKT
06090301111110000,2020,65973,267627,333600,MKT
06090301111110000,2019,65973,267627,333600,MKT
06090301111120000,2021,54677,124323,179000,MKT
06090301111120000,2020,39713,137887,177600,MKT
06090301111120000,2019,39713,137887,177600,MKT
06090301111130000,2021,87962,250238,338200,MKT
06090301111130000,2020,81937,217063,299000,MKT
06090301111130000,2019,81937,217063,299000,MKT
06090301111140000,2021,65658,0,65658,COST
06090301111140000,2020,52482,0,52482,COST
06090301111140000,2019,52482,0,52482,COST
06090301111170000,2021,91945,248955,340900,MKT
06090301111170000,2020,87655,205345,293000,MKT
06090301111170000,2019,87655,205345,293000,MKT
06090301111190000,2021,74332,227068,301400,MKT
06090301111190000,2020,63401,195399,258800,MKT
06090301111190000,2019,63401,195399,258800,MKT
06090301111200000,2021,87962,143338,231300,MKT
06090301111200000,2020,81937,158863,240800,MKT
06090301111200000,2019,81937,158863,240800,MKT
06090301112010000,2021,87962,143138,231100,MKT
06090301112010000,2020,81937,148263,230200,MKT
06090301112010000,2019,81937,148263,230200,MKT
06090301112040000,2021,87962,206138,294100,MKT
06090301112040000,2020,81937,197863,279800,MKT
06090301112040000,2019,81937,197863,279800,MKT
06090301112060000,2021,87962,236338,324300,MKT
06090301112060000,2020,81937,215963,297900,MKT
06090301112060000,2019,81937,215963,297900,MKT
06090301112080000,2021,87962,267538,355500,MKT
06090301112080000,2020,81937,222563,304500,MKT
06090301112080000,2019,81937,222563,304500,MKT
06090301112100000,2021,86393,256807,343200,MKT
06090301112100000,2020,79721,211079,290800,MKT
06090301112100000,2019,79721,211079,290800,MKT
06090301112120000,2021,80562,146938,227500,MKT
06090301112120000,2020,71671,146429,218100,MKT
06090301112120000,2019,71671,146429,218100,MKT
06090301112140000,2021,80562,201738,282300,MKT
06090301112140000,2020,71671,191129,262800,MKT
06090301112140000,2019,71671,191129,262800,MKT
06090301112160000,2021,80562,234438,315000,MKT
06090301112160000,2020,71671,201829,273500,MKT
06090301112160000,2019,71671,201229,272900,MKT
06090301112180000,2021,80562,207738,288300,MKT
06090301112180000,2020,71671,181629,253300,MKT
06090301112180000,2019,71671,181629,253300,MKT
06090301119030000,2021,80662,213238,293900,MKT
06090301119030000,2020,71807,182093,253900,MKT
06090301119030000,2019,71807,182093,253900,MKT
06090301119050000,2021,85740,251960,337700,MKT
06090301119050000,2020,78804,212796,291600,MKT
06090301119050000,2019,78804,212796,291600,MKT
06090301119070000,2021,78624,208476,287100,MKT
06090301119070000,2020,69061,181739,250800,MKT
06090301119070000,2019,69061,181739,250800,MKT
06090301119090000,2021,77381,204919,282300,MKT
06090301119090000,2020,67405,176595,244000,MKT
06090301119090000,2019,67405,176595,244000,MKT
06090301119110000,2021,77381,224419,301800,MKT
06090301119110000,2020,67405,190595,258000,MKT
06090301119110000,2019,67405,190595,258000,MKT
06090301119130000,2021,77381,203819,281200,MKT
06090301119130000,2020,67405,179295,246700,MKT
06090301119130000,2019,67405,179295,246700,MKT
06090301119150000,2021,80861,260880,341741,COST
06090301119150000,2020,72077,245610,317687,COST
06090301119150000,2019,72077,245610,317687,COST
06090301119170000,2021,80861,205739,286600,MKT
06090301119170000,2020,72077,178723,250800,MKT
06090301119170000,2019,72077,178723,250800,MKT
06090301119190000,2021,80861,175339,256200,MKT
06090301119190000,2020,72077,164023,236100,MKT
06090301119190000,2019,72077,164023,236100,MKT
06090301119210000,2021,80861,180039,260900,MKT
06090301119210000,2020,72077,166923,239000,MKT
06090301119210000,2019,72077,166923,239000,MKT
06090301119230000,2021,80861,211739,292600,MKT
06090301119230000,2020,72077,222423,294500,MKT
06090301119230000,2019,72077,222423,294500,MKT
06090301119250000,2021,79030,174370,253400,MKT
06090301119250000,2020,69605,156495,226100,MKT
06090301119250000,2019,69605,156495,226100,MKT
06090301119300000,2021,75591,3300,78891,COST
06090301119300000,2020,65044,3600,68644,COST
06090301119300000,2019,65044,3600,68644,COST
06090301120010000,2021,82025,233475,315500,MKT
06090301120010000,2020,73663,204737,278400,MKT
06090301120010000,2019,73663,204737,278400,MKT
06090301120020000,2021,87962,140838,228800,MKT
06090301120020000,2020,81937,149163,231100,MKT
06090301120020000,2019,81937,149163,231100,MKT
06090301120030000,2021,82025,13000,95025,COST
06090301120030000,2020,73663,13250,86913,COST
06090301120030000,2019,73663,13250,86913,COST
06090301120060000,2021,80662,133438,214100,MKT
06090301120060000,2020,71807,137393,209200,MKT
06090301120060000,2019,71807,137393,209200,MKT
06090301120080000,2021,83321,187279,270600,MKT
06090301120080000,2020,75444,221256,296700,MKT
06090301120080000,2019,75444,221256,296700,MKT
06090301120110000,2021,82293,170407,252700,MKT
06090301120110000,2020,74030,173170,247200,MKT
06090301120110000,2019,74030,173170,247200,MKT
06090301120120000,2021,81762,207838,289600,MKT
06090301120120000,2020,73304,185396,258700,MKT
06090301120120000,2019,73304,185396,258700,MKT
06090301120130000,2021,87962,175038,263000,MKT
06090301120130000,2020,81937,184063,266000,MKT
06090301120130000,2019,81937,184063,266000,MKT
06090301120150000,2021,82025,224875,306900,MKT
06090301120150000,2020,73663,196337,270000,MKT
06090301120150000,2019,73663,196337,270000,MKT
06090301120170000,2021,82025,226675,308700,MKT
06090301120170000,2020,73663,203437,277100,MKT
06090301120170000,2019,73663,203437,277100,MKT
06090301128010000,2021,90410,181290,271700,MKT
06090301128010000,2020,85436,191564,277000,MKT
06090301128010000,2019,85436,191564,277000,MKT
06090301128050000,2021,89231,265769,355000,MKT
06090301128050000,2020,83743,246857,330600,MKT
06090301128050000,2019,83743,246857,330600,MKT
06090301128080000,2021,89231,238769,328000,MKT
06090301128080000,2020,83743,229257,313000,MKT
06090301128080000,2019,83743,229257,313000,MKT
06090301128105002,2021,78710,147890,226600,MKT
06090301128105002,2020,69099,176101,245200,MKT
06090301128105002,2019,69099,176101,245200,MKT
06090301128125001,2021,84431,132969,217400,MKT
06090301128125001,2020,76893,161007,237900,MKT
06090301128125001,2019,76893,161007,237900,MKT
06090301128150000,2021,87962,248638,336600,MKT
06090301128150000,2020,81937,222963,304900,MKT
06090301128150000,2019,81937,222963,304900,MKT
06090301128160000,2021,96270,277630,373900,MKT
06090301128160000,2020,94012,232088,326100,MKT
06090301128160000,2019,94012,232088,326100,MKT
06090301128190000,2021,83321,235279,318600,MKT
06090301128190000,2020,75444,204556,280000,MKT
06090301128190000,2019,75444,204556,280000,MKT
06090301128210000,2021,82025,180175,262200,MKT
06090301128210000,2020,73663,191837,265500,MKT
06090301128210000,2019,73663,191837,265500,MKT
06090301132010000,2021,97814,206486,304300,MKT
06090301132010000,2020,58161,214339,272500,MKT
06090301132010000,2019,58161,214339,272500,MKT
06090301132020000,2021,97814,169486,267300,MKT
06090301132020000,2020,58161,158039,216200,MKT
06090301132020000,2019,58161,158039,216200,MKT
06090301132030000,2021,97814,193086,290900,MKT
06090301132030000,2020,58161,191239,249400,MKT
06090301132030000,2019,58161,191239,249400,MKT
06090301132040000,2021,97814,255686,353500,MKT
06090301132040000,2020,58161,262139,320300,MKT
06090301132040000,2019,58161,262139,320300,MKT
06090301132050000,2021,97814,202286,300100,MKT
06090301132050000,2020,58161,190139,248300,MKT
06090301132050000,2019,58161,186039,244200,MKT
06090301132060000,2021,97814,224986,322800,MKT
06090301132060000,2020,58161,248139,306300,MKT
06090301132060000,2019,58161,213739,271900,MKT
06090301132070000,2021,97814,225286,323100,MKT
06090301132070000,2020,58161,224739,282900,MKT
06090301132070000,2019,58161,224739,282900,MKT
06090301134010000,2021,98792,0,98792,COST
06090301134010000,2020,58696,0,58696,COST
06090301134010000,2019,58696,0,58696,COST
06090301134020000,2021,109557,0,109557,COST
06090301134020000,2020,64558,0,64558,COST
06090301134020000,2019,64558,0,64558,COST
06090301134030000,2021,107411,221289,328700,MKT
06090301134030000,2020,63393,229107,292500,MKT
06090301134030000,2019,63393,229107,292500,MKT
06090301134040000,2021,117541,195059,312600,MKT
06090301134040000,2020,68876,211924,280800,MKT
06090301134040000,2019,68876,211924,280800,MKT
06090301134050000,2021,100911,150689,251600,MKT
06090301134050000,2020,59854,170446,230300,MKT
06090301134050000,2019,59854,170446,230300,MKT
06090301134060000,2021,96022,230378,326400,MKT
06090301134060000,2020,57180,218120,275300,MKT
06090301134060000,2019,57180,218120,275300,MKT
06090301134070000,2021,115282,235218,350500,MKT
06090301134070000,2020,67657,229643,297300,MKT
06090301134070000,2019,67657,229643,297300,MKT
06090301134080000,2021,115492,228108,343600,MKT
06090301134080000,2020,67770,233130,300900,MKT
06090301134080000,2019,67770,233130,300900,MKT
06090301134090000,2021,101775,273825,375600,MKT
06090301134090000,2020,60325,305675,366000,MKT
06090301134090000,2019,60325,305675,366000,MKT
06090301134100000,2021,101775,230225,332000,MKT
06090301134100000,2020,60325,217475,277800,MKT
06090301134100000,2019,60325,214875,275200,MKT
06090301134110000,2021,101775,169225,271000,MKT
06090301134110000,2020,60325,194175,254500,MKT
06090301134110000,2019,60325,194175,254500,MKT
06090301134120000,2021,104286,253914,358200,MKT
06090301134120000,2020,61694,248606,310300,MKT
06090301134120000,2019,61694,248606,310300,MKT
06090301134130000,2021,100319,201981,302300,MKT
06090301134130000,2020,59530,223970,283500,MKT
06090301134130000,2019,59530,223970,283500,MKT
06090301134140000,2021,112298,176002,288300,MKT
06090301134140000,2020,66043,184157,250200,MKT
06090301134140000,2019,66043,184157,250200,MKT
06090301134150000,2021,138384,199116,337500,MKT
06090301134150000,2020,80042,207858,287900,MKT
06090301134150000,2019,80042,207858,287900,MKT
06090301134160000,2021,123562,254738,378300,MKT
06090301134160000,2020,72117,274683,346800,OVR
06090301134160000,2019,72117,274683,346800,MKT
06090301134170000,2021,104309,271591,375900,MKT
06090301134170000,2020,61706,283294,345000,MKT
06090301134170000,2019,61706,283294,345000,MKT
06090301134180000,2021,101361,218639,320000,MKT
06090301134180000,2020,60099,197701,257800,OVR
06090301134180000,2019,60099,197701,257800,MKT
06090301134190000,2021,102336,164264,266600,MKT
06090301134190000,2020,60631,174469,235100,MKT
06090301134190000,2019,60631,174469,235100,MKT
06090301134200000,2021,101939,240461,342400,MKT
06090301134200000,2020,60415,252385,312800,MKT
06090301134200000,2019,60415,252385,312800,MKT
06090301134210000,2021,101939,236861,338800,MKT
06090301134210000,2020,60415,249885,310300,MKT
06090301134210000,2019,60415,249885,310300,MKT
06090301134220000,2021,101939,182161,284100,MKT
06090301134220000,2020,60415,194585,255000,MKT
06090301134220000,2019,60415,194585,255000,MKT
06090301134230000,2021,101540,195260,296800,MKT
06090301134230000,2020,60197,205503,265700,MKT
06090301134230000,2019,60197,170503,230700,MKT
06090301134240000,2021,101540,215560,317100,MKT
06090301134240000,2020,60197,214803,275000,MKT
06090301134240000,2019,60197,214803,275000,MKT
06090301134250000,2021,101139,284661,385800,MKT
06090301134250000,2020,59978,270622,330600,MKT
06090301134250000,2019,59978,270622,330600,MKT
06090301134260000,2021,101139,212661,313800,MKT
06090301134260000,2020,59978,204822,264800,MKT
06090301134260000,2019,59978,204822,264800,MKT
06090301134270000,2021,101139,202261,303400,MKT
06090301134270000,2020,59978,190122,250100,MKT
06090301134270000,2019,59978,190122,250100,MKT
06090301134280000,2021,100735,459799,560534,MRA
06090301134280000,2020,59757,420243,480000,MKT
06090301134280000,2019,59757,420243,480000,MKT
06090301135010000,2021,100968,202332,303300,MKT
06090301135010000,2020,59885,183715,243600,MKT
06090301135010000,2019,59885,183715,243600,MKT
06090301135020000,2021,97968,185232,283200,MKT
06090301135020000,2020,58245,178955,237200,MKT
06090301135020000,2019,58245,178955,237200,MKT
06090301135030000,2021,97968,204332,302300,MKT
06090301135030000,2020,58245,192755,251000,MKT
06090301135030000,2019,58245,192755,251000,MKT
06090301135040000,2021,97968,173132,271100,MKT
06090301135040000,2020,58245,174955,233200,MKT
06090301135040000,2019,58245,174955,233200,MKT
06090301135050000,2021,97968,197632,295600,MKT
06090301135050000,2020,58245,182055,240300,MKT
06090301135050000,2019,58245,182055,240300,MKT
06090301135060000,2021,97968,202532,300500,MKT
06090301135060000,2020,58245,211755,270000,MKT
06090301135060000,2019,58245,211755,270000,MKT
06090301135070000,2021,100968,254332,355300,MKT
06090301135070000,2020,59885,244815,304700,MKT
06090301135070000,2019,59885,244815,304700,MKT
06090301135080000,2021,125030,228270,353300,MKT
06090301135080000,2020,72905,211095,284000,MKT
06090301135080000,2019,72905,211095,284000,MKT
06090301135090000,2021,97968,156332,254300,MKT
06090301135090000,2020,58245,181155,239400,MKT
06090301135090000,2019,58245,181155,239400,MKT
06090301135100000,2021,97968,208432,306400,MKT
06090301135100000,2020,58245,202155,260400,MKT
06090301135100000,2019,58245,202155,260400,MKT
06090301135110000,2021,97968,196532,294500,MKT
06090301135110000,2020,58245,194655,252900,MKT
06090301135110000,2019,58245,194655,252900,MKT
06090301135120000,2021,97968,156432,254400,MKT
06090301135120000,2020,58245,173855,232100,MKT
06090301135120000,2019,58245,173855,232100,MKT
06090301135130000,2021,97968,202532,300500,MKT
06090301135130000,2020,58245,192855,251100,MKT
06090301135130000,2019,58245,191455,249700,MKT
06090301135140000,2021,100968,176632,277600,MKT
06090301135140000,2020,59885,190715,250600,MKT
06090301135140000,2019,59885,190715,250600,MKT
06090301136010000,2021,96140,192560,288700,MKT
06090301136010000,2020,57244,189956,247200,MKT
06090301136010000,2019,57244,189956,247200,MKT
06090301136020000,2021,96140,232060,328200,MKT
06090301136020000,2020,57244,214056,271300,MKT
06090301136020000,2019,57244,214056,271300,MKT
06090301136030000,2021,96140,196060,292200,MKT
06090301136030000,2020,57244,181356,238600,MKT
06090301136030000,2019,57244,181356,238600,MKT
06090301136040000,2021,96140,192760,288900,MKT
06090301136040000,2020,57244,201656,258900,MKT
06090301136040000,2019,57244,201656,258900,MKT
06090301136050000,2021,96140,217560,313700,MKT
06090301136050000,2020,57244,202556,259800,MKT
06090301136050000,2019,57244,202556,259800,MKT
06090301136060000,2021,96140,191260,287400,MKT
06090301136060000,2020,57244,206956,264200,MKT
06090301136060000,2019,57244,206956,264200,MKT
06090301136070000,2021,93906,180894,274800,MKT
06090301136070000,2020,56018,188482,244500,MKT
06090301136070000,2019,56018,188482,244500,MKT
06090301136080000,2021,96140,228260,324400,MKT
06090301136080000,2020,57244,201556,258800,MKT
06090301136080000,2019,57244,201556,258800,MKT
06090301136090000,2021,93906,172694,266600,MKT
06090301136090000,2020,56018,193182,249200,MKT
06090301136090000,2019,56018,193182,249200,MKT
06090301136100000,2021,95689,162711,258400,MKT
06090301136100000,2020,56997,182003,239000,MKT
06090301136100000,2019,56997,182003,239000,MKT
06090301136110000,2021,96140,196560,292700,MKT
06090301136110000,2020,57244,179256,236500,MKT
06090301136110000,2019,57244,179256,236500,MKT
06090301136120000,2021,96140,205160,301300,MKT
06090301136120000,2020,57244,191956,249200,MKT
06090301136120000,2019,57244,191956,249200,MKT
06090301136130000,2021,95689,214711,310400,MKT
06090301136130000,2020,56997,193203,250200,MKT
06090301136130000,2019,56997,193203,250200,MKT
06090301136140000,2021,96140,176860,273000,MKT
06090301136140000,2020,57244,181256,238500,MKT
06090301136140000,2019,57244,181256,238500,MKT
06090301137010000,2021,103882,204718,308600,MKT
06090301137010000,2020,61474,215626,277100,MKT
06090301137010000,2019,61474,215626,277100,MKT
06090301137020000,2021,96140,249260,345400,MKT
06090301137020000,2020,57244,245956,303200,MKT
06090301137020000,2019,57244,245956,303200,MKT
06090301137030000,2021,96140,159760,255900,MKT
06090301137030000,2020,57244,175756,233000,MKT
06090301137030000,2019,57244,175756,233000,MKT
06090301137040000,2021,96140,201660,297800,MKT
06090301137040000,2020,57244,203956,261200,MKT
06090301137040000,2019,57244,203956,261200,MKT
06090301137050000,2021,96140,170260,266400,MKT
06090301137050000,2020,57244,182156,239400,MKT
06090301137050000,2019,57244,182156,239400,MKT
06090301137060000,2021,96140,164160,260300,MKT
06090301137060000,2020,57244,174156,231400,MKT
06090301137060000,2019,57244,174156,231400,MKT
06090301137070000,2021,109603,234097,343700,MKT
06090301137070000,2020,64583,229117,293700,MKT
06090301137070000,2019,64583,229117,293700,MKT
06090301137080000,2021,106280,173920,280200,MKT
06090301137080000,2020,62779,185221,248000,MKT
06090301137080000,2019,62779,185221,248000,MKT
06090301137090000,2021,96140,195960,292100,MKT
06090301137090000,2020,57244,177656,234900,MKT
06090301137090000,2019,57244,177656,234900,MKT
06090301137100000,2021,95915,223885,319800,MKT
06090301137100000,2020,57121,210279,267400,MKT
06090301137100000,2019,57121,210279,267400,MKT
06090301137110000,2021,96140,203760,299900,MKT
06090301137110000,2020,57244,191956,249200,MKT
06090301137110000,2019,57244,191956,249200,MKT
06090301137120000,2021,106954,241246,348200,MKT
06090301137120000,2020,63145,234355,297500,MKT
06090301137120000,2019,63145,234355,297500,MKT
06090301138010000,2021,100573,207627,308200,MKT
06090301138010000,2020,59669,222031,281700,MKT
06090301138010000,2019,59669,222031,281700,MKT
06090301138020000,2021,97584,217316,314900,MKT
06090301138020000,2020,58035,203765,261800,MKT
06090301138020000,2019,58035,203765,261800,MKT
06090301138030000,2021,97968,237432,335400,MKT
06090301138030000,2020,58245,231155,289400,MKT
06090301138030000,2019,58245,231155,289400,MKT
06090301138040000,2021,97968,251532,349500,MKT
06090301138040000,2020,58245,227955,286200,MKT
06090301138040000,2019,58245,227955,286200,MKT
06090301138050000,2021,97968,245632,343600,MKT
06090301138050000,2020,58245,248455,306700,MKT
06090301138050000,2019,58245,235955,294200,MKT
06090301138060000,2021,97968,210432,308400,MKT
06090301138060000,2020,58245,198655,256900,MKT
06090301138060000,2019,58245,198655,256900,MKT
06090301138070000,2021,101110,150790,251900,MKT
06090301138070000,2020,59962,170238,230200,MKT
06090301138070000,2019,59962,170238,230200,MKT
06090301138080000,2021,100968,227532,328500,MKT
06090301138080000,2020,59885,228915,288800,MKT
06090301138080000,2019,59885,228915,288800,MKT
06090301138090000,2021,97584,227016,324600,MKT
06090301138090000,2020,58035,215365,273400,MKT
06090301138090000,2019,58035,215365,273400,MKT
06090301138100000,2021,97584,177316,274900,MKT
06090301138100000,2020,58035,181765,239800,MKT
06090301138100000,2019,58035,183465,241500,MKT
06090301138110000,2021,97584,268516,366100,MKT
06090301138110000,2020,58035,200765,258800,OVR
06090301138110000,2019,58035,200765,258800,MKT
06090301138120000,2021,97584,240016,337600,MKT
06090301138120000,2020,58035,223165,281200,MKT
06090301138120000,2019,58035,223165,281200,MKT
06090301138130000,2021,97584,234616,332200,MKT
06090301138130000,2020,58035,226965,285000,MKT
06090301138130000,2019,58035,226965,285000,MKT
06090301138140000,2021,100573,240827,341400,MKT
06090301138140000,2020,59669,227531,287200,MKT
06090301138140000,2019,59669,227531,287200,MKT
06090301139010000,2021,187995,28020,216015,COST
06090301139010000,2020,69369,27120,96489,COST
06090301139010000,2019,69369,27120,96489,COST
06090301139020000,2021,575246,0,575246,COST
06090301139020000,2020,297052,0,297052,COST
06090301139020000,2019,297052,0,297052,COST
06090301140010000,2021,485244,139200,624444,COST
06090301140010000,2020,146901,114160,261061,COST
06090301140010000,2019,146901,114160,261061,COST
06090301152010000,2021,116944,188356,305300,MKT
06090301152010000,2020,68554,191546,260100,MKT
06090301152010000,2019,68554,191546,260100,MKT
06090301152020000,2021,109666,181734,291400,MKT
06090301152020000,2020,64617,163120,227737,COST
06090301152020000,2019,64617,163120,227737,COST
06090301152030000,2021,109666,142334,252000,MKT
06090301152030000,2020,64617,172183,236800,MKT
06090301152030000,2019,64617,172183,236800,MKT
06090301152040000,2021,109666,181734,291400,MKT
06090301152040000,2020,64617,194783,259400,MKT
06090301152040000,2019,64617,194783,259400,MKT
06090301152050000,2021,116605,132795,249400,MKT
06090301152050000,2020,68554,29630,98184,COST
06090301152050000,2019,68554,29630,98184,COST
06090301152060000,2021,117078,235422,352500,MKT
06090301152060000,2020,68626,250174,318800,MKT
06090301152060000,2019,68626,250174,318800,MKT
06090301152070000,2021,113392,276108,389500,MKT
06090301152070000,2020,66635,271565,338200,MKT
06090301152070000,2019,66635,271565,338200,MKT
06090301152080000,2021,109666,124834,234500,MKT
06090301152080000,2020,64617,144383,209000,MKT
06090301152080000,2019,64617,144383,209000,MKT
06090301152090000,2021,109666,145534,255200,MKT
06090301152090000,2020,64617,174283,238900,MKT
06090301152090000,2019,64617,174283,238900,MKT
06090301152100000,2021,116944,135556,252500,MKT
06090301152100000,2020,68554,158446,227000,MKT
06090301152100000,2019,68554,158446,227000,MKT
06090301201010000,2021,1714924,47220,1762144,COST
06090301201010000,2020,8646803,47560,8694363,COST
06090301201010000,2019,8646803,47560,8694363,COST
06090301201020000,2021,384997,0,384997,COST
06090301201020000,2020,647333,0,647333,COST
06090301201020000,2019,647333,0,647333,COST
06090301201040000,2021,494155,1764345,2258500,INCOME
06090301201040000,2020,955238,1279162,2234400,INCOME
06090301201040000,2019,955238,1279162,2234400,INCOME
06090301201040900,2021,192468,231432,423900,INCOME
06090301201040900,2020,70672,283228,353900,INCOME
06090301201040900,2019,70672,283228,353900,INCOME
06090301201055004,2021,78727,122873,201600,MKT
06090301201055004,2020,47336,132764,180100,MKT
06090301201055004,2019,47336,127164,174500,MKT
06090301201065003,2021,65772,128428,194200,MKT
06090301201065003,2020,35996,130704,166700,MKT
06090301201065003,2019,35996,130704,166700,MKT
06090301201075002,2021,65772,128428,194200,MKT
06090301201075002,2020,35996,130704,166700,MKT
06090301201075002,2019,35996,130704,166700,MKT
06090301201085001,2021,75295,139205,214500,MKT
06090301201085001,2020,44229,156571,200800,MKT
06090301201085001,2019,44229,156571,200800,MKT
06090301201095001,2021,75566,142334,217900,MKT
06090301201095001,2020,44471,157029,201500,MKT
06090301201095001,2019,44471,138729,183200,MKT
06090301201105002,2021,65772,130028,195800,MKT
06090301201105002,2020,35996,140704,176700,MKT
06090301201105002,2019,35996,140704,176700,MKT
06090301201115003,2021,65772,128928,194700,MKT
06090301201115003,2020,35996,139704,175700,MKT
06090301201115003,2019,35996,139704,175700,MKT
06090301201125004,2021,78489,132511,211000,MKT
06090301201125004,2020,47119,150181,197300,MKT
06090301201125004,2019,47119,150181,197300,MKT
06090301201130000,2021,89308,156692,246000,INCOME
06090301201130000,2020,53489,184011,237500,INCOME
06090301201130000,2019,53489,184011,237500,INCOME
06090301201140000,2021,89308,224892,314200,INCOME
06090301201140000,2020,53489,246811,300300,INCOME
06090301201140000,2019,53489,246811,300300,INCOME
06090301201155002,2021,85759,202941,288700,MKT
06090301201155002,2020,53926,167110,221036,COST
06090301201155002,2019,53926,167110,221036,COST
06090301201165001,2021,84838,199462,284300,MKT
06090301201165001,2020,53046,163700,216746,COST
06090301201165001,2019,53046,163700,216746,COST
06090301201175001,2021,84838,107362,192200,MKT
06090301201175001,2020,53046,117654,170700,OVR
06090301201175001,2019,53046,117654,170700,MKT
06090301201185002,2021,85303,115497,200800,MKT
06090301201185002,2020,53489,123511,177000,MKT
06090301201185002,2019,53489,123511,177000,MKT
06090301201195001,2021,76097,140103,216200,MKT
06090301201195001,2020,44949,138860,183809,COST
06090301201195001,2019,44949,138860,183809,COST
06090301201205002,2021,68718,139982,208700,MKT
06090301201205002,2020,38481,138610,177091,COST
06090301201205002,2019,38481,138610,177091,COST
06090301201215001,2021,68712,139588,208300,MKT
06090301201215001,2020,38475,144925,183400,MKT
06090301201215001,2019,38475,144925,183400,MKT
06090301201225002,2021,73979,139621,213600,MKT
06090301201225002,2020,43057,135150,178207,COST
06090301201225002,2019,43057,135150,178207,COST
06090301201235001,2021,79137,139963,219100,MKT
06090301201235001,2020,47713,152287,200000,MKT
06090301201235001,2019,47713,152287,200000,MKT
06090301201245002,2021,73245,140155,213400,MKT
06090301201245002,2020,42408,146292,188700,MKT
06090301201245002,2019,42408,146292,188700,MKT
06090301201255003,2021,79137,139963,219100,MKT
06090301201255003,2020,47713,152287,200000,MKT
06090301201255003,2019,47713,152287,200000,MKT
06090301201290000,2021,187164,236736,423900,INCOME
06090301201290000,2020,69126,284774,353900,INCOME
06090301201290000,2019,69126,284774,353900,INCOME
06090301201350000,2021,187164,236736,423900,INCOME
06090301201350000,2020,69126,345274,414400,INCOME
06090301201350000,2019,69126,345274,414400,INCOME
06090301201360000,2021,187164,304936,492100,INCOME
06090301201360000,2020,69126,345274,414400,INCOME
06090301201360000,2019,69126,345274,414400,INCOME
06090301201440000,2021,118006,177694,295700,INCOME
06090301201440000,2020,69126,211174,280300,INCOME
06090301201440000,2019,69126,211174,280300,INCOME
06090301202110000,2021,140568,96332,236900,MKT
06090301202110000,2020,92573,115227,207800,MKT
06090301202110000,2019,92573,115227,207800,MKT
06090301202130000,2021,149959,211741,361700,MKT
06090301202130000,2020,98250,229950,328200,MKT
06090301202130000,2019,98250,229950,328200,MKT
06090301203010000,2021,112750,99150,211900,INCOME
06090301203010000,2020,66288,140912,207200,INCOME
06090301203010000,2019,66288,140912,207200,INCOME
06090301203030000,2021,177806,192420,370226,COST
06090301203030000,2020,66377,185090,251467,COST
06090301203030000,2019,66377,247423,313800,INCOME
06090301203060000,2021,114660,227340,342000,MKT
06090301203060000,2020,67320,214380,281700,MKT
06090301203060000,2019,67320,206180,273500,MKT
06090301203090000,2021,116004,174196,290200,MKT
06090301203090000,2020,68046,190354,258400,MKT
06090301203090000,2019,68046,190354,258400,MKT
06090301203120000,2021,111388,216912,328300,MKT
06090301203120000,2020,65550,202350,267900,MKT
06090301203120000,2019,65550,202350,267900,MKT
06090301203160000,2021,113512,210788,324300,MKT
06090301203160000,2020,66700,199700,266400,MKT
06090301203160000,2019,66700,199700,266400,MKT
06090301203190000,2021,109245,252050,361295,COST
06090301203190000,2020,64389,234111,298500,OVR
06090301203190000,2019,64389,234111,298500,MKT
06090301203220000,2021,106963,211637,318600,MKT
06090301203220000,2020,63150,206550,269700,MKT
06090301203220000,2019,63150,199350,262500,MKT
06090301203250000,2021,123047,193353,316400,MKT
06090301203250000,2020,71840,183860,255700,MKT
06090301203250000,2019,71840,183860,255700,MKT
06090301203280000,2021,110654,212946,323600,MKT
06090301203280000,2020,65153,205047,270200,MKT
06090301203280000,2019,65153,205047,270200,MKT
06090301203310000,2021,100587,157213,257800,MKT
06090301203310000,2020,64451,185049,249500,MKT
06090301203310000,2019,64451,185049,249500,MKT
06090301203350000,2021,113874,205626,319500,MKT
06090301203350000,2020,72247,193553,265800,MKT
06090301203350000,2019,72247,193553,265800,MKT
06090301203390000,2021,115714,277486,393200,MKT
06090301203390000,2020,73321,256879,330200,MKT
06090301203390000,2019,73321,256879,330200,MKT
06090301203416500,2021,51757,0,51757,COST
06090301203416500,2020,98051,0,98051,COST
06090301203416500,2019,98051,0,98051,COST
06090301203436500,2021,87411,0,87411,COST
06090301203436500,2020,158831,0,158831,COST
06090301203436500,2019,158831,0,158831,COST
06090301203470000,2021,114864,274436,389300,MKT
06090301203470000,2020,67431,269669,337100,MKT
06090301203470000,2019,67431,269669,337100,MKT
06090301203490000,2021,127903,293697,421600,INCOME
06090301203490000,2020,74445,324355,398800,INCOME
06090301203490000,2019,74445,324355,398800,INCOME
06090301203510000,2021,102149,321751,423900,INCOME
06090301203510000,2020,60529,353871,414400,INCOME
06090301203510000,2019,60529,353871,414400,INCOME
06090301203530000,2021,102149,321751,423900,INCOME
06090301203530000,2020,60529,353871,414400,INCOME
06090301203530000,2019,60529,353871,414400,INCOME
06090301203550000,2021,102149,325651,427800,INCOME
06090301203550000,2020,60529,343371,403900,INCOME
06090301203550000,2019,60529,343371,403900,INCOME
06090301203580000,2021,104669,319231,423900,INCOME
06090301203580000,2020,61902,352498,414400,INCOME
06090301203580000,2019,61902,352498,414400,INCOME
06090301203610000,2021,164172,349128,513300,INCOME
06090301203610000,2020,67469,417331,484800,INCOME
06090301203610000,2019,67469,417331,484800,INCOME
06090301203630000,2021,159583,6060,165643,COST
06090301203630000,2020,60934,0,60934,COST
06090301203630000,2019,60934,0,60934,COST
06090301203650000,2021,159583,368817,528400,INCOME
06090301203650000,2020,60934,441066,502000,INCOME
06090301203650000,2019,60934,441066,502000,INCOME
06090301203670000,2021,159642,368758,528400,INCOME
06090301203670000,2020,60952,441048,502000,INCOME
06090301203670000,2019,60952,441048,502000,INCOME
06090301203710000,2021,108481,176419,284900,MKT
06090301203710000,2020,63974,183626,247600,MKT
06090301203710000,2019,63974,183626,247600,MKT
06090301203750000,2021,129570,190330,319900,MKT
06090301203750000,2020,81365,202235,283600,MKT
06090301203750000,2019,81365,202235,283600,MKT
06090301203770000,2021,102149,185151,287300,MKT
06090301203770000,2020,65372,191428,256800,MKT
06090301203770000,2019,65372,191428,256800,MKT
06090301203800000,2021,102149,157051,259200,MKT
06090301203800000,2020,65372,176328,241700,MKT
06090301203800000,2019,65372,176328,241700,MKT
06090301203830000,2021,102149,174451,276600,MKT
06090301203830000,2020,65372,193628,259000,MKT
06090301203830000,2019,65372,193628,259000,MKT
06090301203850000,2021,102149,180651,282800,MKT
06090301203850000,2020,60529,200071,260600,MKT
06090301203850000,2019,60529,200071,260600,MKT
06090301203870000,2021,102149,196251,298400,MKT
06090301203870000,2020,60529,213771,274300,MKT
06090301203870000,2019,60529,213771,274300,MKT
06090301203900000,2021,104795,213805,318600,MKT
06090301203900000,2020,61971,197129,259100,MKT
06090301203900000,2019,61971,197129,259100,MKT
06090301203930000,2021,111863,224137,336000,MKT
06090301203930000,2020,65807,216393,282200,MKT
06090301203930000,2019,65807,207193,273000,MKT
06090301203960000,2021,107536,171664,279200,MKT
06090301203960000,2020,63461,184339,247800,MKT
06090301203960000,2019,63461,184339,247800,MKT
06090301205010000,2021,118848,161252,280100,INCOME
06090301205010000,2020,69581,189919,259500,INCOME
06090301205010000,2019,69581,189919,259500,INCOME
06090301205030000,2021,116293,163807,280100,INCOME
06090301205030000,2020,68202,201898,270100,INCOME
06090301205030000,2019,68202,201898,270100,INCOME
06090301205055002,2021,84553,106047,190600,MKT
06090301205055002,2020,52774,116426,169200,MKT
06090301205055002,2019,52774,115126,167900,MKT
06090301205075001,2021,84553,105747,190300,MKT
06090301205075001,2020,52774,115326,168100,MKT
06090301205075001,2019,52774,115326,168100,MKT
06090301205095002,2021,84553,111947,196500,MKT
06090301205095002,2020,52774,121426,174200,MKT
06090301205095002,2019,52774,121426,174200,MKT
06090301205115001,2021,84553,110847,195400,MKT
06090301205115001,2020,52774,120226,173000,MKT
06090301205115001,2019,52774,120226,173000,MKT
06090301205130000,2021,212509,211391,423900,INCOME
06090301205130000,2020,76434,337966,414400,INCOME
06090301205130000,2019,76434,337966,414400,INCOME
06090301205150000,2021,227174,196726,423900,INCOME
06090301205150000,2020,80579,333821,414400,INCOME
06090301205150000,2019,80579,333821,414400,INCOME
06090301205170000,2021,119829,214171,334000,MKT
06090301205170000,2020,70109,198591,268700,MKT
06090301205170000,2019,70109,198591,268700,MKT
06090301205195002,2021,87768,165632,253400,MKT
06090301205195002,2020,55861,177439,233300,MKT
06090301205195002,2019,55861,177439,233300,MKT
06090301205205001,2021,83788,165012,248800,MKT
06090301205205001,2020,52049,175751,227800,MKT
06090301205205001,2019,52049,175751,227800,MKT
06090301205210000,2021,119516,142684,262200,INCOME
06090301205210000,2020,69940,203060,273000,INCOME
06090301205210000,2019,69940,203060,273000,INCOME
06090301205235001,2021,85911,219989,305900,MKT
06090301205235001,2020,54071,199629,253700,MKT
06090301205235001,2019,54071,194529,248600,MKT
06090301205235002,2021,85892,217908,303800,MKT
06090301205235002,2020,54052,194548,248600,OVR
06090301205235002,2019,54052,194548,248600,MKT
06090301205255002,2021,85695,176305,262000,MKT
06090301205255002,2020,53864,175036,228900,OVR
06090301205255002,2019,53864,175036,228900,MKT
06090301205265001,2021,85830,177570,263400,MKT
06090301205265001,2020,53994,177406,231400,OVR
06090301205265001,2019,53994,177406,231400,MKT
06090301205270000,2021,118886,267514,386400,INCOME
06090301205270000,2020,69601,268199,337800,INCOME
06090301205270000,2019,69601,268199,337800,INCOME
06090301205290000,2021,118568,198932,317500,INCOME
06090301205290000,2020,69430,239670,309100,INCOME
06090301205290000,2019,69430,239670,309100,INCOME
06090301205315001,2021,79112,161088,240200,MKT
06090301205315001,2020,47690,173610,221300,MKT
06090301205315001,2019,47690,173610,221300,MKT
06090301205325002,2021,79112,160688,239800,MKT
06090301205325002,2020,47690,173610,221300,MKT
06090301205325002,2019,47690,173610,221300,MKT
06090301205330000,2021,102149,189851,292000,MKT
06090301205330000,2020,60529,195771,256300,MKT
06090301205330000,2019,60529,195771,256300,MKT
06090301205350000,2021,102149,147551,249700,MKT
06090301205350000,2020,60529,164071,224600,MKT
06090301205350000,2019,60529,164071,224600,MKT
06090301205370000,2021,102149,145951,248100,MKT
06090301205370000,2020,60529,163971,224500,MKT
06090301205370000,2019,60529,163971,224500,MKT
06090301205390000,2021,102149,218751,320900,MKT
06090301205390000,2020,60529,208171,268700,MKT
06090301205390000,2019,60529,208171,268700,MKT
06090301205410000,2021,102145,224355,326500,MKT
06090301205410000,2020,60527,230473,291000,MKT
06090301205410000,2019,60527,214973,275500,MKT
06090301205430000,2021,107089,228811,335900,MKT
06090301205430000,2020,63218,226182,289400,MKT
06090301205430000,2019,63218,226182,289400,MKT
06090301205450000,2021,115919,183681,299600,MKT
06090301205450000,2020,68001,181699,249700,MKT
06090301205450000,2019,68001,181699,249700,MKT
06090301205470000,2021,102294,181406,283700,MKT
06090301205470000,2020,60608,170292,230900,MKT
06090301205470000,2019,60608,170292,230900,MKT
06090301205490000,2021,102149,194351,296500,MKT
06090301205490000,2020,60529,211671,272200,MKT
06090301205490000,2019,60529,211671,272200,MKT
06090301205510000,2021,102149,165651,267800,MKT
06090301205510000,2020,60529,164271,224800,MKT
06090301205510000,2019,60529,164271,224800,MKT
06090301205530000,2021,102149,165951,268100,MKT
06090301205530000,2020,60529,164371,224900,MKT
06090301205530000,2019,60529,164371,224900,MKT
06090301205550000,2021,104669,199031,303700,MKT
06090301205550000,2020,61902,180098,242000,MKT
06090301205550000,2019,61902,180098,242000,MKT
06090301206010000,2021,82449,275851,358300,MKT
06090301206010000,2020,74244,240256,314500,MKT
06090301206010000,2019,74244,240256,314500,MKT
06090301206030000,2021,88000,160900,248900,MKT
06090301206030000,2020,81991,183209,265200,MKT
06090301206030000,2019,81991,183209,265200,MKT
06090301206050000,2021,85365,165635,251000,MKT
06090301206050000,2020,78280,165420,243700,MKT
06090301206050000,2019,78280,165420,243700,MKT
06090301206070000,2021,91544,211060,302604,COST
06090301206070000,2020,87072,198570,285642,COST
06090301206070000,2019,87072,198570,285642,COST
06090301206080000,2021,85365,236435,321800,MKT
06090301206080000,2020,78280,227520,305800,MKT
06090301206080000,2019,78280,227520,305800,MKT
06090301206100000,2021,82025,189275,271300,MKT
06090301206100000,2020,73663,206737,280400,MKT
06090301206100000,2019,73663,206737,280400,MKT
06090301206110000,2021,82025,173175,255200,MKT
06090301206110000,2020,73663,163137,236800,OVR
06090301206110000,2019,73663,163137,236800,MKT
06090301206130000,2021,79011,303089,382100,INCOME
06090301206130000,2020,69580,284320,353900,INCOME
06090301206130000,2019,69580,284320,353900,INCOME
06090301206160000,2021,97066,133734,230800,MKT
06090301206160000,2020,95199,137101,232300,MKT
06090301206160000,2019,95199,137101,232300,MKT
06090301207010000,2021,104669,143131,247800,MKT
06090301207010000,2020,61902,175698,237600,MKT
06090301207010000,2019,61902,175698,237600,MKT
06090301207030000,2021,102149,203651,305800,MKT
06090301207030000,2020,60529,195871,256400,MKT
06090301207030000,2019,60529,195871,256400,MKT
06090301207050000,2021,102149,169351,271500,MKT
06090301207050000,2020,60529,190171,250700,MKT
06090301207050000,2019,60529,190171,250700,MKT
06090301207070000,2021,102149,182851,285000,MKT
06090301207070000,2020,60529,192371,252900,MKT
06090301207070000,2019,60529,192371,252900,MKT
06090301207090000,2021,104444,197856,302300,MKT
06090301207090000,2020,61780,194820,256600,MKT
06090301207090000,2019,61780,194820,256600,MKT
06090301207110000,2021,110243,190157,300400,MKT
06090301207110000,2020,64930,199470,264400,MKT
06090301207110000,2019,64930,199470,264400,MKT
06090301207130000,2021,103260,200740,304000,MKT
06090301207130000,2020,61135,191665,252800,MKT
06090301207130000,2019,61135,185965,247100,MKT
06090301207150000,2021,103260,161640,264900,MKT
06090301207150000,2020,61135,182765,243900,MKT
06090301207150000,2019,61135,182765,243900,MKT
06090301207170000,2021,102892,193608,296500,MKT
06090301207170000,2020,60934,187666,248600,OVR
06090301207170000,2019,60934,187666,248600,MKT
06090301207190000,2021,103260,219140,322400,MKT
06090301207190000,2020,61135,226565,287700,MKT
06090301207190000,2019,61135,226565,287700,MKT
06090301207210000,2021,105808,174292,280100,INCOME
06090301207210000,2020,62522,207578,270100,INCOME
06090301207210000,2019,62522,207578,270100,INCOME
06090301207230000,2021,104669,406831,511500,INCOME
06090301207230000,2020,61902,435798,497700,INCOME
06090301207230000,2019,61902,435798,497700,INCOME
06090301207250000,2021,102149,383851,486000,INCOME
06090301207250000,2020,60529,397671,458200,INCOME
06090301207250000,2019,60529,397671,458200,INCOME
06090301207270000,2021,102149,383851,486000,INCOME
06090301207270000,2020,60529,397671,458200,INCOME
06090301207270000,2019,60529,397671,458200,INCOME
06090301207290000,2021,102149,383851,486000,INCOME
06090301207290000,2020,60529,397671,458200,INCOME
06090301207290000,2019,60529,397671,458200,INCOME
06090301207310000,2021,102075,321825,423900,INCOME
06090301207310000,2020,60489,353911,414400,INCOME
06090301207310000,2019,60489,353911,414400,INCOME
06090301207335001,2021,75310,164690,240000,MKT
06090301207335001,2020,44242,182058,226300,MKT
06090301207335001,2019,44242,182058,226300,MKT
06090301207335002,2021,65586,156814,222400,MKT
06090301207335002,2020,35841,167259,203100,MKT
06090301207335002,2019,35841,167259,203100,MKT
06090301207335003,2021,76964,169236,246200,MKT
06090301207335003,2020,45731,182569,228300,MKT
06090301207335003,2019,45731,182569,228300,MKT
06090301207350000,2021,124864,535636,660500,INCOME
06090301207350000,2020,72816,566484,639300,INCOME
06090301207350000,2019,72816,566484,639300,INCOME
06090301207370000,2021,104426,271374,375800,INCOME
06090301207370000,2020,61770,311530,373300,INCOME
06090301207370000,2019,61770,311530,373300,INCOME
06090301207397000,2021,92956,0,92956,COST
06090301207397000,2020,60747,0,60747,COST
06090301207397000,2019,60747,0,60747,COST
06090301207420000,2021,102149,409351,511500,INCOME
06090301207420000,2020,60529,437171,497700,INCOME
06090301207420000,2019,60529,437171,497700,INCOME
06090301207457000,2021,92589,0,92589,COST
06090301207457000,2020,60527,0,60527,COST
06090301207457000,2019,60527,0,60527,COST
06090301207480000,2021,102149,325351,427500,INCOME
06090301207480000,2020,60529,349671,410200,INCOME
06090301207480000,2019,60529,349671,410200,INCOME
06090301207517000,2021,92589,0,92589,COST
06090301207517000,2020,60527,0,60527,COST
06090301207517000,2019,60527,0,60527,COST
06090301207540000,2021,104669,299431,404100,MKT
06090301207540000,2020,61902,307198,369100,OVR
06090301207540000,2019,61902,307198,369100,MKT
06090301207570000,2021,102149,203651,305800,MKT
06090301207570000,2020,60529,210971,271500,MKT
06090301207570000,2019,60529,210971,271500,MKT
06090301207600000,2021,102149,262851,365000,MKT
06090301207600000,2020,60529,258371,318900,MKT
06090301207600000,2019,60529,258371,318900,MKT
06090301207630000,2021,102149,220751,322900,MKT
06090301207630000,2020,60529,216171,276700,MKT
06090301207630000,2019,60529,216171,276700,MKT
06090301207660000,2021,102149,279951,382100,INCOME
06090301207660000,2020,60529,293371,353900,INCOME
06090301207660000,2019,60529,293371,353900,INCOME
06090301207690000,2021,108855,355245,464100,INCOME
06090301207690000,2020,64177,394023,458200,INCOME
06090301207690000,2019,64177,394023,458200,INCOME
06090301207720000,2021,127276,413324,540600,INCOME
06090301207720000,2020,74109,400791,474900,INCOME
06090301207720000,2019,74109,400791,474900,INCOME
06090301207750000,2021,123157,417443,540600,INCOME
06090301207750000,2020,71899,403001,474900,INCOME
06090301207750000,2019,71899,403001,474900,INCOME
06090301208010000,2021,97066,220480,317546,COST
06090301208010000,2020,95199,252601,347800,MKT
06090301208010000,2019,95199,252601,347800,MKT
06090301208050000,2021,85273,219327,304600,MKT
06090301208050000,2020,78152,191648,269800,MKT
06090301208050000,2019,78152,191648,269800,MKT
06090301208080000,2021,85273,286227,371500,INCOME
06090301208080000,2020,78152,279248,357400,INCOME
06090301208080000,2019,78152,279248,357400,INCOME
06090301208100000,2021,82025,233575,315600,MKT
06090301208100000,2020,73663,231237,304900,MKT
06090301208100000,2019,73663,231237,304900,MKT
06090301208120000,2021,85365,223435,308800,MKT
06090301208120000,2020,78280,193720,272000,MKT
06090301208120000,2019,78280,193720,272000,MKT
06090301208140000,2021,85365,259335,344700,MKT
06090301208140000,2020,78280,209920,288200,MKT
06090301208140000,2019,78280,209920,288200,MKT
06090301208160000,2021,85365,237735,323100,MKT
06090301208160000,2020,78280,200120,278400,MKT
06090301208160000,2019,78280,200120,278400,MKT
06090301208190000,2021,91544,206256,297800,MKT
06090301208190000,2020,87072,201828,288900,MKT
06090301208190000,2019,87072,144810,231882,COST
06090301208210000,2021,85365,155635,241000,MKT
06090301208210000,2020,78280,164620,242900,MKT
06090301208210000,2019,78280,164620,242900,MKT
06090301215010000,2021,82025,218875,300900,MKT
06090301215010000,2020,73663,185837,259500,MKT
06090301215010000,2019,73663,185837,259500,MKT
06090301215040000,2021,87962,221638,309600,MKT
06090301215040000,2020,81937,198263,280200,MKT
06090301215040000,2019,81937,198263,280200,MKT
06090301215060000,2021,95673,0,95673,COST
06090301215060000,2020,96152,0,96152,COST
06090301215060000,2019,96152,0,96152,COST
06090301215080000,2021,472116,0,472116,COST
06090301215080000,2020,1157752,0,1157752,COST
06090301215080000,2019,1157752,0,1157752,COST
06090301215160000,2021,618313,0,618313,COST
06090301215160000,2020,1762973,0,1762973,COST
06090301215160000,2019,1762973,0,1762973,COST
06090301216010000,2021,85365,487508,572873,MRA
06090301216010000,2020,78280,453973,532253,MRA
06090301216010000,2019,78280,453973,532253,MRA
06090301216040000,2021,77358,204742,282100,MKT
06090301216040000,2020,67375,190625,258000,MKT
06090301216040000,2019,67375,190625,258000,MKT
06090301216050000,2021,82449,159051,241500,MKT
06090301216050000,2020,74244,155756,230000,MKT
06090301216050000,2019,74244,155756,230000,MKT
06090301216070000,2021,77368,6170,83538,COST
06090301216070000,2020,67387,6300,73687,COST
06090301216070000,2019,67387,6300,73687,COST
06090301216080000,2021,88017,153160,241177,COST
06090301216080000,2020,82015,124870,206885,COST
06090301216080000,2019,82015,210985,293000,MKT
06090301216100000,2021,82025,234375,316400,MKT
06090301216100000,2020,73663,209537,283200,MKT
06090301216100000,2019,73663,209537,283200,MKT
06090301216120000,2021,87962,193838,281800,MKT
06090301216120000,2020,81937,186363,268300,MKT
06090301216120000,2019,81937,186363,268300,MKT
06090301216130000,2021,82025,204575,286600,MKT
06090301216130000,2020,73663,182037,255700,MKT
06090301216130000,2019,73663,182037,255700,MKT
06090301216140000,2021,70098,109802,179900,MKT
06090301216140000,2020,63401,46510,109911,COST
06090301216140000,2019,63401,46510,109911,COST
06090301216150000,2021,74332,230968,305300,MKT
06090301216150000,2020,63401,210599,274000,MKT
06090301216150000,2019,63401,210599,274000,MKT
06090301216160000,2021,74332,223468,297800,MKT
06090301216160000,2020,63401,194299,257700,MKT
06090301216160000,2019,63401,194299,257700,MKT
06090301225010000,2021,77358,177942,255300,MKT
06090301225010000,2020,67375,174925,242300,MKT
06090301225010000,2019,67375,174925,242300,MKT
06090301225020000,2021,77358,225142,302500,MKT
06090301225020000,2020,67375,196825,264200,MKT
06090301225020000,2019,67375,196825,264200,MKT
06090301225040000,2021,77358,97242,174600,MKT
06090301225040000,2020,67375,98725,166100,MKT
06090301225040000,2019,87072,105728,192800,MKT
06090301225050000,2021,77358,0,77358,COST
06090301225050000,2020,67375,0,67375,COST
06090301225060000,2021,91544,209456,301000,MKT
06090301225060000,2020,87072,191628,278700,MKT
06090301225060000,2019,87072,191628,278700,MKT
06090301225070000,2021,79467,144820,224287,COST
06090301225070000,2020,70193,136850,207043,COST
06090301225070000,2019,70193,136850,207043,COST
06090301225080000,2021,77358,310042,387400,MKT
06090301225080000,2020,67375,293725,361100,MKT
06090301225080000,2019,67375,293725,361100,MKT
06090301225100000,2021,84582,256818,341400,MKT
06090301225100000,2020,77189,267311,344500,MKT
06090301225100000,2019,77189,267311,344500,MKT
06090301225130000,2021,87962,285790,373752,COST
06090301225130000,2020,81937,155163,237100,MKT
06090301225130000,2019,81937,155163,237100,MKT
06090301225150000,2021,79518,0,79518,COST
06090301225150000,2020,70260,0,70260,COST
06090301225150000,2019,70260,0,70260,COST
06090301225160000,2021,79809,0,79809,COST
06090301225160000,2020,70652,0,70652,COST
06090301225160000,2019,70652,0,70652,COST
06090301225170000,2021,79809,18280,98089,COST
06090301225170000,2020,70652,18270,88922,COST
06090301225170000,2019,70652,18270,88922,COST
06090301242020000,2021,113004,167496,280500,MKT
06090301242020000,2020,66425,194775,261200,MKT
06090301242020000,2019,66425,194775,261200,MKT
06090301242030000,2021,118115,203685,321800,MKT
06090301242030000,2020,69185,199715,268900,MKT
06090301242030000,2019,69185,199715,268900,MKT
06090301242040000,2021,112548,178352,290900,MKT
06090301242040000,2020,66179,212221,278400,MKT
06090301242040000,2019,66179,212221,278400,MKT
06090301242050000,2021,112548,0,112548,COST
06090301242050000,2020,66179,0,66179,COST
06090301242050000,2019,66179,0,66179,COST
06090301242060000,2021,119756,144944,264700,MKT
06090301242060000,2020,70069,184931,255000,MKT
06090301242060000,2019,70069,184931,255000,MKT
06090301242070000,2021,106359,187141,293500,MKT
06090301242070000,2020,62822,205678,268500,MKT
06090301242070000,2019,62822,205678,268500,MKT
06090301242080000,2021,102177,181823,284000,MKT
06090301242080000,2020,60545,193955,254500,MKT
06090301242080000,2019,60545,193955,254500,MKT
06090301242090000,2021,102149,189851,292000,MKT
06090301242090000,2020,60529,195671,256200,MKT
06090301242090000,2019,60529,195671,256200,MKT
06090301242100000,2021,102149,181551,283700,MKT
06090301242100000,2020,60529,195771,256300,MKT
06090301242100000,2019,60529,195771,256300,MKT
06090301242110000,2021,102149,190751,292900,MKT
06090301242110000,2020,60529,198171,258700,MKT
06090301242110000,2019,60529,198171,258700,MKT
06090301242120000,2021,102149,240751,342900,MKT
06090301242120000,2020,60529,230671,291200,MKT
06090301242120000,2019,60529,230671,291200,MKT
06090301242130000,2021,102149,219251,321400,MKT
06090301242130000,2020,60529,217071,277600,MKT
06090301242130000,2019,60529,217071,277600,MKT
06090301242140000,2021,102149,208651,310800,MKT
06090301242140000,2020,60529,223071,283600,MKT
06090301242140000,2019,60529,207471,268000,MKT
06090301242190000,2021,112548,167552,280100,MKT
06090301242190000,2020,66179,181721,247900,MKT
06090301242190000,2019,66179,181721,247900,MKT
06090301243010000,2021,101196,168804,270000,MKT
06090301243010000,2020,60009,187091,247100,MKT
06090301243010000,2019,60009,187091,247100,MKT
06090301243020000,2021,107102,186298,293400,MKT
06090301243020000,2020,63225,223175,286400,OVR
06090301243020000,2019,63225,223175,286400,MKT
06090301243030000,2021,107102,167398,274500,MKT
06090301243030000,2020,63225,165475,228700,MKT
06090301243030000,2019,63225,165475,228700,MKT
06090301243040000,2021,107102,194498,301600,MKT
06090301243040000,2020,63225,178375,241600,MKT
06090301243040000,2019,63225,178375,241600,MKT
06090301243050000,2021,107098,180802,287900,MKT
06090301243050000,2020,63223,182177,245400,MKT
06090301243050000,2019,63223,182177,245400,MKT
06090301251010000,2021,103800,248800,352600,MKT
06090301251010000,2020,61429,261571,323000,MKT
06090301251010000,2019,61429,261571,323000,MKT
06090301251020000,2021,101314,195086,296400,MKT
06090301251020000,2020,60073,175727,235800,MKT
06090301251020000,2019,60073,175727,235800,MKT
06090301251030000,2021,101328,172372,273700,MKT
06090301251030000,2020,60081,190619,250700,MKT
06090301251030000,2019,60081,190619,250700,MKT
06090301251040000,2021,101328,167072,268400,MKT
06090301251040000,2020,60081,186919,247000,MKT
06090301251040000,2019,60081,186919,247000,MKT
06090301251050000,2021,101328,176172,277500,MKT
06090301251050000,2020,60081,184519,244600,MKT
06090301251050000,2019,60081,184519,244600,MKT
06090301251060000,2021,101328,161672,263000,MKT
06090301251060000,2020,60081,193519,253600,MKT
06090301251060000,2019,60081,193519,253600,MKT
06090301251070000,2021,101328,178072,279400,MKT
06090301251070000,2020,60081,205019,265100,MKT
06090301251070000,2019,60081,205019,265100,MKT
06090301251080000,2021,101328,213272,314600,MKT
06090301251080000,2020,60081,226219,286300,MKT
06090301251080000,2019,60081,226219,286300,MKT
06090301251090000,2021,101328,190572,291900,MKT
06090301251090000,2020,60081,202819,262900,MKT
06090301251090000,2019,60081,202819,262900,MKT
06090301251100000,2021,101328,148572,249900,MKT
06090301251100000,2020,60081,173419,233500,MKT
06090301251100000,2019,60081,173419,233500,MKT
06090301251110000,2021,103991,190009,294000,MKT
06090301251110000,2020,61533,197467,259000,MKT
06090301251110000,2019,61533,197467,259000,MKT
06090301251120000,2021,101328,205472,306800,MKT
06090301251120000,2020,60081,198219,258300,MKT
06090301251120000,2019,60081,198219,258300,MKT
06090301251130000,2021,103991,172609,276600,MKT
06090301251130000,2020,61533,180967,242500,MKT
06090301251130000,2019,61533,180967,242500,MKT
06090301251140000,2021,101328,199772,301100,MKT
06090301251140000,2020,60081,222619,282700,MKT
06090301251140000,2019,60081,222619,282700,MKT
06090301251150000,2021,103991,217309,321300,MKT
06090301251150000,2020,61533,219667,281200,MKT
06090301251150000,2019,61533,219667,281200,MKT
06090301251160000,2021,109863,182837,292700,MKT
06090301251160000,2020,64724,210076,274800,MKT
06090301251160000,2019,64724,210076,274800,MKT
06090301252020000,2021,142530,244070,386600,MKT
06090301252020000,2020,82247,255153,337400,MKT
06090301252020000,2019,82247,255153,337400,MKT
06090301252030000,2021,106055,160545,266600,MKT
06090301252030000,2020,62656,168344,231000,MKT
06090301252030000,2019,62656,168344,231000,MKT
06090301252040000,2021,103991,181409,285400,MKT
06090301252040000,2020,61533,185367,246900,MKT
06090301252040000,2019,61533,185367,246900,MKT
06090301252050000,2021,109033,185267,294300,MKT
06090301252050000,2020,64274,192526,256800,MKT
06090301252050000,2019,64274,192526,256800,MKT
06090301252060000,2021,109033,225867,334900,MKT
06090301252060000,2020,64274,222026,286300,MKT
06090301252060000,2019,64274,222026,286300,MKT
06090301252070000,2021,108524,229676,338200,MKT
06090301252070000,2020,63997,233603,297600,MKT
06090301252070000,2019,63997,211303,275300,MKT
06090301252080000,2021,108053,208247,316300,MKT
06090301252080000,2020,63742,192558,256300,MKT
06090301252080000,2019,63742,192558,256300,MKT
06090301252090000,2021,108053,131890,239943,COST
06090301252090000,2020,63742,108960,172702,COST
06090301252090000,2019,63742,108960,172702,COST
06090301258010000,2021,104494,224906,329400,MKT
06090301258010000,2020,61807,227893,289700,MKT
06090301258010000,2019,61807,227893,289700,MKT
06090301258020000,2021,100735,173965,274700,MKT
06090301258020000,2020,59757,181043,240800,MKT
06090301258020000,2019,59757,181043,240800,MKT
06090301258030000,2021,98310,174390,272700,MKT
06090301258030000,2020,58432,179568,238000,MKT
06090301258030000,2019,58432,179568,238000,MKT
06090301258040000,2021,100735,184765,285500,MKT
06090301258040000,2020,59757,178743,238500,MKT
06090301258040000,2019,59757,178743,238500,MKT
06090301258050000,2021,98310,177690,276000,MKT
06090301258050000,2020,58432,184468,242900,MKT
06090301258050000,2019,58432,184468,242900,MKT
06090301258060000,2021,100735,186965,287700,MKT
06090301258060000,2020,59757,196543,256300,MKT
06090301258060000,2019,59757,196543,256300,MKT
06090301258070000,2021,98310,146990,245300,MKT
06090301258070000,2020,58432,158368,216800,MKT
06090301258070000,2019,58432,158368,216800,MKT
06090301258080000,2021,100735,170365,271100,MKT
06090301258080000,2020,59757,192043,251800,MKT
06090301258080000,2019,59757,192043,251800,MKT
06090301258090000,2021,98310,161990,260300,MKT
06090301258090000,2020,58432,175068,233500,MKT
06090301258090000,2019,58432,175068,233500,MKT
06090301258100000,2021,98310,173790,272100,MKT
06090301258100000,2020,58432,181168,239600,MKT
06090301258100000,2019,58432,181168,239600,MKT
06090301260010000,2021,97414,159886,257300,MKT
06090301260010000,2020,57942,155558,213500,MKT
06090301260010000,2019,57942,155558,213500,MKT
06090301260020000,2021,96486,216214,312700,MKT
06090301260020000,2020,57434,206866,264300,MKT
06090301260020000,2019,57434,206866,264300,MKT
06090301260030000,2021,96486,242414,338900,MKT
06090301260030000,2020,57434,243866,301300,MKT
06090301260030000,2019,57434,243866,301300,MKT
06090301260040000,2021,96486,233314,329800,MKT
06090301260040000,2020,57434,228166,285600,MKT
06090301260040000,2019,57434,228166,285600,MKT
06090301260050000,2021,96486,249814,346300,MKT
06090301260050000,2020,57434,250966,308400,MKT
06090301260050000,2019,57434,250966,308400,MKT
06090301260060000,2021,96486,135314,231800,MKT
06090301260060000,2020,57434,152366,209800,MKT
06090301260060000,2019,57434,152366,209800,MKT
06090301260070000,2021,96486,209214,305700,MKT
06090301260070000,2020,57434,196766,254200,MKT
06090301260070000,2019,57434,196766,254200,MKT
06090301260080000,2021,96486,178014,274500,MKT
06090301260080000,2020,57434,180166,237600,MKT
06090301260080000,2019,57434,180166,237600,MKT
06090301260090000,2021,96486,210414,306900,MKT
06090301260090000,2020,57434,192466,249900,MKT
06090301260090000,2019,57434,192466,249900,MKT
06090301260100000,2021,96952,208648,305600,MKT
06090301260100000,2020,57689,218411,276100,MKT
06090301260100000,2019,57689,218411,276100,MKT
06090301262010000,2021,96952,174148,271100,MKT
06090301262010000,2020,57689,193411,251100,MKT
06090301262010000,2019,57689,193411,251100,MKT
06090301262020000,2021,96486,202314,298800,MKT
06090301262020000,2020,57434,202566,260000,MKT
06090301262020000,2019,57434,202566,260000,MKT
06090301262030000,2021,96486,231014,327500,MKT
06090301262030000,2020,57434,239866,297300,OVR
06090301262030000,2019,57434,239866,297300,MKT
06090301262040000,2021,96486,174114,270600,MKT
06090301262040000,2020,57434,193766,251200,MKT
06090301262040000,2019,57434,193766,251200,MKT
06090301262050000,2021,96486,221314,317800,MKT
06090301262050000,2020,57434,212066,269500,MKT
06090301262050000,2019,57434,212066,269500,MKT
06090301262060000,2021,96486,213014,309500,MKT
06090301262060000,2020,57434,206566,264000,MKT
06090301262060000,2019,57434,206566,264000,MKT
06090301262070000,2021,96486,177114,273600,MKT
06090301262070000,2020,57434,193866,251300,MKT
06090301262070000,2019,57434,193866,251300,MKT
06090301262080000,2021,96486,221714,318200,MKT
06090301262080000,2020,57434,213266,270700,MKT
06090301262080000,2019,57434,213266,270700,MKT
06090301262090000,2021,96486,199514,296000,MKT
06090301262090000,2020,57434,192766,250200,MKT
06090301262090000,2019,57434,192766,250200,MKT
06090301262100000,2021,97414,172486,269900,MKT
06090301262100000,2020,57942,174558,232500,MKT
06090301262100000,2019,57942,174558,232500,MKT
06090301263010000,2021,106618,167182,273800,MKT
06090301263010000,2020,62962,200138,263100,MKT
06090301263010000,2019,62962,200138,263100,MKT
06090301263020000,2021,99329,186671,286000,MKT
06090301263020000,2020,58990,172710,231700,MKT
06090301263020000,2019,58990,172710,231700,MKT
06090301263030000,2021,99494,241806,341300,MKT
06090301263030000,2020,59080,233720,292800,MKT
06090301263030000,2019,59080,233720,292800,MKT
06090301263040000,2021,99659,230741,330400,MKT
06090301263040000,2020,59170,233530,292700,MKT
06090301263040000,2019,59170,233530,292700,MKT
06090301263050000,2021,99824,176076,275900,MKT
06090301263050000,2020,59260,186240,245500,MKT
06090301263050000,2019,59260,186240,245500,MKT
06090301263060000,2021,99992,194508,294500,MKT
06090301263060000,2020,59352,163248,222600,MKT
06090301263060000,2019,59352,163248,222600,MKT
06090301263070000,2021,100156,195444,295600,MKT
06090301263070000,2020,59441,191659,251100,MKT
06090301263070000,2019,59441,191659,251100,MKT
06090301263080000,2021,100324,202176,302500,MKT
06090301263080000,2020,59533,222067,281600,MKT
06090301263080000,2019,59533,222067,281600,MKT
06090301263090000,2021,100487,195413,295900,MKT
06090301263090000,2020,59622,240578,300200,MKT
06090301263090000,2019,59622,176320,235942,COST
06090301263100000,2021,100654,201946,302600,MKT
06090301263100000,2020,59713,214387,274100,MKT
06090301263100000,2019,59713,214387,274100,MKT
06090301265010000,2021,100768,215532,316300,MKT
06090301265010000,2020,59776,220924,280700,MKT
06090301265010000,2019,59776,220924,280700,MKT
06090301265020000,2021,100773,197327,298100,MKT
06090301265020000,2020,59778,189422,249200,MKT
06090301265020000,2019,59778,189422,249200,MKT
06090301265030000,2021,100768,172232,273000,MKT
06090301265030000,2020,59776,191324,251100,MKT
06090301265030000,2019,59776,191324,251100,MKT
06090301265040000,2021,100773,214027,314800,MKT
06090301265040000,2020,59778,206122,265900,MKT
06090301265040000,2019,59778,206122,265900,MKT
06090301265050000,2021,100773,152127,252900,MKT
06090301265050000,2020,59778,165822,225600,MKT
06090301265050000,2019,59778,165822,225600,MKT
06090301265060000,2021,100773,230527,331300,MKT
06090301265060000,2020,59778,225022,284800,MKT
06090301265060000,2019,59778,225022,284800,MKT
06090301265070000,2021,100773,189227,290000,MKT
06090301265070000,2020,59778,182222,242000,MKT
06090301265070000,2019,59778,182222,242000,MKT
06090301265080000,2021,100773,155027,255800,MKT
06090301265080000,2020,59778,166622,226400,MKT
06090301265080000,2019,59778,166622,226400,MKT
06090301265090000,2021,100773,188327,289100,MKT
06090301265090000,2020,59778,170222,230000,MKT
06090301265090000,2019,59778,170222,230000,MKT
06090301265100000,2021,102698,235402,338100,MKT
06090301265100000,2020,60828,213672,274500,MKT
06090301265100000,2019,60828,213672,274500,MKT
06090301265110000,2021,102966,205834,308800,MKT
06090301265110000,2020,60974,197926,258900,MKT
06090301265110000,2019,60974,197926,258900,MKT
06090301265120000,2021,100768,233532,334300,MKT
06090301265120000,2020,59776,223924,283700,MKT
06090301265120000,2019,59776,223924,283700,MKT
06090301265130000,2021,100768,251132,351900,MKT
06090301265130000,2020,59776,247724,307500,MKT
06090301265130000,2019,59776,247724,307500,MKT
06090301265140000,2021,100768,188232,289000,MKT
06090301265140000,2020,59776,186324,246100,MKT
06090301265140000,2019,59776,186324,246100,MKT
06090301265150000,2021,100768,145232,246000,MKT
06090301265150000,2020,59776,159224,219000,MKT
06090301265150000,2019,59776,159224,219000,MKT
06090301265160000,2021,100768,245832,346600,MKT
06090301265160000,2020,59776,233124,292900,MKT
06090301265160000,2019,59776,233124,292900,MKT
06090301265170000,2021,100768,197932,298700,MKT
06090301265170000,2020,59776,207624,267400,MKT
06090301265170000,2019,59776,207624,267400,MKT
06090301265180000,2021,100768,163932,264700,MKT
06090301265180000,2020,59776,178524,238300,MKT
06090301265180000,2019,59776,178524,238300,MKT
06090301265190000,2021,100768,255632,356400,MKT
06090301265190000,2020,59776,247024,306800,MKT
06090301265190000,2019,59776,247024,306800,MKT
06090301265200000,2021,101441,243659,345100,MKT
06090301265200000,2020,60143,234057,294200,MKT
06090301265200000,2019,60143,234057,294200,MKT
06090301267010000,2021,108481,179019,287500,MKT
06090301267010000,2020,63974,168426,232400,MKT
06090301267010000,2019,63974,168426,232400,MKT
06090301267020000,2021,107756,221244,329000,MKT
06090301267020000,2020,63581,211419,275000,MKT
06090301267020000,2019,63581,211419,275000,MKT
06090301267030000,2021,107756,191544,299300,MKT
06090301267030000,2020,63581,202219,265800,MKT
06090301267030000,2019,63581,168519,232100,MKT
06090301267040000,2021,107756,226344,334100,MKT
06090301267040000,2020,63581,224319,287900,MKT
06090301267040000,2019,63581,203719,267300,MKT
06090301267050000,2021,107756,210544,318300,MKT
06090301267050000,2020,63581,193619,257200,MKT
06090301267050000,2019,63581,193619,257200,MKT
06090301267060000,2021,107756,286844,394600,MKT
06090301267060000,2020,63581,266019,329600,MKT
06090301267060000,2019,63581,210440,274021,COST
06090301267070000,2021,107756,248744,356500,MKT
06090301267070000,2020,63581,240419,304000,MKT
06090301267070000,2019,63581,240419,304000,MKT
06090301267080000,2021,107756,240144,347900,MKT
06090301267080000,2020,63581,239019,302600,MKT
06090301267080000,2019,63581,221819,285400,MKT
06090301267090000,2021,107756,238844,346600,MKT
06090301267090000,2020,63581,219419,283000,MKT
06090301267090000,2019,63581,219419,283000,MKT
06090301267100000,2021,109334,209066,318400,MKT
06090301267100000,2020,64437,216963,281400,MKT
06090301267100000,2019,64437,216963,281400,MKT
06090301301010000,2021,691837,0,691837,COST
06090301301010000,2020,768273,0,768273,COST
06090301301010000,2019,768273,0,768273,COST
06090301303010000,2021,986021,2133879,3119900,INCOME
06090301303010000,2020,1334715,928685,2263400,INCOME
06090301303010000,2019,1334715,928685,2263400,INCOME
06090301303020000,2021,778236,959464,1737700,INCOME
06090301303020000,2020,922959,520041,1443000,INCOME
06090301303020000,2019,922959,520041,1443000,INCOME
06090301303030000,2021,200002,523998,724000,INCOME
06090301303030000,2020,233220,384980,618200,INCOME
06090301303030000,2019,233220,384980,618200,INCOME
06090301303050000,2021,228305,378495,606800,INCOME
06090301303050000,2020,286660,299040,585700,INCOME
06090301303050000,2019,286660,299040,585700,INCOME
06090301304010000,2021,264915,318985,583900,INCOME
06090301304010000,2020,361455,107145,468600,INCOME
06090301304010000,2019,361455,107145,468600,INCOME
06090301305010000,2021,281411,519789,801200,INCOME
06090301305010000,2020,397145,369155,766300,INCOME
06090301305010000,2019,397145,369155,766300,INCOME
06090301305090000,2021,203507,70893,274400,INCOME
06090301305090000,2020,239623,13077,252700,INCOME
06090301305090000,2019,239623,13077,252700,INCOME
06090301305100000,2021,82025,167975,250000,MKT
06090301305100000,2020,73663,182737,256400,MKT
06090301305100000,2019,73663,182737,256400,MKT
06090301305140000,2021,195931,5000,200931,COST
06090301305140000,2020,88885,4860,93745,COST
06090301305140000,2019,88885,4860,93745,COST
06090301305150000,2021,87962,0,87962,COST
06090301305150000,2020,81937,0,81937,COST
06090301305150000,2019,81937,0,81937,COST
06090301305180000,2021,87962,241838,329800,MKT
06090301305180000,2020,81937,244363,326300,MKT
06090301305180000,2019,81937,244363,326300,MKT
06090301306010000,2021,89449,240751,330200,MKT
06090301306010000,2020,84055,218545,302600,MKT
06090301306010000,2019,84055,218545,302600,MKT
06090301306020000,2021,238182,191218,429400,INCOME
06090301306020000,2020,306225,94110,400335,COST
06090301306020000,2019,306225,94110,400335,COST
06090301306050000,2021,88544,162656,251200,MKT
06090301306050000,2020,82763,174537,257300,MKT
06090301306050000,2019,82763,174537,257300,MKT
06090301306060000,2021,92789,164311,257100,MKT
06090301306060000,2020,88883,180617,269500,MKT
06090301306060000,2019,88883,180617,269500,MKT
06090301306070000,2021,240293,277207,517500,INCOME
06090301306070000,2020,310466,85734,396200,INCOME
06090301306070000,2019,310466,65334,375800,INCOME
06090301306090000,2021,83348,174330,257678,COST
06090301306090000,2020,75481,167210,242691,COST
06090301306090000,2019,75481,167210,242691,COST
06090301306110000,2021,78039,113350,191389,COST
06090301306110000,2020,68280,105610,173890,COST
06090301306110000,2019,103349,105610,208959,COST
06090301306120000,2021,241131,136810,377941,COST
06090301306120000,2020,312156,127540,439696,COST
06090301306120000,2019,312156,127540,439696,COST
06090301306150000,2021,94986,263060,358046,COST
06090301306150000,2020,92109,245750,337859,COST
06090301306150000,2019,92109,245750,337859,COST
06090301306202000,2021,164101,0,164101,COST
06090301306202000,2020,335752,0,335752,COST
06090301306202000,2019,335752,0,335752,COST
06090301306210000,2021,711803,2137297,2849100,INCOME
06090301306210000,2020,1687247,864853,2552100,INCOME
06090301306210000,2019,1687247,864853,2552100,INCOME
06090301307010000,2021,91172,184728,275900,MKT
06090301307010000,2020,86535,147765,234300,OVR
06090301307010000,2019,86535,147765,234300,MKT
06090301307040000,2021,171869,252031,423900,INCOME
06090301307040000,2020,73663,340737,414400,INCOME
06090301307040000,2019,73663,340737,414400,INCOME
06090301307070000,2021,237661,0,237661,COST
06090301307070000,2020,95199,0,95199,COST
06090301307070000,2019,95199,0,95199,COST
06090301307100000,2021,231091,659209,890300,INCOME
06090301307100000,2020,93111,689689,782800,INCOME
06090301307100000,2019,93111,689689,782800,INCOME
06090301308010000,2021,70864,0,70864,COST
06090301308010000,2020,58951,0,58951,COST
06090301308010000,2019,58951,0,58951,COST
06090301309010000,2021,84210,200590,284800,MKT
06090301309010000,2020,76673,196627,273300,MKT
06090301309010000,2019,76673,196627,273300,MKT
06090301309110000,2021,318112,1089988,1408100,INCOME
06090301309110000,2020,119902,1449298,1569200,INCOME
06090301309110000,2019,119902,1449298,1569200,INCOME
06090301309150000,2021,86914,236886,323800,MKT
06090301309150000,2020,80455,192345,272800,MKT
06090301309150000,2019,80455,192345,272800,MKT
06090301309230000,2021,86393,267607,354000,MKT
06090301309230000,2020,79721,209579,289300,MKT
06090301309230000,2019,79721,209579,289300,MKT
06090301309250000,2021,84210,251690,335900,MKT
06090301309250000,2020,76673,202527,279200,OVR
06090301309250000,2019,76673,202527,279200,MKT
06090301309300000,2021,75367,147433,222800,MKT
06090301309300000,2020,64751,130349,195100,MKT
06090301309300000,2019,64751,130349,195100,MKT
06090301309320000,2021,75367,156533,231900,MKT
06090301309320000,2020,64751,143349,208100,MKT
06090301309320000,2019,64751,143349,208100,MKT
06090301309340000,2021,76619,170081,246700,MKT
06090301309340000,2020,66396,159104,225500,MKT
06090301309340000,2019,66396,159104,225500,MKT
06090301310012000,2021,584994,0,584994,COST
06090301310012000,2020,379828,0,379828,COST
06090301310012000,2019,379828,0,379828,COST
06090301311010000,2021,90862,146938,237800,MKT
06090301311010000,2020,86087,163713,249800,MKT
06090301311010000,2019,86087,163713,249800,MKT
06090301311030000,2021,289399,711930,1001329,COST
06090301311030000,2020,163260,661540,824800,INCOME
06090301311030000,2019,163260,661540,824800,INCOME
06090301311120000,2021,361518,0,361518,COST
06090301311120000,2020,230947,0,230947,COST
06090301311120000,2019,230947,0,230947,COST
06090301312060000,2021,232000,811090,1043090,COST
06090301312060000,2020,293925,774740,1068665,COST
06090301312060000,2019,293925,774740,1068665,COST
06090301312080000,2021,168023,0,168023,COST
06090301312080000,2020,177753,0,177753,COST
06090301312080000,2019,177753,0,177753,COST
06090301312130000,2021,142119,59070,201189,COST
06090301312130000,2020,53883,56140,110023,COST
06090301312130000,2019,53883,56140,110023,COST
06090301312150000,2021,271882,1880,273762,COST
06090301312150000,2020,148119,4850,152969,COST
06090301312150000,2019,148119,4850,152969,COST
06090301312180000,2021,74332,165868,240200,MKT
06090301312180000,2020,63401,164299,227700,MKT
06090301312180000,2019,63401,164299,227700,MKT
06090301317480000,2021,763567,3152333,3915900,INCOME
06090301317480000,2020,941180,1944520,2885700,INCOME
06090301317480000,2019,941180,1000720,1941900,INCOME
06090301318010000,2021,90862,209238,300100,MKT
06090301318010000,2020,86087,216513,302600,MKT
06090301318010000,2019,86087,216513,302600,MKT
06090301318030000,2021,72740,248560,321300,MKT
06090301318030000,2020,61344,192556,253900,MKT
06090301318030000,2019,61344,192556,253900,MKT
06090301318040000,2021,80314,147786,228100,MKT
06090301318040000,2020,71335,91770,163105,COST
06090301318040000,2019,71335,169765,241100,MKT
06090301318060000,2021,209284,214816,424100,INCOME
06090301318060000,2020,98505,254395,352900,INCOME
06090301318060000,2019,98505,254395,352900,INCOME
06090301318120000,2021,349814,366086,715900,INCOME
06090301318120000,2020,219398,405802,625200,INCOME
06090301318120000,2019,219398,405802,625200,INCOME
06090301320010000,2021,498015,1949890,2447905,COST
06090301320010000,2020,380507,1926240,2306747,COST
06090301320010000,2019,380507,1926240,2306747,COST
06090301320050000,2021,169943,96157,266100,INCOME
06090301320050000,2020,71202,119998,191200,INCOME
06090301320050000,2019,71202,119998,191200,INCOME
06090301321010000,2021,168023,5110,173133,COST
06090301321010000,2020,177753,4940,182693,COST
06090301321010000,2019,177753,4940,182693,COST
06090301322010000,2021,46069,0,46069,COST
06090301322010000,2020,46347,0,46347,COST
06090301322010000,2019,46347,0,46347,COST
06090301323010000,2021,211772,343628,555400,INCOME
06090301323010000,2020,254963,183937,438900,INCOME
06090301323010000,2019,254963,183937,438900,INCOME
06090301324010000,2021,390146,719354,1109500,INCOME
06090301324010000,2020,660878,241622,902500,INCOME
06090301324010000,2019,660878,241622,902500,INCOME
06090301324012000,2021,110716,0,110716,COST
06090301324012000,2020,181809,0,181809,COST
06090301324012000,2019,181809,0,181809,COST
06090301326010000,2021,402871,351730,754601,COST
06090301326010000,2020,296182,325290,621472,COST
06090301326010000,2019,296182,325290,621472,COST
06090301326050000,2021,63317,0,63317,COST
06090301326050000,2020,29943,0,29943,COST
06090301326050000,2019,29943,0,29943,COST
06090301326100000,2021,232002,368110,600112,COST
06090301326100000,2020,115671,346530,462201,COST
06090301326100000,2019,115671,346530,462201,COST
06090301326150000,2021,149503,3950,153453,COST
06090301326150000,2020,58310,4130,62440,COST
06090301326150000,2019,58310,4130,62440,COST
06090301326180000,2021,137343,0,137343,COST
06090301326180000,2020,51087,0,51087,COST
06090301326180000,2019,51087,0,51087,COST
06090301327010000,2021,203507,236193,439700,INCOME
06090301327010000,2020,239623,233677,473300,INCOME
06090301327010000,2019,239623,233677,473300,INCOME
06090301327020000,2021,222766,383734,606500,INCOME
06090301327020000,2020,275894,202206,478100,INCOME
06090301327020000,2019,275894,202206,478100,INCOME
06090301327030000,2021,266953,95150,362103,COST
06090301327030000,2020,292640,91210,383850,COST
06090301327030000,2019,365799,202820,568619,COST
06090301327060000,2021,274006,41494,315500,INCOME
06090301327060000,2020,149927,46373,196300,INCOME
06090301327060000,2019,149927,46373,196300,INCOME
06090301327070000,2021,280927,286673,567600,INCOME
06090301327070000,2020,155871,296529,452400,INCOME
06090301327070000,2019,155871,296529,452400,INCOME
06090301328042000,2021,228884,0,228884,COST
06090301328042000,2020,287795,0,287795,COST
06090301328042000,2019,287795,0,287795,COST
06090301328062000,2021,215773,0,215773,COST
06090301328062000,2020,262512,0,262512,COST
06090301328062000,2019,262512,0,262512,COST
06090301328072000,2021,198171,0,198171,COST
06090301328072000,2020,229901,0,229901,COST
06090301328072000,2019,229901,0,229901,COST
06090301328082000,2021,173880,0,173880,COST
06090301328082000,2020,187506,0,187506,COST
06090301328082000,2019,187506,0,187506,COST
06090301328152000,2021,167820,0,167820,COST
06090301328152000,2020,177418,0,177418,COST
06090301328152000,2019,177418,0,177418,COST
06090301329020000,2021,237661,103339,341000,INCOME
06090301329020000,2020,120100,198030,318130,COST
06090301329020000,2019,120100,230840,350940,COST
06090301329050000,2021,74332,140168,214500,INCOME
06090301329050000,2020,63401,134899,198300,INCOME
06090301329050000,2019,63401,134899,198300,INCOME
06090301329060000,2021,74332,140168,214500,INCOME
06090301329060000,2020,63401,134899,198300,INCOME
06090301329060000,2019,63401,134899,198300,INCOME
06090301329070000,2021,160745,0,160745,COST
06090301329070000,2020,65286,29014,94300,INCOME
06090301329070000,2019,65286,29014,94300,INCOME
06090301329080000,2021,68163,10530,78693,COST
06090301329080000,2020,55563,10340,65903,COST
06090301329080000,2019,55563,10340,65903,COST
06090301329090000,2021,74332,130868,205200,MKT
06090301329090000,2020,63401,150399,213800,MKT
06090301329090000,2019,63401,150399,213800,MKT
06090301329100000,2021,142186,431714,573900,INCOME
06090301329100000,2020,53922,262278,316200,INCOME
06090301329100000,2019,53922,262278,316200,INCOME
06090301329110000,2021,142186,92414,234600,INCOME
06090301329110000,2020,53922,135378,189300,INCOME
06090301329110000,2019,53922,135378,189300,INCOME
06090301329150000,2021,224881,193430,418311,COST
06090301329150000,2020,279986,206014,486000,INCOME
06090301329150000,2019,279986,206014,486000,INCOME
06090301329180000,2021,196576,0,196576,COST
06090301329180000,2020,175000,0,175000,COST
06090301329180000,2019,175000,0,175000,COST
06090301329210000,2021,249613,677887,927500,INCOME
06090301329210000,2020,263551,602749,866300,INCOME
06090301329210000,2019,263551,602749,866300,INCOME
06090301331010000,2021,538179,0,538179,COST
06090301331010000,2020,429408,0,429408,COST
06090301331010000,2019,429408,0,429408,COST
06090301333010000,2021,142186,37414,179600,INCOME
06090301333010000,2020,53922,82678,136600,INCOME
06090301333010000,2019,53922,82678,136600,INCOME
06090301333050000,2021,104127,315532,419659,MRA
06090301333050000,2020,105946,336038,441984,MRA
06090301333050000,2019,105946,336038,441984,MRA
06090301333100000,2021,357294,2033006,2390300,INCOME
06090301333100000,2020,576200,1743100,2319300,INCOME
06090301333100000,2019,576200,1743100,2319300,INCOME
06090301333150000,2021,129597,811303,940900,INCOME
06090301333150000,2020,118584,600116,718700,INCOME
06090301333150000,2019,118584,600116,718700,INCOME
06090301333160000,2021,75929,221170,297099,COST
06090301333160000,2020,51534,210566,262100,INCOME
06090301333160000,2019,51534,210566,262100,INCOME
06090301333170000,2021,74522,106290,180812,COST
06090301333170000,2020,50053,200647,250700,INCOME
06090301333170000,2019,50053,200647,250700,INCOME
06090301333180000,2021,117606,180580,298186,COST
06090301333180000,2020,101928,171440,273368,COST
06090301333180000,2019,101928,171440,273368,COST
06090301333200000,2021,162626,715774,878400,INCOME
06090301333200000,2020,168934,522366,691300,INCOME
06090301333200000,2019,168934,522366,691300,INCOME
06090301333210000,2021,117606,350890,468496,COST
06090301333210000,2020,101928,249072,351000,INCOME
06090301333210000,2019,101928,249072,351000,INCOME
06090301333230000,2021,162626,623974,786600,INCOME
06090301333230000,2020,168934,552830,721764,COST
06090301333230000,2019,168934,552830,721764,COST
06090301333240000,2021,117606,280494,398100,INCOME
06090301333240000,2020,101928,214472,316400,INCOME
06090301333240000,2019,101928,214472,316400,INCOME
06090301333250000,2021,117606,164860,282466,COST
06090301333250000,2020,101928,154360,256288,COST
06090301333250000,2019,101928,154360,256288,COST
06090301333270000,2021,162626,27490,190116,COST
06090301333270000,2020,168934,151150,320084,COST
06090301333270000,2019,168934,151150,320084,COST
06090301334012000,2021,487878,0,487878,COST
06090301334012000,2020,936392,0,936392,COST
06090301334012000,2019,936392,0,936392,COST
06090301334022000,2021,734965,0,734965,COST
06090301334022000,2020,1773604,0,1773604,COST
06090301334022000,2019,1773604,0,1773604,COST
06090301335040000,2021,351970,0,351970,COST
06090301335040000,2020,732488,0,732488,COST
06090301335040000,2019,732488,0,732488,COST
06090301335080000,2021,196236,0,196236,COST
06090301335080000,2020,226411,0,226411,COST
06090301335080000,2019,226411,0,226411,COST
06090301335107000,2021,371501,25450,396951,COST
06090301335107000,2020,612309,29340,641649,COST
06090301335107000,2019,612309,29340,641649,COST
06090301336010000,2021,634320,0,634320,COST
06090301336010000,2020,554806,0,554806,COST
06090301336010000,2019,554806,141894,696700,INCOME
06090301336050000,2021,192340,372960,565300,INCOME
06090301336050000,2020,86359,350141,436500,INCOME
06090301336050000,2019,86359,350141,436500,INCOME
06090301336070000,2021,251450,165550,417000,INCOME
06090301336070000,2020,131136,197250,328386,COST
06090301336070000,2019,131136,197250,328386,COST
06090301336090000,2021,312469,748731,1061200,INCOME
06090301336090000,2020,183994,840006,1024000,INCOME
06090301336090000,2019,183994,840006,1024000,INCOME
06090301336107000,2021,186941,0,186941,COST
06090301336107000,2020,82610,0,82610,COST
06090301336107000,2019,82610,0,82610,COST
06090301336120000,2021,312400,890600,1203000,INCOME
06090301336120000,2020,183930,876170,1060100,INCOME
06090301336120000,2019,183930,876170,1060100,INCOME
06090301336150000,2021,356729,0,356729,COST
06090301336150000,2020,226196,0,226196,COST
06090301336150000,2019,226196,0,226196,COST
06090301337010000,2021,232810,539350,772160,COST
06090301337010000,2020,295526,502774,798300,INCOME
06090301337010000,2019,295526,502774,798300,INCOME
06090301337050000,2021,109886,43420,153306,COST
06090301337050000,2020,156271,42420,198691,COST
06090301337050000,2019,156271,42420,198691,COST
06090301337070000,2021,209742,168158,377900,INCOME
06090301337070000,2020,251165,110235,361400,INCOME
06090301337070000,2019,251165,110235,361400,INCOME
06090301337100000,2021,321931,538180,860111,COST
06090301337100000,2020,489798,516750,1006548,COST
06090301337100000,2019,489798,516750,1006548,COST
06090301337120000,2021,168360,293040,461400,INCOME
06090301337120000,2020,178310,239190,417500,INCOME
06090301337120000,2019,178310,239190,417500,INCOME
06090301337140000,2021,162626,1179374,1342000,INCOME
06090301337140000,2020,168934,1150766,1319700,INCOME
06090301337140000,2019,168934,915530,1084464,COST
06090301337150000,2021,117606,144180,261786,COST
06090301337150000,2020,101928,138760,240688,COST
06090301337150000,2019,101928,138760,240688,COST
06090301337160000,2021,117606,197060,314666,COST
06090301337160000,2020,101928,183272,285200,INCOME
06090301337160000,2019,101928,183272,285200,INCOME
06090301337170000,2021,117606,258794,376400,INCOME
06090301337170000,2020,101928,231672,333600,INCOME
06090301337170000,2019,101928,231672,333600,INCOME
06090301337180000,2021,117606,216960,334566,COST
06090301337180000,2020,101928,208420,310348,COST
06090301337180000,2019,101928,167170,269098,COST
06090301337190000,2021,117606,446794,564400,INCOME
06090301337190000,2020,101928,435872,537800,INCOME
06090301337190000,2019,101928,435872,537800,INCOME
06090301337247000,2021,249613,0,249613,COST
06090301337247000,2020,329439,0,329439,COST
06090301337247000,2019,329439,0,329439,COST
06090301338010000,2021,255425,0,255425,COST
06090301338010000,2020,134381,0,134381,COST
06090301338010000,2019,134381,0,134381,COST
06090301338040000,2021,74365,0,74365,COST
06090301338040000,2020,63445,0,63445,COST
06090301338040000,2019,63445,0,63445,COST
06090301338050000,2021,74332,151468,225800,MKT
06090301338050000,2020,63401,160499,223900,MKT
06090301338050000,2019,63401,160499,223900,MKT
06090301338060000,2021,74332,218268,292600,MKT
06090301338060000,2020,63401,198899,262300,MKT
06090301338060000,2019,63401,198899,262300,MKT
06090301338070000,2021,74332,172368,246700,MKT
06090301338070000,2020,63401,171299,234700,MKT
06090301338070000,2019,63401,171299,234700,MKT
06090301338080000,2021,74332,119068,193400,MKT
06090301338080000,2020,63401,130199,193600,MKT
06090301338080000,2019,63401,130199,193600,MKT
06090301338100000,2021,86393,183807,270200,MKT
06090301338100000,2020,79721,177779,257500,MKT
06090301338100000,2019,79721,177779,257500,MKT
06090301338110000,2021,73006,109430,182436,COST
06090301338110000,2020,61686,103730,165416,COST
06090301338110000,2019,61686,103730,165416,COST
06090301338120000,2021,271827,0,271827,COST
06090301338120000,2020,376262,0,376262,COST
06090301338120000,2019,376262,0,376262,COST
06090301338160000,2021,224881,392450,617331,COST
06090301338160000,2020,84670,381150,465820,COST
06090301338160000,2019,84670,381150,465820,COST
06090301339010000,2021,407987,1326413,1734400,INCOME
06090301339010000,2020,708586,960714,1669300,INCOME
06090301339010000,2019,708586,960714,1669300,INCOME
06090301341030000,2021,301783,878817,1180600,INCOME
06090301341030000,2020,576308,533692,1110000,INCOME
06090301341030000,2019,576308,533692,1110000,INCOME
06090301341070000,2021,85365,142935,228300,MKT
06090301341070000,2020,78280,149320,227600,MKT
06090301341070000,2019,78280,149320,227600,MKT
06090301341090000,2021,85365,177835,263200,MKT
06090301341090000,2020,78280,163020,241300,MKT
06090301341090000,2019,78280,163020,241300,MKT
06090301341110000,2021,69756,113544,183300,MKT
06090301341110000,2020,57553,104047,161600,MKT
06090301341110000,2019,57553,104047,161600,MKT
06090301341130000,2021,83140,175160,258300,MKT
06090301341130000,2020,75194,182606,257800,MKT
06090301341130000,2019,75194,182606,257800,MKT
06090301341150000,2021,271011,359589,630600,INCOME
06090301341150000,2020,374502,138398,512900,INCOME
06090301341150000,2019,374502,138398,512900,INCOME
06090301341190000,2021,224881,401219,626100,INCOME
06090301341190000,2020,279986,291514,571500,INCOME
06090301341190000,2019,279986,291514,571500,INCOME
06090301341230000,2021,224881,161219,386100,INCOME
06090301341230000,2020,279986,92614,372600,INCOME
06090301341230000,2019,279986,92614,372600,INCOME
06090301342010000,2021,92861,179339,272200,MKT
06090301342010000,2020,88989,190311,279300,MKT
06090301342010000,2019,88989,190311,279300,MKT
06090301342040000,2021,82025,150975,233000,MKT
06090301342040000,2020,73663,153037,226700,MKT
06090301342040000,2019,73663,153037,226700,MKT
06090301342060000,2021,74332,192068,266400,MKT
06090301342060000,2020,63401,200499,263900,MKT
06090301342060000,2019,63401,200499,263900,MKT
06090301342070000,2021,74332,305190,379522,COST
06090301342070000,2020,63401,72920,136321,COST
06090301342070000,2019,63401,72920,136321,COST
06090301342080000,2021,88002,0,88002,COST
06090301342080000,2020,81993,0,81993,COST
06090301342080000,2019,81993,0,81993,COST
06090301342090000,2021,74332,210468,284800,MKT
06090301342090000,2020,63401,186999,250400,MKT
06090301342090000,2019,63401,186999,250400,MKT
06090301342100000,2021,74332,0,74332,COST
06090301342100000,2020,63401,0,63401,COST
06090301342100000,2019,63401,0,63401,COST
06090301342110000,2021,74332,155768,230100,MKT
06090301342110000,2020,63401,145799,209200,MKT
06090301342110000,2019,63401,145799,209200,MKT
06090301342120000,2021,74332,178268,252600,MKT
06090301342120000,2020,63401,166199,229600,MKT
06090301342120000,2019,63401,166199,229600,MKT
06090301342130000,2021,74332,153068,227400,MKT
06090301342130000,2020,63401,158399,221800,MKT
06090301342130000,2019,63401,158399,221800,MKT
06090301342140000,2021,187164,368000,555164,COST
06090301342140000,2020,78804,354430,433234,COST
06090301342140000,2019,78804,316510,395314,COST
06090301342160000,2021,77698,133802,211500,MKT
06090301342160000,2020,67826,147774,215600,MKT
06090301342160000,2019,67826,147774,215600,MKT
06090301344010000,2021,377000,0,377000,COST
06090301344010000,2020,626494,0,626494,COST
06090301344010000,2019,626494,0,626494,COST
06090301345010000,2021,70098,100702,170800,MKT
06090301345010000,2020,63401,32410,95811,COST
06090301345010000,2019,63401,32410,95811,COST
06090301345020000,2021,164011,0,164011,COST
06090301345020000,2020,67366,138970,206336,COST
06090301345020000,2019,67366,138970,206336,COST
06090301345030000,2021,85365,181735,267100,MKT
06090301345030000,2020,78280,180720,259000,MKT
06090301345030000,2019,78280,180720,259000,MKT
06090301345050000,2021,65371,160,65531,COST
06090301345050000,2020,52134,160,52294,COST
06090301345050000,2019,52134,160,52294,COST
06090301345060000,2021,77358,136442,213800,MKT
06090301345060000,2020,67375,136225,203600,MKT
06090301345060000,2019,67375,136225,203600,MKT
06090301345070000,2021,74332,171668,246000,INCOME
06090301345070000,2020,63401,174099,237500,INCOME
06090301345070000,2019,63401,174099,237500,INCOME
06090301345090000,2021,79223,129977,209200,MKT
06090301345090000,2020,69865,132935,202800,MKT
06090301345090000,2019,69865,132935,202800,MKT
06090301345110000,2021,79223,200877,280100,INCOME
06090301345110000,2020,69865,200235,270100,INCOME
06090301345110000,2019,69865,200235,270100,INCOME
06090301345130000,2021,80662,133638,214300,MKT
06090301345130000,2020,71807,135793,207600,MKT
06090301345130000,2019,71807,135793,207600,MKT
06090301345150000,2021,162626,0,162626,COST
06090301345150000,2020,168934,0,168934,COST
06090301345150000,2019,168934,0,168934,COST
06090301345210000,2021,162626,10560,173186,COST
06090301345210000,2020,168934,11300,180234,COST
06090301345210000,2019,168934,11300,180234,COST
06090301345230000,2021,162626,153974,316600,INCOME
06090301345230000,2020,168934,73266,242200,INCOME
06090301345230000,2019,168934,73266,242200,INCOME
06090301345240000,2021,162626,370474,533100,INCOME
06090301345240000,2020,168934,258066,427000,INCOME
06090301345240000,2019,168934,258066,427000,INCOME
06090301345257000,2021,271011,8900,279911,COST
06090301345257000,2020,374502,9290,383792,COST
06090301345257000,2019,374502,9290,383792,COST
06090301346010000,2021,87962,173238,261200,MKT
06090301346010000,2020,81937,170263,252200,MKT
06090301346010000,2019,81937,170263,252200,MKT
06090301346040000,2021,87962,228038,316000,MKT
06090301346040000,2020,81937,215763,297700,MKT
06090301346040000,2019,81937,216263,298200,MKT
06090301346050000,2021,74332,153968,228300,MKT
06090301346050000,2020,63401,150599,214000,MKT
06090301346050000,2019,63401,150599,214000,MKT
06090301346060000,2021,74332,183368,257700,MKT
06090301346060000,2020,63401,171299,234700,MKT
06090301346060000,2019,63401,171299,234700,MKT
06090301346070000,2021,74332,140468,214800,MKT
06090301346070000,2020,63401,78790,142191,OVR
06090301346070000,2019,63401,78790,142191,COST
06090301346080000,2021,74332,161068,235400,MKT
06090301346080000,2020,63401,164399,227800,MKT
06090301346080000,2019,63401,149700,213101,COST
06090301346090000,2021,77358,129642,207000,MKT
06090301346090000,2020,67375,142225,209600,MKT
06090301346090000,2019,67375,142225,209600,MKT
06090301346100000,2021,77358,158942,236300,MKT
06090301346100000,2020,67375,154625,222000,MKT
06090301346100000,2019,67375,154625,222000,MKT
06090301346110000,2021,77358,130842,208200,MKT
06090301346110000,2020,67375,133725,201100,MKT
06090301346110000,2019,67375,133725,201100,MKT
06090301346130000,2021,85365,147935,233300,MKT
06090301346130000,2020,78280,147520,225800,MKT
06090301346130000,2019,78280,147520,225800,MKT
06090301346150000,2021,91544,164656,256200,MKT
06090301346150000,2020,87072,172928,260000,MKT
06090301346150000,2019,87072,172928,260000,MKT
06090301346160000,2021,85365,251035,336400,MKT
06090301346160000,2020,78280,238720,317000,MKT
06090301346160000,2019,78280,201620,279900,MKT
06090301347010000,2021,74332,236868,311200,MKT
06090301347010000,2020,63401,249599,313000,MKT
06090301347010000,2019,63401,249599,313000,MKT
06090301347020000,2021,74332,239468,313800,MKT
06090301347020000,2020,63401,201399,264800,MKT
06090301347020000,2019,63401,201399,264800,MKT
06090301347040000,2021,87962,249638,337600,MKT
06090301347040000,2020,81937,219063,301000,MKT
06090301347040000,2019,81937,207363,289300,MKT
06090301347060000,2021,87962,95340,183302,COST
06090301347060000,2020,81937,89700,171637,COST
06090301347060000,2019,81937,89700,171637,COST
06090301347080000,2021,74332,227368,301700,MKT
06090301347080000,2020,63401,99210,162611,COST
06090301347080000,2019,63401,83390,146791,COST
06090301347090000,2021,74332,131180,205512,COST
06090301347090000,2020,55615,0,55615,COST
06090301347090000,2019,55615,0,55615,COST
06090301347110000,2021,82025,410075,492100,INCOME
06090301347110000,2020,73663,401237,474900,INCOME
06090301347110000,2019,73663,401237,474900,INCOME
06090301347120000,2021,74332,149168,223500,MKT
06090301347120000,2020,63401,169599,233000,MKT
06090301347120000,2019,63401,169599,233000,MKT
06090301347140000,2021,87962,165538,253500,MKT
06090301347140000,2020,81937,169563,251500,MKT
06090301347140000,2019,81937,169563,251500,MKT
06090301347150000,2021,74332,240968,315300,MKT
06090301347150000,2020,63401,201799,265200,MKT
06090301347150000,2019,63401,201799,265200,MKT
06090301347160000,2021,74332,218268,292600,MKT
06090301347160000,2020,63401,174899,238300,MKT
06090301347160000,2019,63401,175399,238800,MKT
06090301347180000,2021,82025,410075,492100,INCOME
06090301347180000,2020,73663,401237,474900,INCOME
06090301347180000,2019,73663,401237,474900,INCOME
06090301350340000,2021,426974,692926,1119900,INCOME
06090301350340000,2020,760655,224245,984900,INCOME
06090301350340000,2019,760655,224245,984900,INCOME
06090301350350000,2021,307539,576061,883600,INCOME
06090301350350000,2020,456094,362406,818500,INCOME
06090301350350000,2019,456094,362406,818500,INCOME
06090301350400000,2021,424624,776276,1200900,INCOME
06090301350400000,2020,909841,390659,1300500,INCOME
06090301350400000,2019,909841,390659,1300500,INCOME
06090301351010000,2021,317446,357654,675100,INCOME
06090301351010000,2020,188583,385117,573700,INCOME
06090301351010000,2019,188583,385117,573700,INCOME
06090301351060000,2021,71644,171456,243100,MKT
06090301351060000,2020,59942,172658,232600,MKT
06090301351060000,2019,59942,172658,232600,MKT
06090301351070000,2021,69370,169230,238600,INCOME
06090301351070000,2020,43825,190075,233900,INCOME
06090301351070000,2019,43825,190075,233900,INCOME
06090301351110000,2021,177504,350796,528300,INCOME
06090301351110000,2020,76201,427199,503400,INCOME
06090301351110000,2019,76201,427199,503400,INCOME
06090301351150000,2021,316541,607059,923600,INCOME
06090301351150000,2020,477075,422225,899300,INCOME
06090301351150000,2019,477075,422225,899300,INCOME
06090301351190000,2021,91205,137195,228400,MKT
06090301351190000,2020,86582,144018,230600,MKT
06090301351190000,2019,86582,144018,230600,MKT
06090301351210000,2021,168360,0,168360,COST
06090301351210000,2020,53493,0,53493,COST
06090301351210000,2019,53493,0,53493,COST
06090301351230000,2021,74332,140168,214500,MKT
06090301351230000,2020,63401,133199,196600,MKT
06090301351230000,2019,63401,133199,196600,MKT
06090301353010000,2021,96642,135058,231700,MKT
06090301353010000,2020,94567,138533,233100,OVR
06090301353010000,2019,94567,138533,233100,MKT
06090301353040000,2021,91544,173656,265200,MKT
06090301353040000,2020,87072,177628,264700,MKT
06090301353040000,2019,87072,177628,264700,MKT
06090301353060000,2021,85365,176135,261500,MKT
06090301353060000,2020,78280,198420,276700,MKT
06090301353060000,2019,78280,198420,276700,MKT
06090301353080000,2021,91544,225556,317100,MKT
06090301353080000,2020,87072,191728,278800,MKT
06090301353080000,2019,87072,191728,278800,MKT
06090301353090000,2021,87962,201538,289500,MKT
06090301353090000,2020,81937,177763,259700,MKT
06090301353090000,2019,81937,177763,259700,MKT
06090301353110000,2021,82025,237475,319500,MKT
06090301353110000,2020,73663,186237,259900,MKT
06090301353110000,2019,73663,186237,259900,MKT
06090301353130000,2021,87962,292238,380200,MKT
06090301353130000,2020,81937,235663,317600,MKT
06090301353130000,2019,81937,235663,317600,MKT
06090301353160000,2021,87962,132238,220200,MKT
06090301353160000,2020,81937,144963,226900,MKT
06090301353160000,2019,81937,144963,226900,MKT
06090301354010000,2021,74332,193768,268100,MKT
06090301354010000,2020,63401,209399,272800,MKT
06090301354010000,2019,63401,149090,212491,COST
06090301354020000,2021,74332,184768,259100,MKT
06090301354020000,2020,63401,203799,267200,MKT
06090301354020000,2019,63401,203799,267200,MKT
06090301354030000,2021,97066,189360,286426,COST
06090301354030000,2020,95199,177660,272859,COST
06090301354030000,2019,95199,177660,272859,COST
06090301354070000,2021,82025,173875,255900,MKT
06090301354070000,2020,73663,177337,251000,MKT
06090301354070000,2019,73663,177337,251000,MKT
06090301354080000,2021,82025,168975,251000,MKT
06090301354080000,2020,73663,175237,248900,MKT
06090301354080000,2019,73663,175237,248900,MKT
06090301354100000,2021,212317,252883,465200,INCOME
06090301354100000,2020,100740,342460,443200,INCOME
06090301354100000,2019,100740,342460,443200,INCOME
06090301354110000,2021,65371,0,65371,COST
06090301354110000,2020,52134,0,52134,COST
06090301354110000,2019,52134,0,52134,COST
06090301354120000,2021,85415,260885,346300,MKT
06090301354120000,2020,78351,219749,298100,MKT
06090301354120000,2019,78351,219749,298100,MKT
06090301354130000,2021,77358,146342,223700,MKT
06090301354130000,2020,67375,154025,221400,MKT
06090301354130000,2019,67375,154025,221400,MKT
06090301354140000,2021,77358,260142,337500,MKT
06090301354140000,2020,67375,243025,310400,MKT
06090301354140000,2019,67375,243025,310400,MKT
06090301354150000,2021,77358,140342,217700,MKT
06090301354150000,2020,67375,122225,189600,MKT
06090301354150000,2019,67375,122225,189600,MKT
06090301354160000,2021,77358,153342,230700,MKT
06090301354160000,2020,67375,174925,242300,MKT
06090301354160000,2019,67375,174925,242300,MKT
06090301401030000,2021,301872,785428,1087300,INCOME
06090301401030000,2020,174360,884490,1058850,COST
06090301401030000,2019,174360,884490,1058850,COST
06090301401040900,2021,124756,0,124756,COST
06090301401040900,2020,228150,0,228150,COST
06090301401040900,2019,228150,0,228150,COST
06090301402010000,2021,605398,657720,1263118,COST
06090301402010000,2020,515879,628210,1144089,COST
06090301402010000,2019,515879,628210,1144089,COST
06090301417010000,2021,290499,539920,830419,COST
06090301417010000,2020,417317,510710,928027,COST
06090301417010000,2019,417317,510710,928027,COST
06090301417110000,2021,114685,0,114685,COST
06090301417110000,2020,132427,0,132427,COST
06090301417110000,2019,132427,0,132427,COST
06090301417126500,2021,52391,0,52391,COST
06090301417126500,2020,204293,0,204293,COST
06090301417126500,2019,204293,0,204293,COST
06090301422012000,2021,369729,0,369729,COST
06090301422012000,2020,239176,0,239176,COST
06090301422012000,2019,239176,0,239176,COST
06090301426010000,2021,87962,257538,345500,MKT
06090301426010000,2020,81937,207663,289600,OVR
06090301426010000,2019,81937,207663,289600,MKT
06090301426030000,2021,74332,177668,252000,MKT
06090301426030000,2020,63401,169399,232800,MKT
06090301426030000,2019,63401,169399,232800,MKT
06090301426050000,2021,82025,171975,254000,MKT
06090301426050000,2020,73663,177737,251400,MKT
06090301426050000,2019,73663,177737,251400,MKT
06090301426060000,2021,82025,267075,349100,MKT
06090301426060000,2020,73663,212237,285900,MKT
06090301426060000,2019,73663,212237,285900,MKT
06090301426080000,2021,87962,302538,390500,MKT
06090301426080000,2020,81937,249863,331800,MKT
06090301426080000,2019,81937,249863,331800,MKT
06090301426100000,2021,74332,158468,232800,MKT
06090301426100000,2020,63401,167099,230500,MKT
06090301426100000,2019,63401,149099,212500,MKT
06090301426110000,2021,74332,203168,277500,MKT
06090301426110000,2020,63401,158899,222300,MKT
06090301426110000,2019,63401,158899,222300,MKT
06090301426120000,2021,87962,240990,328952,COST
06090301426120000,2020,81937,227710,309647,COST
06090301426120000,2019,81937,186663,268600,MKT
06090301426130000,2021,74332,318068,392400,MKT
06090301426130000,2020,63401,308999,372400,MKT
06090301426130000,2019,63401,308999,372400,MKT
06090301426140000,2021,74332,145368,219700,MKT
06090301426140000,2020,63401,147199,210600,MKT
06090301426140000,2019,63401,147199,210600,MKT
06090301426160000,2021,74332,157868,232200,MKT
06090301426160000,2020,63401,180099,243500,MKT
06090301426160000,2019,63401,165399,228800,MKT
06090301426170000,2021,74332,300868,375200,MKT
06090301426170000,2020,63401,285399,348800,MKT
06090301426170000,2019,63401,285399,348800,MKT
06090301427010000,2021,76782,137418,214200,MKT
06090301427010000,2020,71871,157129,229000,MKT
06090301427010000,2019,71871,157129,229000,MKT
06090301427030000,2021,90862,193938,284800,MKT
06090301427030000,2020,92883,186517,279400,MKT
06090301427030000,2019,92883,186517,279400,MKT
06090301427040000,2021,76782,153318,230100,MKT
06090301427040000,2020,71871,149029,220900,MKT
06090301427040000,2019,71871,149029,220900,MKT
06090301427060000,2021,77418,161582,239000,MKT
06090301427060000,2020,67454,145846,213300,MKT
06090301427060000,2019,86087,173350,259437,COST
06090301427070000,2021,75354,128246,203600,MKT
06090301427070000,2020,64735,114465,179200,MKT
06090301427080000,2021,90862,174138,265000,MKT
06090301427080000,2020,86087,175213,261300,MKT
06090301427080000,2019,86087,175213,261300,MKT
06090301429010000,2021,81896,243604,325500,MKT
06090301429010000,2020,75771,210929,286700,MKT
06090301429010000,2019,75771,210929,286700,MKT
06090301429020000,2021,81752,194348,276100,MKT
06090301429020000,2020,75568,189832,265400,MKT
06090301429020000,2019,75568,189832,265400,MKT
06090301429030000,2021,79252,175348,254600,MKT
06090301429030000,2020,72077,161923,234000,MKT
06090301429030000,2019,72077,161923,234000,MKT
06090301429040000,2021,79252,254248,333500,MKT
06090301429040000,2020,72077,207123,279200,MKT
06090301429040000,2019,72077,207123,279200,MKT
06090301429050000,2021,79252,207848,287100,MKT
06090301429050000,2020,72077,159120,231197,COST
06090301429050000,2019,72077,159120,231197,COST
06090301429060000,2021,75309,223591,298900,MKT
06090301429060000,2020,66686,202514,269200,MKT
06090301429060000,2019,66686,202514,269200,MKT
06090301429070000,2021,83082,261318,344400,MKT
06090301429070000,2020,77449,203851,281300,MKT
06090301429070000,2019,77449,203851,281300,MKT
06090301430010000,2021,94041,195959,290000,MKT
06090301430010000,2020,93537,190863,284400,MKT
06090301430010000,2019,93537,190863,284400,MKT
06090301430020000,2021,80876,323850,404726,COST
06090301430020000,2020,74338,293562,367900,MKT
06090301430020000,2019,74338,293562,367900,MKT
06090301430030000,2021,81720,238680,320400,MKT
06090301430030000,2020,75523,204877,280400,MKT
06090301430030000,2019,75523,204877,280400,MKT
06090301430040000,2021,81752,231848,313600,MKT
06090301430040000,2020,75568,216832,292400,MKT
06090301430040000,2019,75568,216832,292400,MKT
06090301430050000,2021,81752,246748,328500,MKT
06090301430050000,2020,75568,210832,286400,MKT
06090301430050000,2019,75568,210832,286400,MKT
06090301430060000,2021,81752,240348,322100,MKT
06090301430060000,2020,75568,211732,287300,MKT
06090301430060000,2019,75568,211732,287300,MKT
06090301430070000,2021,80625,276275,356900,MKT
06090301430070000,2020,73987,234813,308800,MKT
06090301430070000,2019,73987,233313,307300,MKT
06090301430080000,2021,81752,227948,309700,MKT
06090301430080000,2020,75568,210732,286300,MKT
06090301430080000,2019,75568,210732,286300,MKT
06090301430090000,2021,81752,224748,306500,MKT
06090301430090000,2020,75568,209632,285200,MKT
06090301430090000,2019,75568,209632,285200,MKT
06090301430100000,2021,81752,256348,338100,MKT
06090301430100000,2020,75568,246332,321900,MKT
06090301430100000,2019,75568,237832,313400,MKT
06090301430110000,2021,81752,214948,296700,MKT
06090301430110000,2020,75568,178532,254100,MKT
06090301430110000,2019,75568,178532,254100,MKT
06090301430120000,2021,81752,253148,334900,MKT
06090301430120000,2020,75568,243432,319000,MKT
06090301430120000,2019,75568,243432,319000,MKT
06090301430130000,2021,81752,248148,329900,MKT
06090301430130000,2020,75568,206432,282000,MKT
06090301430130000,2019,75568,206432,282000,MKT
06090301430140000,2021,81752,265148,346900,MKT
06090301430140000,2020,75568,215832,291400,MKT
06090301430140000,2019,75568,215832,291400,MKT
06090301430150000,2021,79446,213254,292700,MKT
06090301430150000,2020,72346,204554,276900,MKT
06090301430150000,2019,72346,204554,276900,MKT
06090301430160000,2021,79446,275154,354600,MKT
06090301430160000,2020,72346,246754,319100,MKT
06090301430160000,2019,72346,246754,319100,MKT
06090301430170000,2021,79446,261054,340500,MKT
06090301430170000,2020,72346,225054,297400,MKT
06090301430170000,2019,72346,225054,297400,MKT
06090301430180000,2021,79446,239654,319100,MKT
06090301430180000,2020,72346,225954,298300,MKT
06090301430180000,2019,72346,225954,298300,MKT
06090301430190000,2021,87669,271731,359400,MKT
06090301430190000,2020,84055,208345,292400,MKT
06090301430190000,2019,84055,208345,292400,MKT
06090301430210000,2021,87669,238131,325800,MKT
06090301430210000,2020,84055,218245,302300,MKT
06090301430210000,2019,84055,218245,302300,MKT
06090301430220000,2021,75819,255781,331600,MKT
06090301430220000,2020,67375,217125,284500,MKT
06090301430220000,2019,67375,217125,284500,MKT
06090301430230000,2021,81528,236372,317900,MKT
06090301430230000,2020,75254,207846,283100,MKT
06090301430230000,2019,75254,207846,283100,MKT
06090301430240000,2021,86602,339798,426400,MKT
06090301430240000,2020,82503,315297,397800,MKT
06090301430240000,2019,82503,315297,397800,MKT
06090301430250000,2021,81219,238781,320000,MKT
06090301430250000,2020,74819,203381,278200,MKT
06090301430250000,2019,74819,203381,278200,MKT
06090301430260000,2021,83796,279004,362800,MKT
06090301430260000,2020,78465,232635,311100,MKT
06090301430260000,2019,78465,217735,296200,MKT
06090301430270000,2021,81783,258717,340500,MKT
06090301430270000,2020,75613,223087,298700,MKT
06090301430270000,2019,75613,215990,291603,COST
06090301430280000,2021,80263,0,80263,COST
06090301430280000,2020,73481,0,73481,COST
06090301430280000,2019,73481,0,73481,COST
06090301430290000,2021,79909,243291,323200,MKT
06090301430290000,2020,72988,230512,303500,MKT
06090301430290000,2019,72988,230512,303500,MKT
06090301430300000,2021,88541,185259,273800,MKT
06090301430300000,2020,92069,181131,273200,MKT
06090301430300000,2019,92069,181131,273200,MKT
06090301430310000,2021,78594,255406,334000,MKT
06090301430310000,2020,76786,236114,312900,MKT
06090301430310000,2019,76786,236114,312900,MKT
06090301430320000,2021,77047,178553,255600,MKT
06090301430320000,2020,74495,172705,247200,MKT
06090301430320000,2019,74495,172705,247200,MKT
06090301430330000,2021,78261,193239,271500,MKT
06090301430330000,2020,76290,177410,253700,MKT
06090301430330000,2019,76290,179010,255300,MKT
06090301430340000,2021,79446,242754,322200,MKT
06090301430340000,2020,78057,206743,284800,MKT
06090301430340000,2019,78057,206743,284800,MKT
06090301430350000,2021,79446,213454,292900,MKT
06090301430350000,2020,78057,188643,266700,MKT
06090301430350000,2019,78057,188643,266700,MKT
06090301430360000,2021,78344,223456,301800,MKT
06090301430360000,2020,70822,197778,268600,MKT
06090301430360000,2019,70822,197778,268600,MKT
06090301430370000,2021,79334,168566,247900,MKT
06090301430370000,2020,72190,155610,227800,MKT
06090301430370000,2019,72190,155610,227800,MKT
06090301436010000,2021,68409,122591,191000,MKT
06090301436010000,2020,63401,40740,104141,COST
06090301436010000,2019,63401,40740,104141,COST
06090301436030000,2021,87962,165280,253242,COST
06090301436030000,2020,81937,154090,236027,COST
06090301436030000,2019,81937,154090,236027,COST
06090301436050000,2021,82025,258360,340385,COST
06090301436050000,2020,73663,268737,342400,MKT
06090301436050000,2019,73663,268737,342400,MKT
06090301436060000,2021,82025,146175,228200,MKT
06090301436060000,2020,73663,154837,228500,MKT
06090301436060000,2019,73663,154837,228500,MKT
06090301436080000,2021,87962,214438,302400,MKT
06090301436080000,2020,81937,183763,265700,MKT
06090301436080000,2019,81937,183763,265700,MKT
06090301436100000,2021,87962,194338,282300,MKT
06090301436100000,2020,81937,206863,288800,MKT
06090301436100000,2019,81937,206863,288800,MKT
06090301436110000,2021,74332,220568,294900,MKT
06090301436110000,2020,63401,208699,272100,MKT
06090301436110000,2019,63401,208699,272100,MKT
06090301436120000,2021,74332,244468,318800,MKT
06090301436120000,2020,63401,225899,289300,MKT
06090301436120000,2019,63401,225899,289300,MKT
06090301436140000,2021,85740,195060,280800,MKT
06090301436140000,2020,78804,203496,282300,MKT
06090301436140000,2019,78804,203496,282300,MKT
06090301436150000,2021,77698,137502,215200,MKT
06090301436150000,2020,67826,132474,200300,MKT
06090301436150000,2019,67826,132474,200300,MKT
06090301436160000,2021,74332,151168,225500,MKT
06090301436160000,2020,63401,145399,208800,MKT
06090301436160000,2019,63401,145399,208800,MKT
06090301437010000,2021,196089,59311,255400,INCOME
06090301437010000,2020,88997,114503,203500,INCOME
06090301437010000,2019,88997,114503,203500,INCOME
06090301437020000,2021,90862,241738,332600,MKT
06090301437020000,2020,86087,197713,283800,MKT
06090301437020000,2019,86087,197713,283800,MKT
06090301437050000,2021,84729,145460,230189,COST
06090301437050000,2020,77394,137410,214804,COST
06090301437050000,2019,77394,137410,214804,COST
06090301437070000,2021,84729,195371,280100,INCOME
06090301437070000,2020,77394,192706,270100,INCOME
06090301437070000,2019,77394,192706,270100,INCOME
06090301437080000,2021,84729,239771,324500,MKT
06090301437080000,2020,77394,218906,296300,MKT
06090301437080000,2019,77394,218906,296300,MKT
06090301438010000,2021,559285,1443130,2002415,COST
06090301438010000,2020,455945,1405340,1861285,COST
06090301438010000,2019,455945,1405340,1861285,COST
06090301444010000,2021,74332,156768,231100,MKT
06090301444010000,2020,63401,150499,213900,MKT
06090301444010000,2019,63401,150499,213900,MKT
06090301444020000,2021,74332,132168,206500,MKT
06090301444020000,2020,63401,133999,197400,MKT
06090301444020000,2019,63401,133999,197400,MKT
06090301444030000,2021,74332,170468,244800,MKT
06090301444030000,2020,63401,174199,237600,MKT
06090301444030000,2019,63401,174199,237600,MKT
06090301444040000,2021,74332,155868,230200,MKT
06090301444040000,2020,63401,141799,205200,MKT
06090301444040000,2019,63401,141799,205200,MKT
06090301444060000,2021,74332,122568,196900,MKT
06090301444060000,2020,63401,116599,180000,MKT
06090301444060000,2019,63401,116599,180000,MKT
06090301444070000,2021,74332,244568,318900,MKT
06090301444070000,2020,63401,193899,257300,MKT
06090301444070000,2019,63401,193899,257300,MKT
06090301444080000,2021,74332,247868,322200,MKT
06090301444080000,2020,63401,238699,302100,MKT
06090301444080000,2019,63401,238699,302100,MKT
06090301444090000,2021,74332,361930,436262,COST
06090301444090000,2020,63401,347210,410611,COST
06090301444090000,2019,63401,351270,414671,COST
06090301444110000,2021,95335,237365,332700,MKT
06090301444110000,2020,92624,195776,288400,MKT
06090301444110000,2019,92624,195776,288400,MKT
06090301444120000,2021,73006,266194,339200,MKT
06090301444120000,2020,61686,251714,313400,MKT
06090301444120000,2019,61686,251714,313400,MKT
06090301444130000,2021,73006,117094,190100,MKT
06090301444130000,2020,61686,115014,176700,MKT
06090301444130000,2019,61686,115014,176700,MKT
06090301444140000,2021,73006,133194,206200,MKT
06090301444140000,2020,61686,131614,193300,MKT
06090301444140000,2019,61686,131614,193300,MKT
06090301444160000,2021,77244,154756,232000,MKT
06090301444160000,2020,67224,165976,233200,MKT
06090301444160000,2019,67224,165976,233200,MKT
06090301444180000,2021,67823,138277,206100,MKT
06090301444180000,2020,55141,141559,196700,MKT
06090301444180000,2019,55141,141559,196700,MKT
06090301446010000,2021,83642,285758,369400,MKT
06090301446010000,2020,78245,281860,360105,COST
06090301446010000,2019,78245,281860,360105,COST
06090301446020000,2021,81663,193337,275000,MKT
06090301446020000,2020,75444,184856,260300,MKT
06090301446020000,2019,75444,184856,260300,MKT
06090301446030000,2021,81663,226037,307700,MKT
06090301446030000,2020,75444,224356,299800,MKT
06090301446030000,2019,75444,224356,299800,MKT
06090301446040000,2021,81663,193237,274900,MKT
06090301446040000,2020,75444,178156,253600,MKT
06090301446040000,2019,75444,178156,253600,MKT
06090301446050000,2021,81663,218437,300100,MKT
06090301446050000,2020,75444,192256,267700,MKT
06090301446050000,2019,75444,192256,267700,MKT
06090301446060000,2021,81663,251937,333600,MKT
06090301446060000,2020,75444,231656,307100,MKT
06090301446060000,2019,75444,231656,307100,MKT
06090301446070000,2021,81663,174037,255700,INCOME
06090301446070000,2020,75444,173356,248800,INCOME
06090301446070000,2019,75444,173356,248800,INCOME
06090301446080000,2021,81663,192537,274200,MKT
06090301446080000,2020,75444,198756,274200,MKT
06090301446080000,2019,75444,198756,274200,MKT
06090301446090000,2021,81663,231937,313600,MKT
06090301446090000,2020,75444,198356,273800,MKT
06090301446090000,2019,75444,198356,273800,MKT
06090301446100000,2021,93554,215590,309144,COST
06090301446100000,2020,92800,200260,293060,COST
06090301446100000,2019,92800,200260,293060,COST
06090301446110000,2021,77647,0,77647,COST
06090301446110000,2020,69865,0,69865,COST
06090301446110000,2019,69865,0,69865,COST
06090301446120000,2021,89189,270011,359200,MKT
06090301446120000,2020,86285,213315,299600,MKT
06090301446120000,2019,86285,183415,269700,MKT
06090301446130000,2021,84033,261267,345300,MKT
06090301446130000,2020,78804,252496,331300,MKT
06090301446130000,2019,78804,252496,331300,MKT
06090301446140000,2021,88854,222946,311800,MKT
06090301446140000,2020,85793,192707,278500,MKT
06090301446140000,2019,85793,192707,278500,MKT
06090301446150000,2021,80113,228687,308800,MKT
06090301446150000,2020,73272,195828,269100,MKT
06090301446150000,2019,73272,195828,269100,MKT
06090301446160000,2021,80113,185787,265900,MKT
06090301446160000,2020,73272,175128,248400,MKT
06090301446160000,2019,73272,175128,248400,MKT
06090301446170000,2021,79677,185223,264900,MKT
06090301446170000,2020,72666,174234,246900,MKT
06090301446170000,2019,72666,174234,246900,MKT
06090301446180000,2021,79677,177223,256900,MKT
06090301446180000,2020,72666,163334,236000,MKT
06090301446180000,2019,72666,163334,236000,MKT
06090301446190000,2021,87839,213661,301500,MKT
06090301446190000,2020,84304,229496,313800,MKT
06090301446190000,2019,84304,229496,313800,MKT
06090301446200000,2021,93867,178233,272100,MKT
06090301446200000,2020,93274,167626,260900,MKT
06090301446200000,2019,93274,167626,260900,MKT
06090301446210000,2021,83858,240542,324400,MKT
06090301446210000,2020,78554,213346,291900,MKT
06090301446210000,2019,78554,213346,291900,MKT
06090301446220000,2021,88497,237103,325600,MKT
06090301446220000,2020,85268,217232,302500,MKT
06090301446220000,2019,85268,217232,302500,MKT
06090301446230000,2021,79677,238323,318000,MKT
06090301446230000,2020,72666,233934,306600,MKT
06090301446230000,2019,72666,233934,306600,MKT
06090301446240000,2021,79677,255423,335100,MKT
06090301446240000,2020,72666,233934,306600,MKT
06090301446240000,2019,72666,233934,306600,MKT
06090301446250000,2021,87235,194965,282200,MKT
06090301446250000,2020,83423,191077,274500,MKT
06090301446250000,2019,83423,191077,274500,MKT
06090301446260000,2021,82565,0,82565,COST
06090301446260000,2020,76716,0,76716,COST
06090301446260000,2019,76716,0,76716,COST
06090301454010000,2021,388286,0,388286,COST
06090301454010000,2020,140387,0,140387,COST
06090301454010000,2019,140387,0,140387,COST
06090301454170000,2021,355386,0,355386,COST
06090301454170000,2020,130889,0,130889,COST
06090301454170000,2019,130889,0,130889,COST
06090301454180000,2021,170716,90060,260776,COST
06090301454180000,2020,73272,84750,158022,COST
06090301454180000,2019,73272,84750,158022,COST
06090301455010000,2021,374371,0,374371,COST
06090301455010000,2020,136391,0,136391,COST
06090301455010000,2019,136391,0,136391,COST
06090301455160000,2021,374371,0,374371,COST
06090301455160000,2020,136391,0,136391,COST
06090301455160000,2019,136391,0,136391,COST
06090301492877000,2021,106180,1710,107890,COST
06090301492877000,2020,78271,1690,79961,COST
06090301492877000,2019,78271,1690,79961,COST
06090302101010000,2021,210713,0,210713,COST
06090302101010000,2020,178610,0,178610,COST
06090302101010000,2019,178610,0,178610,COST
06090302101020000,2021,401676,0,401676,COST
06090302101020000,2020,488269,0,488269,COST
06090302101020000,2019,488269,0,488269,COST
06090302101030000,2021,440197,343203,783400,INCOME
06090302101030000,2020,563190,201110,764300,INCOME
06090302101030000,2019,563190,201110,764300,INCOME
06090302101040000,2021,294347,966053,1260400,INCOME
06090302101040000,2020,300743,893357,1194100,INCOME
06090302101040000,2019,300743,893357,1194100,INCOME
06090302101050000,2021,365729,1627171,1992900,INCOME
06090302101050000,2020,421881,1562219,1984100,INCOME
06090302101050000,2019,421881,1562219,1984100,INCOME
06090302101060000,2021,269402,441798,711200,INCOME
06090302101060000,2020,261966,158734,420700,INCOME
06090302101060000,2019,261966,158734,420700,INCOME
06090302101077000,2021,320005,36620,356625,COST
06090302101077000,2020,342591,36210,378801,COST
06090302101077000,2019,342591,36210,378801,COST
06090302101080000,2021,226145,396655,622800,INCOME
06090302101080000,2020,199413,345287,544700,INCOME
06090302101080000,2019,199413,345287,544700,INCOME
06090302101090000,2021,397630,298870,696500,INCOME
06090302101090000,2020,480625,179775,660400,INCOME
06090302101090000,2019,480625,54475,535100,INCOME
06090302101100000,2021,242827,200773,443600,INCOME
06090302101100000,2020,222811,190489,413300,INCOME
06090302101100000,2019,222811,131689,354500,INCOME
06090302101110000,2021,239864,1172040,1411904,COST
06090302101110000,2020,218587,1063013,1281600,INCOME
06090302101110000,2019,218587,1063013,1281600,INCOME
06090302101120000,2021,239864,219336,459200,INCOME
06090302101120000,2020,218587,202313,420900,INCOME
06090302101120000,2019,218587,202313,420900,INCOME
06090302101130000,2021,239864,717350,957214,COST
06090302101130000,2020,218587,500113,718700,INCOME
06090302101130000,2019,218587,500113,718700,INCOME
06090302101140000,2021,239864,0,239864,COST
06090302101140000,2020,163000,0,163000,COST
06090302101140000,2019,163000,0,163000,COST
06090302101150000,2021,239864,59636,299500,INCOME
06090302101150000,2020,218587,98350,316937,COST
06090302101150000,2019,218587,98350,316937,COST
06090302101160000,2021,239864,0,239864,COST
06090302101160000,2020,218587,0,218587,COST
06090302101160000,2019,218587,0,218587,COST
06090302101170000,2021,239864,53036,292900,INCOME
06090302101170000,2020,218587,54013,272600,INCOME
06090302101170000,2019,218587,54013,272600,INCOME
06090302101180000,2021,239864,460136,700000,INCOME
06090302101180000,2020,218587,428813,647400,INCOME
06090302101180000,2019,218587,245660,464247,COST
06090302101190000,2021,239864,675040,914904,COST
06090302101190000,2020,218587,646980,865567,COST
06090302101190000,2019,218587,646980,865567,COST
06090302101200000,2021,344302,0,344302,COST
06090302101200000,2020,383988,0,383988,COST
06090302101200000,2019,383988,0,383988,COST
06090302101210000,2021,232888,125710,358598,COST
06090302101210000,2020,208759,130641,339400,INCOME
06090302101210000,2019,208759,130641,339400,INCOME
06090302101220000,2021,446664,1556580,2003244,COST
06090302101220000,2020,505506,1437180,1942686,COST
06090302101220000,2019,505506,1437180,1942686,COST
06090302101230000,2021,225505,492395,717900,INCOME
06090302101230000,2020,198534,496666,695200,INCOME
06090302101230000,2019,198534,496666,695200,INCOME
06090302101250000,2021,390769,1042330,1433099,COST
06090302101250000,2020,467760,959140,1426900,INCOME
06090302101250000,2019,467760,959140,1426900,INCOME
06090302101270000,2021,205454,0,205454,COST
06090302101270000,2020,171709,0,171709,COST
06090302101270000,2019,171709,0,171709,COST
06090302101300000,2021,198191,143209,341400,INCOME
06090302101300000,2020,162341,174259,336600,INCOME
06090302101300000,2019,162341,174259,336600,INCOME
06090302101350000,2021,198191,420700,618891,COST
06090302101350000,2020,162341,408380,570721,COST
06090302101350000,2019,162341,408380,570721,COST
06090302102010000,2021,224146,315710,539856,COST
06090302102010000,2020,196634,301760,498394,COST
06090302102010000,2019,196634,301760,498394,COST
06090302103010000,2021,238141,460059,698200,INCOME
06090302103010000,2020,216145,420155,636300,INCOME
06090302103010000,2019,216145,420155,636300,INCOME
06090302103020000,2021,269402,323998,593400,INCOME
06090302103020000,2020,261966,311634,573600,INCOME
06090302103020000,2019,261966,311634,573600,INCOME
06090302103030000,2021,269402,628598,898000,INCOME
06090302103030000,2020,261966,549334,811300,INCOME
06090302103030000,2019,261966,549334,811300,INCOME
06090302103040000,2021,375857,1672843,2048700,INCOME
06090302103040000,2020,440233,1392367,1832600,INCOME
06090302103040000,2019,440233,1392367,1832600,INCOME
06090302103050000,2021,239864,132836,372700,INCOME
06090302103050000,2020,218587,137413,356000,INCOME
06090302103050000,2019,218587,137413,356000,INCOME
06090302103060000,2021,295761,932139,1227900,INCOME
06090302103060000,2020,302997,632103,935100,INCOME
06090302103060000,2019,302997,632103,935100,INCOME
06090302103070000,2021,302030,63170,365200,INCOME
06090302103070000,2020,313069,38131,351200,INCOME
06090302103070000,2019,313069,38131,351200,INCOME
06090302103080000,2021,353981,0,353981,COST
06090302103080000,2020,400947,0,400947,COST
06090302103080000,2019,400947,0,400947,COST
06090302103097000,2021,280384,108770,389154,COST
06090302103097000,2020,278801,22170,300971,COST
06090302103097000,2019,278801,22170,300971,COST
06090302103100000,2021,381488,374212,755700,INCOME
06090302103100000,2020,450557,247543,698100,INCOME
06090302103100000,2019,450557,247543,698100,INCOME
06090302103110000,2021,375409,1029991,1405400,INCOME
06090302103110000,2020,439415,875785,1315200,INCOME
06090302103110000,2019,439415,875785,1315200,INCOME
06090302103120000,2021,206782,49218,256000,INCOME
06090302103120000,2020,173443,78957,252400,INCOME
06090302103120000,2019,173443,78957,252400,INCOME
06090302123010000,2021,469570,592830,1062400,INCOME
06090302123010000,2020,266783,584117,850900,INCOME
06090302123010000,2019,266783,584117,850900,INCOME
06090302123050000,2021,87855,32570,120425,COST
06090302123050000,2020,25459,30940,56399,COST
06090302123050000,2019,25459,30940,56399,COST
06090302123100000,2021,567483,2989517,3557000,INCOME
06090302123100000,2020,466406,1539894,2006300,INCOME
06090302123100000,2019,466406,1539894,2006300,INCOME
06090302123300000,2021,236531,458769,695300,INCOME
06090302123300000,2020,119210,310690,429900,INCOME
06090302123300000,2019,119210,310690,429900,INCOME
06090302123500000,2021,360751,602549,963300,INCOME
06090302123500000,2020,584914,284786,869700,INCOME
06090302123500000,2019,584914,284786,869700,INCOME
06090302123660000,2021,404965,1312435,1717400,INCOME
06090302123660000,2020,700422,763978,1464400,INCOME
06090302123660000,2019,700422,763978,1464400,INCOME
06090302131010000,2021,470811,1833040,2303851,COST
06090302131010000,2020,348605,1603620,1952225,COST
06090302131010000,2019,348605,1603620,1952225,COST
06090302131100000,2021,385873,969470,1355343,COST
06090302131100000,2020,196453,954140,1150593,COST
06090302131100000,2019,196453,954140,1150593,COST
06090302133010000,2021,590727,651420,1242147,COST
06090302133010000,2020,171641,632250,803891,COST
06090302133010000,2019,171641,632250,803891,COST
06090302138037000,2021,219076,0,219076,COST
06090302138037000,2020,133724,0,133724,COST
06090302138037000,2019,133724,0,133724,COST
06090302138060000,2021,146100,0,146100,COST
06090302138060000,2020,84141,0,84141,COST
06090302138060000,2019,84141,0,84141,COST
06090302138120000,2021,235047,1119100,1354147,COST
06090302138120000,2020,118046,1095430,1213476,COST
06090302138120000,2019,118046,1095430,1213476,COST
06090302139010000,2021,93172,167328,260500,MKT
06090302139010000,2020,55615,185685,241300,MKT
06090302139010000,2019,55615,185685,241300,MKT
06090302139020000,2021,93172,165228,258400,MKT
06090302139020000,2020,55615,184285,239900,MKT
06090302139020000,2019,55615,184285,239900,MKT
06090302139030000,2021,93172,327028,420200,INCOME
06090302139030000,2020,55615,349485,405100,INCOME
06090302139030000,2019,55615,349485,405100,INCOME
06090302139040000,2021,93172,186928,280100,INCOME
06090302139040000,2020,55615,214485,270100,INCOME
06090302139040000,2019,55615,214485,270100,INCOME
06090302139050000,2021,93172,128628,221800,INCOME
06090302139050000,2020,55615,151585,207200,INCOME
06090302139050000,2019,55615,151585,207200,INCOME
06090302139060000,2021,93172,149828,243000,MKT
06090302139060000,2020,55615,167285,222900,MKT
06090302139060000,2019,55615,167285,222900,MKT
06090302139070000,2021,93172,158428,251600,MKT
06090302139070000,2020,55615,190185,245800,MKT
06090302139070000,2019,55615,190185,245800,MKT
06090302139080000,2021,93172,153128,246300,MKT
06090302139080000,2020,55615,172685,228300,MKT
06090302139080000,2019,55615,172685,228300,MKT
06090302139090000,2021,93172,181128,274300,MKT
06090302139090000,2020,55615,190785,246400,MKT
06090302139090000,2019,55615,190785,246400,MKT
06090302139100000,2021,93172,159328,252500,MKT
06090302139100000,2020,55615,172885,228500,MKT
06090302139100000,2019,55615,172885,228500,MKT
06090302139110000,2021,93172,165028,258200,MKT
06090302139110000,2020,55615,178385,234000,MKT
06090302139110000,2019,55615,178385,234000,MKT
06090302139120000,2021,93172,174728,267900,MKT
06090302139120000,2020,55615,194485,250100,MKT
06090302139120000,2019,55615,194485,250100,MKT
06090302139130000,2021,93172,168228,261400,MKT
06090302139130000,2020,55615,185985,241600,MKT
06090302139130000,2019,55615,185985,241600,MKT
06090302139140000,2021,93172,159720,252892,COST
06090302139140000,2020,55615,183085,238700,MKT
06090302139140000,2019,55615,187185,242800,MKT
06090302139150000,2021,93172,168028,261200,MKT
06090302139150000,2020,55615,155890,211505,COST
06090302139150000,2019,55615,155890,211505,COST
06090302139160000,2021,93172,179528,272700,MKT
06090302139160000,2020,55615,192185,247800,MKT
06090302139160000,2019,55615,192185,247800,MKT
06090302148015001,2021,73778,143922,217700,MKT
06090302148015001,2020,42879,162321,205200,MKT
06090302148015001,2019,42879,149121,192000,MKT
06090302148025002,2021,77458,143942,221400,MKT
06090302148025002,2020,46179,162421,208600,MKT
06090302148025002,2019,46179,148921,195100,MKT
06090302148035002,2021,75685,157015,232700,MKT
06090302148035002,2020,44579,175221,219800,MKT
06090302148035002,2019,44579,175221,219800,MKT
06090302148045001,2021,72085,154315,226400,MKT
06090302148045001,2020,41389,164411,205800,MKT
06090302148045001,2019,41389,164411,205800,MKT
06090302148055001,2021,72090,129210,201300,MKT
06090302148055001,2020,41394,145906,187300,MKT
06090302148055001,2019,41394,145906,187300,MKT
06090302148065002,2021,75685,135915,211600,MKT
06090302148065002,2020,44579,153021,197600,MKT
06090302148065002,2019,44579,153021,197600,MKT
06090302148075002,2021,75690,156110,231800,MKT
06090302148075002,2020,44583,166917,211500,MKT
06090302148075002,2019,44583,166917,211500,MKT
06090302148085001,2021,72090,150810,222900,MKT
06090302148085001,2020,41394,161506,202900,MKT
06090302148085001,2019,41394,161506,202900,MKT
06090302148095001,2021,72090,128610,200700,MKT
06090302148095001,2020,41394,145906,187300,MKT
06090302148095001,2019,41394,145806,187200,MKT
06090302148105002,2021,75690,134110,209800,MKT
06090302148105002,2020,44583,151417,196000,MKT
06090302148105002,2019,44583,151417,196000,MKT
06090302148110000,2021,93172,0,93172,COST
06090302148110000,2020,55615,0,55615,COST
06090302148110000,2019,55615,0,55615,COST
06090302148150000,2021,93172,334328,427500,INCOME
06090302148150000,2020,55615,362085,417700,INCOME
06090302148150000,2019,55615,362085,417700,INCOME
06090302148170000,2021,93172,334328,427500,INCOME
06090302148170000,2020,55615,362085,417700,INCOME
06090302148170000,2019,55615,362085,417700,INCOME
06090302148200000,2021,96811,330689,427500,INCOME
06090302148200000,2020,57611,360089,417700,INCOME
06090302148200000,2019,57611,360089,417700,INCOME
06090302148257000,2021,317446,24590,342036,COST
06090302148257000,2020,188583,23790,212373,COST
06090302148257000,2019,188583,23790,212373,COST
06090302148300000,2021,93172,416328,509500,INCOME
06090302148300000,2020,55615,433485,489100,INCOME
06090302148300000,2019,55615,433485,489100,INCOME
06090302149010000,2021,93172,165328,258500,MKT
06090302149010000,2020,55615,184785,240400,MKT
06090302149010000,2019,55615,184785,240400,MKT
06090302149020000,2021,93172,165128,258300,MKT
06090302149020000,2020,55615,184085,239700,MKT
06090302149020000,2019,55615,184085,239700,MKT
06090302149030000,2021,93172,181128,274300,MKT
06090302149030000,2020,55615,187985,243600,MKT
06090302149030000,2019,55615,187985,243600,MKT
06090302149040000,2021,93172,227228,320400,MKT
06090302149040000,2020,55615,225685,281300,MKT
06090302149040000,2019,55615,225685,281300,MKT
06090302149050000,2021,93172,199728,292900,MKT
06090302149050000,2020,55615,198285,253900,OVR
06090302149050000,2019,55615,198285,253900,MKT
06090302149060000,2021,93172,175228,268400,MKT
06090302149060000,2020,55615,182885,238500,MKT
06090302149060000,2019,55615,182885,238500,MKT
06090302149070000,2021,93204,190496,283700,MKT
06090302149070000,2020,55633,178067,233700,MKT
06090302149070000,2019,55633,178067,233700,MKT
06090302149080000,2021,93209,176320,269529,COST
06090302149080000,2020,55636,176764,232400,MKT
06090302149080000,2019,55636,176764,232400,MKT
06090302149090000,2021,93204,194596,287800,MKT
06090302149090000,2020,55633,180667,236300,MKT
06090302149090000,2019,55633,180667,236300,MKT
06090302149100000,2021,93204,213196,306400,MKT
06090302149100000,2020,55633,191167,246800,MKT
06090302149100000,2019,55633,191167,246800,MKT
06090302149117000,2021,111540,0,111540,COST
06090302149117000,2020,71842,0,71842,COST
06090302149117000,2019,71842,0,71842,COST
06090302149130000,2021,93172,213428,306600,INCOME
06090302149130000,2020,55615,239185,294800,INCOME
06090302149130000,2019,55615,239185,294800,INCOME
06090302149140000,2021,93172,199028,292200,MKT
06090302149140000,2020,55615,177385,233000,MKT
06090302149140000,2019,55615,177385,233000,MKT
06090302149150000,2021,93172,177428,270600,MKT
06090302149150000,2020,55615,196485,252100,MKT
06090302149150000,2019,55615,197485,253100,MKT
06090302149160000,2021,93172,161828,255000,MKT
06090302149160000,2020,55615,175085,230700,MKT
06090302149160000,2019,55615,175085,230700,MKT
06090302150010000,2021,121997,143803,265800,MKT
06090302150010000,2020,71276,181624,252900,MKT
06090302150010000,2019,71276,181624,252900,MKT
06090302150020000,2021,107536,194764,302300,MKT
06090302150020000,2020,63461,180539,244000,MKT
06090302150020000,2019,63461,180539,244000,MKT
06090302150030000,2021,107536,159664,267200,MKT
06090302150030000,2020,63461,191739,255200,MKT
06090302150030000,2019,63461,191739,255200,MKT
06090302150040000,2021,115849,227751,343600,MKT
06090302150040000,2020,67963,214037,282000,MKT
06090302150040000,2019,67963,214037,282000,MKT
06090302150050000,2021,114746,166854,281600,MKT
06090302150050000,2020,67367,155533,222900,MKT
06090302150050000,2019,67367,155533,222900,MKT
06090302153010000,2021,95792,327908,423700,INCOME
06090302153010000,2020,69430,0,69430,COST
06090302153010000,2019,69430,0,69430,COST
06090302153020000,2021,95792,207100,302892,COST
06090302153020000,2020,57053,0,57053,COST
06090302153020000,2019,57053,0,57053,COST
06090302153030000,2021,95792,272470,368262,COST
06090302153030000,2020,57053,0,57053,COST
06090302153030000,2019,57053,0,57053,COST
06090302153040000,2021,95792,327908,423700,INCOME
06090302153040000,2020,57053,280747,337800,INCOME
06090302153040000,2019,57053,280747,337800,INCOME
06090302153050000,2021,103076,320624,423700,INCOME
06090302153050000,2020,61035,276765,337800,INCOME
06090302153050000,2019,61035,276765,337800,INCOME
06090302153060000,2021,237661,206739,444400,INCOME
06090302153060000,2020,120100,255400,375500,INCOME
06090302153060000,2019,120100,255400,375500,INCOME
06090302153120000,2021,229567,25530,255097,COST
06090302153120000,2020,113784,26950,140734,COST
06090302153120000,2019,113784,26950,140734,COST
06090302153180000,2021,93172,202528,295700,INCOME
06090302153180000,2020,55615,224685,280300,INCOME
06090302153180000,2019,55615,224685,280300,INCOME
06090302153197000,2021,84455,0,84455,COST
06090302153197000,2020,55615,0,55615,COST
06090302153197000,2019,55615,0,55615,COST
06090302153200000,2021,93172,186928,280100,INCOME
06090302153200000,2020,55615,214485,270100,INCOME
06090302153200000,2019,55615,214485,270100,INCOME
06090302153210000,2021,93172,202528,295700,INCOME
06090302153210000,2020,55615,224685,280300,INCOME
06090302153210000,2019,55615,224685,280300,INCOME
06090302153220000,2021,93172,202528,295700,INCOME
06090302153220000,2020,55615,224685,280300,INCOME
06090302153220000,2019,55615,224685,280300,INCOME
06090302154010000,2021,95792,146308,242100,MKT
06090302154010000,2020,57053,143947,201000,MKT
06090302154010000,2019,57053,143947,201000,MKT
06090302154020000,2021,95792,139708,235500,MKT
06090302154020000,2020,57053,134547,191600,MKT
06090302154020000,2019,57053,134547,191600,MKT
06090302154030000,2021,95792,138408,234200,MKT
06090302154030000,2020,57053,132747,189800,MKT
06090302154030000,2019,57053,132747,189800,MKT
06090302154040000,2021,95792,139408,235200,MKT
06090302154040000,2020,57053,133647,190700,MKT
06090302154040000,2019,57053,133647,190700,MKT
06090302154050000,2021,95792,140708,236500,MKT
06090302154050000,2020,57053,134947,192000,MKT
06090302154050000,2019,57053,134947,192000,MKT
06090302154060000,2021,95792,142408,238200,MKT
06090302154060000,2020,57053,136647,193700,MKT
06090302154060000,2019,57053,136647,193700,MKT
06090302154075001,2021,79850,124150,204000,MKT
06090302154075001,2020,48369,140331,188700,MKT
06090302154075001,2019,48369,140331,188700,MKT
06090302154075002,2021,68150,112050,180200,MKT
06090302154075002,2020,37997,112903,150900,MKT
06090302154075002,2019,37997,112903,150900,MKT
06090302154085001,2021,68150,112050,180200,MKT
06090302154085001,2020,37997,112903,150900,MKT
06090302154085001,2019,37997,112903,150900,MKT
06090302154085002,2021,77306,119394,196700,MKT
06090302154085002,2020,46041,135459,181500,MKT
06090302154085002,2019,46041,135459,181500,MKT
06090302154090000,2021,95792,178708,274500,MKT
06090302154090000,2020,57053,193147,250200,MKT
06090302154090000,2019,57053,193147,250200,MKT
06090302154100000,2021,95792,160408,256200,MKT
06090302154100000,2020,57053,157647,214700,MKT
06090302154100000,2019,57053,157647,214700,MKT
06090302154110000,2021,95792,157108,252900,MKT
06090302154110000,2020,57053,166547,223600,MKT
06090302154110000,2019,57053,166547,223600,MKT
06090302154120000,2021,95792,203708,299500,MKT
06090302154120000,2020,57053,189290,246343,COST
06090302154120000,2019,57053,189290,246343,COST
06090302154130000,2021,95792,167008,262800,MKT
06090302154130000,2020,57053,183547,240600,MKT
06090302154130000,2019,57053,183547,240600,MKT
06090302154140000,2021,95792,181508,277300,MKT
06090302154140000,2020,57053,194447,251500,MKT
06090302154140000,2019,57053,198547,255600,MKT
06090302154150000,2021,95792,180608,276400,MKT
06090302154150000,2020,57053,186747,243800,MKT
06090302154150000,2019,57053,186747,243800,MKT
06090302154160000,2021,118568,162732,281300,MKT
06090302154160000,2020,69430,181070,250500,MKT
06090302154160000,2019,69430,181070,250500,MKT
06090302155010000,2021,122176,126024,248200,MKT
06090302155010000,2020,71372,134528,205900,MKT
06090302155010000,2019,71372,134528,205900,MKT
06090302155020000,2021,107536,220564,328100,MKT
06090302155020000,2020,63461,205139,268600,MKT
06090302155020000,2019,63461,205139,268600,MKT
06090302155030000,2021,107536,181564,289100,MKT
06090302155030000,2020,63461,155739,219200,MKT
06090302155030000,2019,63461,155739,219200,MKT
06090302155040000,2021,107536,191364,298900,MKT
06090302155040000,2020,63461,191239,254700,OVR
06090302155040000,2019,63461,191239,254700,MKT
06090302155050000,2021,107536,209764,317300,MKT
06090302155050000,2020,63461,214739,278200,MKT
06090302155050000,2019,63461,198839,262300,MKT
06090302155060000,2021,110189,143211,253400,MKT
06090302155060000,2020,64901,169699,234600,MKT
06090302155060000,2019,64901,169699,234600,MKT
06090302155070000,2021,110189,157511,267700,MKT
06090302155070000,2020,64901,180499,245400,MKT
06090302155070000,2019,64901,180499,245400,MKT
06090302155080000,2021,107536,205564,313100,MKT
06090302155080000,2020,63461,227739,291200,MKT
06090302155080000,2019,63461,227739,291200,MKT
06090302155090000,2021,107536,170364,277900,MKT
06090302155090000,2020,63461,187639,251100,MKT
06090302155090000,2019,63461,187639,251100,MKT
06090302155100000,2021,109620,197880,307500,MKT
06090302155100000,2020,64592,189908,254500,MKT
06090302155100000,2019,64592,189908,254500,MKT
06090302155110000,2021,127521,177379,304900,MKT
06090302155110000,2020,74241,169920,244161,COST
06090302155110000,2019,74241,169920,244161,COST
06090302156010000,2021,108019,171481,279500,MKT
06090302156010000,2020,63723,159877,223600,OVR
06090302156010000,2019,63723,159877,223600,MKT
06090302156020000,2021,109582,175018,284600,MKT
06090302156020000,2020,64571,178729,243300,MKT
06090302156020000,2019,64571,178729,243300,MKT
06090302156030000,2021,126458,193842,320300,MKT
06090302156030000,2020,73671,195629,269300,MKT
06090302156030000,2019,73671,195629,269300,MKT
06090302156040000,2021,109917,166583,276500,MKT
06090302156040000,2020,64753,191847,256600,MKT
06090302156040000,2019,64753,191847,256600,MKT
06090302156050000,2021,107536,205664,313200,MKT
06090302156050000,2020,63461,222139,285600,MKT
06090302156050000,2019,63461,222139,285600,MKT
06090302156060000,2021,107536,171964,279500,MKT
06090302156060000,2020,63461,173739,237200,MKT
06090302156060000,2019,63461,173739,237200,MKT
06090302156070000,2021,107536,212364,319900,MKT
06090302156070000,2020,63461,200039,263500,MKT
06090302156070000,2019,63461,200039,263500,MKT
06090302156080000,2021,107536,190564,298100,MKT
06090302156080000,2020,63461,207539,271000,MKT
06090302156080000,2019,63461,207539,271000,MKT
06090302156090000,2021,107536,155860,263396,COST
06090302156090000,2020,63461,146880,210341,COST
06090302156090000,2019,63461,146880,210341,COST
06090302162010000,2021,93172,185228,278400,MKT
06090302162010000,2020,55615,201685,257300,MKT
06090302162010000,2019,55615,201685,257300,MKT
06090302162020000,2021,93241,186859,280100,INCOME
06090302162020000,2020,55653,214447,270100,INCOME
06090302162020000,2019,55653,214447,270100,INCOME
06090302162030000,2021,93172,237328,330500,MKT
06090302162030000,2020,55615,251485,307100,MKT
06090302162030000,2019,55615,228185,283800,MKT
06090302162040000,2021,93241,202459,295700,INCOME
06090302162040000,2020,55653,224420,280073,COST
06090302162040000,2019,55653,224420,280073,COST
06090302162055001,2021,74651,152849,227500,MKT
06090302162055001,2020,43654,167346,211000,MKT
06090302162055001,2019,43654,167346,211000,MKT
06090302162060000,2021,93241,152759,246000,INCOME
06090302162060000,2020,55653,181847,237500,INCOME
06090302162060000,2019,55653,181847,237500,INCOME
06090302162070000,2021,93172,217528,310700,MKT
06090302162070000,2020,55615,219185,274800,MKT
06090302162070000,2019,55615,219185,274800,MKT
06090302162080000,2021,93172,186928,280100,INCOME
06090302162080000,2020,55615,214485,270100,INCOME
06090302162080000,2019,55615,214485,270100,INCOME
06090302162090000,2021,123111,886589,1009700,INCOME
06090302162090000,2020,89369,834931,924300,INCOME
06090302162090000,2019,89369,834931,924300,INCOME
06090302162110000,2021,111736,630064,741800,INCOME
06090302162110000,2020,65739,659461,725200,INCOME
06090302162110000,2019,65739,659461,725200,INCOME
06090302162130000,2021,107540,316360,423900,INCOME
06090302162130000,2020,63463,379737,443200,INCOME
06090302162130000,2019,63463,379737,443200,INCOME
06090302162140000,2021,93172,152828,246000,INCOME
06090302162140000,2020,55615,181885,237500,INCOME
06090302162140000,2019,55615,181885,237500,INCOME
06090302162150000,2021,87450,256850,344300,INCOME
06090302162150000,2020,52464,286836,339300,INCOME
06090302162150000,2019,52464,286836,339300,INCOME
06090302162175002,2021,73239,149861,223100,MKT
06090302162175002,2020,42403,169597,212000,MKT
06090302162175002,2019,42403,169597,212000,MKT
06090302162180000,2021,29524,0,29524,COST
06090302162180000,2020,17546,0,17546,COST
06090302162180000,2019,17546,0,17546,COST
06090302163010000,2021,93172,255828,349000,MKT
06090302163010000,2020,55615,252885,308500,MKT
06090302163010000,2019,55615,252885,308500,MKT
06090302163020000,2021,95792,253308,349100,INCOME
06090302163020000,2020,57053,280747,337800,INCOME
06090302163020000,2019,57053,280747,337800,INCOME
06090302163030000,2021,95792,243608,339400,INCOME
06090302163030000,2020,57053,280747,337800,INCOME
06090302163030000,2019,57053,280747,337800,INCOME
06090302163040000,2021,95792,236408,332200,MKT
06090302163040000,2020,57053,226547,283600,MKT
06090302163040000,2019,57053,226547,283600,MKT
06090302163050000,2021,95792,200108,295900,MKT
06090302163050000,2020,57053,204947,262000,MKT
06090302163050000,2019,57053,204947,262000,MKT
06090302163065001,2021,75203,188297,263500,MKT
06090302163065001,2020,44147,189353,233500,MKT
06090302163065001,2019,44147,189353,233500,MKT
06090302163065002,2021,75198,191702,266900,MKT
06090302163065002,2020,44142,188358,232500,MKT
06090302163065002,2019,44142,188358,232500,MKT
06090302163075001,2021,73958,212842,286800,MKT
06090302163075001,2020,43039,217961,261000,MKT
06090302163075001,2019,43039,217961,261000,MKT
06090302163075002,2021,73958,220842,294800,MKT
06090302163075002,2020,43039,222361,265400,MKT
06090302163075002,2019,43039,215861,258900,MKT
06090302163080000,2021,95792,247008,342800,MKT
06090302163080000,2020,57053,232047,289100,MKT
06090302163080000,2019,57053,232047,289100,MKT
06090302163090000,2021,93172,157428,250600,INCOME
06090302163090000,2020,55615,193185,248800,INCOME
06090302163090000,2019,55615,193185,248800,INCOME
06090302163100000,2021,95792,175308,271100,MKT
06090302163100000,2020,57053,187647,244700,MKT
06090302163100000,2019,57053,187647,244700,MKT
06090302163110000,2021,95792,165608,261400,MKT
06090302163110000,2020,57053,187447,244500,MKT
06090302163110000,2019,57053,187447,244500,MKT
06090302163120000,2021,95792,162008,257800,MKT
06090302163120000,2020,57053,154747,211800,MKT
06090302163120000,2019,57053,154747,211800,MKT
06090302163130000,2021,95792,150208,246000,INCOME
06090302163130000,2020,57053,180447,237500,INCOME
06090302163130000,2019,57053,180447,237500,INCOME
06090302163140000,2021,95792,126008,221800,INCOME
06090302163140000,2020,57053,150147,207200,INCOME
06090302163140000,2019,57053,150147,207200,INCOME
06090302163150000,2021,95792,126008,221800,INCOME
06090302163150000,2020,57053,150147,207200,INCOME
06090302163150000,2019,57053,150147,207200,INCOME
06090302163160000,2021,118568,251032,369600,INCOME
06090302163160000,2020,69430,276570,346000,INCOME
06090302163160000,2019,69430,276570,346000,INCOME
06090302164010000,2021,116320,194980,311300,MKT
06090302164010000,2020,68217,194483,262700,MKT
06090302164010000,2019,68217,194483,262700,MKT
06090302164020000,2021,107536,182564,290100,MKT
06090302164020000,2020,63461,177539,241000,MKT
06090302164020000,2019,63461,177539,241000,MKT
06090302164030000,2021,107536,203964,311500,MKT
06090302164030000,2020,63461,204639,268100,MKT
06090302164030000,2019,63461,204639,268100,MKT
06090302164040000,2021,107536,188364,295900,MKT
06090302164040000,2020,63461,178439,241900,MKT
06090302164040000,2019,63461,178439,241900,MKT
06090302164050000,2021,119605,204295,323900,MKT
06090302164050000,2020,69988,206212,276200,MKT
06090302164050000,2019,69988,204312,274300,MKT
06090302164060000,2021,109135,165565,274700,MKT
06090302164060000,2020,64329,162171,226500,MKT
06090302164060000,2019,64329,162171,226500,MKT
06090302164070000,2021,116508,136250,252758,COST
06090302164070000,2020,68319,129690,198009,COST
06090302164070000,2019,68319,129690,198009,COST
06090302165010000,2021,93172,297128,390300,INCOME
06090302165010000,2020,55615,296785,352400,INCOME
06090302165010000,2019,55615,296785,352400,INCOME
06090302165020000,2021,93172,174228,267400,MKT
06090302165020000,2020,55615,188185,243800,MKT
06090302165020000,2019,55615,188185,243800,MKT
06090302165030000,2021,93172,249028,342200,MKT
06090302165030000,2020,55615,227385,283000,MKT
06090302165030000,2019,55615,227385,283000,MKT
06090302165040000,2021,93172,165228,258400,MKT
06090302165040000,2020,55615,182985,238600,MKT
06090302165040000,2019,55615,182985,238600,MKT
06090302165050000,2021,93172,190728,283900,MKT
06090302165050000,2020,55615,196585,252200,MKT
06090302165050000,2019,55615,196585,252200,MKT
06090302165067000,2021,127495,0,127495,COST
06090302165067000,2020,81249,0,81249,COST
06090302165067000,2019,81249,0,81249,COST
06090302166017000,2021,101840,0,101840,COST
06090302166017000,2020,66071,0,66071,COST
06090302166017000,2019,66071,0,66071,COST
06090302166030000,2021,108442,195258,303700,MKT
06090302166030000,2020,63953,199347,263300,MKT
06090302166030000,2019,63953,199347,263300,MKT
06090302166050000,2021,102508,203292,305800,MKT
06090302166050000,2020,60725,209275,270000,MKT
06090302166050000,2019,60725,209275,270000,MKT
06090302166070000,2021,93911,162089,256000,MKT
06090302166070000,2020,56021,154179,210200,MKT
06090302166070000,2019,56021,154179,210200,MKT
06090302166090000,2021,110857,169243,280100,INCOME
06090302166090000,2020,65263,204837,270100,INCOME
06090302166090000,2019,65263,204837,270100,INCOME
06090302166117000,2021,94763,0,94763,COST
06090302166117000,2020,61834,0,61834,COST
06090302166117000,2019,61834,0,61834,COST
06090302166130000,2021,106933,398167,505100,INCOME
06090302166130000,2020,63133,411767,474900,INCOME
06090302166130000,2019,63133,411767,474900,INCOME
06090302166150000,2021,106876,385224,492100,INCOME
06090302166150000,2020,63102,411798,474900,INCOME
06090302166150000,2019,63102,411798,474900,INCOME
06090302166175001,2021,80378,191522,271900,MKT
06090302166175001,2020,48857,189443,238300,MKT
06090302166175001,2019,48857,189443,238300,MKT
06090302166175002,2021,80370,189530,269900,MKT
06090302166175002,2020,48850,187550,236400,MKT
06090302166175002,2019,48850,187550,236400,MKT
06090302166195001,2021,80351,163849,244200,MKT
06090302166195001,2020,48831,183769,232600,MKT
06090302166195001,2019,48831,173369,222200,MKT
06090302166195002,2021,80339,152061,232400,MKT
06090302166195002,2020,48820,173380,222200,MKT
06090302166195002,2019,48820,173380,222200,MKT
06090302166215001,2021,74884,194116,269000,MKT
06090302166215001,2020,43862,188038,231900,MKT
06090302166215001,2019,43862,188038,231900,MKT
06090302166215002,2021,67849,192451,260300,MKT
06090302166215002,2020,37742,189558,227300,MKT
06090302166215002,2019,37742,189558,227300,MKT
06090302166215003,2021,74869,194131,269000,MKT
06090302166215003,2020,43849,188051,231900,MKT
06090302166215003,2019,43849,188051,231900,MKT
06090302166235001,2021,74526,191874,266400,MKT
06090302166235001,2020,43543,183257,226800,MKT
06090302166235001,2019,43543,183257,226800,MKT
06090302166235002,2021,67896,188804,256700,MKT
06090302166235002,2020,37782,184218,222000,MKT
06090302166235002,2019,37782,184218,222000,MKT
06090302166235003,2021,75101,190699,265800,MKT
06090302166235003,2020,44055,185445,229500,MKT
06090302166235003,2019,44055,185445,229500,MKT
06090302166255001,2021,73586,166114,239700,MKT
06090302166255001,2020,42709,168691,211400,MKT
06090302166255001,2019,42709,163791,206500,MKT
06090302166255002,2021,67809,161391,229200,MKT
06090302166255002,2020,37708,165192,202900,MKT
06090302166255002,2019,37708,165192,202900,MKT
06090302166255003,2021,79224,162776,242000,MKT
06090302166255003,2020,47793,163707,211500,MKT
06090302166255003,2019,47793,163707,211500,MKT
06090302167017000,2021,54106,0,54106,COST
06090302167017000,2020,35671,0,35671,COST
06090302167017000,2019,35671,0,35671,COST
06090302167037000,2021,105578,0,105578,COST
06090302167037000,2020,68300,0,68300,COST
06090302167037000,2019,68300,0,68300,COST
06090302167057000,2021,105657,0,105657,COST
06090302167057000,2020,68348,0,68348,COST
06090302167057000,2019,88325,0,88325,COST
06090302167077000,2021,105654,1390,107044,COST
06090302167077000,2020,68346,607354,675700,INCOME
06090302167090000,2021,116562,581738,698300,INCOME
06090302167090000,2020,68348,607352,675700,INCOME
06090302167090000,2019,68348,607352,675700,INCOME
06090302168010000,2021,102149,185851,288000,MKT
06090302168010000,2020,60529,185771,246300,MKT
06090302168010000,2019,60529,185771,246300,MKT
06090302168030000,2021,99533,202967,302500,MKT
06090302168030000,2020,59101,210299,269400,MKT
06090302168030000,2019,59101,210299,269400,MKT
06090302168050000,2021,99533,198767,298300,MKT
06090302168050000,2020,59101,200199,259300,MKT
06090302168050000,2019,59101,200199,259300,MKT
06090302168070000,2021,99533,196567,296100,MKT
06090302168070000,2020,59101,200799,259900,MKT
06090302168070000,2019,59101,200799,259900,MKT
06090302168090000,2021,99533,193767,293300,MKT
06090302168090000,2020,59101,200099,259200,MKT
06090302168090000,2019,59101,200099,259200,MKT
06090302168110000,2021,99785,239615,339400,INCOME
06090302168110000,2020,59239,278561,337800,INCOME
06090302168110000,2019,59239,278561,337800,INCOME
06090302168130000,2021,99281,194719,294000,MKT
06090302168130000,2020,58963,172837,231800,MKT
06090302168130000,2019,58963,172837,231800,MKT
06090302168150000,2021,99949,191551,291500,MKT
06090302168150000,2020,59328,201372,260700,MKT
06090302168150000,2019,59328,201372,260700,MKT
06090302168170000,2021,96927,234273,331200,INCOME
06090302168170000,2020,57675,266625,324300,INCOME
06090302168170000,2019,57675,266625,324300,INCOME
06090302168190000,2021,91518,247882,339400,INCOME
06090302168190000,2020,54706,283094,337800,INCOME
06090302168190000,2019,54706,283094,337800,INCOME
06090302168210000,2021,91518,314482,406000,INCOME
06090302168210000,2020,54706,343094,397800,INCOME
06090302168210000,2019,54706,343094,397800,INCOME
06090302168235001,2021,75179,164521,239700,MKT
06090302168235001,2020,44125,178175,222300,MKT
06090302168235001,2019,44125,178175,222300,MKT
06090302168245002,2021,73773,164527,238300,MKT
06090302168245002,2020,42874,178126,221000,MKT
06090302168245002,2019,42874,178126,221000,MKT
06090302168250000,2021,99509,239891,339400,INCOME
06090302168250000,2020,59088,278712,337800,INCOME
06090302168250000,2019,59088,278712,337800,INCOME
06090302168270000,2021,97194,197006,294200,MKT
06090302168270000,2020,57821,211679,269500,MKT
06090302168270000,2019,57821,211679,269500,MKT
06090302168290000,2021,103380,195720,299100,MKT
06090302168290000,2020,61200,200800,262000,MKT
06090302168290000,2019,61200,200800,262000,MKT
06090302168310000,2021,102698,266102,368800,MKT
06090302168310000,2020,60828,267272,328100,MKT
06090302168310000,2019,60828,267272,328100,MKT
06090302168330000,2021,101587,189913,291500,MKT
06090302168330000,2020,60223,196877,257100,MKT
06090302168330000,2019,60223,196877,257100,MKT
06090302168350000,2021,101328,194472,295800,MKT
06090302168350000,2020,60081,200719,260800,MKT
06090302168350000,2019,60081,200719,260800,MKT
06090302168370000,2021,101328,203972,305300,MKT
06090302168370000,2020,60081,207619,267700,MKT
06090302168370000,2019,60081,207619,267700,MKT
06090302168390000,2021,114707,205993,320700,MKT
06090302168390000,2020,67346,218854,286200,MKT
06090302168390000,2019,67346,218854,286200,MKT
06090302168410000,2021,125577,285870,411447,COST
06090302168410000,2020,73198,299002,372200,MKT
06090302168410000,2019,73198,299502,372700,MKT
06090302169010000,2021,101972,204628,306600,INCOME
06090302169010000,2020,60432,234368,294800,INCOME
06090302169010000,2019,60432,234368,294800,INCOME
06090302169020000,2021,96079,194821,290900,INCOME
06090302169020000,2020,57210,227990,285200,INCOME
06090302169020000,2019,57210,227990,285200,INCOME
06090302169035001,2021,76017,167083,243100,MKT
06090302169035001,2020,44877,173223,218100,MKT
06090302169035001,2019,44877,173223,218100,MKT
06090302169035002,2021,74676,168724,243400,MKT
06090302169035002,2020,43676,175124,218800,MKT
06090302169035002,2019,43676,175124,218800,MKT
06090302169040000,2021,96145,210455,306600,INCOME
06090302169040000,2020,57247,237553,294800,INCOME
06090302169040000,2019,57247,237553,294800,INCOME
06090302169050000,2021,96181,218919,315100,INCOME
06090302169050000,2020,57266,254234,311500,INCOME
06090302169050000,2019,57266,254234,311500,INCOME
06090302169060000,2021,96217,243183,339400,INCOME
06090302169060000,2020,57286,280514,337800,INCOME
06090302169060000,2019,57286,280514,337800,INCOME
06090302169070000,2021,102196,184304,286500,MKT
06090302169070000,2020,60555,199745,260300,MKT
06090302169070000,2019,60555,199745,260300,MKT
06090302169090000,2021,93172,184328,277500,MKT
06090302169090000,2020,55615,170285,225900,MKT
06090302169090000,2019,55615,170285,225900,MKT
06090302169100000,2021,93172,185028,278200,MKT
06090302169100000,2020,55615,201485,257100,MKT
06090302169100000,2019,55615,201485,257100,MKT
06090302169110000,2021,93172,195128,288300,MKT
06090302169110000,2020,55615,202985,258600,MKT
06090302169110000,2019,55615,202985,258600,MKT
06090302169120000,2021,93172,196628,289800,MKT
06090302169120000,2020,55615,206385,262000,MKT
06090302169120000,2019,55615,206385,262000,MKT
06090302169130000,2021,93172,189428,282600,MKT
06090302169130000,2020,55615,196785,252400,MKT
06090302169130000,2019,55615,177885,233500,MKT
06090302169140000,2021,93172,203528,296700,MKT
06090302169140000,2020,55615,199285,254900,MKT
06090302169140000,2019,55615,199285,254900,MKT
06090302169150000,2021,93172,203028,296200,MKT
06090302169150000,2020,55615,197385,253000,MKT
06090302169150000,2019,55615,193685,249300,MKT
06090302169160000,2021,93172,189028,282200,MKT
06090302169160000,2020,55615,205185,260800,MKT
06090302169160000,2019,55615,205185,260800,MKT
06090302170010000,2021,93172,187228,280400,MKT
06090302170010000,2020,55615,206285,261900,MKT
06090302170010000,2019,55615,206285,261900,MKT
06090302170020000,2021,93172,196828,290000,MKT
06090302170020000,2020,55615,176885,232500,MKT
06090302170020000,2019,55615,176885,232500,MKT
06090302170030000,2021,93172,200628,293800,MKT
06090302170030000,2020,55615,207585,263200,MKT
06090302170030000,2019,55615,206985,262600,MKT
06090302170040000,2021,93172,152828,246000,INCOME
06090302170040000,2020,55615,181885,237500,INCOME
06090302170040000,2019,55615,181885,237500,INCOME
06090302170050000,2021,93172,152828,246000,INCOME
06090302170050000,2020,55615,181885,237500,INCOME
06090302170050000,2019,55615,181885,237500,INCOME
06090302170060000,2021,93172,157128,250300,INCOME
06090302170060000,2020,55615,178285,233900,INCOME
06090302170060000,2019,55615,178285,233900,INCOME
06090302170070000,2021,93172,152828,246000,INCOME
06090302170070000,2020,55615,181885,237500,INCOME
06090302170070000,2019,55615,181885,237500,INCOME
06090302170080000,2021,93172,202328,295500,MKT
06090302170080000,2020,55615,200285,255900,MKT
06090302170080000,2019,55615,200285,255900,MKT
06090302170095001,2021,78608,194592,273200,MKT
06090302170095001,2020,47228,192572,239800,MKT
06090302170095001,2019,47228,192572,239800,MKT
06090302170095002,2021,68150,203450,271600,MKT
06090302170095002,2020,37997,193103,231100,MKT
06090302170095002,2019,37997,193103,231100,MKT
06090302170100000,2021,95792,230508,326300,MKT
06090302170100000,2020,57053,242447,299500,MKT
06090302170100000,2019,57053,242447,299500,MKT
06090302170110000,2021,95797,204903,300700,MKT
06090302170110000,2020,57056,212244,269300,MKT
06090302170110000,2019,57056,212244,269300,MKT
06090302170120000,2021,90437,157463,247900,MKT
06090302170120000,2020,54111,153489,207600,MKT
06090302170120000,2019,54111,153489,207600,MKT
06090302170130000,2021,95792,210808,306600,INCOME
06090302170130000,2020,57053,237747,294800,INCOME
06090302170130000,2019,57053,237747,294800,INCOME
06090302170140000,2021,95792,210808,306600,INCOME
06090302170140000,2020,57053,237747,294800,INCOME
06090302170140000,2019,57053,237747,294800,INCOME
06090302170150000,2021,95792,210808,306600,INCOME
06090302170150000,2020,57053,237747,294800,INCOME
06090302170150000,2019,57053,237747,294800,INCOME
06090302170160000,2021,115325,197375,312700,INCOME
06090302170160000,2020,67680,232420,300100,INCOME
06090302170160000,2019,67680,232420,300100,INCOME
06090302171010000,2021,103053,267047,370100,INCOME
06090302171010000,2020,61022,278278,339300,INCOME
06090302171010000,2019,61022,278278,339300,INCOME
06090302171010900,2021,103053,237347,340400,MKT
06090302171010900,2020,61022,224378,285400,MKT
06090302171010900,2019,61022,224378,285400,MKT
06090302171020000,2021,95792,0,95792,COST
06090302171020000,2020,57053,0,57053,COST
06090302171020000,2019,57053,0,57053,COST
06090302171030000,2021,95792,192208,288000,MKT
06090302171030000,2020,57053,201647,258700,MKT
06090302171030000,2019,57053,201647,258700,MKT
06090302171040000,2021,95792,163508,259300,MKT
06090302171040000,2020,57053,181847,238900,MKT
06090302171040000,2019,57053,181747,238800,MKT
06090302171050000,2021,95792,190408,286200,MKT
06090302171050000,2020,57053,199047,256100,MKT
06090302171050000,2019,57053,199047,256100,MKT
06090302171060000,2021,126573,510927,637500,INCOME
06090302171060000,2020,73733,513667,587400,INCOME
06090302171060000,2019,73733,513667,587400,INCOME
06090302171080000,2021,118568,139032,257600,MKT
06090302171080000,2020,69430,162970,232400,MKT
06090302171080000,2019,69430,162970,232400,MKT
06090302171090000,2021,124860,1138040,1262900,INCOME
06090302171090000,2020,91685,951815,1043500,INCOME
06090302171090000,2019,91685,951815,1043500,INCOME
06090302171110000,2021,126573,1136327,1262900,INCOME
06090302171110000,2020,93979,949521,1043500,INCOME
06090302171110000,2019,93979,949521,1043500,INCOME
06090302171130000,2021,126573,744927,871500,INCOME
06090302171130000,2020,93979,593521,687500,INCOME
06090302171130000,2019,93979,593521,687500,INCOME
06090302171150000,2021,95792,0,95792,COST
06090302171150000,2020,57053,0,57053,COST
06090302171150000,2019,57053,0,57053,COST
06090302171160000,2021,112915,255785,368700,MKT
06090302171160000,2020,66377,233523,299900,MKT
06090302171160000,2019,66377,233523,299900,MKT
06090302171170000,2021,109674,333626,443300,INCOME
06090302171170000,2020,64622,352678,417300,INCOME
06090302171170000,2019,64622,352678,417300,INCOME
06090302180010000,2021,93172,182828,276000,MKT
06090302180010000,2020,55615,180285,235900,MKT
06090302180010000,2019,55615,180285,235900,MKT
06090302180020000,2021,93172,252070,345242,COST
06090302180020000,2020,55615,241085,296700,MKT
06090302180020000,2019,55615,248085,303700,MKT
06090302180030000,2021,93172,187928,281100,MKT
06090302180030000,2020,55615,197385,253000,MKT
06090302180030000,2019,55615,197385,253000,MKT
06090302180040000,2021,93172,198128,291300,MKT
06090302180040000,2020,55615,205185,260800,MKT
06090302180040000,2019,55615,205185,260800,MKT
06090302180050000,2021,93172,197728,290900,INCOME
06090302180050000,2020,55615,229585,285200,INCOME
06090302180050000,2019,55615,229585,285200,INCOME
06090302180060000,2021,93172,198728,291900,MKT
06090302180060000,2020,55615,192085,247700,MKT
06090302180060000,2019,55615,192085,247700,MKT
06090302180070000,2021,93172,193428,286600,MKT
06090302180070000,2020,55615,181285,236900,MKT
06090302180070000,2019,55615,181285,236900,MKT
06090302180080000,2021,93172,152828,246000,INCOME
06090302180080000,2020,55615,181885,237500,INCOME
06090302180080000,2019,55615,181885,237500,INCOME
06090302180090000,2021,110064,196536,306600,INCOME
06090302180090000,2020,64833,229967,294800,INCOME
06090302180090000,2019,64833,229967,294800,INCOME
06090302180110000,2021,102957,203643,306600,INCOME
06090302180110000,2020,60969,233831,294800,INCOME
06090302180110000,2019,60969,233831,294800,INCOME
06090302180130000,2021,100468,206132,306600,INCOME
06090302180130000,2020,59611,235189,294800,INCOME
06090302180130000,2019,59611,235189,294800,INCOME
06090302180150000,2021,92688,56860,149548,COST
06090302180150000,2020,55350,239450,294800,INCOME
06090302180150000,2019,55350,239450,294800,INCOME
06090302180170000,2021,110301,222999,333300,INCOME
06090302180170000,2020,64962,262138,327100,INCOME
06090302180170000,2019,64962,262138,327100,INCOME
06090302181010000,2021,109325,382775,492100,INCOME
06090302181010000,2020,64432,410468,474900,INCOME
06090302181010000,2019,64432,410468,474900,INCOME
06090302181020000,2021,95792,190708,286500,MKT
06090302181020000,2020,57053,193447,250500,MKT
06090302181020000,2019,57053,193447,250500,MKT
06090302181030000,2021,95792,182108,277900,MKT
06090302181030000,2020,57053,185747,242800,MKT
06090302181030000,2019,57053,185747,242800,MKT
06090302181040000,2021,95792,240808,336600,MKT
06090302181040000,2020,57053,231247,288300,MKT
06090302181040000,2019,57053,231247,288300,MKT
06090302181050000,2021,118568,220232,338800,MKT
06090302181050000,2020,69430,214870,284300,OVR
06090302181050000,2019,69430,214870,284300,MKT
06090302181070000,2021,93172,275528,368700,MKT
06090302181070000,2020,55615,270185,325800,MKT
06090302181070000,2019,55615,270185,325800,MKT
06090302181080000,2021,111536,168564,280100,INCOME
06090302181080000,2020,65630,204470,270100,INCOME
06090302181080000,2019,65630,204470,270100,INCOME
06090302182010000,2021,115965,171835,287800,MKT
06090302182010000,2020,68026,197574,265600,MKT
06090302182010000,2019,68026,197574,265600,MKT
06090302183010000,2021,19436,0,19436,COST
06090302183010000,2020,39806,0,39806,COST
06090302183010000,2019,39806,0,39806,COST
06090302188015002,2021,92404,219396,311800,MKT
06090302188015002,2020,60417,213883,274300,OVR
06090302188015002,2019,60417,213883,274300,MKT
06090302188025001,2021,78553,213347,291900,MKT
06090302188025001,2020,47177,202523,249700,MKT
06090302188025001,2019,47177,202523,249700,MKT
06090302188030000,2021,102730,340870,443600,INCOME
06090302188030000,2020,60846,353554,414400,INCOME
06090302188030000,2019,60846,353554,414400,INCOME
06090302188050000,2021,123861,447039,570900,INCOME
06090302188050000,2020,72277,473523,545800,INCOME
06090302188050000,2019,72277,473523,545800,INCOME
06090302188075001,2021,79258,156842,236100,MKT
06090302188075001,2020,47823,170177,218000,MKT
06090302188075001,2019,47823,169277,217100,MKT
06090302188075002,2021,63243,166257,229500,MKT
06090302188075002,2020,33909,172891,206800,MKT
06090302188075002,2019,33909,172891,206800,MKT
06090302188075003,2021,70058,156742,226800,MKT
06090302188075003,2020,39629,169171,208800,MKT
06090302188075003,2019,39629,169171,208800,MKT
06090302188095001,2021,81694,185706,267400,MKT
06090302188095001,2020,50080,183620,233700,MKT
06090302188095001,2019,50080,183620,233700,MKT
06090302188095002,2021,67063,185837,252900,MKT
06090302188095002,2020,37078,185422,222500,MKT
06090302188095002,2019,37078,185422,222500,MKT
06090302188095003,2021,76622,185678,262300,MKT
06090302188095003,2020,45422,183578,229000,MKT
06090302188095003,2019,45422,183578,229000,MKT
06090302188115001,2021,72333,188067,260400,MKT
06090302188115001,2020,41606,182694,224300,MKT
06090302188115001,2019,41606,182694,224300,MKT
06090302188115002,2021,67063,190437,257500,MKT
06090302188115002,2020,37078,188122,225200,MKT
06090302188115002,2019,37078,188122,225200,MKT
06090302188115003,2021,78365,188035,266400,MKT
06090302188115003,2020,47005,182595,229600,MKT
06090302188115003,2019,47005,182595,229600,MKT
06090302188135001,2021,69435,148365,217800,MKT
06090302188135001,2020,39094,152606,191700,MKT
06090302188135001,2019,39094,152606,191700,MKT
06090302188135002,2021,62923,145277,208200,MKT
06090302188135002,2020,33648,153252,186900,MKT
06090302188135002,2019,33648,153252,186900,MKT
06090302188135003,2021,62923,145277,208200,MKT
06090302188135003,2020,33648,153252,186900,MKT
06090302188135003,2019,33648,153252,186900,MKT
06090302188135004,2021,69435,144865,214300,MKT
06090302188135004,2020,39094,149006,188100,MKT
06090302188135004,2019,39094,149006,188100,MKT
06090302188155001,2021,69153,182747,251900,MKT
06090302188155001,2020,38852,172948,211800,MKT
06090302188155001,2019,38852,172948,211800,MKT
06090302188155002,2021,63176,181924,245100,MKT
06090302188155002,2020,33854,175946,209800,MKT
06090302188155002,2019,33854,175946,209800,MKT
06090302188155003,2021,63176,182524,245700,MKT
06090302188155003,2020,33854,177746,211600,MKT
06090302188155003,2019,33854,177746,211600,MKT
06090302188155004,2021,69342,185158,254500,MKT
06090302188155004,2020,39014,177686,216700,MKT
06090302188155004,2019,39014,177686,216700,MKT
06090302188170000,2021,103076,498624,601700,INCOME
06090302188170000,2020,61035,514265,575300,INCOME
06090302188170000,2019,61035,514265,575300,INCOME
06090302188190000,2021,107037,398063,505100,INCOME
06090302188190000,2020,63190,411710,474900,INCOME
06090302188190000,2019,63190,411710,474900,INCOME
06090302188210000,2021,108821,396279,505100,INCOME
06090302188210000,2020,64159,410741,474900,INCOME
06090302188210000,2019,64159,410741,474900,INCOME
06090302189010000,2021,108066,263434,371500,INCOME
06090302189010000,2020,63749,296951,360700,INCOME
06090302189010000,2019,63749,296951,360700,INCOME
06090302189035001,2021,83641,192059,275700,MKT
06090302189035001,2020,51910,195590,247500,MKT
06090302189035001,2019,51910,195890,247800,MKT
06090302189035002,2021,81437,189663,271100,MKT
06090302189035002,2020,49841,196159,246000,OVR
06090302189035002,2019,49841,196159,246000,MKT
06090302189055001,2021,75628,143372,219000,MKT
06090302189055001,2020,44527,148473,193000,MKT
06090302189055001,2019,44527,148473,193000,MKT
06090302189055002,2021,76695,143405,220100,MKT
06090302189055002,2020,45488,148512,194000,MKT
06090302189055002,2019,45488,148512,194000,MKT
06090302189070000,2021,90213,190687,280900,MKT
06090302189070000,2020,53987,198713,252700,MKT
06090302189070000,2019,53987,198713,252700,MKT
06090302189090000,2021,90179,196321,286500,MKT
06090302189090000,2020,53969,206831,260800,MKT
06090302189090000,2019,53969,206831,260800,MKT
06090302189116500,2021,29301,0,29301,COST
06090302189116500,2020,58082,0,58082,COST
06090302189116500,2019,58082,0,58082,COST
06090302192010000,2021,97839,206460,304299,COST
06090302192010000,2020,58174,0,58174,COST
06090302192010000,2019,58174,0,58174,COST
06090302192030000,2021,89251,175049,264300,MKT
06090302192030000,2020,53457,188543,242000,MKT
06090302192030000,2019,53457,188543,242000,MKT
06090302192050000,2021,88267,159133,247400,MKT
06090302192050000,2020,52915,156885,209800,MKT
06090302192050000,2019,52915,156885,209800,MKT
06090302192070000,2021,87350,172450,259800,MKT
06090302192070000,2020,52409,169991,222400,MKT
06090302192070000,2019,52409,169991,222400,MKT
06090302192100000,2021,105288,195812,301100,MKT
06090302192100000,2020,62239,210861,273100,MKT
06090302192100000,2019,62239,210861,273100,MKT
06090302192135002,2021,78668,122132,200800,MKT
06090302192135002,2020,47282,137118,184400,MKT
06090302192135002,2019,47282,137118,184400,MKT
06090302192145001,2021,74310,122890,197200,MKT
06090302192145001,2020,43351,138049,181400,MKT
06090302192145001,2019,43351,138049,181400,MKT
06090302192160000,2021,90269,193331,283600,MKT
06090302192160000,2020,54018,203082,257100,MKT
06090302192160000,2019,54018,203082,257100,MKT
06090302192185002,2021,74320,156080,230400,MKT
06090302192185002,2020,43359,170541,213900,MKT
06090302192185002,2019,43359,170541,213900,MKT
06090302192195001,2021,77894,156006,233900,MKT
06090302192195001,2020,46575,170425,217000,MKT
06090302192195001,2019,46575,170425,217000,MKT
06090302192220000,2021,97839,188861,286700,MKT
06090302192220000,2020,58174,196426,254600,MKT
06090302192220000,2019,58174,196426,254600,MKT
06090302192250000,2021,98963,195937,294900,MKT
06090302192250000,2020,58789,203111,261900,MKT
06090302192250000,2019,58789,203111,261900,MKT
06090302192280000,2021,92477,251123,343600,MKT
06090302192280000,2020,55234,235366,290600,MKT
06090302192280000,2019,55234,235366,290600,MKT
06090302192300000,2021,92310,240990,333300,MKT
06090302192300000,2020,55141,240959,296100,MKT
06090302192300000,2019,55141,240959,296100,MKT
06090302192320000,2021,107881,245319,353200,MKT
06090302192320000,2020,63648,243852,307500,MKT
06090302192320000,2019,63648,243852,307500,MKT
06090302192350000,2021,100113,196187,296300,MKT
06090302192350000,2020,59418,203782,263200,MKT
06090302192350000,2019,59418,203782,263200,MKT
06090302202010000,2021,187964,160836,348800,MKT
06090302202010000,2020,134418,179282,313700,MKT
06090302202010000,2019,134418,179282,313700,MKT
06090302202040000,2021,246452,66270,312722,COST
06090302202040000,2020,162240,65480,227720,COST
06090302202040000,2019,162240,65480,227720,COST
06090302202070000,2021,241561,251639,493200,MKT
06090302202070000,2020,159998,284002,444000,MKT
06090302202070000,2019,159998,284002,444000,MKT
06090302202100000,2021,152734,240070,392804,COST
06090302202100000,2020,228485,328570,557055,COST
06090302202100000,2019,228485,328570,557055,COST
06090302202110000,2021,152518,80380,232898,COST
06090302202120000,2021,173478,206122,379600,MKT
06090302202140000,2021,271414,0,271414,COST
06090302202170000,2021,147700,0,147700,COST
06090302202170000,2020,113700,0,113700,COST
06090302202170000,2019,113700,0,113700,COST
06090302202190000,2021,120650,96620,217270,COST
06090302202190000,2020,113700,55790,169490,COST
06090302202190000,2019,113700,55790,169490,COST
06090302202200000,2021,170402,22630,193032,COST
06090302202200000,2020,125568,22760,148328,COST
06090302202200000,2019,125568,22760,148328,COST
06090302202220000,2021,398857,0,398857,COST
06090302203010000,2021,157133,245267,402400,MKT
06090302203010000,2020,114898,273002,387900,MKT
06090302203010000,2019,114898,273002,387900,MKT
06090302203020000,2021,189287,0,189287,COST
06090302203020000,2020,140193,0,140193,COST
06090302203020000,2019,140193,18480,158673,COST
06090302203030000,2021,179475,318525,498000,MKT
06090302203030000,2020,132440,295760,428200,MKT
06090302203030000,2019,132440,309000,441440,COST
06090302204010000,2021,180211,0,180211,COST
06090302204010000,2020,130544,0,130544,COST
06090302204010000,2019,130544,0,130544,COST
06090302204020000,2021,452605,127095,579700,INCOME
06090302204020000,2020,214166,320634,534800,INCOME
06090302204020000,2019,214166,320634,534800,INCOME
06090302204030000,2021,179184,172180,351364,COST
06090302204030000,2020,173520,132340,305860,COST
06090302204030000,2019,173520,95650,269170,COST
06090302204040000,2021,165686,474930,640616,COST
06090302204040000,2020,123144,454770,577914,COST
06090302204040000,2019,123144,454770,577914,COST
06090302204040900,2021,197293,5570,202863,COST
06090302204040900,2020,139017,5740,144757,COST
06090302204040900,2019,139017,5740,144757,COST
06090302204050000,2021,138449,238051,376500,MKT
06090302204050000,2020,131715,128860,260575,OVR
06090302204050000,2019,131715,128860,260575,COST
06090302204050900,2021,182584,281516,464100,MKT
06090302204050900,2020,131735,157980,289715,COST
06090302204050900,2019,131735,157980,289715,COST
06090302204060000,2021,143478,126122,269600,MKT
06090302204060000,2020,136835,29360,166195,COST
06090302204060000,2019,136835,29360,166195,COST
06090302204180000,2021,120650,213850,334500,MKT
06090302204180000,2020,113700,157250,270950,COST
06090302204180000,2019,113700,157250,270950,COST
06090302204200000,2021,120650,142850,263500,MKT
06090302204200000,2020,113700,49350,163050,COST
06090302204200000,2019,113700,49350,163050,COST
06090302204220000,2021,120650,130750,251400,MKT
06090302204220000,2020,113700,27860,141560,COST
06090302204220000,2019,113700,27860,141560,COST
06090302301010000,2021,210692,2750,213442,COST
06090302301010000,2020,164267,3040,167307,COST
06090302301010000,2019,164267,3040,167307,COST
06090302301100000,2021,694029,591200,1285229,COST
06090302301100000,2020,1057195,547600,1604795,COST
06090302301100000,2019,1057195,547600,1604795,COST
06090302301230000,2021,429435,265165,694600,INCOME
06090302301230000,2020,500234,110966,611200,INCOME
06090302301230000,2019,500234,110966,611200,INCOME
06090302301280000,2021,374270,0,374270,COST
06090302301280000,2020,403733,0,403733,COST
06090302301280000,2019,403733,0,403733,COST
06090302301330000,2021,677827,1513673,2191500,INCOME
06090302301330000,2020,1018975,1213300,2232275,COST
06090302301330000,2019,1018975,1204450,2223425,COST
06090302301450000,2021,842454,3973146,4815600,INCOME
06090302301450000,2020,1041472,3146528,4188000,OVR
06090302301450000,2019,1041472,3146528,4188000,INCOME
06090302301670000,2021,1271270,4782630,6053900,COST
06090302301670000,2020,1977852,4744500,6722352,COST
06090302301670000,2019,1977852,4744500,6722352,COST
06090302302010000,2021,404791,208409,613200,INCOME
06090302302010000,2020,456210,112090,568300,INCOME
06090302302010000,2019,456210,112090,568300,INCOME
06090302302050000,2021,404103,757950,1162053,COST
06090302302050000,2020,455002,731470,1186472,COST
06090302302050000,2019,455002,731470,1186472,COST
06090302302100000,2021,440715,792490,1233205,COST
06090302302100000,2020,520867,682333,1203200,INCOME
06090302302100000,2019,520867,682333,1203200,INCOME
06090302302150000,2021,438544,169956,608500,INCOME
06090302302150000,2020,516873,77127,594000,INCOME
06090302302150000,2019,516873,77127,594000,INCOME
06090302302200000,2021,546016,550284,1096300,INCOME
06090302302200000,2020,727396,321804,1049200,INCOME
06090302302200000,2019,727396,321804,1049200,INCOME
06090302302280000,2021,362007,769393,1131400,INCOME
06090302302280000,2020,383302,661898,1045200,INCOME
06090302302280000,2019,383302,661898,1045200,INCOME
06090302302320000,2021,288484,111290,399774,COST
06090302302320000,2020,269061,110240,379301,COST
06090302302320000,2019,269061,110240,379301,COST
06090302302340000,2021,288484,0,288484,COST
06090302302340000,2020,269061,0,269061,COST
06090302302340000,2019,269061,0,269061,COST
06090302303010000,2021,152017,0,152017,COST
06090302303010000,2020,99019,0,99019,COST
06090302303010000,2019,99019,0,99019,COST
06090302401030000,2021,216080,0,216080,COST
06090302401030000,2020,171478,0,171478,COST
06090302401030000,2019,171478,0,171478,COST
06090302401040000,2021,216080,0,216080,COST
06090302401040000,2020,171478,0,171478,COST
06090302401040000,2019,171478,0,171478,COST
06090302401050000,2021,216080,50620,266700,INCOME
06090302401050000,2020,171478,94322,265800,INCOME
06090302401050000,2019,171478,94322,265800,INCOME
06090302401060000,2021,216080,317020,533100,INCOME
06090302401060000,2020,171478,330322,501800,INCOME
06090302401060000,2019,171478,330322,501800,INCOME
06090302401070000,2021,211909,0,211909,COST
06090302401070000,2020,166346,0,166346,COST
06090302401070000,2019,166346,0,166346,COST
06090302401080000,2021,218963,0,218963,COST
06090302401080000,2020,175057,0,175057,COST
06090302401080000,2019,175057,0,175057,COST
06090302401100000,2021,224514,106886,331400,INCOME
06090302401100000,2020,182024,138376,320400,INCOME
06090302401100000,2019,182024,138376,320400,INCOME
06090302402010000,2021,268913,366487,635400,INCOME
06090302402010000,2020,241152,47948,289100,INCOME
06090302402010000,2019,241152,47948,289100,INCOME
06090302402020000,2021,268913,0,268913,COST
06090302402020000,2020,241152,0,241152,COST
06090302402020000,2019,241152,0,241152,COST
06090302402030000,2021,268839,166361,435200,INCOME
06090302402030000,2020,241049,171851,412900,INCOME
06090302402030000,2019,241049,171851,412900,INCOME
06090302402040000,2021,299378,225322,524700,INCOME
06090302402040000,2020,285064,244036,529100,INCOME
06090302402040000,2019,285064,244036,529100,INCOME
06090302402050000,2021,299314,0,299314,COST
06090302402050000,2020,284970,0,284970,COST
06090302402050000,2019,284970,0,284970,COST
06090302402060000,2021,222439,517161,739600,INCOME
06090302402060000,2020,179408,490892,670300,INCOME
06090302402060000,2019,179408,490892,670300,INCOME
06090302402070000,2021,268913,0,268913,COST
06090302402070000,2020,241152,0,241152,COST
06090302402070000,2019,241152,0,241152,COST
06090302402080000,2021,217200,166100,383300,INCOME
06090302402080000,2020,172865,201135,374000,INCOME
06090302402080000,2019,172865,201135,374000,INCOME
06090302402100000,2021,257,0,257,COST
06090302402100000,2020,239,0,239,COST
06090302402100000,2019,239,0,239,COST
06090302402150000,2021,369319,795280,1164599,COST
06090302402150000,2020,395439,805561,1201000,INCOME
06090302402150000,2019,395439,805561,1201000,INCOME
06090302402200000,2021,302273,2500827,2803100,INCOME
06090302402200000,2020,289373,2274827,2564200,INCOME
06090302402200000,2019,289373,2274827,2564200,INCOME
06090302405010000,2021,784998,5992330,6777328,COST
06090302405010000,2020,1280528,5725880,7006408,COST
06090302405010000,2019,1280528,5725880,7006408,COST
06090302410010000,2021,1688458,2273990,3962448,COST
06090302410010000,2020,1541820,1736560,3278380,COST
06090302410010000,2019,1541820,1736560,3278380,COST
06090303124010000,2021,159809,48850,208659,COST
06090303124010000,2020,163723,46660,210383,COST
06090303124010000,2019,163723,46660,210383,COST
06090303124040000,2021,159809,402190,561999,COST
06090303124040000,2020,163723,374677,538400,OVR
06090303124040000,2019,163723,374677,538400,MKT
06090303124080000,2021,159809,28980,188789,COST
06090303124080000,2020,163723,30020,193743,COST
06090303124080000,2019,163723,30020,193743,COST
06090303124120000,2021,159809,362591,522400,MKT
06090303124120000,2020,163723,318677,482400,OVR
06090303124120000,2019,163723,318677,482400,MKT
06090303124160000,2021,159793,0,159793,COST
06090303124160000,2020,163711,0,163711,COST
06090303124160000,2019,163711,0,163711,COST
06090303152010000,2021,155861,279139,435000,MKT
06090303152010000,2020,118026,253074,371100,MKT
06090303152010000,2019,118026,253074,371100,MKT
06090303152040000,2021,147700,496600,644300,COST
06090303152040000,2020,113700,394600,508300,MKT
06090303152040000,2019,113700,394600,508300,MKT
06090303152070000,2021,147700,298900,446600,MKT
06090303152070000,2020,113700,297400,411100,MKT
06090303152070000,2019,113700,297400,411100,MKT
06090303152100000,2021,147700,397800,545500,MKT
06090303152100000,2020,113700,261800,375500,MKT
06090303152100000,2019,113700,257700,371400,MKT
06090303152130000,2021,147700,222000,369700,MKT
06090303152130000,2020,113700,223500,337200,MKT
06090303152130000,2019,113700,223500,337200,MKT
06090303152160000,2021,147700,242700,390400,MKT
06090303152160000,2020,113700,229200,342900,MKT
06090303152160000,2019,113700,229200,342900,MKT
06090303152190000,2021,147757,247843,395600,MKT
06090303152190000,2020,113730,252370,366100,MKT
06090303152190000,2019,113730,252370,366100,MKT
06090303152220000,2021,147700,344200,491900,MKT
06090303152220000,2020,113700,326400,440100,MKT
06090303152220000,2019,113700,326400,440100,MKT
06090303152250000,2021,147700,228900,376600,MKT
06090303152250000,2020,113700,210000,323700,MKT
06090303152250000,2019,113700,210000,323700,MKT
06090303152280000,2021,147700,254420,402120,COST
06090303152280000,2020,113700,198250,311950,COST
06090303152280000,2019,113700,198250,311950,COST
06090303152310000,2021,147700,277200,424900,MKT
06090303152310000,2020,113700,295700,409400,MKT
06090303152310000,2019,113700,295700,409400,MKT
06090303154010000,2021,163710,260290,424000,MKT
06090303154010000,2020,128349,258251,386600,MKT
06090303154010000,2019,128349,258251,386600,MKT
06090303154040000,2021,149946,278554,428500,MKT
06090303154040000,2020,114898,274302,389200,MKT
06090303154040000,2019,114898,274302,389200,MKT
06090303154070000,2021,155944,223156,379100,MKT
06090303154070000,2020,124090,229110,353200,MKT
06090303154070000,2019,124090,229110,353200,MKT
06090303154100000,2021,155944,287956,443900,MKT
06090303154100000,2020,124090,267210,391300,MKT
06090303154100000,2019,124090,267210,391300,MKT
06090303154156500,2021,72444,0,72444,COST
06090303154156500,2020,47982,0,47982,COST
06090303154156500,2019,47982,0,47982,COST
06090303154186500,2021,53210,0,53210,COST
06090303154186500,2020,38727,0,38727,COST
06090303154186500,2019,38727,0,38727,COST
06090303156010000,2021,151049,286451,437500,MKT
06090303156010000,2020,115484,284916,400400,MKT
06090303156010000,2019,115484,284916,400400,MKT
06090303156040000,2021,151049,318851,469900,MKT
06090303156040000,2020,115484,288016,403500,MKT
06090303156040000,2019,115484,288016,403500,MKT
06090303156070000,2021,154812,266388,421200,MKT
06090303156070000,2020,117474,265526,383000,MKT
06090303156070000,2019,117474,265526,383000,MKT
06090303156100000,2021,147700,280300,428000,MKT
06090303156100000,2020,113700,285700,399400,MKT
06090303156100000,2019,113700,285700,399400,MKT
06090303156130000,2021,147700,248700,396400,MKT
06090303156130000,2020,113700,249400,363100,MKT
06090303156130000,2019,113700,249400,363100,MKT
06090303156160000,2021,147700,232500,380200,MKT
06090303156160000,2020,113700,213700,327400,MKT
06090303156160000,2019,113700,213700,327400,MKT
06090303156190000,2021,147700,225500,373200,MKT
06090303156190000,2020,113700,204900,318600,MKT
06090303156190000,2019,113700,204900,318600,MKT
06090303156220000,2021,147700,323100,470800,MKT
06090303156220000,2020,113700,249700,363400,MKT
06090303156220000,2019,113700,249700,363400,MKT
06090303156250000,2021,147700,289300,437000,MKT
06090303156250000,2020,113700,285400,399100,MKT
06090303156250000,2019,113700,285400,399100,MKT
06090303156280000,2021,147700,236300,384000,MKT
06090303156280000,2020,113700,241000,354700,MKT
06090303156280000,2019,113700,241000,354700,MKT
06090303156420000,2021,154583,244217,398800,MKT
06090303156420000,2020,159986,246014,406000,MKT
06090303156420000,2019,159986,241914,401900,MKT
06090303156470000,2021,164820,522910,687730,COST
06090303156470000,2020,167271,377729,545000,MKT
06090303156470000,2019,167271,377729,545000,MKT
06090303156520000,2021,164865,188140,353005,COST
06090303156520000,2020,167302,171790,339092,COST
06090303156520000,2019,167302,171790,339092,COST
06090303156570000,2021,164925,320575,485500,MKT
06090303156570000,2020,167344,307656,475000,MKT
06090303156570000,2019,167344,274056,441400,MKT
06090303156620000,2021,114590,377310,491900,MKT
06090303156620000,2020,129958,334542,464500,MKT
06090303156620000,2019,129958,310442,440400,MKT
06090303156670000,2021,114026,244674,358700,MKT
06090303156670000,2020,129513,248987,378500,MKT
06090303156670000,2019,129513,248987,378500,MKT
06090303158010000,2021,147700,285600,433300,MKT
06090303158010000,2020,113700,267500,381200,MKT
06090303158010000,2019,113700,267500,381200,MKT
06090303158040000,2021,147700,234200,381900,MKT
06090303158040000,2020,113700,236800,350500,MKT
06090303158040000,2019,113700,236800,350500,MKT
06090303158070000,2021,147700,276500,424200,MKT
06090303158070000,2020,113700,269300,383000,MKT
06090303158070000,2019,113700,269300,383000,MKT
06090303158100000,2021,147700,234000,381700,MKT
06090303158100000,2020,113700,241000,354700,MKT
06090303158100000,2019,113700,241000,354700,MKT
06090303160100000,2021,147700,259600,407300,MKT
06090303160100000,2020,113700,235700,349400,MKT
06090303160100000,2019,113700,235700,349400,MKT
06090303160120000,2021,147700,351800,499500,MKT
06090303160120000,2020,113700,315500,429200,MKT
06090303160120000,2019,113700,315500,429200,MKT
06090303160140000,2021,147700,205800,353500,MKT
06090303160140000,2020,113700,212900,326600,MKT
06090303160140000,2019,113700,212900,326600,MKT
06090303160160000,2021,148830,465160,613990,COST
06090303160160000,2020,114303,351697,466000,MKT
06090303160160000,2019,114303,351697,466000,MKT
06090303160180000,2021,148830,227170,376000,MKT
06090303160180000,2020,114303,202997,317300,MKT
06090303160180000,2019,114303,202997,317300,MKT
06090303160200000,2021,148830,515860,664690,COST
06090303160200000,2020,114303,471090,585393,COST
06090303160200000,2019,114303,471090,585393,COST
06090303160220000,2021,151596,247904,399500,MKT
06090303160220000,2020,115774,208926,324700,OVR
06090303160220000,2019,115774,208926,324700,MKT
06090303160240000,2021,151596,262804,414400,MKT
06090303160240000,2020,115774,271526,387300,MKT
06090303160240000,2019,115774,271526,387300,MKT
06090303160260000,2021,151596,285704,437300,MKT
06090303160260000,2020,115774,280226,396000,MKT
06090303160260000,2019,115774,280226,396000,MKT
06090303162010000,2021,154812,456188,611000,MKT
06090303162010000,2020,117474,423526,541000,MKT
06090303162010000,2019,117474,423526,541000,MKT
06090303162030000,2021,154812,224988,379800,MKT
06090303162030000,2020,117474,227326,344800,MKT
06090303162030000,2019,117474,227326,344800,MKT
06090303162060000,2021,154812,262688,417500,MKT
06090303162060000,2020,117474,271926,389400,MKT
06090303162060000,2019,117474,271926,389400,MKT
06090303162100000,2021,154812,277588,432400,MKT
06090303162100000,2020,117474,259426,376900,MKT
06090303162100000,2019,117474,259426,376900,MKT
06090303162130000,2021,154812,285788,440600,MKT
06090303162130000,2020,117474,282326,399800,MKT
06090303162130000,2019,117474,282326,399800,MKT
06090303162160000,2021,154812,341988,496800,MKT
06090303162160000,2020,117474,275326,392800,MKT
06090303162160000,2019,117474,275326,392800,MKT
06090303201020000,2021,183953,742147,926100,INCOME
06090303201020000,2020,132420,687980,820400,INCOME
06090303201020000,2019,132420,687980,820400,INCOME
06090303201030000,2021,153218,73930,227148,COST
06090303201030000,2020,116633,70000,186633,COST
06090303201030000,2019,116633,70000,186633,COST
06090303201040000,2021,147700,212200,359900,MKT
06090303201040000,2020,113700,193200,306900,MKT
06090303201040000,2019,113700,193200,306900,MKT
06090303201050000,2021,147927,7600,155527,COST
06090303201050000,2020,113821,7870,121691,COST
06090303201050000,2019,113821,20290,134111,COST
06090303216010000,2021,161229,359020,520249,COST
06090303216010000,2020,164731,385569,550300,MKT
06090303216010000,2019,164731,385569,550300,MKT
06090303216050000,2021,161260,502880,664140,COST
06090303216050000,2020,164753,418047,582800,MKT
06090303216050000,2019,164753,418047,582800,MKT
06090303216100000,2021,161290,388740,550030,COST
06090303216100000,2020,164775,386925,551700,MKT
06090303216100000,2019,164775,386925,551700,MKT
06090303216150000,2021,161306,448194,609500,MKT
06090303216150000,2020,164786,382614,547400,MKT
06090303216150000,2019,164786,382614,547400,MKT
06090303216200000,2021,161352,0,161352,COST
06090303216200000,2020,164819,0,164819,COST
06090303216200000,2019,164819,0,164819,COST
06090303216250000,2021,162796,255904,418700,MKT
06090303216250000,2020,165842,279558,445400,MKT
06090303216250000,2019,165842,279558,445400,MKT
06090303216300000,2021,162812,557350,720162,COST
06090303216300000,2020,165853,418247,584100,MKT
06090303216300000,2019,165853,418247,584100,MKT
06090303216350000,2021,162842,229958,392800,MKT
06090303216350000,2020,165874,246926,412800,MKT
06090303216350000,2019,165874,246926,412800,MKT
06090303216400000,2021,162873,410227,573100,MKT
06090303216400000,2020,165896,421704,587600,MKT
06090303216400000,2019,165896,421704,587600,MKT
06090303216450000,2021,162903,264197,427100,MKT
06090303216450000,2020,165917,283583,449500,MKT
06090303216450000,2019,165917,283583,449500,MKT
06090303216500000,2021,163374,320526,483900,MKT
06090303216500000,2020,166251,254749,421000,MKT
06090303216500000,2019,166251,254749,421000,MKT
06090303216550000,2021,163420,328780,492200,MKT
06090303216550000,2020,166283,316717,483000,MKT
06090303216550000,2019,166283,316717,483000,MKT
06090303216600000,2021,163450,0,163450,COST
06090303216600000,2020,166304,0,166304,COST
06090303216600000,2019,166304,0,166304,COST
06090303216650000,2021,163496,294130,457626,COST
06090303216650000,2020,166336,267640,433976,COST
06090303216650000,2019,166336,267640,433976,COST
06090303216700000,2021,163783,299217,463000,MKT
06090303216700000,2020,166539,312161,478700,MKT
06090303216700000,2019,166539,312161,478700,MKT
06090303216750000,2021,162322,503978,666300,MKT
06090303216750000,2020,165506,432694,598200,MKT
06090303216750000,2019,165506,432694,598200,MKT
06090303216800000,2021,162353,565880,728233,COST
06090303216800000,2020,165528,433472,599000,MKT
06090303216800000,2019,165528,433472,599000,MKT
06090303216850000,2021,162368,487932,650300,MKT
06090303216850000,2020,165539,415961,581500,MKT
06090303216850000,2019,165539,415961,581500,MKT
06090303216900000,2021,162399,0,162399,COST
06090303216900000,2020,165561,0,165561,COST
06090303216900000,2019,165561,0,165561,COST
06090303216950000,2021,158033,375750,533783,COST
06090303216950000,2020,162457,334990,497447,COST
06090303216950000,2019,162457,334990,497447,COST
06090303224010000,2021,158129,345620,503749,COST
06090303224010000,2020,162526,301980,464506,COST
06090303224010000,2019,162526,301980,464506,COST
06090303224040000,2021,158113,1280,159393,COST
06090303224040000,2020,162515,1340,163855,COST
06090303224040000,2019,162515,1340,163855,COST
06090303224070000,2021,158097,457503,615600,MKT
06090303224070000,2020,162503,422840,585343,COST
06090303224070000,2019,162503,422840,585343,COST
06090303224100000,2021,158081,391770,549851,COST
06090303224100000,2020,162492,355480,517972,COST
06090303224100000,2019,162492,355480,517972,COST
06090303224130000,2021,158241,1170,159411,COST
06090303224130000,2020,162606,1230,163836,COST
06090303224130000,2019,162606,1230,163836,COST
06090303224170000,2021,159478,364622,524100,MKT
06090303224170000,2020,163487,346213,509700,MKT
06090303224170000,2019,163487,346213,509700,MKT
06090303224200000,2021,159463,208237,367700,MKT
06090303224200000,2020,163476,240324,403800,MKT
06090303224200000,2019,163476,240324,403800,MKT
06090303224230000,2021,159463,322337,481800,MKT
06090303224230000,2020,163476,312524,476000,OVR
06090303224230000,2019,163476,312524,476000,MKT
06090303224260000,2021,159447,128750,288197,COST
06090303224260000,2020,163465,115035,278500,INCOME
06090303224260000,2019,163465,115035,278500,INCOME
06090303224300000,2021,159431,285070,444501,COST
06090303224300000,2020,163454,256320,419774,COST
06090303224300000,2019,163454,256320,419774,COST
06090303224706500,2021,1178,0,1178,COST
06090303224706500,2020,1097,0,1097,COST
06090303224706500,2019,1097,0,1097,COST
06090303250160000,2021,101606,218694,320300,MKT
06090303250160000,2020,64999,190340,255339,COST
06090303250160000,2019,64999,190340,255339,COST
06090303250180000,2021,113728,184572,298300,MKT
06090303250180000,2020,65432,128470,193902,COST
06090303250180000,2019,65432,128470,193902,COST
06090303250200000,2021,102057,182843,284900,MKT
06090303250200000,2020,65308,126950,192258,COST
06090303250200000,2019,65308,126950,192258,COST
06090303250220000,2021,114415,208030,322445,COST
06090303250220000,2020,65706,127350,193056,COST
06090303250220000,2019,65706,127350,193056,COST
06090303250240000,2021,114756,198344,313100,MKT
06090303250240000,2020,65842,134680,200522,COST
06090303250240000,2019,65842,134680,200522,COST
06090303250260000,2021,102650,214050,316700,MKT
06090303250260000,2020,65714,180530,246244,COST
06090303250260000,2019,65714,180530,246244,COST
06090303250280000,2021,102846,174154,277000,MKT
06090303250280000,2020,65847,117380,183227,COST
06090303250280000,2019,65847,117380,183227,COST
06090303250300000,2021,115938,185262,301200,MKT
06090303250300000,2020,66312,110740,177052,COST
06090303250300000,2019,66312,110740,177052,COST
06090303250320000,2021,103281,216519,319800,MKT
06090303250320000,2020,66145,169780,235925,COST
06090303250320000,2019,66145,169780,235925,COST
06090303250340000,2021,103521,191179,294700,MKT
06090303250340000,2020,66309,155670,221979,COST
06090303250340000,2019,66309,155670,221979,COST
06090303250360000,2021,103901,194199,298100,MKT
06090303250360000,2020,66570,140100,206670,COST
06090303250360000,2019,66570,140100,206670,COST
06090303254010000,2021,101555,207545,309100,MKT
06090303254010000,2020,64965,148370,213335,COST
06090303254010000,2019,64965,148370,213335,COST
06090303254030000,2021,113382,225218,338600,MKT
06090303254030000,2020,65293,162910,228203,COST
06090303254030000,2019,65293,162910,228203,COST
06090303254050000,2021,101606,216494,318100,MKT
06090303254050000,2020,64999,182340,247339,COST
06090303254050000,2019,64999,182340,247339,COST
06090303254070000,2021,101606,241994,343600,MKT
06090303254070000,2020,64999,193890,258889,COST
06090303254070000,2019,64999,193890,258889,COST
06090303254090000,2021,101606,201894,303500,MKT
06090303254090000,2020,64999,174650,239649,COST
06090303254090000,2019,64999,174650,239649,COST
06090303254110000,2021,101606,242194,343800,MKT
06090303254110000,2020,64999,300430,365429,COST
06090303254110000,2019,64999,300430,365429,COST
06090303254130000,2021,101606,194794,296400,MKT
06090303254130000,2020,64999,147000,211999,COST
06090303254130000,2019,64999,147000,211999,COST
06090303254150000,2021,101656,239244,340900,MKT
06090303254150000,2020,65034,191640,256674,COST
06090303254150000,2019,65034,191640,256674,COST
06090303254170000,2021,101656,175244,276900,MKT
06090303254170000,2020,65034,122260,187294,COST
06090303254170000,2019,65034,122260,187294,COST
06090303254190000,2021,101505,188095,289600,MKT
06090303254190000,2020,64930,140550,205480,COST
06090303254190000,2019,64930,140550,205480,COST
06090303254210000,2021,101656,180344,282000,MKT
06090303254210000,2020,65034,135820,200854,OVR
06090303254210000,2019,65034,135820,200854,COST
06090303254230000,2021,101656,186144,287800,MKT
06090303254230000,2020,65034,126790,191824,COST
06090303254230000,2019,65034,126790,191824,COST
06090303254250000,2021,101656,220844,322500,MKT
06090303254250000,2020,65034,171870,236904,COST
06090303254250000,2019,65034,171870,236904,COST
06090303254270000,2021,101707,197193,298900,MKT
06090303254270000,2020,65068,170450,235518,COST
06090303254270000,2019,65068,170450,235518,COST
06090303254290000,2021,101707,187293,289000,MKT
06090303254290000,2020,65068,131360,196428,COST
06090303254290000,2019,65068,131360,196428,COST
06090303254310000,2021,101707,179093,280800,MKT
06090303254310000,2020,65068,152670,217738,COST
06090303254310000,2019,65068,152670,217738,COST
06090303254330000,2021,101958,230042,332000,MKT
06090303254330000,2020,65240,167510,232750,COST
06090303254330000,2019,65240,167510,232750,COST
06090303257010000,2021,104136,243564,347700,MKT
06090303257010000,2020,66731,194340,261071,COST
06090303257010000,2019,66731,194340,261071,COST
06090303257030000,2021,104136,227464,331600,MKT
06090303257030000,2020,66731,168080,234811,COST
06090303257030000,2019,66731,168080,234811,COST
06090303257050000,2021,104136,296064,400200,MKT
06090303257050000,2020,66731,356610,423341,OVR
06090303257050000,2019,66731,356610,423341,COST
06090303257070000,2021,104183,233617,337800,MKT
06090303257070000,2020,66763,180190,246953,COST
06090303257070000,2019,66763,180190,246953,COST
06090303257090000,2021,104183,162217,266400,MKT
06090303257090000,2020,66763,130580,197343,COST
06090303257090000,2019,66763,130580,197343,COST
06090303257110000,2021,115686,365914,481600,MKT
06090303257110000,2020,95959,311741,407700,MKT
06090303257110000,2019,95959,311741,407700,MKT
06090303257130000,2021,107574,234626,342200,MKT
06090303257130000,2020,69088,180490,249578,COST
06090303257130000,2019,69088,180490,249578,COST
06090303257150000,2021,113565,275735,389300,MKT
06090303257150000,2020,73208,241180,314388,COST
06090303257150000,2019,73208,241180,314388,COST
06090303257170000,2021,109561,183039,292600,MKT
06090303257170000,2020,70453,154170,224623,COST
06090303257170000,2019,70453,154170,224623,COST
06090303257190000,2021,112650,244950,357600,MKT
06090303257190000,2020,72578,185750,258328,COST
06090303257190000,2019,72578,185750,258328,COST
06090303257210000,2021,112650,223250,335900,MKT
06090303257210000,2020,72578,209080,281658,COST
06090303257210000,2019,72578,209080,281658,COST
06090303257230000,2021,132898,398620,531518,COST
06090303257230000,2020,72906,310194,383100,MKT
06090303257230000,2019,72906,310194,383100,MKT
06090303257250000,2021,113121,230479,343600,MKT
06090303257250000,2020,65189,225011,290200,MKT
06090303257250000,2019,65189,225011,290200,MKT
06090303257270000,2021,113121,250179,363300,MKT
06090303257270000,2020,65189,243111,308300,MKT
06090303257270000,2019,65189,243111,308300,MKT
06090303257290000,2021,113121,241679,354800,MKT
06090303257290000,2020,65189,234111,299300,MKT
06090303257290000,2019,65189,234111,299300,MKT
06090303257310000,2021,113121,223679,336800,MKT
06090303257310000,2020,65189,218411,283600,MKT
06090303257310000,2019,65189,218411,283600,MKT
06090303257330000,2021,113121,237479,350600,MKT
06090303257330000,2020,65189,227411,292600,MKT
06090303257330000,2019,65189,227411,292600,MKT
06090303257350000,2021,112650,283030,395680,COST
06090303257350000,2020,72578,274370,346948,COST
06090303257350000,2019,72578,274370,346948,COST
06090303257370000,2021,111712,237888,349600,MKT
06090303257370000,2020,71932,187800,259732,COST
06090303257370000,2019,71932,187800,259732,COST
06090303257390000,2021,115193,255407,370600,MKT
06090303257390000,2020,74331,247920,322251,COST
06090303257390000,2019,74331,254580,328911,COST
06090303257420000,2021,155338,231462,386800,MKT
06090303257420000,2020,81248,207952,289200,MKT
06090303257420000,2019,81248,207952,289200,MKT
06090303257450000,2021,131849,209650,341499,COST
06090303257450000,2020,124868,186570,311438,COST
06090303257450000,2019,124868,186570,311438,COST
06090303257550000,2021,107189,236111,343300,MKT
06090303257550000,2020,68824,176310,245134,COST
06090303257550000,2019,68824,176310,245134,COST
06090303257570000,2021,102699,240701,343400,MKT
06090303257570000,2020,65747,191950,257697,COST
06090303257570000,2019,65747,191950,257697,COST
06090303257590000,2021,103901,246099,350000,MKT
06090303257590000,2020,66570,203250,269820,COST
06090303257590000,2019,66570,203250,269820,COST
06090303257610000,2021,103901,234099,338000,MKT
06090303257610000,2020,66570,193360,259930,COST
06090303257610000,2019,66570,193360,259930,COST
06090303257630000,2021,103901,208199,312100,MKT
06090303257630000,2020,66570,179030,245600,COST
06090303257630000,2019,66570,179030,245600,COST
06090303260010000,2021,117646,292154,409800,MKT
06090303260010000,2020,70858,255242,326100,MKT
06090303260010000,2019,70858,251542,322400,MKT
06090303260030000,2021,117646,241254,358900,MKT
06090303260030000,2020,70858,230942,301800,MKT
06090303260030000,2019,70858,230942,301800,MKT
06090303260050000,2021,117646,315854,433500,MKT
06090303260050000,2020,70858,323742,394600,MKT
06090303260050000,2019,70858,323742,394600,MKT
06090303260070000,2021,113121,246279,359400,MKT
06090303260070000,2020,65189,238111,303300,MKT
06090303260070000,2019,65189,238111,303300,MKT
06090303260090000,2021,113121,247479,360600,MKT
06090303260090000,2020,65189,227911,293100,MKT
06090303260090000,2019,65189,227211,292400,MKT
06090303260110000,2021,117737,222463,340200,MKT
06090303260110000,2020,70895,217605,288500,MKT
06090303260110000,2019,70895,217605,288500,MKT
06090303260130000,2021,117737,235863,353600,MKT
06090303260130000,2020,70895,228805,299700,MKT
06090303260130000,2019,70895,228805,299700,MKT
06090303260150000,2021,117737,233963,351700,MKT
06090303260150000,2020,70895,226605,297500,MKT
06090303260150000,2019,70895,226605,297500,MKT
06090303260170000,2021,117737,257963,375700,MKT
06090303260170000,2020,70895,240205,311100,MKT
06090303260170000,2019,70895,240205,311100,MKT
06090303260190000,2021,101454,186546,288000,MKT
06090303260190000,2020,64896,125860,190756,COST
06090303260190000,2019,64896,125860,190756,COST
06090303260210000,2021,101454,216046,317500,MKT
06090303260210000,2020,64896,152960,217856,COST
06090303260210000,2019,64896,152960,217856,COST
06090303260230000,2021,117646,279554,397200,MKT
06090303260230000,2020,70858,206250,277108,COST
06090303260230000,2019,70858,206250,277108,COST
06090303260250000,2021,105726,214274,320000,MKT
06090303260250000,2020,70087,198920,269007,COST
06090303260250000,2019,70087,198920,269007,COST
06090303260270000,2021,105726,186174,291900,MKT
06090303260270000,2020,70087,130290,200377,COST
06090303260270000,2019,70087,130290,200377,COST
06090303260296500,2021,72125,0,72125,COST
06090303260296500,2020,47835,0,47835,COST
06090303260296500,2019,47835,0,47835,COST
06090303262010000,2021,105726,195174,300900,MKT
06090303262010000,2020,70087,136850,206937,COST
06090303262010000,2019,70087,136850,206937,COST
06090303262030000,2021,105726,205574,311300,MKT
06090303262030000,2020,70087,141520,211607,COST
06090303262030000,2019,70087,141520,211607,COST
06090303262050000,2021,105726,198974,304700,MKT
06090303262050000,2020,70087,156600,226687,COST
06090303262050000,2019,70087,156600,226687,COST
06090303262070000,2021,101454,198646,300100,MKT
06090303262070000,2020,64896,132030,196926,COST
06090303262070000,2019,64896,132030,196926,COST
06090303262090000,2021,101454,249246,350700,MKT
06090303262090000,2020,64896,274040,338936,COST
06090303262090000,2019,64896,274040,338936,COST
06090303262110000,2021,105779,232921,338700,MKT
06090303262110000,2020,70125,167010,237135,COST
06090303262110000,2019,70125,167010,237135,COST
06090303262130000,2021,105779,200221,306000,MKT
06090303262130000,2020,70125,131090,201215,COST
06090303262130000,2019,70125,131090,201215,COST
06090303262150000,2021,105779,232521,338300,MKT
06090303262150000,2020,70125,184860,254985,COST
06090303262150000,2019,70125,184860,254985,COST
06090303262170000,2021,105779,204821,310600,MKT
06090303262170000,2020,70125,154180,224305,COST
06090303262170000,2019,70125,154180,224305,COST
06090303262190000,2021,101454,186146,287600,MKT
06090303262190000,2020,64896,121880,186776,COST
06090303262190000,2019,64896,121880,186776,COST
06090303262210000,2021,101454,222746,324200,MKT
06090303262210000,2020,64896,169570,234466,COST
06090303262210000,2019,64896,169570,234466,COST
06090303262230000,2021,117646,230354,348000,MKT
06090303262230000,2020,70858,188270,259128,COST
06090303262230000,2019,70858,188270,259128,COST
06090303262250000,2021,105726,236474,342200,MKT
06090303262250000,2020,70087,183720,253807,COST
06090303262250000,2019,70087,183720,253807,COST
06090303262270000,2021,105726,220174,325900,MKT
06090303262270000,2020,70087,176910,246997,COST
06090303262270000,2019,70087,176910,246997,COST
06090303262296500,2021,72125,0,72125,COST
06090303262296500,2020,33006,0,33006,COST
06090303262296500,2019,33006,0,33006,COST
06090303265010000,2021,101505,211595,313100,MKT
06090303265010000,2020,64930,151630,216560,COST
06090303265010000,2019,64930,151630,216560,COST
06090303265030000,2021,101505,208995,310500,MKT
06090303265030000,2020,64930,207750,272680,COST
06090303265030000,2019,64930,207750,272680,COST
06090303265050000,2021,113258,170242,283500,MKT
06090303265050000,2020,64930,126860,191790,COST
06090303265050000,2019,64930,126860,191790,COST
06090303265070000,2021,113258,183842,297100,MKT
06090303265070000,2020,64930,121760,186690,COST
06090303265070000,2019,64930,121760,186690,COST
06090303265090000,2021,113258,223142,336400,MKT
06090303265090000,2020,64930,189970,254900,COST
06090303265090000,2019,64930,189970,254900,COST
06090303265110000,2021,113258,175942,289200,MKT
06090303265110000,2020,64930,128230,193160,COST
06090303265110000,2019,64930,128230,193160,COST
06090303265130000,2021,101505,225095,326600,MKT
06090303265130000,2020,64930,151830,216760,COST
06090303265130000,2019,64930,151830,216760,COST
06090303265150000,2021,101505,164495,266000,MKT
06090303265150000,2020,64930,115140,180070,COST
06090303265150000,2019,64930,115140,180070,COST
06090303265170000,2021,101505,167695,269200,MKT
06090303265170000,2020,64930,108340,173270,COST
06090303265170000,2019,64930,108340,173270,COST
06090303265190000,2021,101505,192295,293800,MKT
06090303265190000,2020,64930,144490,209420,COST
06090303265190000,2019,64930,144490,209420,COST
06090303265210000,2021,101505,180295,281800,MKT
06090303265210000,2020,64930,128200,193130,COST
06090303265210000,2019,64930,128200,193130,COST
06090303265230000,2021,113258,228442,341700,MKT
06090303265230000,2020,64930,181960,246890,COST
06090303265230000,2019,64930,181960,246890,COST
06090303265250000,2021,113258,201342,314600,MKT
06090303265250000,2020,64930,178690,243620,COST
06090303265250000,2019,64930,130090,195020,COST
06090303265270000,2021,113258,224942,338200,MKT
06090303265270000,2020,64930,175790,240720,COST
06090303265270000,2019,64930,175790,240720,COST
06090303265290000,2021,113258,191542,304800,MKT
06090303265290000,2020,64930,175370,240300,COST
06090303265290000,2019,64930,175370,240300,COST
06090303265310000,2021,101505,228095,329600,MKT
06090303265310000,2020,64930,168190,233120,COST
06090303265310000,2019,64930,168190,233120,COST
06090303265330000,2021,101757,243343,345100,MKT
06090303265330000,2020,65103,197580,262683,COST
06090303265330000,2019,65103,197580,262683,COST
06090303301350000,2021,74180,233620,307800,MKT
06090303301350000,2020,69522,189078,258600,MKT
06090303301350000,2019,69522,189078,258600,MKT
06090303301370000,2021,74180,238820,313000,MKT
06090303301370000,2020,69522,209378,278900,MKT
06090303301370000,2019,69522,209378,278900,MKT
06090303301390000,2021,74180,348920,423100,MKT
06090303301390000,2020,69522,308778,378300,MKT
06090303301390000,2019,69522,308778,378300,MKT
06090303301410000,2021,74180,255520,329700,MKT
06090303301410000,2020,69522,210178,279700,MKT
06090303301410000,2019,69522,210178,279700,MKT
06090303301430000,2021,74180,236520,310700,MKT
06090303301430000,2020,69522,194678,264200,MKT
06090303301430000,2019,69522,194678,264200,MKT
06090303301450000,2021,74180,238720,312900,MKT
06090303301450000,2020,69522,196378,265900,MKT
06090303301450000,2019,69522,196378,265900,MKT
06090303301470000,2021,74180,244620,318800,MKT
06090303301470000,2020,69522,209978,279500,MKT
06090303301470000,2019,69522,209978,279500,MKT
06090303301490000,2021,74180,254720,328900,MKT
06090303301490000,2020,69522,209178,278700,MKT
06090303301490000,2019,69522,209178,278700,MKT
06090303301510000,2021,74180,243520,317700,MKT
06090303301510000,2020,69522,199978,269500,MKT
06090303301510000,2019,69522,199978,269500,MKT
06090303301530000,2021,74322,272278,346600,MKT
06090303301530000,2020,69615,227885,297500,MKT
06090303301530000,2019,69615,227885,297500,MKT
06090303301550000,2021,75999,275601,351600,MKT
06090303301550000,2020,70702,221698,292400,MKT
06090303301550000,2019,70702,221698,292400,MKT
06090303303016500,2021,19381,0,19381,COST
06090303303016500,2020,18955,0,18955,COST
06090303303016500,2019,18955,0,18955,COST
06090303303030000,2021,70309,262391,332700,MKT
06090303303030000,2020,66983,217317,284300,MKT
06090303303030000,2019,66983,217317,284300,MKT
06090303303050000,2021,70309,253291,323600,MKT
06090303303050000,2020,66983,244717,311700,MKT
06090303303050000,2019,66983,244717,311700,MKT
06090303303070000,2021,70309,249291,319600,MKT
06090303303070000,2020,66983,236017,303000,MKT
06090303303070000,2019,66983,236017,303000,MKT
06090303303090000,2021,70309,262591,332900,MKT
06090303303090000,2020,66983,204717,271700,MKT
06090303303090000,2019,66983,204717,271700,MKT
06090303303110000,2021,70309,214591,284900,MKT
06090303303110000,2020,66983,181517,248500,MKT
06090303303110000,2019,66983,174217,241200,MKT
06090303303130000,2021,70309,254191,324500,MKT
06090303303130000,2020,66983,203717,270700,MKT
06090303303130000,2019,66983,203717,270700,MKT
06090303303150000,2021,70309,215891,286200,MKT
06090303303150000,2020,66983,183117,250100,MKT
06090303303150000,2019,66983,183117,250100,MKT
06090303303170000,2021,70309,253491,323800,MKT
06090303303170000,2020,66983,221017,288000,MKT
06090303303170000,2019,66983,221017,288000,MKT
06090303303190000,2021,70309,294491,364800,MKT
06090303303190000,2020,66983,251917,318900,MKT
06090303303190000,2019,66983,251917,318900,MKT
06090303303210000,2021,70309,236791,307100,MKT
06090303303210000,2020,66983,208617,275600,MKT
06090303303210000,2019,66983,208617,275600,MKT
06090303303236500,2021,19381,0,19381,COST
06090303303236500,2020,18955,0,18955,COST
06090303303236500,2019,18955,0,18955,COST
06090303303250000,2021,59141,248959,308100,MKT
06090303303250000,2020,59402,221598,281000,MKT
06090303303250000,2019,59402,221598,281000,MKT
06090303303270000,2021,58521,212479,271000,MKT
06090303303270000,2020,58968,175232,234200,MKT
06090303303270000,2019,58968,175232,234200,MKT
06090303303290000,2021,58521,227579,286100,MKT
06090303303290000,2020,58968,189832,248800,MKT
06090303303290000,2019,58968,189832,248800,MKT
06090303303310000,2021,58521,211279,269800,MKT
06090303303310000,2020,58968,173332,232300,MKT
06090303303310000,2019,58968,173332,232300,MKT
06090303303330000,2021,58521,240479,299000,MKT
06090303303330000,2020,58968,201032,260000,MKT
06090303303330000,2019,58968,201032,260000,MKT
06090303303350000,2021,58521,221079,279600,MKT
06090303303350000,2020,58968,184632,243600,MKT
06090303303350000,2019,58968,184632,243600,MKT
06090303303370000,2021,58521,222079,280600,MKT
06090303303370000,2020,58968,200232,259200,MKT
06090303303370000,2019,58968,200732,259700,MKT
06090303303390000,2021,58521,225279,283800,MKT
06090303303390000,2020,58968,188832,247800,MKT
06090303303390000,2019,58968,188832,247800,MKT
06090303303410000,2021,58521,232579,291100,MKT
06090303303410000,2020,58968,185632,244600,MKT
06090303303410000,2019,58968,185632,244600,MKT
06090303303430000,2021,58521,238879,297400,MKT
06090303303430000,2020,58968,212232,271200,MKT
06090303303430000,2019,58968,212232,271200,MKT
06090303303450000,2021,58521,204479,263000,MKT
06090303303450000,2020,58968,182032,241000,MKT
06090303303450000,2019,58968,182032,241000,MKT
06090303303470000,2021,58521,219779,278300,MKT
06090303303470000,2020,58968,183432,242400,MKT
06090303303470000,2019,58968,183432,242400,MKT
06090303303490000,2021,58521,247379,305900,MKT
06090303303490000,2020,58968,218132,277100,MKT
06090303303490000,2019,58968,206532,265500,MKT
06090303303510000,2021,58521,255179,313700,MKT
06090303303510000,2020,58968,210132,269100,MKT
06090303303510000,2019,58968,210132,269100,MKT
06090303303530000,2021,58521,252579,311100,MKT
06090303303530000,2020,58968,208832,267800,MKT
06090303303530000,2019,58968,204532,263500,MKT
06090303303550000,2021,58521,218579,277100,MKT
06090303303550000,2020,58968,183232,242200,MKT
06090303303550000,2019,58968,183932,242900,MKT
06090303303570000,2021,58521,218979,277500,MKT
06090303303570000,2020,58968,200632,259600,MKT
06090303303570000,2019,58968,200632,259600,MKT
06090303303590000,2021,58521,189279,247800,MKT
06090303303590000,2020,58968,170432,229400,MKT
06090303303590000,2019,58968,170432,229400,MKT
06090303303610000,2021,58521,204679,263200,MKT
06090303303610000,2020,58968,184232,243200,OVR
06090303303610000,2019,58968,184232,243200,MKT
06090303303630000,2021,59141,278459,337600,MKT
06090303303630000,2020,59402,240698,300100,MKT
06090303303630000,2019,59402,240698,300100,MKT
06090303304230000,2021,74464,282636,357100,MKT
06090303304230000,2020,69707,238893,308600,MKT
06090303304230000,2019,69707,238893,308600,MKT
06090303304250000,2021,73461,235839,309300,MKT
06090303304250000,2020,69053,232747,301800,MKT
06090303304250000,2019,69053,232747,301800,MKT
06090303304270000,2021,73461,238839,312300,MKT
06090303304270000,2020,69053,198047,267100,MKT
06090303304270000,2019,69053,198047,267100,MKT
06090303304290000,2021,73461,267839,341300,MKT
06090303304290000,2020,69053,228047,297100,MKT
06090303304290000,2019,69053,228047,297100,MKT
06090303304310000,2021,73461,231639,305100,MKT
06090303304310000,2020,69053,184347,253400,MKT
06090303304310000,2019,69053,184347,253400,MKT
06090303304330000,2021,73461,234739,308200,MKT
06090303304330000,2020,69053,192847,261900,MKT
06090303304330000,2019,69053,192847,261900,MKT
06090303304350000,2021,73461,276339,349800,MKT
06090303304350000,2020,69053,229847,298900,MKT
06090303304350000,2019,69053,229847,298900,MKT
06090303304370000,2021,73461,239639,313100,MKT
06090303304370000,2020,69053,198147,267200,MKT
06090303304370000,2019,69053,198147,267200,MKT
06090303304390000,2021,73461,274239,347700,MKT
06090303304390000,2020,69053,226347,295400,MKT
06090303304390000,2019,69053,226347,295400,MKT
06090303304410000,2021,73461,235339,308800,MKT
06090303304410000,2020,69053,198847,267900,MKT
06090303304410000,2019,69053,198847,267900,MKT
06090303304430000,2021,75168,259332,334500,MKT
06090303304430000,2020,70164,230436,300600,MKT
06090303304430000,2019,70164,230436,300600,MKT
06090303304450000,2021,59141,280259,339400,MKT
06090303304450000,2020,59402,219198,278600,MKT
06090303304450000,2019,59402,219198,278600,MKT
06090303304470000,2021,58521,221379,279900,MKT
06090303304470000,2020,58968,208632,267600,MKT
06090303304470000,2019,58968,202332,261300,MKT
06090303304490000,2021,58521,223479,282000,MKT
06090303304490000,2020,58968,186232,245200,MKT
06090303304490000,2019,58968,186232,245200,MKT
06090303304510000,2021,58521,249579,308100,MKT
06090303304510000,2020,58968,205332,264300,MKT
06090303304510000,2019,58968,205332,264300,MKT
06090303304530000,2021,58521,221379,279900,MKT
06090303304530000,2020,58968,184632,243600,MKT
06090303304530000,2019,58968,184632,243600,MKT
06090303304550000,2021,58521,222579,281100,MKT
06090303304550000,2020,58968,200332,259300,MKT
06090303304550000,2019,58968,200332,259300,MKT
06090303304570000,2021,58521,210279,268800,MKT
06090303304570000,2020,58968,172732,231700,MKT
06090303304570000,2019,58968,172732,231700,MKT
06090303304590000,2021,58521,218579,277100,MKT
06090303304590000,2020,58968,183232,242200,MKT
06090303304590000,2019,58968,183232,242200,MKT
06090303304610000,2021,58521,217779,276300,MKT
06090303304610000,2020,58968,196232,255200,MKT
06090303304610000,2019,58968,196232,255200,MKT
06090303304630000,2021,58521,217579,276100,MKT
06090303304630000,2020,58968,180632,239600,MKT
06090303304630000,2019,58968,180632,239600,MKT
06090303304650000,2021,58521,243679,302200,MKT
06090303304650000,2020,58968,199232,258200,MKT
06090303304650000,2019,58968,199232,258200,MKT
06090303304670000,2021,58521,219679,278200,MKT
06090303304670000,2020,58968,183732,242700,MKT
06090303304670000,2019,58968,183732,242700,MKT
06090303304690000,2021,58521,218279,276800,MKT
06090303304690000,2020,58968,197632,256600,MKT
06090303304690000,2019,58968,197632,256600,MKT
06090303304710000,2021,58521,240479,299000,MKT
06090303304710000,2020,58968,201532,260500,MKT
06090303304710000,2019,58968,201532,260500,MKT
06090303304730000,2021,58521,225379,283900,MKT
06090303304730000,2020,58968,203632,262600,MKT
06090303304730000,2019,58968,203632,262600,MKT
06090303304750000,2021,58521,210279,268800,MKT
06090303304750000,2020,58968,185932,244900,OVR
06090303304750000,2019,58968,185932,244900,MKT
06090303304770000,2021,58521,218379,276900,MKT
06090303304770000,2020,58968,182832,241800,MKT
06090303304770000,2019,58968,182832,241800,MKT
06090303304790000,2021,58521,241179,299700,MKT
06090303304790000,2020,58968,211032,270000,MKT
06090303304790000,2019,58968,211032,270000,MKT
06090303304810000,2021,58521,224479,283000,MKT
06090303304810000,2020,58968,206932,265900,MKT
06090303304810000,2019,58968,206932,265900,MKT
06090303304830000,2021,58521,233679,292200,MKT
06090303304830000,2020,58968,201432,260400,MKT
06090303304830000,2019,58968,201432,260400,MKT
06090303305010000,2021,75168,220332,295500,MKT
06090303305010000,2020,70164,191236,261400,MKT
06090303305010000,2019,70164,191236,261400,MKT
06090303305030000,2021,73461,217739,291200,MKT
06090303305030000,2020,69053,184847,253900,MKT
06090303305030000,2019,69053,184847,253900,MKT
06090303305050000,2021,73461,234239,307700,MKT
06090303305050000,2020,69053,188247,257300,MKT
06090303305050000,2019,69053,188247,257300,MKT
06090303305070000,2021,73461,212239,285700,MKT
06090303305070000,2020,69053,192747,261800,MKT
06090303305070000,2019,69053,192747,261800,MKT
06090303305090000,2021,73461,232039,305500,MKT
06090303305090000,2020,69053,188447,257500,MKT
06090303305090000,2019,69053,188447,257500,MKT
06090303305110000,2021,73461,229239,302700,MKT
06090303305110000,2020,69053,188047,257100,MKT
06090303305110000,2019,69053,188047,257100,MKT
06090303305130000,2021,73461,226839,300300,MKT
06090303305130000,2020,69053,181647,250700,MKT
06090303305130000,2019,69053,181647,250700,MKT
06090303305150000,2021,73461,229239,302700,MKT
06090303305150000,2020,69053,184347,253400,MKT
06090303305150000,2019,69053,184347,253400,MKT
06090303305170000,2021,73461,227839,301300,MKT
06090303305170000,2020,69053,183547,252600,MKT
06090303305170000,2019,69053,183547,252600,MKT
06090303305190000,2021,73461,231139,304600,MKT
06090303305190000,2020,69053,189347,258400,MKT
06090303305190000,2019,69053,189347,258400,MKT
06090303305210000,2021,74464,234036,308500,MKT
06090303305210000,2020,69707,211593,281300,MKT
06090303305210000,2019,69707,211593,281300,MKT
06090303305235001,2021,59141,192559,251700,MKT
06090303305235001,2020,59402,172798,232200,MKT
06090303305235001,2019,59402,172798,232200,MKT
06090303305245002,2021,58521,193179,251700,MKT
06090303305245002,2020,58968,173532,232500,MKT
06090303305245002,2019,58968,173532,232500,MKT
06090303305255001,2021,58521,185779,244300,MKT
06090303305255001,2020,58968,164532,223500,MKT
06090303305255001,2019,58968,164532,223500,MKT
06090303305265002,2021,58521,185779,244300,MKT
06090303305265002,2020,58968,164532,223500,MKT
06090303305265002,2019,58968,164532,223500,MKT
06090303305275001,2021,58521,165379,223900,MKT
06090303305275001,2020,58968,164132,223100,MKT
06090303305275001,2019,58968,164132,223100,MKT
06090303305285002,2021,58521,165379,223900,MKT
06090303305285002,2020,58968,164132,223100,MKT
06090303305285002,2019,58968,164132,223100,MKT
06090303305295001,2021,58521,186779,245300,MKT
06090303305295001,2020,58968,165432,224400,MKT
06090303305295001,2019,58968,165432,224400,MKT
06090303305305002,2021,58521,193979,252500,MKT
06090303305305002,2020,58968,170932,229900,MKT
06090303305305002,2019,58968,168132,227100,MKT
06090303305315001,2021,58521,187479,246000,MKT
06090303305315001,2020,58968,163532,222500,MKT
06090303305315001,2019,58968,163532,222500,MKT
06090303305325002,2021,58521,185479,244000,MKT
06090303305325002,2020,58968,159632,218600,MKT
06090303305325002,2019,58968,159632,218600,MKT
06090303305335001,2021,58521,186179,244700,MKT
06090303305335001,2020,58968,164532,223500,MKT
06090303305335001,2019,58968,164532,223500,MKT
06090303305345002,2021,58521,186179,244700,MKT
06090303305345002,2020,58968,164532,223500,MKT
06090303305345002,2019,58968,164532,223500,MKT
06090303305355001,2021,58521,194679,253200,MKT
06090303305355001,2020,58968,167932,226900,MKT
06090303305355001,2019,58968,167932,226900,MKT
06090303305365002,2021,58521,184079,242600,MKT
06090303305365002,2020,58968,161832,220800,MKT
06090303305365002,2019,58968,161832,220800,MKT
06090303305375001,2021,58521,187179,245700,MKT
06090303305375001,2020,58968,166632,225600,MKT
06090303305375001,2019,58968,166632,225600,MKT
06090303305385002,2021,58521,186179,244700,MKT
06090303305385002,2020,58968,164532,223500,MKT
06090303305385002,2019,58968,164532,223500,MKT
06090303305395001,2021,58521,181379,239900,MKT
06090303305395001,2020,58968,158232,217200,MKT
06090303305395001,2019,58968,158232,217200,MKT
06090303305405002,2021,58521,189679,248200,MKT
06090303305405002,2020,58968,164632,223600,MKT
06090303305405002,2019,58968,164632,223600,MKT
06090303305415001,2021,58521,188179,246700,MKT
06090303305415001,2020,58968,164732,223700,MKT
06090303305415001,2019,58968,164732,223700,MKT
06090303305425002,2021,58936,188164,247100,MKT
06090303305425002,2020,59258,164742,224000,MKT
06090303305425002,2019,59258,164742,224000,MKT
06090303306015001,2021,59141,191959,251100,MKT
06090303306015001,2020,59402,166298,225700,MKT
06090303306015001,2019,59402,166298,225700,MKT
06090303306025002,2021,58521,191979,250500,MKT
06090303306025002,2020,58968,166332,225300,MKT
06090303306025002,2019,58968,166332,225300,MKT
06090303306035001,2021,58521,200179,258700,MKT
06090303306035001,2020,58968,173832,232800,MKT
06090303306035001,2019,58968,173832,232800,MKT
06090303306045002,2021,58521,193879,252400,MKT
06090303306045002,2020,58968,172932,231900,MKT
06090303306045002,2019,58968,172932,231900,MKT
06090303306055001,2021,58521,193479,252000,MKT
06090303306055001,2020,58968,172932,231900,MKT
06090303306055001,2019,58968,172932,231900,MKT
06090303306065002,2021,58521,193479,252000,MKT
06090303306065002,2020,58968,172932,231900,MKT
06090303306065002,2019,58968,172932,231900,MKT
06090303306075001,2021,58521,189479,248000,MKT
06090303306075001,2020,58968,168332,227300,MKT
06090303306075001,2019,58968,168332,227300,MKT
06090303306085002,2021,58521,189479,248000,MKT
06090303306085002,2020,58968,168332,227300,MKT
06090303306085002,2019,58968,168332,227300,MKT
06090303306095001,2021,58521,165779,224300,MKT
06090303306095001,2020,58968,164232,223200,MKT
06090303306095001,2019,58968,164232,223200,MKT
06090303306105002,2021,58521,165779,224300,MKT
06090303306105002,2020,58968,164132,223100,MKT
06090303306105002,2019,58968,164232,223200,MKT
06090303306115001,2021,58521,193479,252000,MKT
06090303306115001,2020,58968,172932,231900,MKT
06090303306115001,2019,58968,172932,231900,MKT
06090303306125002,2021,58521,193479,252000,MKT
06090303306125002,2020,58968,172932,231900,MKT
06090303306125002,2019,58968,172932,231900,MKT
06090303306135001,2021,58521,185579,244100,MKT
06090303306135001,2020,58968,160832,219800,MKT
06090303306135001,2019,58968,160832,219800,MKT
06090303306145002,2021,58521,189079,247600,MKT
06090303306145002,2020,58968,164332,223300,MKT
06090303306145002,2019,58968,164332,223300,MKT
06090303306155001,2021,58521,133779,192300,MKT
06090303306155001,2020,58968,135332,194300,OVR
06090303306155001,2019,58968,135332,194300,MKT
06090303306165002,2021,58521,133779,192300,MKT
06090303306165002,2020,58968,135332,194300,OVR
06090303306165002,2019,58968,135332,194300,MKT
06090303306175001,2021,58521,158679,217200,MKT
06090303306175001,2020,58968,148232,207200,MKT
06090303306175001,2019,58968,148232,207200,MKT
06090303306185002,2021,58521,158679,217200,MKT
06090303306185002,2020,58968,148232,207200,MKT
06090303306185002,2019,58968,148232,207200,MKT
06090303306195001,2021,58521,150379,208900,MKT
06090303306195001,2020,58968,147832,206800,OVR
06090303306195001,2019,58968,147832,206800,MKT
06090303306205002,2021,59141,150359,209500,MKT
06090303306205002,2020,59402,147898,207300,OVR
06090303306205002,2019,59402,147898,207300,MKT
06090303306230000,2021,74464,237936,312400,MKT
06090303306230000,2020,69707,195693,265400,MKT
06090303306230000,2019,69707,195693,265400,MKT
06090303306250000,2021,73461,236239,309700,MKT
06090303306250000,2020,69053,204647,273700,MKT
06090303306250000,2019,69053,208247,277300,MKT
06090303306270000,2021,73461,242139,315600,MKT
06090303306270000,2020,69053,199747,268800,MKT
06090303306270000,2019,69053,199747,268800,MKT
06090303306290000,2021,73461,239339,312800,MKT
06090303306290000,2020,69053,205447,274500,MKT
06090303306290000,2019,69053,205447,274500,MKT
06090303306310000,2021,73461,211339,284800,MKT
06090303306310000,2020,69053,184747,253800,MKT
06090303306310000,2019,69053,184747,253800,MKT
06090303306330000,2021,73461,273339,346800,MKT
06090303306330000,2020,69053,223947,293000,MKT
06090303306330000,2019,69053,223947,293000,MKT
06090303306350000,2021,73461,241339,314800,MKT
06090303306350000,2020,69053,197847,266900,MKT
06090303306350000,2019,69053,197847,266900,MKT
06090303306370000,2021,73461,222739,296200,MKT
06090303306370000,2020,69053,178747,247800,MKT
06090303306370000,2019,69053,178747,247800,MKT
06090303306390000,2021,73461,231739,305200,MKT
06090303306390000,2020,69053,186647,255700,MKT
06090303306390000,2019,69053,186647,255700,MKT
06090303306410000,2021,73461,257239,330700,MKT
06090303306410000,2020,69053,225147,294200,MKT
06090303306410000,2019,69053,225147,294200,MKT
06090303306430000,2021,75168,244932,320100,MKT
06090303306430000,2020,70164,202136,272300,MKT
06090303306430000,2019,70164,202136,272300,MKT
06090303307010000,2021,75168,273732,348900,MKT
06090303307010000,2020,70164,220236,290400,MKT
06090303307010000,2019,70164,220236,290400,MKT
06090303307030000,2021,73461,254339,327800,MKT
06090303307030000,2020,69053,215947,285000,MKT
06090303307030000,2019,69053,215947,285000,MKT
06090303307050000,2021,73461,217839,291300,MKT
06090303307050000,2020,69053,184047,253100,MKT
06090303307050000,2019,69053,184047,253100,MKT
06090303307070000,2021,73461,212639,286100,MKT
06090303307070000,2020,69053,185647,254700,MKT
06090303307070000,2019,69053,185647,254700,MKT
06090303307090000,2021,73461,237539,311000,MKT
06090303307090000,2020,69053,194947,264000,MKT
06090303307090000,2019,69053,194947,264000,MKT
06090303307110000,2021,73461,237939,311400,MKT
06090303307110000,2020,69053,195547,264600,MKT
06090303307110000,2019,69053,195547,264600,MKT
06090303307130000,2021,73461,224039,297500,MKT
06090303307130000,2020,69053,180047,249100,MKT
06090303307130000,2019,69053,180047,249100,MKT
06090303307150000,2021,73461,252539,326000,MKT
06090303307150000,2020,69053,218247,287300,MKT
06090303307150000,2019,69053,218247,287300,MKT
06090303307170000,2021,73461,244139,317600,MKT
06090303307170000,2020,69053,217447,286500,MKT
06090303307170000,2019,69053,217447,286500,MKT
06090303307190000,2021,73461,239639,313100,MKT
06090303307190000,2020,69053,195647,264700,MKT
06090303307190000,2019,69053,193247,262300,MKT
06090303307210000,2021,74464,235836,310300,MKT
06090303307210000,2020,69707,195393,265100,MKT
06090303307210000,2019,69707,195393,265100,MKT
06090303307230000,2021,74464,270536,345000,MKT
06090303307230000,2020,69707,234893,304600,MKT
06090303307230000,2019,69707,234893,304600,MKT
06090303307250000,2021,73461,234539,308000,MKT
06090303307250000,2020,69053,193047,262100,MKT
06090303307250000,2019,69053,193047,262100,MKT
06090303307270000,2021,73461,219539,293000,MKT
06090303307270000,2020,69053,188947,258000,MKT
06090303307270000,2019,69053,188947,258000,MKT
06090303307290000,2021,73461,251039,324500,MKT
06090303307290000,2020,69053,207447,276500,MKT
06090303307290000,2019,69053,207447,276500,MKT
06090303307310000,2021,73461,235439,308900,MKT
06090303307310000,2020,69053,188747,257800,MKT
06090303307310000,2019,69053,188747,257800,MKT
06090303307330000,2021,73461,256039,329500,MKT
06090303307330000,2020,69053,210347,279400,MKT
06090303307330000,2019,69053,210347,279400,MKT
06090303307350000,2021,73461,285939,359400,MKT
06090303307350000,2020,69053,240947,310000,MKT
06090303307350000,2019,69053,240947,310000,MKT
06090303307370000,2021,73461,283439,356900,MKT
06090303307370000,2020,69053,246047,315100,MKT
06090303307370000,2019,69053,246047,315100,MKT
06090303307390000,2021,73461,250839,324300,MKT
06090303307390000,2020,69053,205247,274300,MKT
06090303307390000,2019,69053,205247,274300,MKT
06090303307410000,2021,73461,250939,324400,MKT
06090303307410000,2020,69053,205847,274900,MKT
06090303307410000,2019,69053,205847,274900,MKT
06090303307430000,2021,75168,248532,323700,MKT
06090303307430000,2020,70164,223136,293300,MKT
06090303307430000,2019,70164,223136,293300,MKT
06090303308010000,2021,81572,300828,382400,MKT
06090303308010000,2020,74263,246537,320800,MKT
06090303308010000,2019,74263,246537,320800,MKT
06090303308030000,2021,79187,248213,327400,MKT
06090303308030000,2020,72748,222252,295000,MKT
06090303308030000,2019,72748,222252,295000,MKT
06090303308050000,2021,79187,244813,324000,MKT
06090303308050000,2020,72748,202352,275100,MKT
06090303308050000,2019,72748,202352,275100,MKT
06090303308070000,2021,79187,285713,364900,MKT
06090303308070000,2020,72748,237452,310200,MKT
06090303308070000,2019,72748,237452,310200,MKT
06090303308090000,2021,82354,236346,318700,MKT
06090303308090000,2020,78165,200435,278600,MKT
06090303308090000,2019,78165,200435,278600,MKT
06090303308110000,2021,82354,262346,344700,MKT
06090303308110000,2020,78165,216635,294800,MKT
06090303308110000,2019,78165,216635,294800,MKT
06090303308130000,2021,82354,315646,398000,MKT
06090303308130000,2020,78165,311435,389600,MKT
06090303308130000,2019,78165,311435,389600,MKT
06090303308150000,2021,82354,317246,399600,MKT
06090303308150000,2020,78165,258535,336700,MKT
06090303308150000,2019,78165,258535,336700,MKT
06090303308170000,2021,82354,362146,444500,MKT
06090303308170000,2020,78165,302235,380400,MKT
06090303308170000,2019,78165,302235,380400,MKT
06090303308190000,2021,82354,317846,400200,MKT
06090303308190000,2020,78165,251135,329300,MKT
06090303308190000,2019,78165,251135,329300,MKT
06090303308210000,2021,82354,336346,418700,MKT
06090303308210000,2020,78165,298635,376800,MKT
06090303308210000,2019,78165,298635,376800,MKT
06090303308230000,2021,83805,320795,404600,MKT
06090303308230000,2020,79119,283781,362900,MKT
06090303308230000,2019,79119,283781,362900,MKT
06090303308306500,2021,66386,0,66386,COST
06090303308306500,2020,44567,0,44567,COST
06090303308306500,2019,44567,0,44567,COST
06090303308556500,2021,106383,0,106383,COST
06090303308556500,2020,61833,0,61833,COST
06090303308556500,2019,61833,0,61833,COST
06090303308607000,2021,201662,408420,610082,COST
06090303308607000,2020,112404,394630,507034,COST
06090303308607000,2019,112404,32460,144864,COST
06090303308640000,2021,236700,1270200,1506900,INCOME
06090303308640000,2020,144289,1312311,1456600,INCOME
06090303308640000,2019,144289,5290,149579,COST
06090303308680000,2021,108008,116470,224478,COST
06090303308680000,2020,83228,112740,195968,COST
06090303308680000,2019,83228,112740,195968,COST
06090303308740000,2021,128372,1065950,1194322,COST
06090303308740000,2020,55592,0,55592,COST
06090303308740000,2019,55592,0,55592,COST
06090303308767000,2021,132535,303730,436265,COST
06090303308767000,2020,58428,293880,352308,COST
06090303308767000,2019,58428,0,58428,COST
06090303308820000,2021,194521,1405679,1600200,INCOME
06090303308820000,2020,106261,1256139,1362400,INCOME
06090303308820000,2019,106261,1256139,1362400,INCOME
06090303308860000,2021,161058,427842,588900,INCOME
06090303308860000,2020,79172,489228,568400,INCOME
06090303308860000,2019,79172,489228,568400,INCOME
06090303309016500,2021,39540,0,39540,COST
06090303309016500,2020,31099,0,31099,COST
06090303309016500,2019,31099,0,31099,COST
06090303310010000,2021,85808,527492,613300,INCOME
06090303310010000,2020,76920,512580,589500,INCOME
06090303310010000,2019,76920,512580,589500,INCOME
06090303310030000,2021,84317,528983,613300,INCOME
06090303310030000,2020,75990,513510,589500,INCOME
06090303310030000,2019,75990,513510,589500,INCOME
06090303310050000,2021,84317,528983,613300,INCOME
06090303310050000,2020,75990,513510,589500,INCOME
06090303310050000,2019,75990,513510,589500,INCOME
06090303310070000,2021,84317,528983,613300,INCOME
06090303310070000,2020,75990,513510,589500,INCOME
06090303310070000,2019,75990,513510,589500,INCOME
06090303310097000,2021,84049,0,84049,COST
06090303310097000,2020,75990,0,75990,COST
06090303310097000,2019,75990,0,75990,COST
06090303310110000,2021,85468,527832,613300,INCOME
06090303310110000,2020,76708,512792,589500,INCOME
06090303310110000,2019,76708,512792,589500,INCOME
06090303310130000,2021,75168,250832,326000,MKT
06090303310130000,2020,70164,220936,291100,MKT
06090303310130000,2019,70164,220936,291100,MKT
06090303310150000,2021,72877,238423,311300,MKT
06090303310150000,2020,68672,199028,267700,MKT
06090303310150000,2019,68672,199028,267700,MKT
06090303310170000,2021,72877,231223,304100,MKT
06090303310170000,2020,68672,187728,256400,MKT
06090303310170000,2019,68672,187728,256400,MKT
06090303310190000,2021,72877,231523,304400,MKT
06090303310190000,2020,68672,188728,257400,MKT
06090303310190000,2019,68672,188728,257400,MKT
06090303310210000,2021,78016,288684,366700,MKT
06090303310210000,2020,71999,268901,340900,MKT
06090303310210000,2019,71999,268901,340900,MKT
06090303310230000,2021,94576,270724,365300,MKT
06090303310230000,2020,82296,233204,315500,MKT
06090303310230000,2019,82296,233204,315500,MKT
06090303310250000,2021,95058,239242,334300,MKT
06090303310250000,2020,82587,242713,325300,MKT
06090303310250000,2019,82587,242713,325300,MKT
06090303310270000,2021,78147,238553,316700,MKT
06090303310270000,2020,72084,207716,279800,MKT
06090303310270000,2019,72084,207716,279800,MKT
06090303310290000,2021,71837,286063,357900,MKT
06090303310290000,2020,67990,239210,307200,MKT
06090303310290000,2019,67990,209510,277500,MKT
06090303310310000,2021,72286,263014,335300,MKT
06090303310310000,2020,68285,205915,274200,MKT
06090303310310000,2019,68285,205915,274200,MKT
06090303310330000,2021,72582,233518,306100,MKT
06090303310330000,2020,68479,186521,255000,MKT
06090303310330000,2019,68479,183721,252200,MKT
06090303310350000,2021,73024,236976,310000,MKT
06090303310350000,2020,68768,207032,275800,MKT
06090303310350000,2019,68768,207032,275800,MKT
06090303310370000,2021,73315,247285,320600,MKT
06090303310370000,2020,68959,218841,287800,MKT
06090303310370000,2019,68959,212441,281400,MKT
06090303310390000,2021,73750,240450,314200,MKT
06090303310390000,2020,69242,199258,268500,MKT
06090303310390000,2019,69242,199258,268500,MKT
06090303310410000,2021,74180,231020,305200,MKT
06090303310410000,2020,69522,198678,268200,MKT
06090303310410000,2019,69522,199278,268800,MKT
06090303310430000,2021,74464,236636,311100,MKT
06090303310430000,2020,69707,208693,278400,MKT
06090303310430000,2019,69707,208693,278400,MKT
06090303310450000,2021,74888,237912,312800,MKT
06090303310450000,2020,69982,200018,270000,MKT
06090303310450000,2019,69982,200018,270000,MKT
06090303310470000,2021,82302,238598,320900,MKT
06090303310470000,2020,74724,193076,267800,MKT
06090303310470000,2019,74724,193076,267800,MKT
06090303310490000,2021,99410,273690,373100,MKT
06090303310490000,2020,85194,241506,326700,OVR
06090303310490000,2019,85194,241506,326700,MKT
06090303310510000,2021,98600,235800,334400,MKT
06090303310510000,2020,84712,199888,284600,MKT
06090303310510000,2019,84712,199888,284600,MKT
06090303310530000,2021,84201,234099,318300,MKT
06090303310530000,2020,75917,191983,267900,MKT
06090303310530000,2019,75917,191983,267900,MKT
06090303310550000,2021,73605,302795,376400,MKT
06090303310550000,2020,69148,256452,325600,MKT
06090303310550000,2019,69148,256452,325600,MKT
06090303310570000,2021,73605,251595,325200,MKT
06090303310570000,2020,69148,229252,298400,MKT
06090303310570000,2019,69148,229252,298400,MKT
06090303310590000,2021,73605,242495,316100,MKT
06090303310590000,2020,69148,209852,279000,MKT
06090303310590000,2019,69148,209852,279000,MKT
06090303311010000,2021,75168,227132,302300,MKT
06090303311010000,2020,70164,221536,291700,MKT
06090303311010000,2019,70164,221536,291700,MKT
06090303311030000,2021,75168,237832,313000,MKT
06090303311030000,2020,70164,194736,264900,MKT
06090303311030000,2019,70164,194736,264900,MKT
06090303311050000,2021,75168,251232,326400,MKT
06090303311050000,2020,70164,214736,284900,MKT
06090303311050000,2019,70164,214736,284900,MKT
06090303311070000,2021,75168,265832,341000,MKT
06090303311070000,2020,70164,230436,300600,MKT
06090303311070000,2019,70164,230436,300600,MKT
06090303311090000,2021,75168,225132,300300,MKT
06090303311090000,2020,70164,186536,256700,MKT
06090303311090000,2019,70164,186536,256700,MKT
06090303311110000,2021,75168,279832,355000,MKT
06090303311110000,2020,70164,247236,317400,MKT
06090303311110000,2019,70164,244836,315000,MKT
06090303311130000,2021,75168,238032,313200,MKT
06090303311130000,2020,70164,192136,262300,MKT
06090303311130000,2019,70164,192136,262300,MKT
06090303311150000,2021,75168,237632,312800,MKT
06090303311150000,2020,70164,201836,272000,MKT
06090303311150000,2019,70164,201836,272000,MKT
06090303311170000,2021,105458,507842,613300,INCOME
06090303311170000,2020,88761,500739,589500,INCOME
06090303311170000,2019,88761,500739,589500,INCOME
06090303311210000,2021,84550,528750,613300,INCOME
06090303311210000,2020,76135,513365,589500,INCOME
06090303311210000,2019,76135,513365,589500,INCOME
06090303311230000,2021,84434,528866,613300,INCOME
06090303311230000,2020,76062,513438,589500,INCOME
06090303311230000,2019,76062,513438,589500,INCOME
06090303311250000,2021,84434,528866,613300,INCOME
06090303311250000,2020,76062,513438,589500,INCOME
06090303311250000,2019,76062,513438,589500,INCOME
06090303311277000,2021,84280,0,84280,COST
06090303311277000,2020,76135,0,76135,COST
06090303311277000,2019,76135,0,76135,COST
06090303311290000,2021,85468,527832,613300,INCOME
06090303311290000,2020,76708,512792,589500,INCOME
06090303311290000,2019,76708,512792,589500,INCOME
06090303312016500,2021,50263,0,50263,COST
06090303312016500,2020,36738,0,36738,COST
06090303312016500,2019,36738,0,36738,COST
06090303312107000,2021,299033,0,299033,COST
06090303312107000,2020,183439,0,183439,COST
06090303312107000,2019,183439,0,183439,COST
06090303313010000,2021,73750,539550,613300,INCOME
06090303313010000,2020,69242,520258,589500,INCOME
06090303313010000,2019,69242,520258,589500,INCOME
06090303313020000,2021,83850,529450,613300,INCOME
06090303313020000,2020,75697,513803,589500,INCOME
06090303313020000,2019,75697,513803,589500,INCOME
06090303313030000,2021,83850,359750,443600,INCOME
06090303313030000,2020,75697,338703,414400,INCOME
06090303313030000,2019,75697,338703,414400,INCOME
06090303313040000,2021,83850,359750,443600,INCOME
06090303313040000,2020,75697,338703,414400,INCOME
06090303313040000,2019,75697,338703,414400,INCOME
06090303313050000,2021,83850,408250,492100,INCOME
06090303313050000,2020,75697,338703,414400,INCOME
06090303313050000,2019,75697,338703,414400,INCOME
06090303313060000,2021,86034,527266,613300,INCOME
06090303313060000,2020,77060,512440,589500,INCOME
06090303313060000,2019,77060,512440,589500,INCOME
06090303313080000,2021,93699,519601,613300,INCOME
06090303313080000,2020,81765,507735,589500,INCOME
06090303313080000,2019,81765,507735,589500,INCOME
06090303313090000,2021,83850,529450,613300,INCOME
06090303313090000,2020,75697,513803,589500,INCOME
06090303313090000,2019,75697,513803,589500,INCOME
06090303313100000,2021,83850,529450,613300,INCOME
06090303313100000,2020,75697,513803,589500,INCOME
06090303313100000,2019,75697,513803,589500,INCOME
06090303313110000,2021,83850,529450,613300,INCOME
06090303313110000,2020,75697,513803,589500,INCOME
06090303313110000,2019,75697,513803,589500,INCOME
06090303313120000,2021,83850,529450,613300,INCOME
06090303313120000,2020,75697,513803,589500,INCOME
06090303313120000,2019,75697,513803,589500,INCOME
06090303313130000,2021,83850,529450,613300,INCOME
06090303313130000,2020,75697,513803,589500,INCOME
06090303313130000,2019,75697,513803,589500,INCOME
06090303313140000,2021,79825,533475,613300,INCOME
06090303313140000,2020,73155,516345,589500,INCOME
06090303313140000,2019,73155,516345,589500,INCOME
06090303313270000,2021,64309,224791,289100,MKT
06090303313270000,2020,63030,187230,250260,COST
06090303313270000,2019,63030,187230,250260,COST
06090303313286500,2021,19274,0,19274,COST
06090303313286500,2020,18882,0,18882,COST
06090303313286500,2019,18882,0,18882,COST
06090303313300000,2021,64130,172470,236600,MKT
06090303313300000,2020,62908,117130,180038,COST
06090303313300000,2019,62908,117130,180038,COST
06090303313310000,2021,64130,193470,257600,MKT
06090303313310000,2020,62908,151100,214008,COST
06090303313310000,2019,62908,151100,214008,COST
06090303313320000,2021,64130,231970,296100,MKT
06090303313320000,2020,62838,178062,240900,MKT
06090303313320000,2019,62838,178062,240900,MKT
06090303313330000,2021,64130,272970,337100,MKT
06090303313330000,2020,62908,279850,342758,COST
06090303313330000,2019,62908,279850,342758,COST
06090303313340000,2021,64130,218370,282500,MKT
06090303313340000,2020,62908,166840,229748,COST
06090303313340000,2019,62908,166840,229748,COST
06090303313350000,2021,64130,220670,284800,MKT
06090303313350000,2020,62908,187840,250748,COST
06090303313350000,2019,62908,187840,250748,COST
06090303313360000,2021,64130,169270,233400,MKT
06090303313360000,2020,62908,105650,168558,COST
06090303313360000,2019,62908,105650,168558,COST
06090303313370000,2021,64130,132770,196900,MKT
06090303313370000,2020,62908,62880,125788,COST
06090303313370000,2019,62908,62880,125788,COST
06090303313380000,2021,64130,187670,251800,MKT
06090303313380000,2020,62908,100090,162998,COST
06090303313380000,2019,62908,480,63388,COST
06090303313390000,2021,64130,490,64620,COST
06090303313390000,2020,62908,480,63388,COST
06090303313390000,2019,62908,480,63388,COST
06090303313400000,2021,64130,172670,236800,MKT
06090303313400000,2020,62908,123650,186558,COST
06090303313400000,2019,62908,123650,186558,COST
06090303313410000,2021,64130,151870,216000,MKT
06090303313410000,2020,62908,87970,150878,COST
06090303313410000,2019,62908,87970,150878,COST
06090303313420000,2021,64130,490,64620,COST
06090303313420000,2020,62908,480,63388,COST
06090303313420000,2019,62908,480,63388,COST
06090303313430000,2021,68239,490,68729,COST
06090303313430000,2020,65680,480,66160,COST
06090303313430000,2019,65680,480,66160,COST
06090303313440000,2021,68239,201661,269900,MKT
06090303313440000,2020,65680,136950,202630,COST
06090303313440000,2019,65680,136950,202630,COST
06090303313450000,2021,64130,177870,242000,MKT
06090303313450000,2020,62908,113040,175948,COST
06090303313450000,2019,62908,113040,175948,COST
06090303313460000,2021,69415,183085,252500,MKT
06090303313460000,2020,64679,139490,204169,COST
06090303313460000,2019,64679,139490,204169,COST
06090303313470000,2021,128799,341160,469959,COST
06090303313470000,2020,101981,319180,421161,COST
06090303313470000,2019,101981,319180,421161,COST
06090303313550000,2021,180922,823278,1004200,INCOME
06090303313550000,2020,156593,809007,965600,INCOME
06090303313550000,2019,156593,809007,965600,INCOME
06090303314390000,2021,88992,137720,226712,COST
06090303314390000,2020,78891,138120,217011,COST
06090303314390000,2019,78891,138120,217011,COST
06090303314430000,2021,73170,232230,305400,MKT
06090303314430000,2020,68940,163090,232030,COST
06090303314430000,2019,68940,163090,232030,COST
06090303314450000,2021,73170,146430,219600,MKT
06090303314450000,2020,68940,80570,149510,COST
06090303314450000,2019,68940,80570,149510,COST
06090303314470000,2021,73170,186930,260100,MKT
06090303314470000,2020,68940,135740,204680,COST
06090303314470000,2019,68940,135740,204680,COST
06090303314490000,2021,73170,147230,220400,MKT
06090303314490000,2020,68940,81120,150060,COST
06090303314490000,2019,68940,81120,150060,COST
06090303314510000,2021,73170,171430,244600,MKT
06090303314510000,2020,68940,118670,187610,COST
06090303314510000,2019,68940,118670,187610,COST
06090303315010000,2021,66236,233664,299900,MKT
06090303315010000,2020,64335,175440,239775,COST
06090303315010000,2019,64335,175440,239775,COST
06090303315030000,2021,64130,177070,241200,MKT
06090303315030000,2020,62908,118600,181508,COST
06090303315030000,2019,62908,118600,181508,COST
06090303315050000,2021,64130,146770,210900,MKT
06090303315050000,2020,62908,67930,130838,COST
06090303315050000,2019,62908,67930,130838,COST
06090303315070000,2021,64130,190970,255100,MKT
06090303315070000,2020,62908,117530,180438,COST
06090303315070000,2019,62908,117530,180438,COST
06090303315090000,2021,64130,490,64620,COST
06090303315090000,2020,62908,480,63388,COST
06090303315090000,2019,62908,480,63388,COST
06090303315110000,2021,64130,138870,203000,MKT
06090303315110000,2020,62908,75730,138638,COST
06090303315110000,2019,62908,75730,138638,COST
06090303315130000,2021,64130,490,64620,COST
06090303315130000,2020,62908,480,63388,COST
06090303315130000,2019,62908,480,63388,COST
06090303315150000,2021,64130,1440,65570,COST
06090303315150000,2020,62908,1410,64318,COST
06090303315150000,2019,62908,1410,64318,COST
06090303315170000,2021,64130,169270,233400,MKT
06090303315170000,2020,62908,92310,155218,COST
06090303315170000,2019,62908,92310,155218,COST
06090303315190000,2021,64130,186070,250200,MKT
06090303315190000,2020,62908,119040,181948,COST
06090303315190000,2019,62908,119040,181948,COST
06090303315210000,2021,64130,143970,208100,MKT
06090303315210000,2020,62908,83050,145958,COST
06090303315210000,2019,62908,83050,145958,COST
06090303315230000,2021,64130,142570,206700,MKT
06090303315230000,2020,62908,80650,143558,COST
06090303315230000,2019,62908,80650,143558,COST
06090303315250000,2021,64130,177170,241300,MKT
06090303315250000,2020,62908,101980,164888,COST
06090303315250000,2019,62908,101980,164888,COST
06090303315270000,2021,64130,148570,212700,MKT
06090303315270000,2020,62908,79560,142468,COST
06090303315270000,2019,62908,79560,142468,COST
06090303315290000,2021,64130,152070,216200,MKT
06090303315290000,2020,62908,76780,139688,COST
06090303315290000,2019,62908,76780,139688,COST
06090303315310000,2021,64130,155270,219400,MKT
06090303315310000,2020,62908,92570,155478,COST
06090303315310000,2019,62908,92570,155478,COST
06090303315330000,2021,64130,191970,256100,MKT
06090303315330000,2020,62908,138910,201818,COST
06090303315330000,2019,62908,138910,201818,COST
06090303315350000,2021,66695,206105,272800,MKT
06090303315350000,2020,62908,160740,223648,COST
06090303315350000,2019,62908,160740,223648,COST
06090303315376500,2021,19220,0,19220,COST
06090303315376500,2020,18846,0,18846,COST
06090303315376500,2019,18846,0,18846,COST
06090303315390000,2021,64130,214470,278600,MKT
06090303315390000,2020,62908,131160,194068,COST
06090303315390000,2019,62908,131160,194068,COST
06090303315410000,2021,66236,222464,288700,MKT
06090303315410000,2020,64335,178470,242805,COST
06090303315410000,2019,64335,178470,242805,COST
06090303315430000,2021,66236,193164,259400,MKT
06090303315430000,2020,64335,127240,191575,OVR
06090303315430000,2019,64335,127240,191575,COST
06090303315450000,2021,64309,196891,261200,MKT
06090303315450000,2020,63030,128770,191800,COST
06090303315450000,2019,63030,131750,194780,COST
06090303315490000,2021,64309,490,64799,COST
06090303315490000,2020,63030,480,63510,COST
06090303315490000,2019,63030,480,63510,COST
06090303315510000,2021,64309,148091,212400,MKT
06090303315510000,2020,63030,90790,153820,COST
06090303315510000,2019,63030,90790,153820,COST
06090303315530000,2021,59952,187848,247800,MKT
06090303315530000,2020,59966,132334,192300,MKT
06090303315530000,2019,59966,132334,192300,MKT
06090303315550000,2021,59952,179648,239600,MKT
06090303315550000,2020,59966,146634,206600,MKT
06090303315550000,2019,59966,146634,206600,MKT
06090303315570000,2021,59952,178448,238400,MKT
06090303315570000,2020,59966,132234,192200,MKT
06090303315570000,2019,59966,132234,192200,MKT
06090303315590000,2021,59952,225548,285500,MKT
06090303315590000,2020,59966,183134,243100,MKT
06090303315590000,2019,59966,159920,219886,COST
06090303315610000,2021,59952,182748,242700,MKT
06090303315610000,2020,59966,135134,195100,MKT
06090303315610000,2019,59966,135134,195100,MKT
06090303315630000,2021,59952,199648,259600,MKT
06090303315630000,2020,59966,155334,215300,MKT
06090303315630000,2019,59966,155334,215300,MKT
06090303315650000,2021,64309,217391,281700,MKT
06090303315650000,2020,63030,150780,213810,COST
06090303315650000,2019,63030,150780,213810,COST
06090303315670000,2021,64309,218291,282600,MKT
06090303315670000,2020,63030,160060,223090,COST
06090303315670000,2019,63030,160060,223090,COST
06090303315690000,2021,64309,180091,244400,MKT
06090303315690000,2020,63030,135870,198900,OVR
06090303315690000,2019,63030,135870,198900,OVR
06090303315710000,2021,64309,188650,252959,COST
06090303315710000,2020,63030,116600,179630,COST
06090303315710000,2019,63030,116600,179630,COST
06090303315730000,2021,59952,182548,242500,MKT
06090303315730000,2020,59966,150434,210400,MKT
06090303315730000,2019,59966,150434,210400,MKT
06090303315750000,2021,59952,197148,257100,MKT
06090303315750000,2020,59966,161434,221400,MKT
06090303315750000,2019,59966,143634,203600,MKT
06090303315770000,2021,59952,198448,258400,MKT
06090303315770000,2020,59966,154734,214700,MKT
06090303315770000,2019,59966,154734,214700,MKT
06090303315790000,2021,59952,189748,249700,MKT
06090303315790000,2020,59966,143234,203200,MKT
06090303315790000,2019,59966,143234,203200,MKT
06090303315810000,2021,59952,177248,237200,MKT
06090303315810000,2020,59966,131534,191500,MKT
06090303315810000,2019,59966,131534,191500,MKT
06090303315830000,2021,59952,209448,269400,MKT
06090303315830000,2020,60033,136510,196543,COST
06090303315830000,2019,60033,136510,196543,COST
06090303315850000,2021,64309,209591,273900,MKT
06090303315850000,2020,63030,156710,219740,COST
06090303315850000,2019,63030,156710,219740,COST
06090303315870000,2021,66236,271864,338100,MKT
06090303315870000,2020,64335,206910,271245,COST
06090303315870000,2019,64335,206910,271245,COST
06090303316010000,2021,66236,180264,246500,MKT
06090303316010000,2020,64335,121340,185675,COST
06090303316010000,2019,64335,121340,185675,COST
06090303316030000,2021,64309,203191,267500,MKT
06090303316030000,2020,63030,133820,196850,COST
06090303316030000,2019,63030,133820,196850,COST
06090303316050000,2021,59952,178748,238700,MKT
06090303316050000,2020,59966,133234,193200,MKT
06090303316050000,2019,59966,133234,193200,MKT
06090303316070000,2021,59952,162748,222700,MKT
06090303316070000,2020,59966,131434,191400,MKT
06090303316070000,2019,59966,131434,191400,MKT
06090303316090000,2021,59952,181248,241200,MKT
06090303316090000,2020,59966,146134,206100,MKT
06090303316090000,2019,59966,146134,206100,MKT
06090303316110000,2021,59952,180348,240300,MKT
06090303316110000,2020,59966,133234,193200,MKT
06090303316110000,2019,59966,133234,193200,MKT
06090303316130000,2021,59952,189048,249000,MKT
06090303316130000,2020,59966,140834,200800,MKT
06090303316130000,2019,59966,140834,200800,MKT
06090303316150000,2021,59952,190048,250000,MKT
06090303316150000,2020,59966,143434,203400,MKT
06090303316150000,2019,59966,143434,203400,MKT
06090303316170000,2021,64309,206791,271100,MKT
06090303316170000,2020,63030,136430,199460,COST
06090303316170000,2019,63030,136430,199460,COST
06090303316190000,2021,64309,207191,271500,MKT
06090303316190000,2020,63030,146330,209360,COST
06090303316190000,2019,63030,146330,209360,COST
06090303316210000,2021,64309,179891,244200,MKT
06090303316210000,2020,63030,92240,155270,COST
06090303316210000,2019,63030,92240,155270,COST
06090303316230000,2021,64309,169091,233400,MKT
06090303316230000,2020,63030,109600,172630,COST
06090303316230000,2019,63030,109600,172630,COST
06090303316250000,2021,59952,182048,242000,MKT
06090303316250000,2020,60033,171540,231573,COST
06090303316250000,2019,60033,171540,231573,COST
06090303316270000,2021,59952,211348,271300,MKT
06090303316270000,2020,60033,155050,215083,COST
06090303316270000,2019,60033,155050,215083,COST
06090303316290000,2021,59952,550,60502,COST
06090303316290000,2020,60033,540,60573,COST
06090303316290000,2019,60033,540,60573,COST
06090303316310000,2021,59952,550,60502,COST
06090303316310000,2020,60033,540,60573,COST
06090303316310000,2019,60033,540,60573,COST
06090303316330000,2021,59952,277548,337500,MKT
06090303316330000,2020,59966,215834,275800,MKT
06090303316330000,2019,59966,215834,275800,MKT
06090303316350000,2021,59952,233048,293000,MKT
06090303316350000,2020,59966,196234,256200,MKT
06090303316350000,2019,59966,196234,256200,MKT
06090303316370000,2021,64309,238791,303100,MKT
06090303316370000,2020,62960,193540,256500,MKT
06090303316370000,2019,62960,193540,256500,MKT
06090303316390000,2021,64309,242591,306900,MKT
06090303316390000,2020,62960,205940,268900,MKT
06090303316390000,2019,62960,205940,268900,MKT
06090303316410000,2021,64309,130791,195100,MKT
06090303316410000,2020,63030,61710,124740,COST
06090303316410000,2019,63030,61710,124740,COST
06090303316436500,2021,27299,0,27299,COST
06090303316436500,2020,24046,0,24046,COST
06090303316436500,2019,24046,0,24046,COST
06090303316450000,2021,66236,186164,252400,MKT
06090303316450000,2020,64335,125610,189945,COST
06090303316450000,2019,64335,125610,189945,COST
06090303316470000,2021,66236,235764,302000,MKT
06090303316470000,2020,64263,191237,255500,MKT
06090303316470000,2019,64263,191237,255500,MKT
06090303316496500,2021,24263,0,24263,COST
06090303316496500,2020,22155,0,22155,COST
06090303316496500,2019,22155,0,22155,COST
06090303316510000,2021,64309,244191,308500,MKT
06090303316510000,2020,62960,206940,269900,MKT
06090303316510000,2019,62960,206940,269900,MKT
06090303316530000,2021,64309,238891,303200,MKT
06090303316530000,2020,62960,192340,255300,MKT
06090303316530000,2019,62960,192340,255300,MKT
06090303316550000,2021,64309,249491,313800,MKT
06090303316550000,2020,62960,212940,275900,MKT
06090303316550000,2019,62960,212940,275900,MKT
06090303316570000,2021,59952,238948,298900,MKT
06090303316570000,2020,59966,194234,254200,MKT
06090303316570000,2019,59966,194234,254200,MKT
06090303316590000,2021,59952,236348,296300,MKT
06090303316590000,2020,59966,188634,248600,MKT
06090303316590000,2019,59966,188634,248600,MKT
06090303316610000,2021,59952,240248,300200,MKT
06090303316610000,2020,59966,195334,255300,MKT
06090303316610000,2019,59966,195334,255300,MKT
06090303316630000,2021,59952,236648,296600,MKT
06090303316630000,2020,59966,192234,252200,MKT
06090303316630000,2019,59966,192234,252200,MKT
06090303316650000,2021,59952,239148,299100,MKT
06090303316650000,2020,59966,192734,252700,MKT
06090303316650000,2019,59966,192734,252700,MKT
06090303316670000,2021,59952,250848,310800,MKT
06090303316670000,2020,59966,200834,260800,MKT
06090303316670000,2019,59966,200834,260800,MKT
06090303316690000,2021,64309,232191,296500,MKT
06090303316690000,2020,62960,187940,250900,MKT
06090303316690000,2019,62960,187940,250900,MKT
06090303316710000,2021,64309,259591,323900,MKT
06090303316710000,2020,62960,211840,274800,MKT
06090303316710000,2019,62960,211840,274800,MKT
06090303316730000,2021,64309,235191,299500,MKT
06090303316730000,2020,62960,190540,253500,MKT
06090303316730000,2019,62960,190540,253500,MKT
06090303316750000,2021,64309,249291,313600,MKT
06090303316750000,2020,62960,205740,268700,MKT
06090303316750000,2019,62960,205740,268700,MKT
06090303316770000,2021,59952,240848,300800,MKT
06090303316770000,2020,59966,194634,254600,MKT
06090303316770000,2019,59966,194634,254600,MKT
06090303316790000,2021,59952,242648,302600,MKT
06090303316790000,2020,59966,196234,256200,MKT
06090303316790000,2019,59966,196234,256200,MKT
06090303316810000,2021,59952,236348,296300,MKT
06090303316810000,2020,59966,188534,248500,MKT
06090303316810000,2019,59966,188534,248500,MKT
06090303316830000,2021,59952,236148,296100,MKT
06090303316830000,2020,59966,188234,248200,MKT
06090303316830000,2019,59966,188234,248200,MKT
06090303316850000,2021,59952,238448,298400,MKT
06090303316850000,2020,59966,188834,248800,MKT
06090303316850000,2019,59966,188834,248800,MKT
06090303316870000,2021,59952,250948,310900,MKT
06090303316870000,2020,59966,197834,257800,MKT
06090303316870000,2019,59966,197834,257800,MKT
06090303316890000,2021,82060,307940,390000,MKT
06090303316890000,2020,74571,259729,334300,MKT
06090303316890000,2019,74571,259729,334300,MKT
06090303317010000,2021,83260,242940,326200,MKT
06090303317010000,2020,75327,198373,273700,MKT
06090303317010000,2019,75327,198373,273700,MKT
06090303317030000,2021,93993,234007,328000,MKT
06090303317030000,2020,81943,195557,277500,MKT
06090303317030000,2019,81943,195557,277500,MKT
06090303317050000,2021,96855,270745,367600,MKT
06090303317050000,2020,83668,235432,319100,MKT
06090303317050000,2019,83668,235432,319100,MKT
06090303317070000,2021,81449,278251,359700,MKT
06090303317070000,2020,74185,239950,314135,COST
06090303317070000,2019,74185,239950,314135,COST
06090303317090000,2021,70464,230036,300500,MKT
06090303317090000,2020,67085,189515,256600,MKT
06090303317090000,2019,67085,189515,256600,MKT
06090303317110000,2021,64309,274391,338700,MKT
06090303317110000,2020,62960,229240,292200,MKT
06090303317110000,2019,62960,229240,292200,MKT
06090303317130000,2021,64309,242291,306600,MKT
06090303317130000,2020,62960,210540,273500,MKT
06090303317130000,2019,62960,206840,269800,MKT
06090303317150000,2021,64309,235591,299900,MKT
06090303317150000,2020,62960,187940,250900,MKT
06090303317150000,2019,62960,187940,250900,MKT
06090303317170000,2021,64309,241291,305600,MKT
06090303317170000,2020,62960,199740,262700,MKT
06090303317170000,2019,62960,199740,262700,MKT
06090303317190000,2021,64309,238091,302400,MKT
06090303317190000,2020,62960,189840,252800,MKT
06090303317190000,2019,62960,189840,252800,MKT
06090303317210000,2021,64309,245291,309600,MKT
06090303317210000,2020,62960,207640,270600,MKT
06090303317210000,2019,62960,207640,270600,MKT
06090303317230000,2021,64309,236891,301200,MKT
06090303317230000,2020,62960,188540,251500,MKT
06090303317230000,2019,62960,188540,251500,MKT
06090303317250000,2021,64309,252991,317300,MKT
06090303317250000,2020,62960,216440,279400,MKT
06090303317250000,2019,62960,216440,279400,MKT
06090303317270000,2021,64309,242691,307000,MKT
06090303317270000,2020,62960,193840,256800,MKT
06090303317270000,2019,62960,193840,256800,MKT
06090303317290000,2021,64309,244191,308500,MKT
06090303317290000,2020,62960,206940,269900,MKT
06090303317290000,2019,62960,206940,269900,MKT
06090303317310000,2021,64309,235191,299500,MKT
06090303317310000,2020,62960,187540,250500,MKT
06090303317310000,2019,62960,187540,250500,MKT
06090303317330000,2021,64309,245891,310200,MKT
06090303317330000,2020,62960,207940,270900,MKT
06090303317330000,2019,62960,207940,270900,MKT
06090303317350000,2021,64309,232191,296500,MKT
06090303317350000,2020,62960,187940,250900,MKT
06090303317350000,2019,62960,187940,250900,MKT
06090303317370000,2021,64309,244191,308500,MKT
06090303317370000,2020,62960,206940,269900,MKT
06090303317370000,2019,62960,206940,269900,MKT
06090303317390000,2021,64309,235191,299500,MKT
06090303317390000,2020,62960,187540,250500,MKT
06090303317390000,2019,62960,187540,250500,MKT
06090303317410000,2021,64309,245891,310200,MKT
06090303317410000,2020,62960,207940,270900,OVR
06090303317410000,2019,62960,207940,270900,MKT
06090303317430000,2021,64309,242691,307000,MKT
06090303317430000,2020,62960,193840,256800,MKT
06090303317430000,2019,62960,193840,256800,MKT
06090303317450000,2021,64309,249491,313800,MKT
06090303317450000,2020,62960,212940,275900,MKT
06090303317450000,2019,62960,212940,275900,MKT
06090303335015006,2021,59549,199351,258900,MKT
06090303335015006,2020,59686,180914,240600,MKT
06090303335015006,2019,59686,180914,240600,MKT
06090303335035005,2021,49254,197146,246400,MKT
06090303335035005,2020,52315,178685,231000,MKT
06090303335035005,2019,52315,178685,231000,MKT
06090303335055004,2021,48978,198622,247600,MKT
06090303335055004,2020,52112,180488,232600,MKT
06090303335055004,2019,52112,180488,232600,MKT
06090303335075003,2021,48978,197722,246700,MKT
06090303335075003,2020,52112,180288,232400,MKT
06090303335075003,2019,52112,180288,232400,MKT
06090303335095002,2021,48978,196122,245100,MKT
06090303335095002,2020,52112,178088,230200,MKT
06090303335095002,2019,52112,178088,230200,MKT
06090303335115001,2021,64666,199134,263800,MKT
06090303335115001,2020,63202,180598,243800,MKT
06090303335115001,2019,63202,180598,243800,MKT
06090303336015004,2021,60549,202451,263000,MKT
06090303336015004,2020,60380,185220,245600,MKT
06090303336015004,2019,60380,185220,245600,MKT
06090303336035003,2021,52882,198518,251400,MKT
06090303336035003,2020,54962,181638,236600,MKT
06090303336035003,2019,54962,181638,236600,MKT
06090303336055002,2021,52882,198518,251400,MKT
06090303336055002,2020,54962,185238,240200,MKT
06090303336055002,2019,54962,185238,240200,MKT
06090303336075001,2021,59141,200259,259400,MKT
06090303336075001,2020,59402,183298,242700,MKT
06090303336075001,2019,59402,183298,242700,MKT
06090303336095001,2021,59141,200859,260000,MKT
06090303336095001,2020,59402,183398,242800,MKT
06090303336095001,2019,59402,183398,242800,MKT
06090303336115002,2021,52882,199218,252100,MKT
06090303336115002,2020,54962,181738,236700,MKT
06090303336115002,2019,54962,181738,236700,MKT
06090303336135003,2021,52882,199218,252100,MKT
06090303336135003,2020,54962,181738,236700,MKT
06090303336135003,2019,54962,181738,236700,MKT
06090303336155004,2021,59141,202759,261900,MKT
06090303336155004,2020,59402,183898,243300,MKT
06090303336155004,2019,59402,183898,243300,MKT
06090303336175001,2021,59141,208759,267900,MKT
06090303336175001,2020,59402,186698,246100,MKT
06090303336175001,2019,59402,186698,246100,MKT
06090303336195002,2021,52882,197918,250800,MKT
06090303336195002,2020,54962,180738,235700,MKT
06090303336195002,2019,54962,180738,235700,MKT
06090303336215003,2021,52882,197918,250800,MKT
06090303336215003,2020,54962,180738,235700,MKT
06090303336215003,2019,54962,180738,235700,MKT
06090303336235004,2021,59141,201359,260500,MKT
06090303336235004,2020,59402,182998,242400,MKT
06090303336235004,2019,59402,182998,242400,MKT
06090303336255001,2021,59141,200159,259300,MKT
06090303336255001,2020,59402,182698,242100,MKT
06090303336255001,2019,59402,182698,242100,MKT
06090303336275002,2021,52882,198918,251800,MKT
06090303336275002,2020,54962,181538,236500,MKT
06090303336275002,2019,54962,181538,236500,MKT
06090303336295003,2021,52882,199018,251900,MKT
06090303336295003,2020,54962,181638,236600,MKT
06090303336295003,2019,54962,181038,236000,MKT
06090303336315004,2021,59141,200659,259800,MKT
06090303336315004,2020,59402,183298,242700,MKT
06090303336315004,2019,59402,183298,242700,MKT
06090303340010000,2021,62097,235803,297900,MKT
06090303340010000,2020,61448,196852,258300,MKT
06090303340010000,2019,61448,196852,258300,MKT
06090303340016500,2021,9673,0,9673,COST
06090303340016500,2020,11699,0,11699,COST
06090303340016500,2019,11699,0,11699,COST
06090303340030000,2021,62097,219003,281100,MKT
06090303340030000,2020,61448,183752,245200,MKT
06090303340030000,2019,61448,183752,245200,MKT
06090303340050000,2021,61907,235893,297800,MKT
06090303340050000,2020,61317,190983,252300,MKT
06090303340050000,2019,61317,190983,252300,MKT
06090303340070000,2021,61907,213893,275800,MKT
06090303340070000,2020,61317,175983,237300,MKT
06090303340070000,2019,61317,175983,237300,MKT
06090303340090000,2021,61907,204393,266300,MKT
06090303340090000,2020,61317,170683,232000,MKT
06090303340090000,2019,61317,170683,232000,MKT
06090303340110000,2021,61907,222493,284400,MKT
06090303340110000,2020,61317,182183,243500,MKT
06090303340110000,2019,61317,182183,243500,MKT
06090303340130000,2021,61907,271693,333600,MKT
06090303340130000,2020,61317,221983,283300,MKT
06090303340130000,2019,61317,221983,283300,MKT
06090303340150000,2021,61907,237293,299200,MKT
06090303340150000,2020,61317,206883,268200,MKT
06090303340150000,2019,61317,206883,268200,MKT
06090303340170000,2021,61907,252493,314400,MKT
06090303340170000,2020,61317,206583,267900,MKT
06090303340170000,2019,61317,206583,267900,MKT
06090303340190000,2021,61907,237393,299300,MKT
06090303340190000,2020,61317,200583,261900,MKT
06090303340190000,2019,61317,200583,261900,MKT
06090303340210000,2021,61907,276593,338500,MKT
06090303340210000,2020,61317,230683,292000,MKT
06090303340210000,2019,61317,213283,274600,MKT
06090303341010000,2021,58101,237599,295700,MKT
06090303341010000,2020,58675,197625,256300,MKT
06090303341010000,2019,58675,197625,256300,MKT
06090303341016500,2021,11614,0,11614,COST
06090303341016500,2020,13283,0,13283,COST
06090303341016500,2019,13283,0,13283,COST
06090303341030000,2021,58101,240999,299100,MKT
06090303341030000,2020,58675,194225,252900,MKT
06090303341030000,2019,58675,194225,252900,MKT
06090303341050000,2021,58101,242999,301100,MKT
06090303341050000,2020,58675,197425,256100,MKT
06090303341050000,2019,58675,197425,256100,MKT
06090303341070000,2021,58101,244999,303100,MKT
06090303341070000,2020,58675,215425,274100,MKT
06090303341070000,2019,58675,215425,274100,MKT
06090303341090000,2021,58101,264099,322200,MKT
06090303341090000,2020,58675,221325,280000,MKT
06090303341090000,2019,58675,221325,280000,MKT
06090303341110000,2021,58101,250799,308900,MKT
06090303341110000,2020,58675,202025,260700,MKT
06090303341110000,2019,58675,202025,260700,MKT
06090303341130000,2021,58101,243199,301300,MKT
06090303341130000,2020,58675,203725,262400,MKT
06090303341130000,2019,58675,203725,262400,MKT
06090303341150000,2021,58101,228099,286200,MKT
06090303341150000,2020,58675,184725,243400,MKT
06090303341150000,2019,58675,184725,243400,MKT
06090303341170000,2021,58101,234099,292200,MKT
06090303341170000,2020,58675,195825,254500,MKT
06090303341170000,2019,58675,195825,254500,MKT
06090303341190000,2021,58101,247999,306100,MKT
06090303341190000,2020,58675,203825,262500,MKT
06090303341190000,2019,58675,203825,262500,MKT
06090303341210000,2021,58101,283799,341900,MKT
06090303341210000,2020,58675,239525,298200,MKT
06090303341210000,2019,58675,239525,298200,MKT
06090303341230000,2021,58101,282399,340500,MKT
06090303341230000,2020,58675,232125,290800,MKT
06090303341230000,2019,58675,224725,283400,MKT
06090303341250000,2021,58101,266799,324900,MKT
06090303341250000,2020,58675,219025,277700,OVR
06090303341250000,2019,58675,219025,277700,MKT
06090303341270000,2021,58101,245799,303900,MKT
06090303341270000,2020,58675,197825,256500,MKT
06090303341270000,2019,58675,197825,256500,MKT
06090303341290000,2021,58101,272299,330400,MKT
06090303341290000,2020,58675,208425,267100,MKT
06090303341290000,2019,58675,208425,267100,MKT
06090303341310000,2021,58101,238199,296300,MKT
06090303341310000,2020,58675,194125,252800,MKT
06090303341310000,2019,58675,194125,252800,MKT
06090303341330000,2021,58101,239099,297200,MKT
06090303341330000,2020,58675,194625,253300,MKT
06090303341330000,2019,58675,194625,253300,MKT
06090303341350000,2021,58101,270199,328300,MKT
06090303341350000,2020,58675,221625,280300,MKT
06090303341350000,2019,58675,209425,268100,MKT
06090303341370000,2021,58101,216899,275000,MKT
06090303341370000,2020,58675,192125,250800,MKT
06090303341370000,2019,58675,192125,250800,MKT
06090303341390000,2021,58101,271499,329600,MKT
06090303341390000,2020,58675,227225,285900,MKT
06090303341390000,2019,58675,227225,285900,MKT
06090303341410000,2021,58101,281699,339800,MKT
06090303341410000,2020,58675,231725,290400,MKT
06090303341410000,2019,58675,231725,290400,MKT
06090303341430000,2021,58101,246199,304300,MKT
06090303341430000,2020,58675,204125,262800,MKT
06090303341430000,2019,58675,204125,262800,MKT
06090303360400000,2021,366432,0,366432,COST
06090303360400000,2020,210778,0,210778,COST
06090303360400000,2019,210778,0,210778,COST
06090303401020000,2021,358245,4690,362935,COST
06090303401020000,2020,210359,4490,214849,COST
06090303401020000,2019,210359,5350,215709,COST
06090303408016500,2021,15321,0,15321,COST
06090303408016500,2020,16100,0,16100,COST
06090303408016500,2019,16100,0,16100,COST
06090303408020000,2021,72877,240623,313500,MKT
06090303408020000,2020,68672,201628,270300,MKT
06090303408020000,2019,68672,201628,270300,MKT
06090303408040000,2021,72877,216123,289000,MKT
06090303408040000,2020,68672,195128,263800,MKT
06090303408040000,2019,68672,195128,263800,MKT
06090303408060000,2021,72730,240170,312900,MKT
06090303408060000,2020,68576,212024,280600,MKT
06090303408060000,2019,68576,212024,280600,MKT
06090303408080000,2021,72730,240570,313300,MKT
06090303408080000,2020,68576,195924,264500,MKT
06090303408080000,2019,68576,194724,263300,MKT
06090303408100000,2021,72730,277670,350400,MKT
06090303408100000,2020,68576,273624,342200,MKT
06090303408100000,2019,68576,276524,345100,MKT
06090303408120000,2021,72582,279718,352300,MKT
06090303408120000,2020,68479,225721,294200,MKT
06090303408120000,2019,68479,225721,294200,MKT
06090303408140000,2021,72582,208118,280700,MKT
06090303408140000,2020,68479,184621,253100,MKT
06090303408140000,2019,68479,182921,251400,MKT
06090303408160000,2021,72434,287166,359600,MKT
06090303408160000,2020,68382,244518,312900,MKT
06090303408160000,2019,68382,244518,312900,MKT
06090303408180000,2021,74606,262994,337600,MKT
06090303408180000,2020,69799,258501,328300,OVR
06090303408180000,2019,69799,258501,328300,MKT
06090303410010000,2021,607174,7207200,7814374,COST
06090303410010000,2020,858309,6900150,7758459,COST
06090303410010000,2019,858309,6900150,7758459,COST
06090303410606500,2021,65854,0,65854,COST
06090303410606500,2020,44319,0,44319,COST
06090303410606500,2019,44319,0,44319,COST
06090303410620000,2021,75168,233432,308600,MKT
06090303410620000,2020,102261,142280,244541,COST
06090303410620000,2019,102261,142280,244541,COST
06090303410640000,2021,75168,208232,283400,MKT
06090303410640000,2020,102261,145660,247921,COST
06090303410640000,2019,102261,145660,247921,COST
06090303410660000,2021,75168,251732,326900,MKT
06090303410660000,2020,70242,212220,282462,COST
06090303410660000,2019,70242,212220,282462,COST
06090303410680000,2021,75168,179532,254700,MKT
06090303410680000,2020,70242,127770,198012,COST
06090303410680000,2019,70242,127770,198012,COST
06090303410700000,2021,73461,205939,279400,MKT
06090303410700000,2020,69130,163120,232250,COST
06090303410700000,2019,69130,163120,232250,COST
06090303410720000,2021,70464,209336,279800,MKT
06090303410720000,2020,67160,156850,224010,COST
06090303410720000,2019,67160,156850,224010,COST
06090303410740000,2021,88779,248821,337600,MKT
06090303410740000,2020,78847,186300,265147,OVR
06090303410740000,2019,78847,186300,265147,OVR
06090303410760000,2021,93895,172305,266200,MKT
06090303410760000,2020,81975,154750,236725,COST
06090303410760000,2019,81975,154750,236725,COST
06090303410780000,2021,75308,198092,273400,MKT
06090303410780000,2020,70333,157620,227953,COST
06090303410780000,2019,70333,157620,227953,COST
06090303410800000,2021,74037,214663,288700,MKT
06090303410800000,2020,69506,180830,250336,COST
06090303410800000,2019,69506,180830,250336,COST
06090303410820000,2021,89944,261556,351500,MKT
06090303410820000,2020,79564,225080,304644,COST
06090303410820000,2019,79564,225080,304644,COST
06090303410840000,2021,88132,213768,301900,MKT
06090303410840000,2020,78361,206439,284800,MKT
06090303410840000,2019,78361,206439,284800,MKT
06090303410860000,2021,70464,182036,252500,MKT
06090303410860000,2020,67160,152090,219250,COST
06090303410860000,2019,67160,152090,219250,COST
06090303410880000,2021,73461,202239,275700,MKT
06090303410880000,2020,69130,166280,235410,COST
06090303410880000,2019,69130,163880,233010,COST
06090303412010000,2021,75168,223532,298700,MKT
06090303412010000,2020,70242,169010,239252,COST
06090303412010000,2019,70242,169010,239252,COST
06090303412030000,2021,75168,261732,336900,MKT
06090303412030000,2020,70242,198030,268272,COST
06090303412030000,2019,70242,198030,268272,COST
06090303412050000,2021,78016,207684,285700,MKT
06090303412050000,2020,72080,160800,232880,COST
06090303412050000,2019,72080,160800,232880,COST
06090303412070000,2021,78016,214284,292300,MKT
06090303412070000,2020,72080,156740,228820,COST
06090303412070000,2019,72080,156740,228820,COST
06090303414010000,2021,72434,191266,263700,MKT
06090303414010000,2020,68458,181300,249758,COST
06090303414010000,2019,68458,181300,249758,COST
06090303414030000,2021,71687,203213,274900,MKT
06090303414030000,2020,67967,189110,257077,COST
06090303414030000,2019,67967,189110,257077,COST
06090303414050000,2021,71687,217113,288800,MKT
06090303414050000,2020,67891,196309,264200,MKT
06090303414050000,2019,67891,196309,264200,MKT
06090303414070000,2021,71687,218913,290600,MKT
06090303414070000,2020,67967,166970,234937,COST
06090303414070000,2019,67967,166970,234937,COST
06090303414090000,2021,71687,195013,266700,MKT
06090303414090000,2020,67967,163490,231457,COST
06090303414090000,2019,67967,163490,231457,COST
06090303414110000,2021,72434,216166,288600,MKT
06090303414110000,2020,68458,186130,254588,COST
06090303414110000,2019,68458,186130,254588,COST
06090303414130000,2021,87697,224603,312300,MKT
06090303414130000,2020,78179,180310,258489,COST
06090303414130000,2019,78179,180310,258489,COST
06090303414150000,2021,77884,213516,291400,MKT
06090303414150000,2020,71995,165550,237545,COST
06090303414150000,2019,71995,165550,237545,COST
06090303414170000,2021,77884,200816,278700,MKT
06090303414170000,2020,71995,163360,235355,COST
06090303414170000,2019,71995,163360,235355,COST
06090303414190000,2021,87697,210503,298200,MKT
06090303414190000,2020,78179,154130,232309,COST
06090303414190000,2019,78179,154130,232309,COST
06090303416010000,2021,73461,203539,277000,MKT
06090303416010000,2020,69130,165550,234680,COST
06090303416010000,2019,69130,165550,234680,COST
06090303416030000,2021,75028,203472,278500,MKT
06090303416030000,2020,70151,168880,239031,COST
06090303416030000,2019,70151,168820,238971,COST
06090303416050000,2021,83615,207485,291100,MKT
06090303416050000,2020,75634,163110,238744,COST
06090303416050000,2019,75634,163110,238744,COST
06090303416070000,2021,83850,229750,313600,MKT
06090303416070000,2020,75781,187580,263361,COST
06090303416070000,2019,75781,187580,263361,COST
06090303416090000,2021,79315,218485,297800,MKT
06090303416090000,2020,72911,155280,228191,COST
06090303416090000,2019,72911,155280,228191,COST
06090303416106500,2021,46223,0,46223,COST
06090303416106500,2020,34661,0,34661,COST
06090303416106500,2019,34661,0,34661,COST
06090303416110000,2021,71232,195668,266900,MKT
06090303416110000,2020,67668,147060,214728,COST
06090303416110000,2019,67668,147060,214728,COST
06090303416130000,2021,70309,201991,272300,MKT
06090303416130000,2020,67057,150040,217097,COST
06090303416130000,2019,67057,163600,230657,COST
06090303416150000,2021,70309,211191,281500,MKT
06090303416150000,2020,67057,179200,246257,COST
06090303416150000,2019,67057,179200,246257,COST
06090303416170000,2021,76409,230691,307100,MKT
06090303416170000,2020,71046,168500,239546,COST
06090303416170000,2019,71046,168500,239546,COST
06090303416190000,2021,84550,196050,280600,MKT
06090303416190000,2020,76219,147220,223439,COST
06090303416190000,2019,76219,147220,223439,COST
06090303416210000,2021,85011,221989,307000,MKT
06090303416210000,2020,76508,196980,273488,COST
06090303416210000,2019,76508,196980,273488,COST
06090303416230000,2021,83967,206533,290500,MKT
06090303416230000,2020,75855,187450,263305,COST
06090303416230000,2019,75855,187450,263305,COST
06090303416250000,2021,74037,198863,272900,MKT
06090303416250000,2020,69506,152000,221506,COST
06090303416250000,2019,69506,152000,221506,COST
06090303416270000,2021,74037,356790,430827,COST
06090303416270000,2020,69506,227320,296826,COST
06090303416270000,2019,69506,227320,296826,COST
06090303416290000,2021,74037,211663,285700,MKT
06090303416290000,2020,69506,170030,239536,COST
06090303416290000,2019,69506,167630,237136,COST
06090303416310000,2021,74037,187063,261100,MKT
06090303416310000,2020,69506,151510,221016,COST
06090303416310000,2019,69506,151510,221016,COST
06090303416330000,2021,74037,193663,267700,MKT
06090303416330000,2020,69506,130800,200306,COST
06090303416330000,2019,69506,130800,200306,COST
06090303416350000,2021,74037,217063,291100,MKT
06090303416350000,2020,69506,179790,249296,COST
06090303416350000,2019,69506,179790,249296,COST
06090303416370000,2021,74037,221363,295400,MKT
06090303416370000,2020,69506,187250,256756,COST
06090303416370000,2019,69506,187250,256756,COST
06090303417270000,2021,83850,239950,323800,MKT
06090303417270000,2020,75697,209503,285200,MKT
06090303417270000,2019,75697,209503,285200,MKT
06090303417300000,2021,75168,258532,333700,MKT
06090303417300000,2020,70164,211536,281700,MKT
06090303417300000,2019,70164,201436,271600,MKT
06090303417310000,2021,64309,258291,322600,MKT
06090303417310000,2020,62960,203640,266600,MKT
06090303417310000,2019,62960,203640,266600,MKT
06090303417320000,2021,64309,242791,307100,MKT
06090303417320000,2020,62960,190040,253000,MKT
06090303417320000,2019,62960,190040,253000,MKT
06090303417330000,2021,64309,275091,339400,MKT
06090303417330000,2020,62960,219340,282300,MKT
06090303417330000,2019,62960,219240,282200,MKT
06090303417340000,2021,64309,221091,285400,MKT
06090303417340000,2020,62960,184340,247300,MKT
06090303417340000,2019,62960,184340,247300,MKT
06090303417350000,2021,64309,223691,288000,MKT
06090303417350000,2020,62960,186940,249900,MKT
06090303417350000,2019,62960,186940,249900,MKT
06090303417360000,2021,64309,221591,285900,MKT
06090303417360000,2020,62960,187740,250700,MKT
06090303417360000,2019,62960,187740,250700,MKT
06090303417370000,2021,64309,190991,255300,MKT
06090303417370000,2020,62960,159440,222400,MKT
06090303417370000,2019,62960,159440,222400,MKT
06090303417380000,2021,74464,257436,331900,MKT
06090303417380000,2020,69707,210593,280300,MKT
06090303417380000,2019,69707,210593,280300,MKT
06090303417410000,2021,75168,192832,268000,MKT
06090303417410000,2020,70164,164236,234400,MKT
06090303417410000,2019,70164,164236,234400,MKT
06090303417420000,2021,65892,250208,316100,MKT
06090303417420000,2020,64032,204968,269000,MKT
06090303417420000,2019,64032,204968,269000,MKT
06090303417430000,2021,65892,231808,297700,MKT
06090303417430000,2020,64032,196868,260900,MKT
06090303417430000,2019,64032,196868,260900,MKT
06090303417440000,2021,65892,224508,290400,MKT
06090303417440000,2020,64032,187168,251200,OVR
06090303417440000,2019,64032,187168,251200,OVR
06090303417450000,2021,67416,220484,287900,MKT
06090303417450000,2020,65057,185743,250800,MKT
06090303417450000,2019,65057,185743,250800,MKT
06090303417460000,2021,75168,240232,315400,MKT
06090303417460000,2020,70164,187236,257400,MKT
06090303417460000,2019,70164,187236,257400,MKT
06090303417490000,2021,72582,227818,300400,MKT
06090303417490000,2020,68555,174090,242645,COST
06090303417490000,2019,68555,174090,242645,COST
06090303417500000,2021,64130,181470,245600,MKT
06090303417500000,2020,62908,115050,177958,COST
06090303417500000,2019,62908,115050,177958,COST
06090303417510000,2021,64130,211470,275600,MKT
06090303417510000,2020,62908,158960,221868,COST
06090303417510000,2019,62908,158960,221868,COST
06090303417520000,2021,64130,189570,253700,MKT
06090303417520000,2020,62908,144450,207358,COST
06090303417520000,2019,62908,144450,207358,COST
06090303417530000,2021,64130,173770,237900,MKT
06090303417530000,2020,62908,123730,186638,COST
06090303417530000,2019,62908,123730,186638,COST
06090303417540000,2021,64130,960,65090,COST
06090303417540000,2020,62908,990,63898,COST
06090303417540000,2019,62908,990,63898,COST
06090303417550000,2021,64130,188370,252500,MKT
06090303417550000,2020,62908,127110,190018,COST
06090303417550000,2019,62908,127110,190018,COST
06090303417560000,2021,69997,187803,257800,MKT
06090303417560000,2020,66851,130000,196851,COST
06090303417560000,2019,66851,130000,196851,COST
06090303417570000,2021,64309,198091,262400,MKT
06090303417570000,2020,63030,136300,199330,COST
06090303417570000,2019,63030,136300,199330,COST
06090303417586500,2021,19274,0,19274,COST
06090303417586500,2020,18882,0,18882,COST
06090303417586500,2019,18882,0,18882,COST
06090303417590000,2021,64130,490,64620,COST
06090303417590000,2020,62908,480,63388,COST
06090303417590000,2019,62908,480,63388,COST
06090303417600000,2021,64130,174670,238800,MKT
06090303417600000,2020,62908,131310,194218,COST
06090303417600000,2019,62908,131310,194218,COST
06090303417610000,2021,64130,196570,260700,MKT
06090303417610000,2020,62908,136580,199488,COST
06090303417610000,2019,62908,136580,199488,COST
06090303417620000,2021,64130,135070,199200,MKT
06090303417620000,2020,62908,46800,109708,COST
06090303417620000,2019,62908,46260,109168,COST
06090303417630000,2021,64130,490,64620,COST
06090303417630000,2020,62908,480,63388,COST
06090303417630000,2019,62908,480,63388,COST
06090303417640000,2021,64130,148470,212600,MKT
06090303417640000,2020,62908,79200,142108,COST
06090303417640000,2019,62908,79200,142108,COST
06090303417650000,2021,64130,149570,213700,MKT
06090303417650000,2020,62908,81410,144318,COST
06090303417650000,2019,62908,81410,144318,COST
06090303417660000,2021,64130,158970,223100,MKT
06090303417660000,2020,62908,121690,184598,COST
06090303417660000,2019,62908,121690,184598,COST
06090303417670000,2021,64130,199470,263600,MKT
06090303417670000,2020,62908,134230,197138,COST
06090303417670000,2019,62908,134230,197138,COST
06090303417680000,2021,64130,141970,206100,MKT
06090303417680000,2020,62908,81690,144598,COST
06090303417680000,2019,62908,81690,144598,COST
06090303417690000,2021,64130,140070,204200,MKT
06090303417690000,2020,62908,59020,121928,OVR
06090303417690000,2019,62908,59020,121928,COST
06090303417700000,2021,64130,208070,272200,MKT
06090303417700000,2020,62908,151360,214268,COST
06090303417700000,2019,62908,151360,214268,COST
06090303418010000,2021,66236,203764,270000,MKT
06090303418010000,2020,64335,181300,245635,COST
06090303418010000,2019,64335,181300,245635,COST
06090303418030000,2021,64130,490,64620,COST
06090303418030000,2020,62908,480,63388,COST
06090303418030000,2019,62908,480,63388,COST
06090303418050000,2021,66695,161505,228200,MKT
06090303418050000,2020,62908,93390,156298,COST
06090303418050000,2019,62908,93390,156298,COST
06090303418070000,2021,66695,155405,222100,MKT
06090303418070000,2020,67959,85680,153639,COST
06090303418070000,2019,67959,85680,153639,COST
06090303418090000,2021,64130,0,64130,COST
06090303418090000,2020,62838,0,62838,COST
06090303418090000,2019,62838,0,62838,COST
06090303418110000,2021,64130,0,64130,COST
06090303418110000,2020,62838,0,62838,COST
06090303418110000,2019,62838,0,62838,COST
06090303418130000,2021,66695,144105,210800,MKT
06090303418130000,2020,67959,480,68439,COST
06090303418130000,2019,67959,480,68439,COST
06090303418150000,2021,66695,167605,234300,MKT
06090303418150000,2020,67959,152240,220199,COST
06090303418150000,2019,67959,152240,220199,COST
06090303418170000,2021,66695,217905,284600,MKT
06090303418170000,2020,67959,186090,254049,COST
06090303418170000,2019,67959,186090,254049,COST
06090303418190000,2021,66695,148505,215200,MKT
06090303418190000,2020,67959,80590,148549,COST
06090303418190000,2019,67959,80590,148549,COST
06090303418210000,2021,66695,201905,268600,MKT
06090303418210000,2020,67959,144560,212519,COST
06090303418210000,2019,67959,144560,212519,COST
06090303418230000,2021,66695,186905,253600,MKT
06090303418230000,2020,67959,170340,238299,COST
06090303418230000,2019,67959,170340,238299,COST
06090303418250000,2021,66695,169305,236000,MKT
06090303418250000,2020,67959,91630,159589,COST
06090303418250000,2019,67959,91630,159589,COST
06090303418270000,2021,66695,178905,245600,MKT
06090303418270000,2020,67959,125510,193469,COST
06090303418270000,2019,67959,125510,193469,COST
06090303418290000,2021,64130,0,64130,COST
06090303418290000,2020,62838,0,62838,COST
06090303418290000,2019,62838,0,62838,COST
06090303418310000,2021,64130,0,64130,COST
06090303418310000,2020,62838,0,62838,COST
06090303418310000,2019,62838,0,62838,COST
06090303418330000,2021,66695,185405,252100,MKT
06090303418330000,2020,67959,113080,181039,COST
06090303418330000,2019,67959,113080,181039,COST
06090303418350000,2021,66695,240205,306900,MKT
06090303418350000,2020,67517,207683,275200,MKT
06090303418350000,2019,67517,207683,275200,MKT
06090303418370000,2021,64130,490,64620,COST
06090303418370000,2020,62908,480,63388,COST
06090303418370000,2019,62908,480,63388,COST
06090303418390000,2021,66236,141464,207700,MKT
06090303418390000,2020,64335,87490,151825,COST
06090303418390000,2019,64335,87490,151825,COST
06090303418416500,2021,54388,0,54388,COST
06090303418416500,2020,38806,0,38806,COST
06090303418416500,2019,38806,0,38806,COST
06090303418840000,2021,76097,134803,210900,MKT
06090303418840000,2020,74476,80130,154606,COST
06090303418840000,2019,74476,78230,152706,COST
06090303418860000,2021,76097,225103,301200,MKT
06090303418860000,2020,74476,182940,257416,COST
06090303418860000,2019,74476,182940,257416,COST
06090303418900000,2021,76097,212403,288500,MKT
06090303418900000,2020,74476,125440,199916,COST
06090303418900000,2019,74476,125440,199916,COST
06090303418920000,2021,76097,183103,259200,MKT
06090303418920000,2020,74476,112600,187076,COST
06090303418920000,2019,74476,112600,187076,COST
06090303419010000,2021,66236,244564,310800,MKT
06090303419010000,2020,64263,196337,260600,MKT
06090303419010000,2019,64263,196337,260600,MKT
06090303419030000,2021,64130,237970,302100,MKT
06090303419030000,2020,62838,195962,258800,MKT
06090303419030000,2019,62838,195962,258800,MKT
06090303419050000,2021,64130,258770,322900,MKT
06090303419050000,2020,62838,219962,282800,MKT
06090303419050000,2019,62838,219962,282800,MKT
06090303419070000,2021,64130,248070,312200,MKT
06090303419070000,2020,62838,202362,265200,MKT
06090303419070000,2019,62838,202362,265200,MKT
06090303419090000,2021,64130,219370,283500,MKT
06090303419090000,2020,62838,192962,255800,MKT
06090303419090000,2019,62838,192962,255800,MKT
06090303419110000,2021,64130,273270,337400,MKT
06090303419110000,2020,62838,225062,287900,MKT
06090303419110000,2019,62838,216562,279400,MKT
06090303419130000,2021,64130,227570,291700,MKT
06090303419130000,2020,62838,189862,252700,MKT
06090303419130000,2019,62838,189862,252700,MKT
06090303419150000,2021,64130,267370,331500,MKT
06090303419150000,2020,62838,215162,278000,MKT
06090303419150000,2019,62838,215162,278000,MKT
06090303419170000,2021,64130,276970,341100,MKT
06090303419170000,2020,62838,233562,296400,MKT
06090303419170000,2019,62838,233562,296400,MKT
06090303419190000,2021,64130,268070,332200,MKT
06090303419190000,2020,62838,228462,291300,MKT
06090303419190000,2019,62838,228462,291300,MKT
06090303419210000,2021,64130,279270,343400,MKT
06090303419210000,2020,62838,227062,289900,MKT
06090303419210000,2019,62838,227062,289900,MKT
06090303419230000,2021,64130,234470,298600,MKT
06090303419230000,2020,62838,185162,248000,MKT
06090303419230000,2019,62838,185162,248000,MKT
06090303419250000,2021,64130,235970,300100,MKT
06090303419250000,2020,62838,191062,253900,MKT
06090303419250000,2019,62838,191062,253900,MKT
06090303419270000,2021,64130,249870,314000,MKT
06090303419270000,2020,62838,202962,265800,MKT
06090303419270000,2019,62838,202962,265800,MKT
06090303419290000,2021,64130,234070,298200,MKT
06090303419290000,2020,62838,190562,253400,MKT
06090303419290000,2019,62838,190562,253400,MKT
06090303419310000,2021,64130,233770,297900,MKT
06090303419310000,2020,62838,187462,250300,MKT
06090303419310000,2019,62838,187462,250300,MKT
06090303419330000,2021,64130,236070,300200,MKT
06090303419330000,2020,62838,191162,254000,MKT
06090303419330000,2019,62838,191162,254000,MKT
06090303419350000,2021,64130,252470,316600,MKT
06090303419350000,2020,62838,220662,283500,MKT
06090303419350000,2019,62838,220662,283500,MKT
06090303419396500,2021,24954,0,24954,COST
06090303419396500,2020,22591,0,22591,COST
06090303419396500,2019,22591,0,22591,COST
06090303420010000,2021,74464,242236,316700,MKT
06090303420010000,2020,69707,198393,268100,MKT
06090303420010000,2019,69707,198393,268100,MKT
06090303420030000,2021,70309,267191,337500,MKT
06090303420030000,2020,66983,224117,291100,MKT
06090303420030000,2019,66983,224117,291100,MKT
06090303420050000,2021,70309,288991,359300,MKT
06090303420050000,2020,66983,233417,300400,OVR
06090303420050000,2019,66983,233417,300400,MKT
06090303420070000,2021,70309,200691,271000,MKT
06090303420070000,2020,66983,184817,251800,MKT
06090303420070000,2019,66983,184817,251800,MKT
06090303420090000,2021,70309,209691,280000,MKT
06090303420090000,2020,66983,186717,253700,MKT
06090303420090000,2019,66983,187317,254300,MKT
06090303420110000,2021,70309,222291,292600,MKT
06090303420110000,2020,66983,187317,254300,MKT
06090303420110000,2019,66983,187317,254300,MKT
06090303420130000,2021,70309,256191,326500,MKT
06090303420130000,2020,66983,225217,292200,MKT
06090303420130000,2019,66983,225217,292200,MKT
06090303420150000,2021,74747,284553,359300,MKT
06090303420150000,2020,69891,228509,298400,MKT
06090303420150000,2019,69891,228509,298400,MKT
06090303420170000,2021,74180,224720,298900,MKT
06090303420170000,2020,69522,208878,278400,MKT
06090303420170000,2019,69522,208878,278400,MKT
06090303420190000,2021,71232,270668,341900,MKT
06090303420190000,2020,67592,217408,285000,MKT
06090303420190000,2019,67592,217408,285000,MKT
06090303420210000,2021,71232,249868,321100,MKT
06090303420210000,2020,67592,218608,286200,MKT
06090303420210000,2019,67592,218608,286200,MKT
06090303420230000,2021,71232,260868,332100,MKT
06090303420230000,2020,67592,212908,280500,MKT
06090303420230000,2019,67592,212908,280500,MKT
06090303420250000,2021,71232,291368,362600,MKT
06090303420250000,2020,67592,235108,302700,MKT
06090303420250000,2019,67592,235108,302700,MKT
