id,year,land,building,total,method
06069803303050000,2021,425074,544910,969984,COST
06069803303050000,2020,309850,469780,779630,COST
06069803303050000,2019,309850,406030,715880,COST
06069803303100000,2021,376201,236760,612961,COST
06069803303100000,2020,269152,229220,498372,COST
06069803303100000,2019,269152,229220,498372,COST
06069803303150000,2021,372759,358280,731039,COST
06069803303150000,2020,266314,343386,609700,MKT
06069803303150000,2019,266314,343386,609700,MKT
06069803303200000,2021,367350,289780,657130,COST
06069803303200000,2020,261865,299835,561700,MKT
06069803303200000,2019,261865,299835,561700,MKT
06069803303420000,2021,605236,413590,1018826,COST
06069803303420000,2020,465661,395630,861291,COST
06069803303420000,2019,465661,395630,861291,COST
06069803303450000,2021,605257,237840,843097,COST
06069803303450000,2020,465680,230660,696340,COST
06069803303450000,2019,465680,161140,626820,COST
06069803304010000,2021,608386,5970,614356,COST
06069803304010000,2020,468456,6110,474566,COST
06069803304010000,2019,468456,6110,474566,COST
06069803304050000,2021,443120,30120,473240,COST
06069803304050000,2020,325063,23770,348833,COST
06069803304050000,2019,325063,23770,348833,COST
06069803304150000,2021,634216,440760,1074976,COST
06069803304150000,2020,491459,422700,914159,COST
06069803304150000,2019,491459,422700,914159,COST
06069803304200000,2021,507481,235170,742651,COST
06069803304200000,2020,380075,258334,638409,MRA
06069803304200000,2019,380075,258334,638409,MRA
06069803304220000,2021,361002,304698,665700,MKT
06069803304220000,2020,288199,248701,536900,MKT
06069803304220000,2019,288199,248701,536900,MKT
06069803304250000,2021,577949,478320,1056269,COST
06069803304250000,2020,441542,474760,916302,COST
06069803304250000,2019,441542,474760,916302,COST
06069803304300000,2021,602703,689460,1292163,COST
06069803304300000,2020,463414,657090,1120504,COST
06069803304300000,2019,463414,657090,1120504,COST
06069803305010000,2021,380992,521300,902292,COST
06069803305010000,2020,306674,502810,809484,COST
06069803305010000,2019,306674,502810,809484,COST
06069803305100000,2021,365278,247322,612600,MKT
06069803305100000,2020,292138,278162,570300,MKT
06069803305100000,2019,292138,278162,570300,MKT
06069803305160000,2021,280523,0,280523,COST
06069803305160000,2020,215480,0,215480,COST
06069803305160000,2019,215480,0,215480,COST
06069803305200000,2021,391025,334980,726005,COST
06069803305200000,2020,316003,301197,617200,MKT
06069803305200000,2019,316003,301197,617200,MKT
06069803401010000,2021,458607,296340,754947,COST
06069803401010000,2020,379762,288420,668182,COST
06069803401010000,2019,379762,288420,668182,COST
06069803401050000,2021,387972,233780,621752,COST
06069803401050000,2020,313160,222640,535800,MKT
06069803401050000,2019,313160,222640,535800,MKT
06069803401100000,2021,502916,379760,882676,COST
06069803401100000,2020,422366,371560,793926,COST
06069803401100000,2019,422366,371560,793926,COST
06069803401150000,2021,1107,0,1107,COST
06069803401150000,2020,1030,0,1030,COST
06069803401150000,2019,1030,0,1030,COST
06069803401200000,2021,495955,260180,756135,COST
06069803401200000,2020,415633,253130,668763,COST
06069803401200000,2019,415633,253130,668763,COST
06069803401300000,2021,496305,461890,958195,COST
06069803401300000,2020,415972,443590,859562,COST
06069803401300000,2019,415972,443590,859562,COST
06069803401400000,2021,557161,216270,773431,COST
06069803401400000,2020,475307,210220,685527,COST
06069803401400000,2019,475307,210220,685527,COST
06069803401450000,2021,387999,300790,688789,COST
06069803401450000,2020,313185,292280,605465,COST
06069803401450000,2019,313185,292280,605465,COST
06069803402010000,2021,311957,264843,576800,MKT
06069803402010000,2020,243547,230153,473700,MKT
06069803402010000,2019,243547,230153,473700,MKT
06069803402020000,2021,335777,295110,630887,COST
06069803402020000,2020,265109,285280,550389,COST
06069803402020000,2019,265109,285280,550389,COST
06069803402030000,2021,344539,0,344539,COST
06069803402030000,2020,273101,0,273101,COST
06069803402030000,2019,273101,0,273101,COST
06069803402040000,2021,310849,205551,516400,MKT
06069803402040000,2020,242550,220150,462700,MKT
06069803402040000,2019,242550,220150,462700,MKT
06069803402050000,2021,281365,978780,1260145,COST
06069803402050000,2020,216225,960020,1176245,COST
06069803402050000,2019,216225,960020,1176245,COST
06069803402060000,2021,280623,262077,542700,MKT
06069803402060000,2020,215568,228332,443900,MKT
06069803402060000,2019,215568,228332,443900,MKT
06069803402070000,2021,332458,313942,646400,MKT
06069803402070000,2020,262090,246910,509000,MKT
06069803402070000,2019,262090,246910,509000,MKT
06069803402080000,2021,326650,489150,815800,MKT
06069803402080000,2020,256819,0,256819,COST
06069803402080000,2019,256819,0,256819,COST
06069803402096500,2021,117307,0,117307,COST
06069803402096500,2020,94679,0,94679,COST
06069803402096500,2019,94679,0,94679,COST
06069803403010000,2021,269990,247810,517800,MKT
06069803403010000,2020,206179,231421,437600,MKT
06069803403010000,2019,206179,231421,437600,MKT
06069803403020000,2021,271104,396400,667504,COST
06069803403020000,2020,207160,379710,586870,COST
06069803403020000,2019,207160,379710,586870,COST
06069803403030000,2021,260080,212920,473000,MKT
06069803403030000,2020,197479,206121,403600,MKT
06069803403030000,2019,197479,206121,403600,MKT
06069803403040000,2021,257376,435724,693100,MKT
06069803403040000,2020,195113,402887,598000,MKT
06069803403040000,2019,195113,402887,598000,MKT
06069803403056500,2021,66639,0,66639,COST
06069803403056500,2020,49330,0,49330,COST
06069803403056500,2019,49330,0,49330,COST
06069803403060000,2021,288835,202665,491500,MKT
06069803403060000,2020,222856,212744,435600,MKT
06069803403060000,2019,222856,212744,435600,MKT
06069803403070000,2021,290845,0,290845,COST
06069803403070000,2020,224646,0,224646,COST
06069803403070000,2019,224646,0,224646,COST
06069803404010000,2021,350284,359030,709314,COST
06069803404010000,2020,278357,348450,626807,COST
06069803404010000,2019,278357,348450,626807,COST
06069803404020000,2021,255269,381331,636600,MKT
06069803404020000,2020,193273,408727,602000,MKT
06069803404020000,2019,193273,408727,602000,MKT
06069803404030000,2021,308236,319664,627900,MKT
06069803404030000,2020,240201,282699,522900,MKT
06069803404030000,2019,240201,282699,522900,MKT
06069803404040000,2021,336953,369847,706800,MKT
06069803404040000,2020,266179,319921,586100,MKT
06069803404040000,2019,266179,319921,586100,MKT
06069803404056500,2021,105630,0,105630,COST
06069803404056500,2020,83898,0,83898,COST
06069803404056500,2019,83898,0,83898,COST
06069803404060000,2021,267845,375455,643300,MKT
06069803404060000,2020,204292,403808,608100,MKT
06069803404060000,2019,204292,403808,608100,MKT
06069803404070000,2021,280920,228980,509900,MKT
06069803404070000,2020,215831,213369,429200,MKT
06069803404070000,2019,215831,213369,429200,MKT
06069803404080000,2021,294248,442952,737200,MKT
06069803404080000,2020,227678,414722,642400,MKT
06069803404080000,2019,227678,414722,642400,MKT
06069803404090000,2021,270575,327125,597700,MKT
06069803404090000,2020,206694,280906,487600,MKT
06069803404090000,2019,206694,280906,487600,MKT
06069803404100000,2021,307692,448108,755800,MKT
06069803404100000,2020,239712,432088,671800,MKT
06069803404100000,2019,239712,432088,671800,MKT
06069803405010000,2021,282937,495400,778337,COST
06069803405010000,2020,217618,484130,701748,COST
06069803405010000,2019,217618,484130,701748,COST
06069803405020000,2021,326010,221290,547300,MKT
06069803405020000,2020,256239,207561,463800,MKT
06069803405020000,2019,256239,207561,463800,MKT
06069803405030000,2021,338615,306685,645300,MKT
06069803405030000,2020,267693,260507,528200,MKT
06069803405030000,2019,267693,260507,528200,MKT
06069804101010000,2021,264990,354940,619930,COST
06069804101010000,2020,241240,310970,552210,COST
06069804101010000,2019,241240,310970,552210,COST
06069804101020000,2021,142675,278925,421600,MKT
06069804101020000,2020,143700,202480,346180,COST
06069804101020000,2019,143700,202480,346180,COST
06069804101030000,2021,163827,559000,722827,COST
06069804101030000,2020,144730,837480,982210,COST
06069804101030000,2019,144730,837480,982210,COST
06069804101200000,2021,164325,651070,815395,COST
06069804101200000,2020,145194,533940,679134,COST
06069804101200000,2019,1545,0,1545,COST
06069804101300000,2021,163772,943120,1106892,COST
06069804101300000,2020,217966,787200,1005166,COST
06069804101300000,2019,217966,787200,1005166,COST
06069804101400000,2021,145697,1288880,1434577,COST
06069804101400000,2020,145280,1073870,1219150,COST
06069804101400000,2019,145280,1073870,1219150,COST
06069804112010000,2021,163790,537950,701740,COST
06069804112010000,2020,217983,446560,664543,COST
06069804112010000,2019,217983,446560,664543,COST
06069804112100000,2021,428921,2126340,2555261,COST
06069804112100000,2020,222016,2042140,2264156,COST
06069804112100000,2019,222016,2042140,2264156,COST
06069804201200000,2021,6202,1136200,1142402,COST
06069804201200000,2020,6133,959700,965833,COST
06069804201200000,2019,6133,959700,965833,COST
06069804201260000,2021,145052,797750,942802,COST
06069804201260000,2020,144679,668350,813029,COST
06069804201260000,2019,144679,668350,813029,COST
06069804201340000,2021,145052,410210,555262,COST
06069804201340000,2020,144679,355190,499869,COST
06069804201340000,2019,144679,355190,499869,COST
06069804201440000,2021,145052,272890,417942,COST
06069804201440000,2020,144679,234870,379549,COST
06069804201440000,2019,144679,234870,379549,COST
06069804201520000,2021,1107,0,1107,COST
06069804201520000,2020,1030,0,1030,COST
06069804201520000,2019,1030,0,1030,COST
06069804201600000,2021,145052,978850,1123902,COST
06069804201600000,2020,1030,0,1030,COST
06069804201600000,2019,1030,0,1030,COST
06069804201640000,2021,277194,813380,1090574,COST
06069804201680000,2021,289023,419950,708973,COST
06069804201680000,2020,575946,1040380,1616326,COST
06069804201680000,2019,288597,817920,1106517,COST
06069804201720000,2021,192635,567165,759800,MKT
06069804201720000,2020,183994,570970,754964,COST
06069804201720000,2019,183994,570970,754964,COST
06069804201730000,2021,224074,36590,260664,COST
06069804201740000,2021,170673,812520,983193,COST
06069804201740000,2020,243078,700640,943718,COST
06069804201740000,2019,243078,700640,943718,COST
06069804201760000,2021,216378,0,216378,COST
06069804201760000,2020,203088,0,203088,COST
06069804201760000,2019,203088,0,203088,COST
06069804201800000,2021,1295,4900,6195,COST
06069804201800000,2020,1205,4720,5925,COST
06069804201800000,2019,1205,4720,5925,COST
06069804301010000,2021,17129,0,17129,COST
06069804301010000,2020,21941,0,21941,COST
06069804301010000,2019,21941,0,21941,COST
06069804301020000,2021,194163,310637,504800,MKT
06069804301020000,2020,185233,231667,416900,MKT
06069804301020000,2019,185233,231667,416900,MKT
06069804301380000,2021,145052,630800,775852,COST
06069804301380000,2020,144679,498590,643269,COST
06069804301380000,2019,144679,498590,643269,COST
06069804301500000,2021,5224,763970,769194,COST
06069804301500000,2020,5263,658660,663923,COST
06069804301500000,2019,5263,658660,663923,COST
06069804301620000,2021,145052,416810,561862,COST
06069804301620000,2020,144679,353740,498419,COST
06069804301620000,2019,144679,353740,498419,COST
06069804301750000,2021,145052,562360,707412,COST
06069804301750000,2020,144679,477800,622479,OVR
06069804301750000,2019,144679,477800,622479,COST
06069804318010000,2021,6890,514220,521110,COST
06069804318010000,2020,6809,439700,446509,COST
06069804318010000,2019,6809,439700,446509,COST
06069804324010000,2021,14958,442280,457238,COST
06069804324010000,2020,18624,377040,395664,COST
06069804324010000,2019,18624,377040,395664,COST
06069804401050000,2021,261312,332588,593900,MKT
06069804401050000,2020,238392,275908,514300,MKT
06069804401050000,2019,238392,275908,514300,MKT
06069804401060000,2021,75949,206440,282389,COST
06069804401060000,2020,74660,181910,256570,COST
06069804401060000,2019,74660,181910,256570,COST
06069804401100000,2021,144000,0,144000,COST
06069804401100000,2020,143700,0,143700,COST
06069804401100000,2019,143700,0,143700,COST
06069805101020000,2021,224743,104770,329513,COST
06069805101020000,2020,222819,90290,313109,COST
06069805101020000,2019,222819,90290,313109,COST
06069805201010000,2021,47376,0,47376,COST
06069805201010000,2020,48326,0,48326,COST
06069805201010000,2019,48326,0,48326,COST
06069805201300000,2021,156653,0,156653,COST
06069805201300000,2020,208498,0,208498,COST
06069805201300000,2019,208498,0,208498,COST
06069805301201001,2021,591,0,591,COST
06069805301201001,2020,549,0,549,COST
06069805301201001,2019,549,0,549,COST
06069805301201002,2021,10944,627930,638874,COST
06069805301201002,2020,13587,535620,549207,COST
06069805301201002,2019,13587,535620,549207,COST
06069805301500000,2021,5290,0,5290,COST
06069805301500000,2020,4923,0,4923,COST
06069805301500000,2019,4923,0,4923,COST
06069806101020000,2021,126176,467220,593396,COST
06069806101020000,2020,160808,435180,595988,COST
06069806101020000,2019,160808,435180,595988,COST
06069806101100000,2021,144000,341100,485100,MKT
06069806101100000,2020,143700,300700,444400,MKT
06069806101100000,2019,143700,300700,444400,MKT
06069806101300000,2021,170720,457380,628100,MKT
06069806101300000,2020,166055,387445,553500,MKT
06069806101300000,2019,166055,387445,553500,MKT
06069806301010000,2021,99155,46470,145625,COST
06069806301010000,2020,95663,44510,140173,COST
06069806301010000,2019,95663,44510,140173,COST
06069806306050000,2021,325546,6580,332126,COST
06069806306050000,2020,287326,6590,293916,COST
06069806306050000,2019,287326,6590,293916,COST
06069806330050000,2021,200346,282254,482600,MKT
06069806330050000,2020,190232,233968,424200,MKT
06069806330050000,2019,190232,233968,424200,MKT
06069806401010000,2021,237703,257597,495300,MKT
06069806401010000,2020,219968,181760,401728,COST
06069806401010000,2019,219968,181760,401728,COST
06069807101010000,2021,433424,0,433424,COST
06069807101010000,2020,443045,0,443045,COST
06069807101010000,2019,586743,0,586743,COST
06069807101040000,2021,360655,194145,554800,MKT
06069807101040000,2020,231317,142683,374000,MKT
06069807101040000,2019,231317,142683,374000,MKT
06069807101050000,2021,463762,202960,666722,COST
06069807101050000,2020,528215,175420,703635,COST
06069807101050000,2019,528215,175420,703635,COST
06069807101100000,2021,371337,0,371337,COST
06069807101100000,2020,321311,0,321311,COST
06069807101100000,2019,321311,0,321311,COST
06069807201010000,2021,145089,125990,271079,COST
06069807201010000,2020,144713,106540,251253,COST
06069807201010000,2019,144713,106540,251253,COST
06069807201050000,2021,374582,263520,638102,COST
06069807201050000,2020,323695,226690,550385,COST
06069807201050000,2019,323695,226690,550385,COST
06069807201100000,2021,374582,274718,649300,MKT
06069807201100000,2020,323695,240410,564105,COST
06069807201100000,2019,323695,288030,611725,COST
06069807201200000,2021,152087,163500,315587,COST
06069807201200000,2020,150527,138960,289487,COST
06069807201200000,2019,150527,138960,289487,COST
06069807248010000,2021,15348,0,15348,COST
06069807248010000,2020,14927,0,14927,COST
06069807248010000,2019,14927,0,14927,COST
06069807301010000,2021,143919,69640,213559,COST
06069807301010000,2020,144858,52540,197398,COST
06069807301010000,2019,144858,52540,197398,COST
06069807301020000,2021,326463,727930,1054393,COST
06069807301020000,2020,434926,613310,1048236,COST
06069807301020000,2019,434926,613310,1048236,COST
06069807301030000,2021,166,0,166,COST
06069807301030000,2020,155,0,155,COST
06069807301030000,2019,155,0,155,COST
06069807301040000,2021,51044,3740,54784,COST
06069807301040000,2020,49674,3670,53344,COST
06069807301040000,2019,49674,3670,53344,COST
06069807301050000,2021,170290,501810,672100,MKT
06069807301050000,2020,165699,428401,594100,MKT
06069807301050000,2019,165699,428401,594100,MKT
06069807302010000,2021,284800,0,284800,COST
06069807302010000,2020,256475,0,256475,COST
06069807302010000,2019,256475,0,256475,COST
06069807302020000,2021,284588,309212,593800,MKT
06069807302020000,2020,256313,246530,502843,COST
06069807302020000,2019,256313,246530,502843,COST
06069807302030000,2021,353791,452709,806500,MKT
06069807302030000,2020,308368,402030,710398,COST
06069807302030000,2019,308368,402030,710398,COST
06069807302040000,2021,287422,0,287422,COST
06069807302040000,2020,258479,0,258479,COST
06069807302040000,2019,258479,0,258479,COST
06069807302050000,2021,315484,350170,665654,COST
06069807302050000,2020,279765,300470,580235,COST
06069807302050000,2019,279765,300470,580235,COST
06069807303010000,2021,287909,145000,432909,COST
06069807303010000,2020,258852,124260,383112,COST
06069807303010000,2019,258852,124260,383112,COST
06069807303020000,2021,287119,266781,553900,MKT
06069807303020000,2020,258248,218452,476700,MKT
06069807303020000,2019,258248,218452,476700,MKT
06069807303030000,2021,286746,364954,651700,MKT
06069807303030000,2020,257963,286337,544300,MKT
06069807303030000,2019,257963,286337,544300,MKT
06069807303040000,2021,287422,252078,539500,MKT
06069807303040000,2020,258479,189921,448400,MKT
06069807303040000,2019,258479,189921,448400,MKT
06069807304010000,2021,283240,325360,608600,MKT
06069807304010000,2020,255281,262919,518200,MKT
06069807304010000,2019,255281,262919,518200,MKT
06069807304020000,2021,283240,261860,545100,MKT
06069807304020000,2020,255281,247760,503041,COST
06069807304020000,2019,255281,247760,503041,COST
06069807304030000,2021,285834,211466,497300,MKT
06069807304030000,2020,257266,157334,414600,OVR
06069807304030000,2019,257266,157334,414600,MKT
06069807304040000,2021,283856,0,283856,COST
06069807304040000,2020,255753,0,255753,COST
06069807304040000,2019,255753,0,255753,COST
06069807304050000,2021,283074,217126,500200,MKT
06069807304050000,2020,255154,171346,426500,MKT
06069807304050000,2019,255154,171346,426500,MKT
06069807304060000,2021,283097,262503,545600,MKT
06069807304060000,2020,255172,221328,476500,MKT
06069807304060000,2019,255172,221328,476500,MKT
06069807304070000,2021,319927,226373,546300,MKT
06069807304070000,2020,385337,194790,580127,COST
06069807304070000,2019,385337,194790,580127,COST
06069807304080000,2021,319820,260980,580800,MKT
06069807304080000,2020,385228,213980,599208,COST
06069807304080000,2019,385228,213980,599208,COST
06069807304090000,2021,319846,285954,605800,MKT
06069807304090000,2020,385255,238640,623895,COST
06069807304090000,2019,385255,238640,623895,COST
06069807401010000,2021,23557,284630,308187,COST
06069807401010000,2020,33368,245350,278718,COST
06069807401010000,2019,33368,245350,278718,COST
06069807401100000,2021,6723,0,6723,COST
06069807401100000,2020,6257,0,6257,COST
06069807401100000,2019,6257,0,6257,COST
06069808101010000,2021,113610,242080,355690,COST
06069808101010000,2020,154800,210080,364880,COST
06069808101010000,2019,154800,210080,364880,COST
06069808101201001,2021,112086,0,112086,COST
06069808101201001,2020,115675,0,115675,COST
06069808101201001,2019,115675,0,115675,COST
06069808101201002,2021,42326,0,42326,COST
06069808101201002,2020,44191,0,44191,COST
06069808101201002,2019,44191,0,44191,COST
06069808101201003,2021,152501,0,152501,COST
06069808101201003,2020,158244,0,158244,COST
06069808101201003,2019,158244,0,158244,COST
06069808201011001,2021,187,0,187,COST
06069808201011001,2020,174,0,174,COST
06069808201011001,2019,174,0,174,COST
06069808201011002,2021,3393,488440,491833,COST
06069808201011002,2020,3560,413260,416820,COST
06069808201011002,2019,3560,189260,192820,COST
06069808201100000,2021,14743,0,14743,COST
06069808201100000,2020,21040,0,21040,COST
06069808201100000,2019,21040,0,21040,COST
06069808301010000,2021,35264,0,35264,COST
06069808301010000,2020,42199,0,42199,COST
06069808301010000,2019,42199,0,42199,COST
06069808301100000,2021,546164,206340,752504,COST
06069808301100000,2020,329083,177580,506663,COST
06069808301100000,2019,329083,177580,506663,COST
06069808301200000,2021,24346,0,24346,COST
06069808301200000,2020,25064,0,25064,COST
06069808301200000,2019,25064,0,25064,COST
06069808401010000,2021,26903,0,26903,COST
06069808401010000,2020,26011,0,26011,COST
06069808401010000,2019,26011,0,26011,COST
06069809101010000,2021,144000,244300,388300,MKT
06069809101010000,2020,143700,188900,332600,MKT
06069809101010000,2019,143700,188900,332600,MKT
06069809101010900,2021,144000,397200,541200,MKT
06069809101010900,2020,143700,327000,470700,MKT
06069809101010900,2019,143700,327000,470700,MKT
06069809101020000,2021,369617,484109,853726,OVR
06069809101020000,2020,320047,428180,748227,COST
06069809101020000,2019,320047,283020,603067,COST
06069809101030000,2021,105793,166810,272603,COST
06069809101030000,2020,108693,145010,253703,COST
06069809101030000,2019,108869,145010,253879,COST
06069809101040000,2021,156051,388049,544100,MKT
06069809101040000,2020,153853,300047,453900,MKT
06069809101040000,2019,153853,300047,453900,MKT
06069809101050000,2021,7845,632870,640715,COST
06069809101050000,2020,8933,603090,612023,COST
06069809101050000,2019,8933,603090,612023,COST
06069809101060000,2021,144000,0,144000,COST
06069809101060000,2020,143700,0,143700,COST
06069809101060000,2019,143700,0,143700,COST
06069809101200000,2021,1747,0,1747,COST
06069809101200000,2020,2411,0,2411,COST
06069809101200000,2019,2411,0,2411,COST
06069809101350000,2021,315954,268846,584800,MKT
06069809101350000,2020,280118,211890,492008,COST
06069809101350000,2019,280118,211890,492008,COST
06069809301010000,2021,8745,0,8745,COST
06069809301010000,2020,8139,0,8139,COST
06069809301010000,2019,8139,0,8139,COST
06069809401010000,2021,189796,193350,383146,COST
06069809401010000,2020,258678,159310,417988,COST
06069809401010000,2019,258013,0,258013,COST
06069809404040000,2021,158247,293653,451900,MKT
06069809404040000,2020,155691,251709,407400,MKT
06069809404040000,2019,155691,251709,407400,MKT
06069809405010000,2021,155509,326291,481800,MKT
06069809405010000,2020,153399,268401,421800,MKT
06069809405010000,2019,153399,268401,421800,MKT
06069810101020000,2021,11326,365660,376986,COST
06069810101020000,2020,13383,348130,361513,COST
06069810101020000,2019,183281,350730,534011,COST
06069810101030000,2021,7702,284990,292692,COST
06069810101030000,2020,7813,277640,285453,COST
06069810101030000,2019,7813,277640,285453,COST
06069810102010000,2021,282986,196514,479500,MKT
06069810102010000,2020,217661,168039,385700,OVR
06069810102010000,2019,217661,168039,385700,MKT
06069810102020000,2021,294293,373307,667600,MKT
06069810102020000,2020,227719,342681,570400,MKT
06069810102020000,2019,227719,342681,570400,MKT
06069810102030000,2021,279427,296273,575700,MKT
06069810102030000,2020,214509,259691,474200,MKT
06069810102030000,2019,214509,238991,453500,MKT
06069810102040000,2021,271262,202438,473700,MKT
06069810102040000,2020,207299,219701,427000,MKT
06069810102040000,2019,207299,219701,427000,MKT
06069810102050000,2021,241184,225916,467100,MKT
06069810102050000,2020,181032,235668,416700,MKT
06069810102050000,2019,181032,235668,416700,MKT
06069810102060000,2021,242032,267000,509032,COST
06069810102060000,2020,181766,262234,444000,MKT
06069810102060000,2019,181766,262234,444000,MKT
06069810102070000,2021,261385,243815,505200,MKT
06069810102070000,2020,198621,238679,437300,MKT
06069810102070000,2019,198621,238679,437300,MKT
06069810102080000,2021,276907,517500,794407,COST
06069810102080000,2020,212280,489920,702200,MKT
06069810102080000,2019,212280,489920,702200,MKT
06069810102090000,2021,245812,308388,554200,MKT
06069810102090000,2020,185042,289558,474600,MKT
06069810102090000,2019,185042,289558,474600,MKT
06069810102100000,2021,245812,264488,510300,MKT
06069810102100000,2020,185042,232458,417500,MKT
06069810102100000,2019,185042,232458,417500,MKT
06069810102110000,2021,245812,260888,506700,MKT
06069810102110000,2020,185042,255458,440500,MKT
06069810102110000,2019,185042,255458,440500,MKT
06069810102120000,2021,245812,363580,609392,COST
06069810102120000,2020,185042,360140,545182,COST
06069810102120000,2019,185042,360140,545182,COST
06069810102130000,2021,245812,256288,502100,MKT
06069810102130000,2020,185042,267858,452900,MKT
06069810102130000,2019,185042,267858,452900,MKT
06069810102140000,2021,245812,315288,561100,MKT
06069810102140000,2020,185042,290658,475700,MKT
06069810102140000,2019,185042,290658,475700,MKT
06069810102150000,2021,248254,245080,493334,COST
06069810102150000,2020,187163,281737,468900,MKT
06069810102150000,2019,187163,281737,468900,MKT
06069810102160000,2021,94,0,94,COST
06069810102160000,2020,88,0,88,COST
06069810102160000,2019,88,0,88,COST
06069810102170000,2021,274963,329837,604800,MKT
06069810102170000,2020,210563,337537,548100,MKT
06069810102170000,2019,210563,345737,556300,MKT
06069810102180000,2021,261272,320828,582100,MKT
06069810102180000,2020,198522,305778,504300,MKT
06069810102180000,2019,198522,305778,504300,MKT
06069810102190000,2021,311506,125050,436556,COST
06069810102190000,2020,243141,121400,364541,COST
06069810102190000,2019,243141,121400,364541,COST
06069810102200000,2021,255622,450820,706442,COST
06069810102200000,2020,193582,362218,555800,OVR
06069810102200000,2019,193582,362218,555800,MKT
06069810103010000,2021,248626,255720,504346,COST
06069810103010000,2020,187486,242114,429600,MKT
06069810103010000,2019,187486,242114,429600,MKT
06069810103020000,2021,246442,331758,578200,MKT
06069810103020000,2020,185589,320711,506300,MKT
06069810103020000,2019,185589,320711,506300,MKT
06069810103030000,2021,248502,349298,597800,MKT
06069810103030000,2020,187378,348422,535800,MKT
06069810103030000,2019,187378,348422,535800,MKT
06069810103040000,2021,248687,262913,511600,MKT
06069810103040000,2020,187540,263260,450800,MKT
06069810103040000,2019,187540,246960,434500,MKT
06069810103050000,2021,248687,402313,651000,MKT
06069810103050000,2020,187540,397260,584800,MKT
06069810103050000,2019,187540,338860,526400,MKT
06069810103060000,2021,253010,284790,537800,MKT
06069810103060000,2020,191303,206297,397600,OVR
06069810103060000,2019,191303,206297,397600,MKT
06069810103070000,2021,259394,277806,537200,MKT
06069810103070000,2020,196879,272721,469600,MKT
06069810103070000,2019,196879,272721,469600,MKT
06069810103080000,2021,277971,238729,516700,MKT
06069810103080000,2020,213221,205479,418700,MKT
06069810103080000,2019,213221,205479,418700,MKT
06069810104010000,2021,250225,292875,543100,MKT
06069810104010000,2020,188877,310923,499800,MKT
06069810104010000,2019,188877,310923,499800,MKT
06069810104020000,2021,239406,244694,484100,MKT
06069810104020000,2020,179494,299306,478800,MKT
06069810104020000,2019,179494,299306,478800,MKT
06069810104030000,2021,239406,192594,432000,MKT
06069810104030000,2020,179494,201406,380900,MKT
06069810104030000,2019,179494,201406,380900,MKT
06069810104040000,2021,239539,255361,494900,MKT
06069810104040000,2020,179609,257391,437000,MKT
06069810104040000,2019,179609,257391,437000,MKT
06069810104050000,2021,251745,350055,601800,MKT
06069810104050000,2020,190201,321299,511500,MKT
06069810104050000,2019,190201,321299,511500,MKT
06069810104060000,2021,271420,273960,545380,COST
06069810104060000,2020,207439,276861,484300,MKT
06069810104060000,2019,207439,276861,484300,MKT
06069810104070000,2021,251503,440897,692400,MKT
06069810104070000,2020,189990,378610,568600,OVR
06069810104070000,2019,189990,378610,568600,MKT
06069810104080000,2021,251685,238015,489700,MKT
06069810104080000,2020,190148,269152,459300,MKT
06069810104080000,2019,190148,269152,459300,MKT
06069810104090000,2021,250103,501450,751553,COST
06069810104090000,2020,188771,493270,682041,COST
06069810104090000,2019,188771,298629,487400,MKT
06069810104100000,2021,250103,379497,629600,MKT
06069810104100000,2020,188771,363029,551800,MKT
06069810104100000,2019,188771,363029,551800,MKT
06069810104110000,2021,250103,287097,537200,MKT
06069810104110000,2020,188771,265729,454500,MKT
06069810104110000,2019,188771,265729,454500,MKT
06069810104120000,2021,244159,286141,530300,MKT
06069810104120000,2020,183609,307291,490900,MKT
06069810104120000,2019,183609,272391,456000,MKT
06069810105010000,2021,248005,218295,466300,MKT
06069810105010000,2020,186947,217853,404800,MKT
06069810105010000,2019,186947,217853,404800,MKT
06069810105020000,2021,254500,249010,503510,COST
06069810105020000,2020,192602,288498,481100,MKT
06069810105020000,2019,192602,288498,481100,MKT
06069810105030000,2021,255916,470384,726300,MKT
06069810105030000,2020,193838,475962,669800,OVR
06069810105030000,2019,193838,475962,669800,MKT
06069810105040000,2021,255622,254340,509962,COST
06069810105040000,2020,193582,275518,469100,MKT
06069810105040000,2019,193582,275518,469100,MKT
06069810105050000,2021,250652,190548,441200,MKT
06069810105050000,2020,189249,241751,431000,OVR
06069810105050000,2019,189249,241751,431000,OVR
06069810105060000,2021,243325,273675,517000,MKT
06069810105060000,2020,182886,273214,456100,MKT
06069810105060000,2019,182886,273214,456100,MKT
06069810105070000,2021,241446,488154,729600,MKT
06069810105070000,2020,181258,402580,583838,COST
06069810105070000,2019,181258,206942,388200,MKT
06069810105080000,2021,243003,527120,770123,COST
06069810105080000,2020,182607,507980,690587,COST
06069810105080000,2019,182607,507980,690587,COST
06069810106010000,2021,271894,227906,499800,MKT
06069810106010000,2020,207856,204244,412100,MKT
06069810106010000,2019,207856,204244,412100,MKT
06069810106020000,2021,257898,323202,581100,MKT
06069810106020000,2020,195570,314630,510200,MKT
06069810106020000,2019,195570,314630,510200,MKT
06069810106030000,2021,274137,302763,576900,MKT
06069810106030000,2020,209834,285966,495800,MKT
06069810106030000,2019,209834,285966,495800,MKT
06069810106040000,2021,280325,336175,616500,MKT
06069810106040000,2020,215304,328196,543500,MKT
06069810106040000,2019,215304,328196,543500,MKT
06069810106050000,2021,276296,546904,823200,MKT
06069810106050000,2020,211740,528060,739800,MKT
06069810106050000,2019,211740,528060,739800,MKT
06069810106060000,2021,250713,300987,551700,MKT
06069810106060000,2020,189302,284298,473600,MKT
06069810106060000,2019,189302,284298,473600,MKT
06069810106070000,2021,246254,814046,1060300,MKT
06069810106070000,2020,185426,596574,782000,OVR
06069810106070000,2019,185426,596574,782000,OVR
06069810106080000,2021,246254,252946,499200,MKT
06069810106080000,2020,185426,252274,437700,MKT
06069810106080000,2019,185426,252274,437700,MKT
06069810106090000,2021,246254,295946,542200,MKT
06069810106090000,2020,185426,297774,483200,MKT
06069810106090000,2019,185426,297774,483200,MKT
06069810106100000,2021,246065,376635,622700,MKT
06069810106100000,2020,185261,385939,571200,MKT
06069810106100000,2019,185261,385939,571200,MKT
06069810106110000,2021,270575,277325,547900,MKT
06069810106110000,2020,206694,292006,498700,MKT
06069810106110000,2019,206694,292006,498700,MKT
06069810106120000,2021,254441,335759,590200,MKT
06069810106120000,2020,192551,347949,540500,MKT
06069810106120000,2019,192551,347949,540500,MKT
06069810201010000,2021,326838,0,326838,COST
06069810201010000,2020,256989,0,256989,COST
06069810201020000,2021,622167,431850,1054017,COST
06069810201020000,2020,480710,422370,903080,COST
06069810201020000,2019,532281,397720,930001,COST
06069810201040000,2021,347181,47030,394211,COST
06069810201040000,2020,275516,49180,324696,COST
06069810201040000,2019,275516,49180,324696,COST
06069810201050000,2021,570361,316680,887041,COST
06069810201050000,2020,488313,309270,797583,COST
06069810201050000,2019,488313,309270,797583,COST
06069810201060000,2021,271736,175164,446900,MKT
06069810201060000,2020,207717,199783,407500,MKT
06069810201060000,2019,207717,199783,407500,MKT
06069810201160000,2021,263737,304840,568577,COST
06069810201160000,2020,200684,56990,257674,COST
06069810201160000,2019,200684,56990,257674,COST
06069810201200000,2021,299220,594000,893220,COST
06069810201200000,2020,232120,570500,802620,COST
06069810201200000,2019,232120,570500,802620,COST
06069810201230000,2021,329559,327241,656800,MKT
06069810201230000,2020,259457,331443,590900,MKT
06069810201230000,2019,259457,331443,590900,MKT
06069810201250000,2021,427613,586200,1013813,COST
06069810201250000,2020,350329,611890,962219,OVR
06069810201250000,2019,350329,611890,962219,COST
06069810201280000,2021,321114,0,321114,COST
06069810201280000,2020,251807,0,251807,COST
06069810201280000,2019,251807,0,251807,COST
06069810201300000,2021,219500,241300,460800,MKT
06069810201300000,2020,162400,251700,414100,MKT
06069810201300000,2019,162400,251700,414100,MKT
06069810201320000,2021,220698,290940,511638,COST
06069810201320000,2020,163515,284230,447745,COST
06069810201320000,2019,163515,284230,447745,COST
06069810201400000,2021,53901,0,53901,COST
06069810201400000,2020,46761,0,46761,COST
06069810201400000,2019,3148,0,3148,COST
06069810301010000,2021,28127,0,28127,COST
06069810301010000,2020,36276,0,36276,COST
06069810301010000,2019,36276,0,36276,COST
06069810301020000,2021,240857,378343,619200,MKT
06069810301020000,2020,180749,349451,530200,MKT
06069810301020000,2019,180749,349451,530200,MKT
06069810301030000,2021,289960,496040,786000,MKT
06069810301030000,2020,223858,491042,714900,MKT
06069810301030000,2019,223858,491042,714900,MKT
06069810301040000,2021,219733,714967,934700,MKT
06069810301040000,2020,162599,655640,818239,COST
06069810301040000,2019,162599,655640,818239,COST
06069810301050000,2021,219500,353200,572700,COST
06069810301050000,2020,162400,345700,508100,MKT
06069810301050000,2019,162400,345700,508100,MKT
06069810301060000,2021,581857,239000,820857,COST
06069810301060000,2020,444985,232040,677025,COST
06069810301060000,2019,444985,232040,677025,COST
06069810301100000,2021,366165,615730,981895,COST
06069810301100000,2020,292956,614380,907336,COST
06069810301100000,2019,292956,614380,907336,COST
06069810301120000,2021,387999,340860,728859,COST
06069810301120000,2020,313185,337915,651100,MKT
06069810301120000,2019,313185,337915,651100,MKT
06069810301160000,2021,366073,446430,812503,COST
06069810301160000,2020,292871,452029,744900,MKT
06069810301160000,2019,292871,368029,660900,MKT
06069810301180000,2021,534074,459370,993444,COST
06069810301180000,2020,452674,451780,904454,COST
06069810301180000,2019,452674,451780,904454,COST
06069810301340000,2021,413879,0,413879,COST
06069810301340000,2020,337389,0,337389,COST
06069810301340000,2019,337389,0,337389,COST
06069810301400000,2021,413879,706000,1119879,COST
06069810301400000,2020,337389,673990,1011379,COST
06069810301400000,2019,337389,673990,1011379,COST
06069810302010000,2021,270468,288532,559000,MKT
06069810302010000,2020,206600,249800,456400,MKT
06069810302010000,2019,206600,249800,456400,MKT
06069810302020000,2021,293655,380390,674045,COST
06069810302020000,2020,227150,377920,605070,COST
06069810302020000,2019,227150,377920,605070,COST
06069810302030000,2021,266598,442402,709000,MKT
06069810302030000,2020,203195,447305,650500,MKT
06069810302030000,2019,203195,447305,650500,MKT
06069810302040000,2021,219500,268600,488100,MKT
06069810302040000,2020,162400,286100,448500,MKT
06069810302040000,2019,162400,286100,448500,MKT
06069810302050000,2021,251321,466679,718000,MKT
06069810302050000,2020,189832,459468,649300,MKT
06069810302050000,2019,189832,459468,649300,MKT
06069810302060000,2021,259852,303548,563400,MKT
06069810302060000,2020,197279,280521,477800,MKT
06069810302060000,2019,197279,294721,492000,MKT
06069810302070000,2021,233368,553332,786700,MKT
06069810302070000,2020,174285,527315,701600,MKT
06069810302070000,2019,174285,527315,701600,MKT
06069810302080000,2021,276500,435400,711900,MKT
06069810302080000,2020,211920,414690,626610,COST
06069810302080000,2019,211920,345280,557200,MKT
06069810302090000,2021,259165,434610,693775,COST
06069810302090000,2020,196678,418900,615578,COST
06069810302090000,2019,196678,418900,615578,COST
06069810302100000,2021,244223,452577,696800,MKT
06069810302100000,2020,183664,432136,615800,MKT
06069810302100000,2019,183664,432136,615800,MKT
06069810303010000,2021,240134,284366,524500,MKT
06069810303010000,2020,180123,253077,433200,MKT
06069810303010000,2019,180123,253077,433200,MKT
06069810303020000,2021,244988,352740,597728,COST
06069810303020000,2020,184328,323072,507400,MKT
06069810303020000,2019,184328,323072,507400,MKT
06069810303030000,2021,249735,174765,424500,MKT
06069810303030000,2020,188451,187549,376000,MKT
06069810303030000,2019,188451,187549,376000,MKT
06069810303040000,2021,233020,266480,499500,MKT
06069810303040000,2020,173986,275514,449500,MKT
06069810303040000,2019,173986,275514,449500,MKT
06069810303050000,2021,265724,333876,599600,MKT
06069810303050000,2020,202427,347073,549500,MKT
06069810303050000,2019,202427,347073,549500,MKT
06069810303060000,2021,247382,290518,537900,MKT
06069810303060000,2020,186406,283894,470300,MKT
06069810303060000,2019,186406,256694,443100,MKT
06069810303070000,2021,248564,317136,565700,MKT
06069810303070000,2020,187432,277868,465300,MKT
06069810303070000,2019,187432,277868,465300,MKT
06069810303080000,2021,266707,220793,487500,MKT
06069810303080000,2020,203291,224509,427800,MKT
06069810303080000,2019,203291,224509,427800,MKT
06069810303090000,2021,262790,581410,844200,MKT
06069810303090000,2020,199853,508647,708500,MKT
06069810303090000,2019,199853,508647,708500,MKT
06069810303100000,2021,240134,596666,836800,MKT
06069810303100000,2020,180123,517577,697700,MKT
06069810303100000,2019,180123,517577,697700,MKT
06069810303100900,2021,235367,299933,535300,MKT
06069810303100900,2020,176007,304793,480800,MKT
06069810303100900,2019,176007,304793,480800,MKT
06069810303110000,2021,223624,329776,553400,MKT
06069810303110000,2020,165922,313978,479900,MKT
06069810303110000,2019,165922,313978,479900,MKT
06069810303110900,2021,223398,331302,554700,MKT
06069810303110900,2020,165730,321370,487100,MKT
06069810303110900,2019,165730,321370,487100,MKT
06069810303120000,2021,221120,208780,429900,MKT
06069810303120000,2020,163783,232717,396500,MKT
06069810303120000,2019,163783,232717,396500,MKT
06069810303130000,2021,219500,211900,431400,MKT
06069810303130000,2020,162400,206200,368600,MKT
06069810303130000,2019,162400,206200,368600,MKT
06069810304010000,2021,316476,381024,697500,MKT
06069810304010000,2020,247619,360560,608179,COST
06069810304010000,2019,247619,360560,608179,COST
06069810304020000,2021,306978,377322,684300,MKT
06069810304020000,2020,239071,324229,563300,MKT
06069810304020000,2019,239071,324229,563300,MKT
06069810304030000,2021,232322,317478,549800,MKT
06069810304030000,2020,173385,292815,466200,MKT
06069810304030000,2019,173385,292815,466200,MKT
06069810304030900,2021,232041,327159,559200,MKT
06069810304030900,2020,173143,330557,503700,MKT
06069810304030900,2019,173143,330557,503700,MKT
06069810304040000,2021,269082,319318,588400,MKT
06069810304040000,2020,205380,342020,547400,MKT
06069810304040000,2019,205380,342020,547400,MKT
06069810304050000,2021,219810,326390,546200,MKT
06069810304050000,2020,162665,347435,510100,MKT
06069810304050000,2019,162665,347435,510100,MKT
06069810304060000,2021,219810,255690,475500,MKT
06069810304060000,2020,162665,260235,422900,MKT
06069810304060000,2019,162665,260235,422900,MKT
06069810304070000,2021,258013,166687,424700,MKT
06069810304070000,2020,195671,183229,378900,MKT
06069810304070000,2019,195671,183229,378900,MKT
06069810305010000,2021,229489,301511,531000,MKT
06069810305010000,2020,170950,325150,496100,MKT
06069810305010000,2019,170950,325150,496100,MKT
06069810305020000,2021,229417,197883,427300,MKT
06069810305020000,2020,170888,226112,397000,MKT
06069810305020000,2019,170888,226112,397000,MKT
06069810305030000,2021,291031,0,291031,COST
06069810305030000,2020,224811,0,224811,COST
06069810305030000,2019,224811,0,224811,COST
06069810305040000,2021,302842,673640,976482,COST
06069810305040000,2020,235362,659020,894382,COST
06069810305040000,2019,235362,659020,894382,COST
06069810305050000,2021,271947,289153,561100,MKT
06069810305050000,2020,207902,280698,488600,MKT
06069810305050000,2019,207902,280698,488600,MKT
06069810305060000,2021,223999,262701,486700,MKT
06069810305060000,2020,166243,237757,404000,MKT
06069810305060000,2019,166243,237757,404000,MKT
06069810305070000,2021,223924,441676,665600,MKT
06069810305070000,2020,166179,418721,584900,MKT
06069810305070000,2019,166179,418721,584900,MKT
06069810305080000,2021,223924,241576,465500,MKT
06069810305080000,2020,166179,249021,415200,MKT
06069810305080000,2019,166179,249021,415200,MKT
06069810305090000,2021,223924,200776,424700,MKT
06069810305090000,2020,166179,213821,380000,MKT
06069810305090000,2019,166179,213821,380000,MKT
06069810305100000,2021,223924,180576,404500,MKT
06069810305100000,2020,166179,189821,356000,MKT
06069810305100000,2019,166179,189821,356000,MKT
06069810307010000,2021,234130,486470,720600,MKT
06069810307010000,2020,174941,449059,624000,MKT
06069810307010000,2019,174941,449059,624000,MKT
06069810307020000,2021,237537,220963,458500,MKT
06069810307020000,2020,177879,216721,394600,MKT
06069810307020000,2019,177879,216721,394600,MKT
06069810307030000,2021,247195,0,247195,COST
06069810307030000,2020,186243,0,186243,COST
06069810307030000,2019,186243,0,186243,COST
06069810307040000,2021,265065,548435,813500,MKT
06069810307040000,2020,201849,530651,732500,MKT
06069810307040000,2019,201849,422151,624000,MKT
06069810307050000,2021,246191,327909,574100,MKT
06069810307050000,2020,185371,321629,507000,MKT
06069810307050000,2019,185371,321629,507000,MKT
06069810307060000,2021,262734,482820,745554,COST
06069810307060000,2020,199804,479740,679544,COST
06069810307060000,2019,199804,479740,679544,COST
06069810308010000,2021,266216,378640,644856,COST
06069810308010000,2020,202860,360520,563380,COST
06069810308010000,2019,202860,360520,563380,COST
06069810308020000,2021,275015,257385,532400,MKT
06069810308020000,2020,210609,242091,452700,MKT
06069810308020000,2019,210609,242091,452700,MKT
06069810308030000,2021,291772,0,291772,COST
06069810308030000,2020,225471,0,225471,COST
06069810308030000,2019,225471,0,225471,COST
06069810390010000,2021,393689,309711,703400,MKT
06069810390010000,2020,318486,304714,623200,MKT
06069810390010000,2019,318486,304714,623200,MKT
06069810401010000,2021,232532,279968,512500,MKT
06069810401010000,2020,173565,303635,477200,MKT
06069810401010000,2019,173565,303635,477200,MKT
06069810401020000,2021,232602,343198,575800,MKT
06069810401020000,2020,173625,328075,501700,MKT
06069810401020000,2019,173625,328075,501700,MKT
06069810401030000,2021,232602,330698,563300,MKT
06069810401030000,2020,173625,365975,539600,MKT
06069810401030000,2019,173625,365975,539600,MKT
06069810402010000,2021,268814,233686,502500,MKT
06069810402010000,2020,205144,229656,434800,MKT
06069810402010000,2019,205144,229656,434800,MKT
06069810402020000,2021,268653,367000,635653,COST
06069810402020000,2020,205002,368898,573900,MKT
06069810402020000,2019,205002,368898,573900,MKT
06069810403010000,2021,233507,213293,446800,MKT
06069810403010000,2020,174405,246895,421300,MKT
06069810403010000,2019,174405,246895,421300,MKT
06069810403020000,2021,298424,360576,659000,MKT
06069810403020000,2020,231408,302592,534000,MKT
06069810403020000,2019,231408,302592,534000,MKT
06069810404010000,2021,280523,318110,598633,COST
06069810404010000,2020,215480,309110,524590,COST
06069810404010000,2019,215480,309110,524590,COST
06069810404020000,2021,264015,266785,530800,MKT
06069810404020000,2020,200927,243173,444100,MKT
06069810404020000,2019,200927,243173,444100,MKT
06069810404030000,2021,264015,191485,455500,MKT
06069810404030000,2020,200927,234173,435100,MKT
06069810404030000,2019,200927,234173,435100,MKT
06069810404040000,2021,264015,273600,537615,COST
06069810404040000,2020,200927,295573,496500,MKT
06069810404040000,2019,200927,295573,496500,MKT
06069810404050000,2021,506654,480040,986694,COST
06069810404050000,2020,379361,459160,838521,COST
06069810404050000,2019,379361,459160,838521,COST
06069810404060000,2021,520789,475880,996669,COST
06069810404060000,2020,391589,463860,855449,COST
06069810404060000,2019,391589,463860,855449,COST
06069810404070000,2021,625022,562470,1187492,COST
06069810404070000,2020,483255,540510,1023765,OVR
06069810404070000,2019,483255,540510,1023765,COST
06069810404080000,2021,325714,504286,830000,OVR
06069810404080000,2020,227954,516746,744700,MKT
06069810404080000,2019,227954,494146,722100,MKT
06069810404090000,2021,306538,327462,634000,MKT
06069810404090000,2020,212552,293748,506300,MKT
06069810404090000,2019,212552,293748,506300,MKT
06069810404100000,2021,315340,422260,737600,MKT
06069810404100000,2020,219604,366596,586200,MKT
06069810404100000,2019,219604,366596,586200,MKT
06069810404110000,2021,319234,499666,818900,MKT
06069810404110000,2020,222733,482267,705000,MKT
06069810404110000,2019,222733,482267,705000,MKT
06069810404120000,2021,336832,650120,986952,COST
06069810404120000,2020,236947,648090,885037,COST
06069810404120000,2019,236947,648090,885037,COST
06069810404130000,2021,329453,457147,786600,MKT
06069810404130000,2020,230973,446727,677700,MKT
06069810404130000,2019,230973,446727,677700,MKT
06069810404140000,2021,319234,286966,606200,MKT
06069810404140000,2020,222733,297567,520300,MKT
06069810404140000,2019,222733,297567,520300,MKT
06069810404150000,2021,256326,287474,543800,MKT
06069810404150000,2020,194196,322904,517100,MKT
06069810404150000,2019,194196,322904,517100,MKT
06069810404150900,2021,280969,307631,588600,MKT
06069810404150900,2020,215875,313725,529600,MKT
06069810404150900,2019,215875,313725,529600,MKT
06069810404160000,2021,272546,397854,670400,MKT
06069810404160000,2020,185617,408683,594300,MKT
06069810404160000,2019,185617,408683,594300,MKT
06069810404170000,2021,236321,0,236321,COST
06069810404170000,2020,176830,0,176830,COST
06069810404170000,2019,176830,0,176830,COST
06069810404206500,2021,191576,0,191576,COST
06069810404206500,2020,166660,0,166660,COST
06069810404206500,2019,166660,0,166660,COST
06069810404600000,2021,342541,783670,1126211,COST
06069810404600000,2020,241583,754420,996003,COST
06069810404600000,2019,241583,754420,996003,COST
06069810404630000,2021,451660,787360,1239020,COST
06069810404630000,2020,288285,684000,972285,COST
06069810404630000,2019,288285,684000,972285,COST
06069810404660000,2021,208091,162870,370961,COST
06069810404660000,2020,221722,177678,399400,MKT
06069810404660000,2019,221722,177678,399400,MKT
06069810404700000,2021,219500,217000,436500,MKT
06069810404700000,2020,162400,235700,398100,MKT
06069810404700000,2019,162400,235700,398100,MKT
06069810405010000,2021,264789,0,264789,COST
06069810405010000,2020,201607,0,201607,COST
06069810405010000,2019,201607,0,201607,COST
06069810405020000,2021,260705,0,260705,COST
06069810405020000,2020,198026,0,198026,COST
06069810405020000,2019,198026,0,198026,COST
06069810405030000,2021,282005,479195,761200,MKT
06069810405030000,2020,216793,480360,697153,COST
06069810405030000,2019,216793,480360,697153,COST
06069810406010000,2021,286129,273071,559200,MKT
06069810406010000,2020,220451,240449,460900,MKT
06069810406010000,2019,220451,240449,460900,MKT
06069810406020000,2021,252529,205971,458500,MKT
06069810406020000,2020,190884,197816,388700,MKT
06069810406020000,2019,190884,197816,388700,MKT
06069810406030000,2021,240791,302009,542800,MKT
06069810406030000,2020,180692,308508,489200,MKT
06069810406030000,2019,180692,308508,489200,MKT
06069810406030900,2021,240726,402274,643000,MKT
06069810406030900,2020,180635,373020,553655,COST
06069810406030900,2019,180635,373020,553655,COST
06069810406050000,2021,281019,482181,763200,MKT
06069810406050000,2020,215919,501000,716919,COST
06069810406050000,2019,215919,501000,716919,COST
06069810406060000,2021,219810,373290,593100,MKT
06069810406060000,2020,162665,321935,484600,MKT
06069810406060000,2019,162665,321935,484600,MKT
06069810406070000,2021,251261,0,251261,COST
06069810406070000,2020,189779,0,189779,COST
06069810406070000,2019,189779,0,189779,COST
06069810406080000,2021,255563,281837,537400,MKT
06069810406080000,2020,193530,276570,470100,MKT
06069810406080000,2019,193530,276570,470100,MKT
06069810406090000,2021,271473,304227,575700,MKT
06069810406090000,2020,207485,344215,551700,MKT
06069810406090000,2019,207485,344215,551700,MKT
06069810406100000,2021,219578,255622,475200,MKT
06069810406100000,2020,162466,268934,431400,MKT
06069810406100000,2019,162466,268934,431400,MKT
06069810406110000,2021,219578,212422,432000,MKT
06069810406110000,2020,162466,218234,380700,MKT
06069810406110000,2019,162466,218234,380700,MKT
06069810406120000,2021,219578,370622,590200,MKT
06069810406120000,2020,162466,324634,487100,MKT
06069810406120000,2019,162466,324634,487100,MKT
06069810406130000,2021,219655,308845,528500,MKT
06069810406130000,2020,162532,313268,475800,MKT
06069810406130000,2019,162532,313268,475800,MKT
06069810406140000,2021,259680,428320,688000,MKT
06069810406140000,2020,197129,387671,584800,MKT
06069810406140000,2019,197129,387671,584800,MKT
06069810406150000,2021,234130,0,234130,COST
06069810406150000,2020,174941,0,174941,COST
06069810406150000,2019,174941,0,174941,COST
06069810407010000,2021,277009,450291,727300,MKT
06069810407010000,2020,212370,400630,613000,MKT
06069810407010000,2019,212370,294630,507000,MKT
06069810407020000,2021,304560,369240,673800,MKT
06069810407020000,2020,236902,287798,524700,MKT
06069810407020000,2019,236902,287798,524700,MKT
06069810407030000,2021,303661,250039,553700,MKT
06069810407030000,2020,236095,247305,483400,MKT
06069810407030000,2019,236095,247305,483400,MKT
06069810408010000,2021,263515,237785,501300,MKT
06069810408010000,2020,200489,218511,419000,MKT
06069810408010000,2019,200489,218511,419000,MKT
06069810408010900,2021,233299,505101,738400,MKT
06069810408010900,2020,174225,448475,622700,MKT
06069810408010900,2019,174225,448475,622700,MKT
06069810408020000,2021,290147,317353,607500,MKT
06069810408020000,2020,224024,312876,536900,MKT
06069810408020000,2019,224024,312876,536900,MKT
06069810408030000,2021,259738,317062,576800,MKT
06069810408030000,2020,197179,314821,512000,MKT
06069810408030000,2019,197179,314821,512000,MKT
06069810408040000,2021,260023,267277,527300,MKT
06069810408040000,2020,197429,245171,442600,MKT
06069810408040000,2019,197429,245171,442600,MKT
06069810408050000,2021,244031,243969,488000,MKT
06069810408050000,2020,183498,228402,411900,MKT
06069810408050000,2019,183498,228402,411900,MKT
06069810408060000,2021,242551,1350,243901,COST
06069810408060000,2020,182215,1260,183475,COST
06069810408060000,2019,182215,1260,183475,COST
06069810408070000,2021,235024,342676,577700,MKT
06069810408070000,2020,175712,313488,489200,OVR
06069810408070000,2019,175712,313488,489200,MKT
06069810408080000,2021,231690,0,231690,COST
06069810408080000,2020,172841,0,172841,COST
06069810408080000,2019,172841,0,172841,COST
06069810410040000,2021,323808,162490,486298,COST
06069810410040000,2020,254244,150856,405100,MKT
06069810410040000,2019,254244,150856,405100,MKT
06069810410070000,2021,233229,175571,408800,MKT
06069810410070000,2020,174165,222035,396200,MKT
06069810410070000,2019,174165,222035,396200,MKT
06069811101010000,2021,1137,0,1137,COST
06069811101010000,2020,1058,0,1058,COST
06069811101010000,2019,1058,0,1058,COST
06069811101250000,2021,75445,247420,322865,COST
06069811101250000,2020,74212,187930,262142,COST
06069811101250000,2019,74212,187930,262142,COST
06069811101550000,2021,387972,504070,892042,COST
06069811101550000,2020,313160,495960,809120,COST
06069811101550000,2019,313160,495960,809120,COST
06069811102010000,2021,227613,655287,882900,MKT
06069811102010000,2020,169339,577961,747300,MKT
06069811102010000,2019,169339,577961,747300,MKT
06069811102040000,2021,227176,0,227176,COST
06069811102040000,2020,168965,0,168965,COST
06069811102040000,2019,168965,0,168965,COST
06069811102070000,2021,227976,529520,757496,COST
06069811102070000,2020,169651,527360,697011,COST
06069811102070000,2019,169651,527360,697011,COST
06069811102100000,2021,228193,0,228193,COST
06069811102100000,2020,169837,0,169837,COST
06069811102100000,2019,169837,0,169837,COST
06069811102130000,2021,228627,0,228627,COST
06069811102130000,2020,170209,0,170209,COST
06069811102130000,2019,170209,0,170209,COST
06069811102160000,2021,228771,0,228771,COST
06069811102160000,2020,170333,0,170333,COST
06069811102160000,2019,170333,0,170333,COST
06069811102190000,2021,229989,0,229989,COST
06069811102190000,2020,171379,0,171379,COST
06069811102190000,2019,171379,0,171379,COST
06069811102220000,2021,232811,428889,661700,MKT
06069811102220000,2020,173806,0,173806,COST
06069811102220000,2019,173806,0,173806,COST
06069811102250000,2021,247445,0,247445,COST
06069811102250000,2020,186460,0,186460,COST
06069811102250000,2019,186460,0,186460,COST
06069811102280000,2021,255681,0,255681,COST
06069811102280000,2020,193633,0,193633,COST
06069811102280000,2019,193633,0,193633,COST
06069811102310000,2021,259738,0,259738,COST
06069811102310000,2020,197179,0,197179,COST
06069811102310000,2019,197179,0,197179,COST
06069811102346500,2021,142626,0,142626,COST
06069811102346500,2020,118605,0,118605,COST
06069811102346500,2019,118605,0,118605,COST
06069811103010000,2021,256707,0,256707,COST
06069811103010000,2020,191188,0,191188,COST
06069811103010000,2019,191188,0,191188,COST
06069811103040000,2021,250206,616094,866300,MKT
06069811103040000,2020,185617,697583,883200,MKT
06069811103040000,2019,185617,0,185617,COST
06069811103070000,2021,248851,518549,767400,MKT
06069811103070000,2020,184459,482141,666600,MKT
06069811103070000,2019,184459,482141,666600,MKT
06069811103100000,2021,248851,583850,832701,COST
06069811103100000,2020,184459,543241,727700,MKT
06069811103100000,2019,184459,543241,727700,MKT
06069811103130000,2021,256707,739993,996700,MKT
06069811103130000,2020,191188,767810,958998,COST
06069811103130000,2019,191188,616912,808100,MKT
06069811103160000,2021,258385,949610,1207995,COST
06069811103160000,2020,192629,767971,960600,OVR
06069811103160000,2019,192629,767971,960600,OVR
06069811104010000,2021,267575,0,267575,COST
06069811104010000,2020,204054,0,204054,COST
06069811104010000,2019,204054,0,204054,COST
06069811104020000,2021,249919,215920,465839,COST
06069811104020000,2020,188611,0,188611,COST
06069811104020000,2019,188611,0,188611,COST
06069811104040000,2021,252890,921520,1174410,COST
06069811104040000,2020,191198,886810,1078008,COST
06069811104040000,2019,191198,886810,1078008,COST
06069811104070000,2021,250041,667959,918000,MKT
06069811104070000,2020,188717,605010,793727,COST
06069811104070000,2019,188717,605010,793727,COST
06069811104100000,2021,231690,808110,1039800,MKT
06069811104100000,2020,172841,634059,806900,MKT
06069811104100000,2019,172841,691550,864391,COST
06069811104130000,2021,248851,715149,964000,MKT
06069811104130000,2020,184459,694480,878939,COST
06069811104130000,2019,184459,694480,878939,COST
06069811104160000,2021,248851,646549,895400,MKT
06069811104160000,2020,184459,715141,899600,MKT
06069811104160000,2019,184459,500741,685200,MKT
06069811104190000,2021,249106,0,249106,COST
06069811104190000,2020,184677,0,184677,COST
06069811104190000,2019,184677,0,184677,COST
06069811160050000,2021,387972,14250,402222,COST
06069811160050000,2020,313160,14980,328140,COST
06069811160050000,2019,313160,14980,328140,COST
06069811201010000,2021,387972,257040,645012,COST
06069811201010000,2020,313160,244430,557590,COST
06069811201010000,2019,313160,244430,557590,COST
06069811201010100,2021,76568,0,76568,COST
06069811201010100,2020,57896,0,57896,COST
06069811201010100,2019,57896,0,57896,COST
06069811201030000,2021,282153,765770,1047923,COST
06069811201030000,2020,199222,831680,1030902,OVR
06069811201030000,2019,199222,831680,1030902,COST
06069811201050000,2021,280722,303178,583900,MKT
06069811201050000,2020,241534,267366,508900,MKT
06069811201050000,2019,241534,235166,476700,MKT
06069811201070000,2021,281167,507633,788800,MKT
06069811201070000,2020,241976,527420,769396,COST
06069811201070000,2019,241976,258500,500476,COST
06069811201090000,2021,277313,0,277313,COST
06069811201090000,2020,238156,0,238156,COST
06069811201090000,2019,238156,0,238156,COST
06069811201110000,2021,307554,302946,610500,MKT
06069811201110000,2020,235474,255526,491000,MKT
06069811201110000,2019,235474,255526,491000,MKT
06069811201156500,2021,110842,0,110842,COST
06069811201156500,2020,88689,0,88689,COST
06069811201156500,2019,88689,0,88689,COST
06069811202010000,2021,219810,319290,539100,MKT
06069811202010000,2020,162665,335535,498200,MKT
06069811202010000,2019,162665,335535,498200,MKT
06069811202020000,2021,223549,315251,538800,MKT
06069811202020000,2020,165858,334342,500200,MKT
06069811202020000,2019,165858,334342,500200,MKT
06069811202030000,2021,278876,224324,503200,MKT
06069811202030000,2020,214022,202978,417000,MKT
06069811202030000,2019,214022,202978,417000,MKT
06069811202050000,2021,278625,264575,543200,MKT
06069811202050000,2020,213800,221900,435700,MKT
06069811202050000,2019,213800,221900,435700,MKT
06069811202070000,2021,286368,0,286368,COST
06069811202070000,2020,220664,0,220664,COST
06069811202070000,2019,220664,0,220664,COST
06069811202090000,2021,257782,307940,565722,COST
06069811202090000,2020,195468,301932,497400,MKT
06069811202090000,2019,195468,301932,497400,MKT
06069811202990000,2021,220834,194390,415224,COST
06069811202990000,2020,163642,187500,351142,COST
06069811202990000,2019,163642,187500,351142,COST
06069811203010000,2021,286750,228250,515000,MKT
06069811203010000,2020,221003,207397,428400,MKT
06069811203010000,2019,221003,207397,428400,MKT
06069811203030000,2021,286702,0,286702,COST
06069811203030000,2020,220961,0,220961,COST
06069811203030000,2019,220961,0,220961,COST
06069811203050000,2021,285553,187447,473000,MKT
06069811203050000,2020,219897,173903,393800,MKT
06069811203050000,2019,219897,173903,393800,MKT
06069811203070000,2021,284541,0,284541,COST
06069811203070000,2020,219041,0,219041,COST
06069811203070000,2019,219041,0,219041,COST
06069811203090000,2021,277161,246539,523700,MKT
06069811203090000,2020,212505,227095,439600,MKT
06069811203090000,2019,212505,227095,439600,MKT
06069811203110000,2021,277009,345991,623000,MKT
06069811203110000,2020,212370,304830,517200,MKT
06069811203110000,2019,212370,244830,457200,MKT
06069811203130000,2021,274654,241646,516300,MKT
06069811203130000,2020,210290,234310,444600,MKT
06069811203130000,2019,210290,234310,444600,MKT
06069811203150000,2021,277313,454187,731500,MKT
06069811203150000,2020,212639,485661,698300,MKT
06069811203150000,2019,212639,485661,698300,MKT
06069811204010000,2021,283425,965650,1249075,COST
06069811204010000,2020,218051,961560,1179611,COST
06069811204010000,2019,218051,961560,1179611,COST
06069811204020000,2021,248005,333195,581200,MKT
06069811204020000,2020,186947,285653,472600,MKT
06069811204020000,2019,186947,285653,472600,MKT
06069811205010000,2021,271368,284532,555900,MKT
06069811205010000,2020,207392,240508,447900,MKT
06069811205010000,2019,207392,240708,448100,MKT
06069811205020000,2021,266979,257521,524500,MKT
06069811205020000,2020,203530,245170,448700,MKT
06069811205020000,2019,203530,245170,448700,MKT
06069811205030000,2021,261836,396264,658100,MKT
06069811205030000,2020,199017,409883,608900,MKT
06069811205030000,2019,199017,409883,608900,MKT
06069811205040000,2021,259566,499734,759300,MKT
06069811205040000,2020,197029,493071,690100,MKT
06069811205040000,2019,197029,301171,498200,MKT
06069811205050000,2021,261328,371172,632500,MKT
06069811205050000,2020,198572,327128,525700,MKT
06069811205050000,2019,198572,327128,525700,MKT
06069811205060000,2021,294475,401825,696300,MKT
06069811205060000,2020,227881,455419,683300,MKT
06069811205060000,2019,227881,455419,683300,MKT
06069811205070000,2021,233507,316293,549800,MKT
06069811205070000,2020,174405,283795,458200,MKT
06069811205070000,2019,174405,283795,458200,MKT
06069811205080000,2021,238942,479458,718400,MKT
06069811205080000,2020,179093,470707,649800,MKT
06069811205080000,2019,179093,470707,649800,MKT
06069811205090000,2021,238942,211558,450500,MKT
06069811205090000,2020,179093,224607,403700,MKT
06069811205090000,2019,179093,224607,403700,MKT
06069811205100000,2021,241902,294998,536900,MKT
06069811205100000,2020,181653,281847,463500,MKT
06069811205100000,2019,181653,281847,463500,MKT
06069811205110000,2021,337166,203234,540400,MKT
06069811205110000,2020,266373,196027,462400,MKT
06069811205110000,2019,266373,196027,462400,MKT
06069811205120000,2021,293473,200170,493643,COST
06069811205120000,2020,226987,152060,379047,COST
06069811205120000,2019,226987,152060,379047,COST
06069811206010000,2021,305540,273060,578600,MKT
06069811206010000,2020,237781,247019,484800,MKT
06069811206010000,2019,237781,247019,484800,MKT
06069811206020000,2021,330555,195545,526100,MKT
06069811206020000,2020,260361,181239,441600,MKT
06069811206020000,2019,260361,181239,441600,MKT
06069811206030000,2021,302540,267640,570180,COST
06069811206030000,2020,235091,259560,494651,COST
06069811206030000,2019,235091,259560,494651,COST
06069811206040000,2021,292141,351459,643600,MKT
06069811206040000,2020,225800,321900,547700,MKT
06069811206040000,2019,225800,321900,547700,MKT
06069811206050000,2021,252529,248271,500800,MKT
06069811206050000,2020,190884,240816,431700,MKT
06069811206050000,2019,190884,240816,431700,MKT
06069811206060000,2021,231338,217262,448600,MKT
06069811206060000,2020,172538,240762,413300,MKT
06069811206060000,2019,172538,240762,413300,MKT
06069811207010000,2021,229274,234626,463900,MKT
06069811207010000,2020,170765,262035,432800,MKT
06069811207010000,2019,170765,262035,432800,MKT
06069811207020000,2021,241967,310333,552300,MKT
06069811207020000,2020,181709,291591,473300,MKT
06069811207020000,2019,181709,291591,473300,MKT
06069811207030000,2021,241902,240898,482800,MKT
06069811207030000,2020,181653,264347,446000,OVR
06069811207030000,2019,181653,264347,446000,MKT
06069811207040000,2021,245812,245388,491200,MKT
06069811207040000,2020,185042,261358,446400,MKT
06069811207040000,2019,185042,261358,446400,MKT
06069811207050000,2021,280325,305375,585700,MKT
06069811207050000,2020,215304,278596,493900,MKT
06069811207050000,2019,215304,278596,493900,MKT
06069811207060000,2021,261102,272698,533800,MKT
06069811207060000,2020,198374,244626,443000,MKT
06069811207060000,2019,198374,244626,443000,MKT
06069811207070000,2021,261159,194841,456000,MKT
06069811207070000,2020,198423,202777,401200,MKT
06069811207070000,2019,198423,202777,401200,MKT
06069811207080000,2021,241967,384933,626900,MKT
06069811207080000,2020,181709,393891,575600,MKT
06069811207080000,2019,181709,393891,575600,MKT
06069811207090000,2021,243325,312575,555900,MKT
06069811207090000,2020,182886,314214,497100,MKT
06069811207090000,2019,182886,314214,497100,MKT
06069811208010000,2021,259623,233777,493400,MKT
06069811208010000,2020,197079,179721,376800,OVR
06069811208010000,2019,197079,179721,376800,MKT
06069811208020000,2021,258129,217171,475300,MKT
06069811208020000,2020,195772,210428,406200,MKT
06069811208020000,2019,195772,210428,406200,MKT
06069811208030000,2021,267033,394167,661200,MKT
06069811208030000,2020,203578,377422,581000,MKT
06069811208030000,2019,203578,377422,581000,MKT
06069811208040000,2021,259394,317006,576400,MKT
06069811208040000,2020,196879,302521,499400,MKT
06069811208040000,2019,196879,302521,499400,MKT
06069811208050000,2021,250713,262387,513100,MKT
06069811208050000,2020,189302,271298,460600,MKT
06069811208050000,2019,189302,271298,460600,MKT
06069811208060000,2021,242032,295668,537700,MKT
06069811208060000,2020,181766,308934,490700,MKT
06069811208060000,2019,181766,308934,490700,MKT
06069811208070000,2021,245496,440304,685800,MKT
06069811208070000,2020,184768,432532,617300,MKT
06069811208070000,2019,184768,432532,617300,MKT
06069811241010000,2021,385874,949000,1334874,COST
06069811241010000,2020,311209,907610,1218819,COST
06069811241010000,2019,311209,907610,1218819,COST
06069811241040000,2021,253369,345431,598800,MKT
06069811241040000,2020,191616,283884,475500,MKT
06069811241040000,2019,191616,264884,456500,MKT
06069811241050000,2021,219500,0,219500,COST
06069811241050000,2020,162400,0,162400,COST
06069811241050000,2019,162400,0,162400,COST
06069811292030000,2021,407644,903600,1311244,COST
06069811292030000,2020,331536,892480,1224016,COST
06069811292030000,2019,331536,892480,1224016,COST
06069811301050000,2021,327887,0,327887,COST
06069811301050000,2020,257940,0,257940,COST
06069811301050000,2019,257940,0,257940,COST
06069811302010000,2021,219578,0,219578,COST
06069811302010000,2020,162466,0,162466,COST
06069811302010000,2019,162466,0,162466,COST
06069811302020000,2021,238542,272158,510700,MKT
06069811302020000,2020,178747,253753,432500,MKT
06069811302020000,2019,178747,253753,432500,MKT
06069811302030000,2021,219655,380145,599800,MKT
06069811302030000,2020,162532,330868,493400,MKT
06069811302030000,2019,162532,330868,493400,MKT
06069811302040000,2021,219500,326700,546200,MKT
06069811302040000,2020,162400,314800,477200,MKT
06069811302040000,2019,162400,314800,477200,MKT
06069811302050000,2021,219500,320600,540100,MKT
06069811302050000,2020,162400,306100,468500,MKT
06069811302050000,2019,162400,306100,468500,MKT
06069811302150000,2021,319164,0,319164,COST
06069811302150000,2020,250045,0,250045,COST
06069811302150000,2019,250045,0,250045,COST
06069811302160000,2021,281019,915381,1196400,MKT
06069811302160000,2020,215919,738581,954500,MKT
06069811302160000,2019,215919,738581,954500,MKT
06069811302170000,2021,281019,290581,571600,MKT
06069811302170000,2020,215919,251681,467600,MKT
06069811302170000,2019,215919,251681,467600,MKT
06069811302250000,2021,355604,577150,932754,COST
06069811302250000,2020,283236,558580,841816,COST
06069811302250000,2019,283236,558580,841816,COST
06069811302350000,2021,365638,691040,1056678,COST
06069811302350000,2020,256648,671120,927768,COST
06069811302350000,2019,256648,671120,927768,COST
06069811302370000,2021,340004,0,340004,COST
06069811302370000,2020,236018,0,236018,COST
06069811302370000,2019,236018,0,236018,COST
06069811302390000,2021,362708,0,362708,COST
06069811302390000,2020,254279,0,254279,COST
06069811302390000,2019,254279,0,254279,COST
06069811304010000,2021,219810,271580,491390,COST
06069811304010000,2020,162665,271435,434100,MKT
06069811304010000,2019,162665,271435,434100,MKT
06069811304020000,2021,219500,417500,637000,MKT
06069811304020000,2020,162400,437300,599700,MKT
06069811304020000,2019,162400,437300,599700,MKT
06069811304030000,2021,219500,392600,612100,MKT
06069811304030000,2020,162400,382080,544480,COST
06069811304030000,2019,162400,382080,544480,COST
06069811304040000,2021,219500,583600,803100,MKT
06069811304040000,2020,162400,555800,718200,MKT
06069811304040000,2019,162400,555800,718200,MKT
06069811304050000,2021,219500,0,219500,COST
06069811304050000,2020,162400,0,162400,COST
06069811304050000,2019,162400,0,162400,COST
06069811304060000,2021,219500,447100,666600,MKT
06069811304060000,2020,162400,408700,571100,MKT
06069811304060000,2019,162400,408700,571100,MKT
06069811304070000,2021,219500,415300,634800,MKT
06069811304070000,2020,162400,408400,570800,MKT
06069811304070000,2019,162400,408400,570800,MKT
06069811304080000,2021,219500,339400,558900,MKT
06069811304080000,2020,162400,333600,496000,MKT
06069811304080000,2019,162400,333600,496000,MKT
06069811304090000,2021,226150,319150,545300,MKT
06069811304090000,2020,168086,312814,480900,MKT
06069811304090000,2019,168086,312814,480900,MKT
06069811304100000,2021,219500,430100,649600,MKT
06069811304100000,2020,162400,424100,586500,MKT
06069811304100000,2019,162400,424100,586500,MKT
06069811305010000,2021,377065,386890,763955,COST
06069811305010000,2020,269865,346435,616300,MKT
06069811305010000,2019,269865,346435,616300,MKT
06069811305020000,2021,219500,220400,439900,MKT
06069811305020000,2020,162400,232300,394700,MKT
06069811305020000,2019,162400,232300,394700,MKT
06069811305030000,2021,219500,504600,724100,MKT
06069811305030000,2020,162400,413600,576000,MKT
06069811305030000,2019,162400,413600,576000,MKT
06069811305040000,2021,220197,296803,517000,MKT
06069811305040000,2020,162995,336105,499100,MKT
06069811305040000,2019,162995,336105,499100,MKT
06069811305050000,2021,377065,424235,801300,MKT
06069811305050000,2020,269865,363035,632900,MKT
06069811305050000,2019,269865,363035,632900,MKT
06069811305060000,2021,220120,712180,932300,MKT
06069811305060000,2020,162929,569480,732409,COST
06069811305060000,2019,162929,569480,732409,COST
06069811305070000,2021,220120,262680,482800,MKT
06069811305070000,2020,162929,274871,437800,MKT
06069811305070000,2019,162929,274871,437800,MKT
06069811305080000,2021,219578,367322,586900,MKT
06069811305080000,2020,162466,339534,502000,MKT
06069811305080000,2019,162466,339534,502000,MKT
06069811305096500,2021,122814,0,122814,COST
06069811305096500,2020,99821,0,99821,COST
06069811305096500,2019,99821,0,99821,COST
06069811320010000,2021,235367,336433,571800,MKT
06069811320010000,2020,176007,344993,521000,MKT
06069811320010000,2019,176007,344993,521000,MKT
06069811320040000,2021,231055,356945,588000,MKT
06069811320040000,2020,172295,391405,563700,MKT
06069811320040000,2019,172295,391405,563700,MKT
06069811320070000,2021,220737,449863,670600,MKT
06069811320070000,2020,163455,466145,629600,MKT
06069811320070000,2019,163455,466145,629600,MKT
06069811320100000,2021,224819,417981,642800,MKT
06069811320100000,2020,166945,413355,580300,MKT
06069811320100000,2019,166945,413355,580300,MKT
06069811320130000,2021,219733,477467,697200,MKT
06069811320130000,2020,162599,509501,672100,MKT
06069811320130000,2019,162599,509501,672100,MKT
06069811320160000,2021,223849,553151,777000,MKT
06069811320160000,2020,166115,473585,639700,MKT
06069811320160000,2019,166115,473585,639700,MKT
06069811320190000,2021,221120,466180,687300,MKT
06069811320190000,2020,163783,466717,630500,MKT
06069811320190000,2019,163783,466717,630500,MKT
06069811320220000,2021,228482,456018,684500,MKT
06069811320220000,2020,170085,470315,640400,MKT
06069811320220000,2019,170085,470315,640400,MKT
06069811320250000,2021,235161,347539,582700,MKT
06069811320250000,2020,175830,370470,546300,MKT
06069811320250000,2019,175830,370470,546300,MKT
06069811320280000,2021,247881,617219,865100,MKT
06069811320280000,2020,186839,601261,788100,MKT
06069811320280000,2019,186839,601261,788100,MKT
06069811322010000,2021,239768,443680,683448,COST
06069811322010000,2020,192912,535588,728500,MKT
06069811322010000,2019,192912,535588,728500,MKT
06069811322040000,2021,283773,993127,1276900,MKT
06069811322040000,2020,191616,686184,877800,MKT
06069811322040000,2019,191616,0,191616,COST
06069811322070000,2021,283840,698379,982219,MRA
06069811322070000,2020,191668,654860,846528,COST
06069811322070000,2019,191668,654860,846528,COST
06069811322100000,2021,283840,653560,937400,MKT
06069811322100000,2020,191668,665732,857400,MKT
06069811322100000,2019,191668,665732,857400,MKT
06069811322130000,2021,283840,0,283840,COST
06069811322130000,2020,191668,0,191668,COST
06069811322130000,2019,191668,0,191668,COST
06069811322160000,2021,285305,370595,655900,MKT
06069811322160000,2020,192809,426391,619200,MKT
06069811322160000,2019,192809,426391,619200,MKT
06069811322190000,2021,247225,451975,699200,MKT
06069811322190000,2020,163455,455145,618600,MKT
06069811322190000,2019,163455,455145,618600,MKT
06069811322220000,2021,266867,510033,776900,MKT
06069811322220000,2020,178516,594473,772989,OVR
06069811322220000,2019,178516,594473,772989,OVR
06069811322250000,2021,244223,0,244223,COST
06069811322250000,2020,183664,0,183664,COST
06069811322250000,2019,183664,0,183664,COST
06069811322280000,2021,219965,537835,757800,MKT
06069811322280000,2020,162797,531203,694000,MKT
06069811322280000,2019,162797,497103,659900,MKT
06069811322310000,2021,233715,302385,536100,MKT
06069811322310000,2020,174584,304916,479500,MKT
06069811322310000,2019,174584,304916,479500,MKT
06069811322340000,2021,230488,476012,706500,MKT
06069811322340000,2020,171808,454292,626100,MKT
06069811322340000,2019,171808,454292,626100,MKT
06069811322370000,2021,226298,440102,666400,MKT
06069811322370000,2020,168212,414888,583100,MKT
06069811322370000,2019,168212,414888,583100,MKT
06069811326120000,2021,263764,561310,825074,COST
06069811326120000,2020,176125,486275,662400,MKT
06069811326120000,2019,176125,486275,662400,MKT
06069811326126500,2021,2828,0,2828,COST
06069811326126500,2020,2632,0,2632,COST
06069811326126500,2019,2632,0,2632,COST
06069811326550000,2021,263764,833940,1097704,COST
06069811326550000,2020,176125,804340,980465,COST
06069811326550000,2019,176125,804340,980465,COST
06069811326600000,2021,276227,451373,727600,MKT
06069811326600000,2020,185753,422020,607773,COST
06069811326600000,2019,185753,422020,607773,COST
06069811326720000,2021,261450,1364699,1626149,MRA
06069811326720000,2020,174345,1425655,1600000,OVR
06069811326720000,2019,174345,1425655,1600000,OVR
06069811401010000,2021,497877,241260,739137,COST
06069811401010000,2020,417491,234550,652041,COST
06069811401010000,2019,417491,234550,652041,COST
06069811401030000,2021,323916,0,323916,COST
06069811401030000,2020,223191,0,223191,COST
06069811401030000,2019,223191,0,223191,COST
06069811401050000,2021,323916,0,323916,COST
06069811401050000,2020,223191,0,223191,COST
06069811401050000,2019,223191,0,223191,COST
06069811401100000,2021,323916,0,323916,COST
06069811401100000,2020,223191,0,223191,COST
06069811401100000,2019,223191,0,223191,COST
06069811401150000,2021,323916,0,323916,COST
06069811401150000,2020,223191,0,223191,COST
06069811401150000,2019,223191,0,223191,COST
06069811401180000,2021,323916,0,323916,COST
06069811401180000,2020,223191,0,223191,COST
06069811401180000,2019,223191,0,223191,COST
06069811401200000,2021,323916,349184,673100,MKT
06069811401200000,2020,223191,392509,615700,MKT
06069811401200000,2019,223191,392509,615700,MKT
06069811401256500,2021,158079,0,158079,COST
06069811401256500,2020,133538,0,133538,COST
06069811401256500,2019,133538,0,133538,COST
06069811401320000,2021,509689,589020,1098709,COST
06069811401320000,2020,428930,577210,1006140,COST
06069811401320000,2019,428930,577210,1006140,COST
06069811401370000,2021,300976,0,300976,COST
06069811401370000,2020,233691,0,233691,COST
06069811401370000,2019,233691,0,233691,COST
06069811401400000,2021,531982,448890,980872,COST
06069811401400000,2020,450631,420260,870891,OVR
06069811401400000,2019,450631,420260,870891,COST
06069811401450000,2021,522413,815900,1338313,COST
06069811401450000,2020,441298,786850,1228148,COST
06069811401450000,2019,441298,933130,1374428,COST
06069811401500000,2021,499319,455120,954439,COST
06069811401500000,2020,418885,430810,849695,COST
06069811401500000,2019,418885,430810,849695,COST
06069811401550000,2021,217621,0,217621,COST
06069811401550000,2020,160798,0,160798,COST
06069811401550000,2019,160798,0,160798,COST
06069811401580000,2021,217936,478764,696700,MKT
06069811401580000,2020,161067,472933,634000,MKT
06069811401580000,2019,161067,472933,634000,MKT
06069811401600000,2021,217621,389579,607200,MKT
06069811401600000,2020,160798,423502,584300,MKT
06069811401600000,2019,160798,423502,584300,MKT
06069811405010000,2021,273410,380490,653900,MKT
06069811405010000,2020,209193,450980,660173,OVR
06069811405010000,2019,209193,450980,660173,COST
06069811405020000,2021,311547,417553,729100,MKT
06069811405020000,2020,243178,343022,586200,MKT
06069811405020000,2019,243178,343022,586200,MKT
06069811405030000,2021,290613,0,290613,COST
06069811405030000,2020,224439,490810,715249,COST
06069811405030000,2019,224439,490810,715249,COST
06069811405040000,2021,290613,505400,796013,COST
06069811405040000,2020,232435,0,232435,COST
06069811405040000,2019,232435,0,232435,COST
06069811405050000,2021,273930,314270,588200,MKT
06069811405050000,2020,209651,266349,476000,MKT
06069811405050000,2019,209651,266349,476000,MKT
06069811405090000,2021,598646,543200,1141846,COST
06069811405090000,2020,516336,520350,1036686,COST
06069811405090000,2019,516336,520350,1036686,COST
06069811433010000,2021,336134,505066,841200,MKT
06069811433010000,2020,265434,538550,803984,COST
06069811433010000,2019,265434,538550,803984,COST
06069811433050000,2021,336312,346688,683000,MKT
06069811433050000,2020,265596,310104,575700,MKT
06069811433050000,2019,265596,310104,575700,MKT
06069811433100000,2021,336704,591410,928114,COST
06069811433100000,2020,265953,572170,838123,COST
06069811433100000,2019,265953,572170,838123,COST
06069811433150000,2021,333836,0,333836,COST
06069811433150000,2020,263343,0,263343,COST
06069811433150000,2019,263343,0,263343,COST
06069811454010000,2021,323389,203811,527200,MKT
06069811454010000,2020,222773,240527,463300,MKT
06069811454010000,2019,222773,240527,463300,MKT
06069811454050000,2021,289211,313589,602800,MKT
06069811454050000,2020,223191,258740,481931,COST
06069811454050000,2019,223191,258740,481931,COST
06069811454100000,2021,289211,0,289211,COST
06069811454100000,2020,223191,0,223191,COST
06069811454100000,2019,223191,0,223191,COST
06069811454150000,2021,285889,464620,750509,COST
06069811454150000,2020,220239,451860,672099,COST
06069811454150000,2019,220239,451860,672099,COST
06069811456010000,2021,283473,436027,719500,MKT
06069811456010000,2020,218094,386206,604300,MKT
06069811456010000,2019,218094,386206,604300,MKT
06069811456050000,2021,282986,246014,529000,MKT
06069811456050000,2020,217661,228739,446400,MKT
06069811456050000,2019,217661,228739,446400,MKT
06069811456150000,2021,282986,361614,644600,MKT
06069811456150000,2020,217661,379339,597000,MKT
06069811456150000,2019,217661,379339,597000,MKT
06069811492010000,2021,253369,290531,543900,MKT
06069811492010000,2020,191616,270984,462600,MKT
06069811492010000,2019,191616,270984,462600,MKT
06069811492020000,2021,244159,309941,554100,MKT
06069811492020000,2020,183609,311191,494800,MKT
06069811492020000,2019,183609,311191,494800,MKT
06069812101040000,2021,387972,276410,664382,COST
06069812101040000,2020,313160,269840,583000,MKT
06069812101040000,2019,313160,259040,572200,MKT
06069812101070000,2021,17332,3590,20922,COST
06069812101070000,2020,9599,3560,13159,COST
06069812101070000,2019,9599,3560,13159,COST
06069812101090000,2021,166,0,166,COST
06069812101090000,2020,155,0,155,COST
06069812101090000,2019,155,0,155,COST
06069812103010000,2021,221898,295402,517300,MKT
06069812103010000,2020,165449,282551,448000,MKT
06069812103010000,2019,165449,282551,448000,MKT
06069812103020000,2021,214251,296949,511200,MKT
06069812103020000,2020,158894,267940,426834,COST
06069812103020000,2019,158894,267940,426834,COST
06069812103030000,2021,214251,287449,501700,MKT
06069812103030000,2020,158894,291706,450600,MKT
06069812103030000,2019,158894,291706,450600,MKT
06069812103040000,2021,214251,235849,450100,MKT
06069812103040000,2020,158894,223306,382200,MKT
06069812103040000,2019,158894,223306,382200,MKT
06069812103050000,2021,223371,258029,481400,MKT
06069812103050000,2020,166716,269084,435800,MKT
06069812103050000,2019,166716,269084,435800,MKT
06069812103060000,2021,246089,665611,911700,MKT
06069812103060000,2020,186412,640310,826722,COST
06069812103060000,2019,186412,640310,826722,COST
06069812103070000,2021,440682,494970,935652,COST
06069812103070000,2020,325322,474100,799422,COST
06069812103070000,2019,325322,474100,799422,COST
06069812103080000,2021,287144,783340,1070484,COST
06069812103080000,2020,198541,759530,958071,COST
06069812103080000,2019,198541,759530,958071,COST
06069812103090000,2021,284855,437445,722300,MKT
06069812103090000,2020,196717,472783,669500,MKT
06069812103090000,2019,196717,472783,669500,MKT
06069812103100000,2021,287954,582046,870000,MKT
06069812103100000,2020,199186,651160,850346,COST
06069812103100000,2019,199186,586170,785356,COST
06069812103110000,2021,282698,589702,872400,MKT
06069812103110000,2020,195001,566699,761700,OVR
06069812103110000,2019,195001,566699,761700,MKT
06069812103120000,2021,303635,549565,853200,MKT
06069812103120000,2020,211744,586556,798300,MKT
06069812103120000,2019,211744,586556,798300,MKT
06069812103130000,2021,305240,395550,700790,COST
06069812103130000,2020,213034,360766,573800,MKT
06069812103130000,2019,213034,360766,573800,MKT
06069812103140000,2021,304513,768590,1073103,COST
06069812103140000,2020,212449,721251,933700,MKT
06069812103140000,2019,212449,721251,933700,MKT
06069812103180000,2021,155298,0,155298,COST
06069812103180000,2020,99863,0,99863,COST
06069812103180000,2019,99863,0,99863,COST
06069812104020000,2021,233217,478583,711800,MKT
06069812104020000,2020,175216,411984,587200,MKT
06069812104020000,2019,175216,411984,587200,MKT
06069812104030000,2021,234563,517537,752100,MKT
06069812104030000,2020,176383,460517,636900,MKT
06069812104030000,2019,176383,460517,636900,MKT
06069812104040000,2021,233217,441983,675200,MKT
06069812104040000,2020,175216,427984,603200,MKT
06069812104040000,2019,175216,427984,603200,MKT
06069812105010000,2021,242358,344240,586598,COST
06069812105010000,2020,183157,376343,559500,MKT
06069812105010000,2019,183157,376343,559500,MKT
06069812105020000,2021,265512,0,265512,COST
06069812105020000,2020,203474,0,203474,COST
06069812105020000,2019,203474,0,203474,COST
06069812105030000,2021,273816,323984,597800,MKT
06069812105030000,2020,210827,298173,509000,MKT
06069812105030000,2019,210827,298173,509000,MKT
06069812105040000,2021,254301,398599,652900,MKT
06069812105040000,2020,193601,419799,613400,MKT
06069812105040000,2019,193601,419799,613400,MKT
06069812105050000,2021,231857,462670,694527,COST
06069812105050000,2020,174039,377761,551800,MKT
06069812105050000,2019,174039,377761,551800,MKT
06069812105060000,2021,247310,466990,714300,MKT
06069812105060000,2020,187479,420821,608300,MKT
06069812105060000,2019,187479,420821,608300,MKT
06069812105070000,2021,238648,471352,710000,MKT
06069812105070000,2020,179929,405971,585900,MKT
06069812105070000,2019,179929,405971,585900,MKT
06069812105080000,2021,223371,640629,864000,MKT
06069812105080000,2020,166716,634484,801200,MKT
06069812105080000,2019,166716,634484,801200,MKT
06069812105100000,2021,264441,411059,675500,MKT
06069812105100000,2020,202527,365673,568200,MKT
06069812105100000,2019,202527,365673,568200,MKT
06069812105110000,2021,261177,335223,596400,MKT
06069812105110000,2020,199648,250752,450400,MKT
06069812105110000,2019,199648,250752,450400,MKT
06069812105120000,2021,264441,455020,719461,COST
06069812105120000,2020,202527,441760,644287,COST
06069812105120000,2019,202527,441760,644287,COST
06069812106010000,2021,223371,256229,479600,MKT
06069812106010000,2020,166716,264984,431700,MKT
06069812106010000,2019,166716,264984,431700,MKT
06069812106020000,2021,220407,507210,727617,COST
06069812106020000,2020,164168,495440,659608,COST
06069812106020000,2019,164168,342332,506500,MKT
06069812106030000,2021,221898,218602,440500,MKT
06069812106030000,2020,165449,240351,405800,MKT
06069812106030000,2019,165449,240351,405800,MKT
06069812106040000,2021,224826,217374,442200,MKT
06069812106040000,2020,167969,220231,388200,MKT
06069812106040000,2019,167969,220231,388200,MKT
06069812106050000,2021,217369,238131,455500,MKT
06069812106050000,2020,161562,230438,392000,MKT
06069812106050000,2019,161562,230438,392000,MKT
06069812106060000,2021,214251,335649,549900,MKT
06069812106060000,2020,158894,284206,443100,MKT
06069812106060000,2019,158894,284206,443100,MKT
06069812106070000,2021,220407,778293,998700,MKT
06069812106070000,2020,164168,714832,879000,MKT
06069812106070000,2019,164168,403190,567358,COST
06069812106080000,2021,221898,388402,610300,MKT
06069812106080000,2020,165449,341851,507300,MKT
06069812106080000,2019,165449,341851,507300,MKT
06069812106090000,2021,227686,280414,508100,MKT
06069812106090000,2020,170434,271566,442000,MKT
06069812106090000,2019,170434,271566,442000,MKT
06069812106100000,2021,212661,238039,450700,MKT
06069812106100000,2020,157535,259765,417300,MKT
06069812106100000,2019,157535,259765,417300,MKT
06069812106110000,2021,211048,250652,461700,MKT
06069812106110000,2020,156158,269742,425900,MKT
06069812106110000,2019,156158,269742,425900,MKT
06069812107010000,2021,363033,0,363033,COST
06069812107010000,2020,291836,0,291836,COST
06069812107010000,2019,291836,0,291836,COST
06069812107020000,2021,344774,1702030,2046804,COST
06069812107020000,2020,274981,1644250,1919231,COST
06069812107020000,2019,274981,1644250,1919231,COST
06069812107030000,2021,346227,653110,999337,COST
06069812107030000,2020,276316,639480,915796,COST
06069812107030000,2019,276316,639480,915796,COST
06069812107040000,2021,327928,249470,577398,COST
06069812107040000,2020,259549,231251,490800,MKT
06069812107040000,2019,259549,231251,490800,MKT
06069812107050000,2021,315287,402113,717400,MKT
06069812107050000,2020,248049,333451,581500,MKT
06069812107050000,2019,248049,333451,581500,MKT
06069812107060000,2021,319906,311094,631000,MKT
06069812107060000,2020,252243,240657,492900,MKT
06069812107060000,2019,252243,240657,492900,MKT
06069812107070000,2021,314661,328339,643000,MKT
06069812107070000,2020,247482,261118,508600,MKT
06069812107070000,2019,247482,261118,508600,MKT
06069812107080000,2021,314661,380139,694800,MKT
06069812107080000,2020,247482,355718,603200,MKT
06069812107080000,2019,247482,355718,603200,MKT
06069812108010000,2021,342373,413927,756300,MKT
06069812108010000,2020,272774,361326,634100,MKT
06069812108010000,2019,272774,361326,634100,MKT
06069812108020000,2021,365312,257530,622842,COST
06069812108020000,2020,293949,235551,529500,MKT
06069812108020000,2019,293949,235551,529500,MKT
06069812108030000,2021,312930,268570,581500,MKT
06069812108030000,2020,245912,253588,499500,MKT
06069812108030000,2019,245912,253588,499500,MKT
06069812108040000,2021,279,0,279,COST
06069812108040000,2020,260,0,260,COST
06069812108040000,2019,260,0,260,COST
06069812108050000,2021,457558,597950,1055508,COST
06069812108050000,2020,306009,545297,851306,MRA
06069812108050000,2019,306009,545297,851306,MRA
06069812108060000,2021,396103,550900,947003,COST
06069812108060000,2020,322693,528950,851643,COST
06069812108060000,2019,322693,528950,851643,COST
06069812108070000,2021,321721,434190,755911,COST
06069812108070000,2020,253893,430680,684573,COST
06069812108070000,2019,253893,430680,684573,COST
06069812108080000,2021,337820,258880,596700,MKT
06069812108080000,2020,268596,270404,539000,MKT
06069812108080000,2019,268596,270404,539000,MKT
06069812109010000,2021,374121,482510,856631,COST
06069812109010000,2020,302136,469330,771466,COST
06069812109010000,2019,302136,469330,771466,COST
06069812109020000,2021,379308,468892,848200,MKT
06069812109020000,2020,306970,458620,765590,COST
06069812109020000,2019,306970,458620,765590,COST
06069812110010000,2021,362852,609030,971882,COST
06069812110010000,2020,291668,594400,886068,COST
06069812110010000,2019,291668,594400,886068,COST
06069812110020000,2021,363575,363300,726875,COST
06069812110020000,2020,292338,346100,638438,COST
06069812110020000,2019,292338,346100,638438,COST
06069812110030000,2021,348904,469270,818174,COST
06069812110030000,2020,278782,452410,731192,COST
06069812110030000,2019,278782,465450,744232,COST
06069812111010000,2021,305327,491830,797157,COST
06069812111010000,2020,239037,447763,686800,MKT
06069812111010000,2019,239037,447763,686800,MKT
06069812111020000,2021,312851,275149,588000,MKT
06069812111020000,2020,245841,223459,469300,MKT
06069812111020000,2019,245841,223459,469300,MKT
06069812111030000,2021,310380,270920,581300,MKT
06069812111030000,2020,243603,219197,462800,MKT
06069812111030000,2019,243603,219197,462800,MKT
06069812111040000,2021,313955,324645,638600,MKT
06069812111040000,2020,246841,301759,548600,MKT
06069812111040000,2019,246841,256759,503600,MKT
06069812112010000,2021,310540,488870,799410,COST
06069812112010000,2020,243748,479652,723400,MKT
06069812112010000,2019,243748,479652,723400,MKT
06069812112020000,2021,366915,0,366915,COST
06069812112020000,2020,295437,0,295437,COST
06069812112020000,2019,295437,0,295437,COST
06069812113010000,2021,288619,581290,869909,COST
06069812113010000,2020,224021,571200,795221,COST
06069812113010000,2019,224021,571200,795221,COST
06069812113050000,2021,334419,0,334419,COST
06069812113050000,2020,266376,0,266376,COST
06069812113100000,2021,337545,0,337545,COST
06069812113100000,2020,268344,0,268344,COST
06069812114010000,2021,311819,0,311819,COST
06069812114010000,2020,244906,0,244906,COST
06069812114010000,2019,244906,0,244906,COST
06069812114020000,2021,315287,486013,801300,MKT
06069812114020000,2020,248049,435680,683729,COST
06069812114020000,2019,248049,435680,683729,COST
06069812114030000,2021,321796,352270,674066,COST
06069812114030000,2020,253962,329838,583800,MKT
06069812114030000,2019,253962,329838,583800,MKT
06069812114040000,2021,327782,313890,641672,COST
06069812114040000,2020,259416,273525,532941,OVR
06069812114040000,2019,259416,273525,532941,OVR
06069812114050000,2021,328073,318360,646433,COST
06069812114050000,2020,259681,286419,546100,MKT
06069812114050000,2019,259681,286419,546100,MKT
06069812114060000,2021,323218,483182,806400,MKT
06069812114060000,2020,255256,477844,733100,MKT
06069812114060000,2019,255256,477844,733100,MKT
06069812114070000,2021,318380,512320,830700,MKT
06069812114070000,2020,250857,490440,741297,COST
06069812114070000,2019,250857,490440,741297,COST
06069812114080000,2021,296578,481490,778068,COST
06069812114080000,2020,231158,461842,693000,MKT
06069812114080000,2019,231158,461842,693000,MKT
06069812115010000,2021,383442,300550,683992,COST
06069812115010000,2020,310831,298870,609701,COST
06069812115010000,2019,310831,298870,609701,COST
06069812115020000,2021,390422,340000,730422,COST
06069812115020000,2020,317363,303263,620626,MRA
06069812115020000,2019,317363,303263,620626,MRA
06069812115030000,2021,381082,608540,989622,COST
06069812115030000,2020,308626,588160,896786,COST
06069812115030000,2019,308626,588160,896786,COST
06069812115040000,2021,619778,453820,1073598,COST
06069812115040000,2020,540678,437450,978128,COST
06069812115040000,2019,540678,437450,978128,COST
06069812115060000,2021,627527,707330,1334857,COST
06069812115060000,2020,440445,626417,1066862,MRA
06069812115060000,2019,440445,626417,1066862,MRA
06069812116010000,2021,339464,340936,680400,MKT
06069812116010000,2020,270104,278796,548900,MKT
06069812116010000,2019,270104,278796,548900,MKT
06069812116020000,2021,330165,334735,664900,MKT
06069812116020000,2020,261592,279808,541400,MKT
06069812116020000,2019,261592,279808,541400,MKT
06069812116030000,2021,325294,379000,704294,COST
06069812116030000,2020,257147,346453,603600,MKT
06069812116030000,2019,257147,346453,603600,MKT
06069812116040000,2021,324777,0,324777,COST
06069812116040000,2020,256676,0,256676,COST
06069812116040000,2019,256676,0,256676,COST
06069812116050000,2021,323293,736710,1060003,COST
06069812116050000,2020,255324,728150,983474,COST
06069812116050000,2019,255324,728150,983474,COST
06069812116060000,2021,316065,630740,946805,COST
06069812116060000,2020,248755,571445,820200,MKT
06069812116060000,2019,248755,571445,820200,MKT
06069812116070000,2021,323442,625730,949172,COST
06069812116070000,2020,255460,600000,855460,COST
06069812116070000,2019,255460,600000,855460,COST
06069812116080000,2021,312534,402866,715400,MKT
06069812116080000,2020,245554,336146,581700,MKT
06069812116080000,2019,245554,336146,581700,MKT
06069812116096500,2021,164519,0,164519,COST
06069812116096500,2020,140883,0,140883,COST
06069812116096500,2019,140883,0,140883,COST
06069812117020000,2021,341835,0,341835,COST
06069812117020000,2020,272280,0,272280,COST
06069812117020000,2019,272280,0,272280,COST
06069812117030000,2021,313167,0,313167,COST
06069812117030000,2020,246127,0,246127,COST
06069812117030000,2019,246127,0,246127,COST
06069812118010000,2021,322546,0,322546,COST
06069812118010000,2020,254644,0,254644,COST
06069812118010000,2019,254644,0,254644,COST
06069812118020000,2021,380141,358890,739031,COST
06069812118020000,2020,307748,335152,642900,MKT
06069812118020000,2019,307748,335152,642900,MKT
06069812118030000,2021,410537,1615700,2026237,COST
06069812118030000,2020,336286,1546310,1882596,COST
06069812118030000,2019,336286,1546310,1882596,COST
06069812118040000,2021,456528,1896610,2353138,COST
06069812118040000,2020,380080,1556665,1936745,MRA
06069812118040000,2019,380080,1556665,1936745,MRA
06069812118050000,2021,543103,312220,855323,COST
06069812118050000,2020,372863,304290,677153,COST
06069812118050000,2019,372863,304290,677153,COST
06069812119010000,2021,539175,502190,1041365,COST
06069812119010000,2020,369431,434553,803984,MRA
06069812119010000,2019,521753,434553,956306,MRA
06069812119020000,2021,499065,0,499065,COST
06069812119020000,2020,338228,0,338228,COST
06069812119040000,2021,298380,621620,920000,MKT
06069812119040000,2020,231368,538770,770138,COST
06069812119040000,2019,231368,538770,770138,COST
06069812119070000,2021,272889,461411,734300,MKT
06069812119070000,2020,208733,422767,631500,MKT
06069812119070000,2019,208733,422767,631500,MKT
06069812119100000,2021,444859,13140,457999,COST
06069812119100000,2020,366667,13940,380607,COST
06069812119100000,2019,366667,13940,380607,COST
06069812119110000,2021,387972,237210,625182,COST
06069812119110000,2020,313160,228530,541690,COST
06069812119110000,2019,313160,228530,541690,COST
06069812119130000,2021,516188,451020,967208,COST
06069812119130000,2020,435241,440000,875241,COST
06069812119130000,2019,435241,440000,875241,COST
06069812119160000,2021,247694,418060,665754,COST
06069812119160000,2020,186677,408730,595407,COST
06069812119160000,2019,186677,408730,595407,COST
06069812201020000,2021,349521,486479,836000,MKT
06069812201020000,2020,277658,484530,762188,COST
06069812201020000,2019,277658,393650,671308,COST
06069812201030000,2021,274396,294604,569000,MKT
06069812201030000,2020,210062,240438,450500,MKT
06069812201030000,2019,210062,240438,450500,MKT
06069812201040000,2021,274396,225704,500100,MKT
06069812201040000,2020,210062,208638,418700,MKT
06069812201040000,2019,210062,208638,418700,MKT
06069812201050000,2021,274447,231353,505800,MKT
06069812201050000,2020,210108,191792,401900,MKT
06069812201050000,2019,210108,191792,401900,MKT
06069812202010000,2021,273930,211370,485300,MKT
06069812202010000,2020,209651,222849,432500,MKT
06069812202010000,2019,209651,222849,432500,MKT
06069812202020000,2021,273878,274322,548200,MKT
06069812202020000,2020,209605,246295,455900,MKT
06069812202020000,2019,209605,246295,455900,MKT
06069812202030000,2021,276907,208693,485600,MKT
06069812202030000,2020,212280,229820,442100,MKT
06069812202030000,2019,212280,229820,442100,MKT
06069812202040000,2021,305157,203843,509000,MKT
06069812202040000,2020,237437,183663,421100,MKT
06069812202040000,2019,237437,183663,421100,MKT
06069812202050000,2021,273566,592980,866546,COST
06069812202050000,2020,209331,583200,792531,COST
06069812202050000,2019,209331,583200,792531,COST
06069812203010000,2021,268868,789032,1057900,MKT
06069812203010000,2020,205191,681109,886300,MKT
06069812203010000,2019,205191,681109,886300,MKT
06069812203020000,2021,269029,392990,662019,COST
06069812203020000,2020,205333,382090,587423,COST
06069812203020000,2019,205333,382090,587423,COST
06069812203030000,2021,265009,326991,592000,MKT
06069812203030000,2020,201800,285300,487100,MKT
06069812203030000,2019,201800,285300,487100,MKT
06069812203040000,2021,264513,0,264513,COST
06069812203040000,2020,201364,0,201364,COST
06069812203040000,2019,201364,0,201364,COST
06069812203050000,2021,266924,0,266924,COST
06069812203050000,2020,203482,0,203482,COST
06069812203050000,2019,203482,0,203482,COST
06069812203060000,2021,270256,241144,511400,MKT
06069812203060000,2020,206413,269287,475700,MKT
06069812203060000,2019,206413,269287,475700,MKT
06069812203070000,2021,275989,241011,517000,MKT
06069812203070000,2020,211469,249531,461000,MKT
06069812203070000,2019,211469,249531,461000,MKT
06069812210010000,2021,397794,360070,757864,COST
06069812210010000,2020,322317,343680,665997,COST
06069812210010000,2019,322317,343680,665997,COST
06069812210050000,2021,389368,0,389368,COST
06069812210050000,2020,314459,0,314459,COST
06069812210050000,2019,314459,0,314459,COST
06069812210100000,2021,408295,0,408295,COST
06069812210100000,2020,332147,0,332147,COST
06069812210100000,2019,332147,0,332147,COST
06069812210150000,2021,409841,259600,669441,COST
06069812210150000,2020,333597,250920,584517,COST
06069812210150000,2019,333597,250920,584517,COST
06069812301150000,2021,24280,90670,114950,COST
06069812301150000,2020,13076,91380,104456,COST
06069812301150000,2019,13076,91380,104456,COST
06069812401010000,2021,136152,0,136152,COST
06069812401010000,2020,73532,0,73532,COST
06069812401010000,2019,73532,0,73532,COST
06069813101010000,2021,313300,0,313300,COST
06069813101010000,2020,168977,0,168977,COST
06069813101010000,2019,168977,0,168977,COST
06069814101010000,2021,164752,0,164752,COST
06069814101010000,2020,89228,0,89228,COST
06069814101010000,2019,89228,0,89228,COST
06069814101021000,2021,989,0,989,COST
06069814101021000,2020,920,0,920,COST
06069814101021000,2019,920,0,920,COST
06069814101021001,2021,187,0,187,COST
06069814101021001,2020,174,0,174,COST
06069814101021001,2019,174,0,174,COST
06069814101031000,2021,219750,219970,439720,COST
06069814101031000,2020,162633,213770,376403,COST
06069814101031000,2019,162633,213770,376403,COST
06069814101031001,2021,41,0,41,COST
06069814101031001,2020,38,0,38,COST
06069814101031001,2019,38,0,38,COST
06069814101041000,2021,247257,509610,756867,COST
06069814101041000,2020,186297,493470,679767,COST
06069814101041000,2019,186297,493470,679767,COST
06069814101041001,2021,213934,0,213934,COST
06069814101041001,2020,157662,0,157662,COST
06069814101041001,2019,157662,0,157662,COST
06069814101050000,2021,305710,511690,817400,MKT
06069814101050000,2020,237933,463667,701600,MKT
06069814101050000,2019,237933,463667,701600,MKT
06069814101081000,2021,338,0,338,COST
06069814101081000,2020,314,0,314,COST
06069814101081000,2019,314,0,314,COST
06069814101081001,2021,4801,0,4801,COST
06069814101081001,2020,6242,0,6242,COST
06069814101081001,2019,6242,0,6242,COST
06069814101101000,2021,373,0,373,COST
06069814101101000,2020,348,0,348,COST
06069814101101000,2019,348,0,348,COST
06069814101101001,2021,12497,573740,586237,COST
06069814101101001,2020,17583,180540,198123,COST
06069814101101001,2019,17583,180540,198123,COST
06069814101201000,2021,1129,0,1129,COST
06069814101201000,2020,1603,0,1603,COST
06069814101201000,2019,1603,0,1603,COST
06069814101201001,2021,10470,0,10470,COST
06069814101201001,2020,15247,0,15247,COST
06069814101201001,2019,15247,0,15247,COST
06069814201010000,2021,725,12100,12825,COST
06069814201010000,2020,676,11100,11776,COST
06069814201010000,2019,676,11100,11776,COST
06069814201020000,2021,1108,0,1108,COST
06069814201020000,2020,1031,0,1031,COST
06069814201020000,2019,1031,0,1031,COST
06069814301010000,2021,2408,0,2408,COST
06069814301010000,2020,1300,0,1300,COST
06069814301010000,2019,1300,0,1300,COST
06069814301100000,2021,38121,0,38121,COST
06069814301100000,2020,20603,0,20603,COST
06069814301100000,2019,20603,0,20603,COST
06069814303010000,2021,15228,0,15228,COST
06069814303010000,2020,8320,0,8320,COST
06069814303010000,2019,8320,0,8320,COST
06069814401100000,2021,234229,326120,560349,COST
06069814401100000,2020,171219,310560,481779,COST
06069814401100000,2019,171219,310560,481779,COST
06069815101010000,2021,231934,229190,461124,COST
06069815101010000,2020,169116,220780,389896,COST
06069815101010000,2019,168991,220780,389771,COST
06069815101020000,2021,6176,0,6176,COST
06069815101020000,2020,3338,0,3338,COST
06069815101020000,2019,3517,0,3517,COST
06069815101040000,2021,5770,0,5770,COST
06069815101040000,2020,3116,0,3116,COST
06069815101040000,2019,3116,0,3116,COST
06069815101060000,2021,495832,781480,1277312,COST
06069815101060000,2020,415514,770660,1186174,COST
06069815101060000,2019,415514,770660,1186174,COST
06069815101120000,2021,220553,689290,909843,COST
06069815101120000,2020,163380,664700,828080,COST
06069815101120000,2019,163380,664700,828080,COST
06069815101140000,2021,435437,0,435437,COST
06069815101140000,2020,300000,0,300000,OVR
06069815101140000,2019,357729,0,357729,COST
06069815101160000,2021,606477,0,606477,COST
06069815101160000,2020,524129,0,524129,COST
06069815101160000,2019,524129,0,524129,COST
06069815101300000,2021,514634,0,514634,COST
06069815101300000,2020,433732,0,433732,COST
06069815101300000,2019,433732,0,433732,COST
06069815101320000,2021,4396,265930,270326,COST
06069815101320000,2020,4497,258040,262537,COST
06069815101320000,2019,4497,258040,262537,COST
06069815101340000,2021,353174,533440,886614,COST
06069815101340000,2020,281006,470794,751800,MKT
06069815101340000,2019,281006,324894,605900,MKT
06069815101350000,2021,323464,1382470,1705934,COST
06069815101350000,2020,253933,1507530,1761463,COST
06069815101350000,2019,253933,1507530,1761463,COST
06069815101360000,2021,486822,470270,957092,COST
06069815101360000,2020,406822,462220,869042,COST
06069815101360000,2019,406822,462220,869042,COST
06069815101400000,2021,388027,0,388027,COST
06069815101400000,2020,313211,0,313211,COST
06069815101400000,2019,313211,0,313211,COST
06069815101410000,2021,498051,0,498051,COST
06069815101410000,2020,417659,0,417659,COST
06069815101410000,2019,417659,0,417659,COST
06069815101520000,2021,383980,220090,604070,COST
06069815101520000,2020,309448,231152,540600,MKT
06069815101520000,2019,309448,231152,540600,MKT
06069815130010000,2021,247819,578781,826600,MKT
06069815130010000,2020,186785,503015,689800,MKT
06069815130010000,2019,186785,503015,689800,MKT
06069815130020000,2021,398108,667410,1065518,COST
06069815130020000,2020,322611,654470,977081,COST
06069815130020000,2019,322611,538770,861381,COST
06069815130030000,2021,426160,431250,857410,COST
06069815130030000,2020,348957,412580,761537,COST
06069815130030000,2019,348957,412580,761537,COST
06069815130040000,2021,341998,553290,895288,COST
06069815130040000,2020,270780,546140,816920,COST
06069815130040000,2019,270780,546140,816920,COST
06069815130050000,2021,312038,356962,669000,MKT
06069815130050000,2020,243620,326480,570100,MKT
06069815130050000,2019,243620,326480,570100,MKT
06069815130060000,2021,278525,378075,656600,MKT
06069815130060000,2020,213711,381189,594900,MKT
06069815130060000,2019,213711,381189,594900,MKT
06069815130070000,2021,257550,278090,535640,COST
06069815130070000,2020,195266,275710,470976,COST
06069815130070000,2019,195266,275710,470976,COST
06069815130080000,2021,247257,199443,446700,MKT
06069815130080000,2020,186297,218703,405000,MKT
06069815130080000,2019,186297,218703,405000,MKT
06069815131010000,2021,318141,643759,961900,MKT
06069815131010000,2020,249122,657070,906192,COST
06069815131010000,2019,249122,657070,906192,COST
06069815131020000,2021,302972,353050,656022,COST
06069815131020000,2020,235478,336520,571998,COST
06069815131020000,2019,235478,336520,571998,COST
06069815131030000,2021,229704,383696,613400,MKT
06069815131030000,2020,171134,368166,539300,MKT
06069815131030000,2019,171134,368166,539300,MKT
06069815131030900,2021,229632,292068,521700,MKT
06069815131030900,2020,171073,295090,466163,COST
06069815131030900,2019,171073,295090,466163,COST
06069815131040000,2021,229918,604670,834588,COST
06069815131040000,2020,171318,578790,750108,OVR
06069815131040000,2019,171318,578790,750108,COST
06069815131050000,2021,303789,353111,656900,MKT
06069815131050000,2020,236211,299360,535571,OVR
06069815131050000,2019,236211,317160,553371,COST
06069815131060000,2021,281167,0,281167,COST
06069815131060000,2020,216050,0,216050,COST
06069815131060000,2019,216050,0,216050,COST
06069815131070000,2021,230630,430570,661200,MKT
06069815131070000,2020,171930,399120,571050,COST
06069815131070000,2019,171930,399120,571050,COST
06069815139010000,2021,285106,399894,685000,MKT
06069815139010000,2020,215773,406827,622600,MKT
06069815139010000,2019,215773,406827,622600,MKT
06069815139020000,2021,298284,300816,599100,MKT
06069815139020000,2020,227310,255190,482500,MKT
06069815139020000,2019,227310,255190,482500,MKT
06069815139030000,2021,308016,1257960,1565976,COST
06069815139030000,2020,235882,1106960,1342842,COST
06069815139030000,2019,235882,893650,1129532,COST
06069815139040000,2021,308016,236884,544900,MKT
06069815139040000,2020,235882,230318,466200,MKT
06069815139040000,2019,235882,230318,466200,MKT
06069815139050000,2021,306975,234925,541900,MKT
06069815139050000,2020,234963,234680,469643,COST
06069815139050000,2019,234963,234680,469643,COST
06069815139066500,2021,177107,0,177107,COST
06069815139066500,2020,152235,0,152235,COST
06069815139066500,2019,152235,0,152235,COST
06069815140010000,2021,285106,246994,532100,MKT
06069815140010000,2020,215773,283727,499500,MKT
06069815140010000,2019,215773,283727,499500,MKT
06069815140020000,2021,298284,581350,879634,COST
06069815140020000,2020,227310,558660,785970,OVR
06069815140020000,2019,227310,558660,785970,COST
06069815140030000,2021,308016,445184,753200,MKT
06069815140030000,2020,235882,480718,716600,MKT
06069815140030000,2019,235882,480718,716600,MKT
06069815140040000,2021,308016,588384,896400,MKT
06069815140040000,2020,235882,500618,736500,MKT
06069815140040000,2019,235882,500618,736500,MKT
06069815140050000,2021,306975,678350,985325,COST
06069815140050000,2020,234963,664750,899713,COST
06069815140050000,2019,234963,664750,899713,COST
06069815149010000,2021,258071,265729,523800,MKT
06069815149010000,2020,195721,250779,446500,MKT
06069815149010000,2019,195721,250779,446500,MKT
06069815149020000,2021,279777,615370,895147,COST
06069815149020000,2020,214819,607940,822759,COST
06069815149020000,2019,214819,607940,822759,COST
06069815149030000,2021,229489,424111,653600,MKT
06069815149030000,2020,170950,401450,572400,MKT
06069815149030000,2019,170950,401450,572400,MKT
06069815149040000,2021,242809,249600,492409,COST
06069815149040000,2020,182439,283861,466300,OVR
06069815149040000,2019,182439,283861,466300,MKT
06069815149050000,2021,290752,754150,1044902,COST
06069815149050000,2020,224563,732750,957313,COST
06069815149050000,2019,224563,732750,957313,COST
06069815149060000,2021,259222,323678,582900,MKT
06069815149060000,2020,196728,282072,478800,MKT
06069815149060000,2019,196728,282072,478800,MKT
06069815149070000,2021,265943,300457,566400,MKT
06069815149070000,2020,202620,295780,498400,MKT
06069815149070000,2019,202620,295780,498400,MKT
06069815149080000,2021,251564,232736,484300,MKT
06069815149080000,2020,190043,210657,400700,MKT
06069815149080000,2019,190043,210657,400700,MKT
06069815149090000,2021,260137,432163,692300,MKT
06069815149090000,2020,197529,400371,597900,MKT
06069815149090000,2019,197529,414971,612500,MKT
06069815149170000,2021,225413,347087,572500,MKT
06069815149170000,2020,167454,333346,500800,MKT
06069815149170000,2019,167454,333346,500800,MKT
06069815149210000,2021,227176,489024,716200,MKT
06069815149210000,2020,168965,517735,686700,MKT
06069815149210000,2019,168965,517735,686700,MKT
06069815150010000,2021,306975,302725,609700,MKT
06069815150010000,2020,234963,259337,494300,MKT
06069815150010000,2019,234963,259337,494300,MKT
06069815150020000,2021,2596,241190,243786,COST
06069815150020000,2020,235882,226118,462000,MKT
06069815150020000,2019,235882,226118,462000,MKT
06069815150030000,2021,308016,269684,577700,MKT
06069815150030000,2020,235882,234918,470800,MKT
06069815150030000,2019,235882,234918,470800,MKT
06069815150040000,2021,298284,403416,701700,MKT
06069815150040000,2020,227310,467150,694460,COST
06069815150040000,2019,227310,467150,694460,COST
06069815150050000,2021,285106,238994,524100,MKT
06069815150050000,2020,215773,209327,425100,MKT
06069815150050000,2019,215773,209327,425100,MKT
06069815152010000,2021,306975,295625,602600,MKT
06069815152010000,2020,234963,291537,526500,MKT
06069815152010000,2019,234963,291437,526400,MKT
06069815152020000,2021,308016,522360,830376,COST
06069815152020000,2020,235882,469483,705365,MRA
06069815152020000,2019,235882,469483,705365,MRA
06069815152030000,2021,308016,643184,951200,MKT
06069815152030000,2020,235882,691290,927172,COST
06069815152030000,2019,235882,676480,912362,COST
06069815152040000,2021,298284,428516,726800,MKT
06069815152040000,2020,227310,0,227310,COST
06069815152040000,2019,227310,0,227310,COST
06069815152050000,2021,285239,230461,515700,MKT
06069815152050000,2020,215773,226827,442600,MKT
06069815152050000,2019,215773,226827,442600,MKT
06069815153010000,2021,245179,424221,669400,MKT
06069815153010000,2020,184493,465207,649700,MKT
06069815153010000,2019,184493,465207,649700,MKT
06069815153010900,2021,245115,670660,915775,COST
06069815153010900,2020,184438,593960,778398,COST
06069815153010900,2019,184438,542170,726608,COST
06069815153020000,2021,334016,340610,674626,COST
06069815153020000,2020,263507,319660,583167,COST
06069815153020000,2019,263507,276993,540500,MKT
06069815153030000,2021,367382,281550,648932,COST
06069815153030000,2020,294079,269721,563800,MKT
06069815153030000,2019,294079,269721,563800,MKT
06069815153040000,2021,369644,0,369644,COST
06069815153040000,2020,296167,0,296167,COST
06069815153040000,2019,296167,0,296167,COST
06069815201010000,2021,435560,4010770,4446330,COST
06069815201010000,2020,325970,3882380,4208350,COST
06069815201010000,2019,325970,3882380,4208350,COST
06069815201030000,2021,259043,847457,1106500,MKT
06069815201030000,2020,161298,805670,966968,COST
06069815201030000,2019,161298,0,161298,COST
06069815201050000,2021,258223,1055377,1313600,MKT
06069815201050000,2020,160580,957510,1118090,COST
06069815201050000,2019,160580,957510,1118090,COST
06069815201070000,2021,258223,791777,1050000,MKT
06069815201070000,2020,160580,684020,844600,MKT
06069815201070000,2019,160580,685220,845800,MKT
06069815201090000,2021,258223,756777,1015000,MKT
06069815201090000,2020,160580,754320,914900,MKT
06069815201090000,2019,160580,754320,914900,MKT
06069815201100000,2021,229853,476347,706200,MKT
06069815201100000,2020,176208,430592,606800,MKT
06069815201100000,2019,176208,430592,606800,MKT
06069815201110000,2021,258223,684177,942400,MKT
06069815201110000,2020,160580,731420,892000,MKT
06069815201110000,2019,160580,731420,892000,MKT
06069815201130000,2021,258223,0,258223,COST
06069815201130000,2020,160580,0,160580,COST
06069815201130000,2019,160580,0,160580,COST
06069815201150000,2021,258223,0,258223,COST
06069815201150000,2020,160580,0,160580,COST
06069815201150000,2019,160580,0,160580,COST
06069815201170000,2021,258223,1393400,1651623,COST
06069815201170000,2020,160580,1371140,1531720,COST
06069815201170000,2019,160580,1371140,1531720,COST
06069815201190000,2021,215186,772914,988100,MKT
06069815201190000,2020,160580,649520,810100,MKT
06069815201190000,2019,160580,649520,810100,MKT
06069815201210000,2021,215186,813020,1028206,COST
06069815201210000,2020,160580,790320,950900,MKT
06069815201210000,2019,160580,790320,950900,MKT
06069815201230000,2021,215186,623414,838600,MKT
06069815201230000,2020,160580,676420,837000,MKT
06069815201230000,2019,160580,676420,837000,MKT
06069815201250000,2021,258223,1132777,1391000,MKT
06069815201250000,2020,160580,894820,1055400,MKT
06069815201250000,2019,160580,1145750,1306330,COST
06069815201270000,2021,258223,798640,1056863,COST
06069815201270000,2020,160580,881520,1042100,MKT
06069815201270000,2019,160580,881520,1042100,MKT
06069815201290000,2021,215186,1342260,1557446,COST
06069815201290000,2020,160580,1248860,1409440,COST
06069815201290000,2019,160580,1248860,1409440,COST
06069815201310000,2021,258223,626677,884900,MKT
06069815201310000,2020,160580,650620,811200,COST
06069815201310000,2019,160580,793300,953880,COST
06069815201330000,2021,215338,0,215338,COST
06069815201330000,2020,160740,0,160740,COST
06069815201330000,2019,160740,0,160740,COST
06069815201350000,2021,215186,0,215186,COST
06069815201350000,2020,160580,0,160580,COST
06069815201350000,2019,160580,0,160580,COST
06069815201370000,2021,215262,0,215262,COST
06069815201370000,2020,160660,0,160660,COST
06069815201370000,2019,160660,0,160660,COST
06069815201390000,2021,215262,0,215262,COST
06069815201390000,2020,160660,0,160660,COST
06069815201390000,2019,160660,0,160660,COST
06069815201410000,2021,215186,0,215186,COST
06069815201410000,2020,160580,0,160580,COST
06069815201410000,2019,160580,0,160580,COST
06069815201430000,2021,215338,715162,930500,MKT
06069815201430000,2020,160740,716260,877000,MKT
06069815201430000,2019,160740,716260,877000,MKT
06069815201450000,2021,215869,693931,909800,MKT
06069815201450000,2020,161298,726102,887400,MKT
06069815201450000,2019,161298,726102,887400,MKT
06069815201470000,2021,215186,0,215186,COST
06069815201470000,2020,160580,0,160580,COST
06069815201470000,2019,160580,0,160580,COST
06069815201490000,2021,215186,0,215186,COST
06069815201490000,2020,160580,0,160580,COST
06069815201490000,2019,160580,0,160580,COST
06069815201510000,2021,215186,1468530,1683716,COST
06069815201510000,2020,160580,1421210,1581790,COST
06069815201510000,2019,160580,1421210,1581790,COST
06069815201530000,2021,215186,0,215186,COST
06069815201530000,2020,160580,0,160580,COST
06069815201530000,2019,160580,0,160580,COST
06069815201550000,2021,215414,0,215414,COST
06069815201550000,2020,160820,0,160820,COST
06069815201550000,2019,160820,0,160820,COST
06069815201570000,2021,215566,866670,1082236,COST
06069815201570000,2020,160979,851560,1012539,COST
06069815201570000,2019,160979,851560,1012539,COST
06069815201590000,2021,215186,0,215186,COST
06069815201590000,2020,160580,0,160580,COST
06069815201590000,2019,160580,0,160580,COST
06069815201610000,2021,215338,0,215338,COST
06069815201610000,2020,160740,0,160740,COST
06069815201610000,2019,160740,0,160740,COST
06069815201630000,2021,215338,842262,1057600,MKT
06069815201630000,2020,160740,832760,993500,MKT
06069815201630000,2019,160740,832760,993500,MKT
06069815201650000,2021,215262,0,215262,COST
06069815201650000,2020,160660,0,160660,COST
06069815201650000,2019,160660,0,160660,COST
06069815201670000,2021,215869,0,215869,COST
06069815201670000,2020,161298,0,161298,COST
06069815201670000,2019,161298,0,161298,COST
06069815301010000,2021,263360,772620,1035980,COST
06069815301010000,2020,186925,805820,992745,OVR
06069815301010000,2019,186925,805820,992745,COST
06069815301030000,2021,267544,819810,1087354,COST
06069815301030000,2020,191121,781350,972471,COST
06069815301030000,2019,191121,0,191121,COST
06069815301050000,2021,267544,1129556,1397100,MKT
06069815301050000,2020,191121,1044490,1235611,COST
06069815301050000,2019,191121,1044490,1235611,COST
06069815301070000,2021,263360,0,263360,COST
06069815301070000,2020,186925,0,186925,COST
06069815301070000,2019,186925,0,186925,COST
06069815301090000,2021,271612,1392810,1664422,COST
06069815301090000,2020,195227,1464773,1660000,OVR
06069815301090000,2019,195227,1823360,2018587,COST
06069815301106500,2021,7622,0,7622,COST
06069815301106500,2020,7103,0,7103,COST
06069815301106500,2019,7103,0,7103,COST
06069815301110000,2021,275571,0,275571,COST
06069815301110000,2020,199248,0,199248,COST
06069815301110000,2019,199248,0,199248,COST
06069815301130000,2021,264646,0,264646,COST
06069815301130000,2020,188212,0,188212,COST
06069815301130000,2019,188212,0,188212,COST
06069815301150000,2021,263360,0,263360,COST
06069815301150000,2020,186925,0,186925,COST
06069815301150000,2019,186925,0,186925,COST
06069815301170000,2021,272568,0,272568,COST
06069815301170000,2020,196196,0,196196,COST
06069815301170000,2019,196196,0,196196,COST
06069815301190000,2021,269592,0,269592,COST
06069815301190000,2020,193185,0,193185,COST
06069815301190000,2019,193185,0,193185,COST
06069815301210000,2021,271612,1278140,1549752,COST
06069815301210000,2020,195227,1233570,1428797,COST
06069815301210000,2019,195227,551660,746887,COST
06069815301230000,2021,263360,1482520,1745880,COST
06069815301230000,2020,186925,1166210,1353135,COST
06069815301230000,2019,186925,1166210,1353135,COST
06069815301250000,2021,263360,0,263360,COST
06069815301250000,2020,186925,0,186925,COST
06069815301250000,2019,186925,0,186925,COST
06069815301270000,2021,262527,929160,1191687,COST
06069815301270000,2020,186093,915370,1101463,COST
06069815301270000,2019,186093,915370,1101463,COST
06069815301290000,2021,265467,0,265467,COST
06069815301290000,2020,189035,0,189035,COST
06069815301290000,2019,189035,0,189035,COST
06069815301310000,2021,263360,702140,965500,MKT
06069815301310000,2020,186925,699960,886885,COST
06069815301310000,2019,186925,699960,886885,COST
06069815301330000,2021,265830,894870,1160700,MKT
06069815301330000,2020,189399,0,189399,COST
06069815301330000,2019,189399,0,189399,COST
06069815301350000,2021,263083,0,263083,COST
06069815301350000,2020,186648,0,186648,COST
06069815301350000,2019,186648,0,186648,COST
06069815301370000,2021,265467,1293233,1558700,MKT
06069815301370000,2020,189035,1356060,1545095,COST
06069815301370000,2019,189035,1356060,1545095,COST
06069815301390000,2021,263360,1443460,1706820,COST
06069815301390000,2020,186925,792975,979900,MKT
06069815301390000,2019,186925,792975,979900,MKT
06069815301410000,2021,264004,0,264004,COST
06069815301410000,2020,187570,0,187570,COST
06069815301410000,2019,187570,0,187570,COST
06069815301430000,2021,262805,1147995,1410800,MKT
06069815301430000,2020,186371,1232330,1418701,COST
06069815301430000,2019,186371,1171360,1357731,COST
06069815301450000,2021,262527,1297300,1559827,COST
06069815301450000,2020,186093,1256280,1442373,COST
06069815301450000,2019,186093,1256280,1442373,COST
06069815301470000,2021,262620,1368580,1631200,MKT
06069815301470000,2020,186185,1338270,1524455,COST
06069815301470000,2019,186185,1338270,1524455,COST
06069815301490000,2021,273260,0,273260,COST
06069815301490000,2020,196898,0,196898,COST
06069815301490000,2019,196898,0,196898,COST
06069815301510000,2021,267544,773856,1041400,MKT
06069815301510000,2020,191121,877760,1068881,COST
06069815301510000,2019,191121,877760,1068881,COST
06069815301530000,2021,262527,796800,1059327,COST
06069815301530000,2020,186093,778420,964513,COST
06069815301530000,2019,186093,778420,964513,COST
06069815301550000,2021,262527,1450100,1712627,COST
06069815301550000,2020,186093,1498270,1684363,COST
06069815301550000,2019,186093,1498270,1684363,COST
06069815301570000,2021,262527,1620280,1882807,COST
06069815301570000,2020,186093,1675440,1861533,COST
06069815301570000,2019,186093,1675440,1861533,COST
06069815301590000,2021,262527,2512860,2775387,COST
06069815301590000,2020,186093,2466980,2653073,COST
06069815301590000,2019,186093,2466980,2653073,COST
06069815301610000,2021,265467,925950,1191417,COST
06069815301610000,2020,189035,904960,1093995,COST
06069815301610000,2019,189035,904960,1093995,COST
06069815301630000,2021,182089,0,182089,COST
06069815301630000,2020,188029,0,188029,COST
06069815301630000,2019,188029,0,188029,COST
06069815301650000,2021,262434,1031870,1294304,COST
06069815301650000,2020,186000,1001260,1187260,COST
06069815301650000,2019,186000,1001260,1187260,COST
06069815301670000,2021,262527,0,262527,COST
06069815301670000,2020,186093,0,186093,COST
06069815301670000,2019,186093,0,186093,COST
06069815301690000,2021,262527,979780,1242307,COST
06069815301690000,2020,186093,945590,1131683,COST
06069815301690000,2019,186093,945590,1131683,COST
06069815301710000,2021,262527,1461110,1723637,COST
06069815301710000,2020,186093,1425310,1611403,COST
06069815301710000,2019,186093,1425310,1611403,COST
06069815301730000,2021,262527,0,262527,COST
06069815301730000,2020,186093,0,186093,COST
06069815301730000,2019,186093,0,186093,COST
06069816101010000,2021,98399,0,98399,COST
06069816101010000,2020,122689,0,122689,COST
06069816101010000,2019,122689,0,122689,COST
06069816101040000,2021,10876,94540,105416,COST
06069816101040000,2020,31604,81080,112684,COST
06069816101040000,2019,31604,81080,112684,COST
06069816101070000,2021,15818,802610,818428,COST
06069816101070000,2020,18951,766690,785641,COST
06069816101070000,2019,18951,766690,785641,COST
06069816101780000,2021,103846,275254,379100,MKT
06069816101780000,2020,108858,230942,339800,MKT
06069816101780000,2019,108858,230942,339800,MKT
06069816101810000,2021,103846,280354,384200,MKT
06069816101810000,2020,108858,254242,363100,MKT
06069816101810000,2019,108858,254242,363100,MKT
06069816101840000,2021,116935,248965,365900,MKT
06069816101840000,2020,120407,196093,316500,MKT
06069816101840000,2019,120407,196093,316500,MKT
06069816201010000,2021,76159,4720,80879,COST
06069816201010000,2020,102878,4780,107658,COST
06069816201010000,2019,102878,4780,107658,COST
06069816202010000,2021,94402,0,94402,COST
06069816202010000,2020,100486,0,100486,COST
06069816202010000,2019,100486,0,100486,COST
06069816401050000,2021,155874,25060,180934,COST
06069816401050000,2020,203342,21940,225282,COST
06069816401050000,2019,203342,21940,225282,COST
06069817101010000,2021,11539,0,11539,COST
06069817101010000,2020,13591,0,13591,COST
06069817101010000,2019,13591,0,13591,COST
06069817101300000,2021,111100,0,111100,COST
06069817101300000,2020,81578,0,81578,COST
06069817101300000,2019,81578,0,81578,COST
06069817201010000,2021,102429,230420,332849,COST
06069817201010000,2020,147881,211210,359091,COST
06069817201010000,2019,147881,211210,359091,COST
06069817301010000,2021,166193,666780,832973,COST
06069817301010000,2020,220219,560860,781079,COST
06069817301010000,2019,220219,560860,781079,COST
06069817301020000,2021,18419,225430,243849,COST
06069817301020000,2020,19152,196210,215362,COST
06069817301020000,2019,19152,196210,215362,COST
06069817301030000,2021,1117,0,1117,COST
06069817301030000,2020,1040,0,1040,COST
06069817301030000,2019,1040,0,1040,COST
06069817301040000,2021,164602,176230,340832,COST
06069817301040000,2020,218738,156020,374758,COST
06069817301040000,2019,218738,156020,374758,COST
06069817301050000,2021,357834,233860,591694,COST
06069817301050000,2020,423790,197250,621040,COST
06069817301050000,2019,423790,197250,621040,COST
06069817301060000,2021,203322,362850,566172,COST
06069817301060000,2020,262187,315350,577537,COST
06069817301060000,2019,262187,315350,577537,COST
06069817302010000,2021,5556,325090,330646,COST
06069817302010000,2020,5578,277090,282668,COST
06069817302010000,2019,5578,277090,282668,COST
06069817304010000,2021,1117,0,1117,COST
06069817304010000,2020,1040,0,1040,COST
06069817304010000,2019,1040,0,1040,COST
06069817401300000,2021,329045,637255,966300,MKT
06069817401300000,2020,289947,673130,963077,COST
06069817401300000,2019,289947,673130,963077,COST
06069817402010000,2021,45622,0,45622,COST
06069817402010000,2020,56737,0,56737,COST
06069817402010000,2019,56737,0,56737,COST
06069817404010000,2021,192635,0,192635,COST
06069817404010000,2020,183994,0,183994,COST
06069817404010000,2019,183994,0,183994,COST
06069818101010000,2021,74953,119290,194243,COST
06069818101010000,2020,90487,101880,192367,COST
06069818101010000,2019,90487,101880,192367,COST
06069818101020000,2021,228380,224290,452670,COST
06069818101020000,2020,212617,196570,409187,COST
06069818101020000,2019,212617,196570,409187,COST
06069818101030000,2021,345061,250310,595371,COST
06069818101030000,2020,410905,182660,593565,COST
06069818101030000,2019,410905,182660,593565,COST
06069818301010000,2021,91701,1639640,1731341,COST
06069818301010000,2020,81062,1479540,1560602,COST
06069818301010000,2019,81062,1479540,1560602,COST
06069818301200000,2021,14442,0,14442,COST
06069818301200000,2020,15136,0,15136,COST
06069818301200000,2019,15136,0,15136,COST
06069818301400000,2021,16312,127550,143862,COST
06069818301400000,2020,16897,0,16897,COST
06069818301400000,2019,16897,0,16897,COST
06069818401010000,2021,145059,211950,357009,COST
06069818401010000,2020,144685,185320,330005,COST
06069818401010000,2019,144685,185320,330005,COST
06069818420150000,2021,145052,858870,1003922,COST
06069818420150000,2020,144679,738180,882859,COST
06069818420150000,2019,144679,738180,882859,COST
06069818420400000,2021,145059,839720,984779,COST
06069818420400000,2020,144685,697790,842475,OVR
06069818420400000,2019,144685,690110,834795,COST
06069819101100000,2021,32636,0,32636,COST
06069819101100000,2020,34909,0,34909,COST
06069819101100000,2019,34909,0,34909,COST
06069819101300000,2021,145669,84590,230259,COST
06069819101300000,2020,145254,75080,220334,COST
06069819101300000,2019,145254,75080,220334,COST
06069819101400000,2021,145052,288930,433982,COST
06069819101400000,2020,144679,260320,404999,COST
06069819101400000,2019,144679,260320,404999,COST
06069819101600000,2021,145052,292380,437432,COST
06069819101600000,2020,144679,255750,400429,COST
06069819101600000,2019,144679,255750,400429,COST
06069819201010000,2021,100104,205360,305464,COST
06069819201010000,2020,133787,175610,309397,COST
06069819201010000,2019,135830,271600,407430,COST
06069819201040000,2021,145447,666130,811577,COST
06069819201040000,2020,145047,596120,741167,COST
06069819201040000,2019,145047,596120,741167,COST
06069819202010000,2021,146424,892480,1038904,COST
06069819202010000,2020,145956,753040,898996,COST
06069819202010000,2019,145956,753040,898996,COST
06069819202300000,2021,9618,709110,718728,COST
06069819202300000,2020,10263,610810,621073,COST
06069819202300000,2019,10263,610810,621073,COST
06069819301010000,2021,145975,1037580,1183555,COST
06069819301010000,2020,145538,870630,1016168,COST
06069819301010000,2019,145538,870630,1016168,COST
06069819401010000,2021,455757,691760,1147517,COST
06069819401010000,2020,382382,595820,978202,COST
06069819401010000,2019,6635,595820,602455,COST
06069819401040000,2021,277023,56920,333943,COST
06069819401040000,2020,250513,50810,301323,OVR
06069819401040000,2019,250513,50810,301323,COST
06069819401070000,2021,276900,0,276900,COST
06069819401070000,2020,250419,0,250419,COST
06069819401070000,2019,250419,0,250419,COST
06069819401100000,2021,423115,272680,695795,COST
06069819401100000,2020,358989,223880,582869,COST
06069819401100000,2019,358989,223880,582869,COST
06069819401200000,2021,104867,19850,124717,COST
06069819401200000,2020,141480,19320,160800,COST
06069819401200000,2019,141480,19320,160800,COST
06069819401300000,2021,291475,0,291475,COST
06069819401300000,2020,261573,0,261573,COST
06069819401300000,2019,261573,0,261573,COST
06069820101030000,2021,35856,4070,39926,COST
06069820101030000,2020,26225,3940,30165,COST
06069820101030000,2019,26225,3940,30165,COST
06069820201010000,2021,67637,0,67637,COST
06069820201010000,2020,70363,0,70363,COST
06069820201010000,2019,70363,0,70363,COST
06069820301010000,2021,145494,100980,246474,COST
06069820301010000,2020,145091,88510,233601,COST
06069820301010000,2019,145091,88510,233601,COST
06069820301050000,2021,10155,257360,267515,COST
06069820301050000,2020,9710,228970,238680,COST
06069820301050000,2019,9710,228970,238680,COST
06069820301150000,2021,374097,269003,643100,MKT
06069820301150000,2020,323339,201640,524979,COST
06069820301150000,2019,323339,201640,524979,COST
06069820301200000,2021,143730,333490,477220,COST
06069820301200000,2020,144682,182140,326822,COST
06069820301200000,2019,144682,179900,324582,COST
06069820301250000,2021,2221,0,2221,COST
06069820301250000,2020,2067,0,2067,COST
06069820301250000,2019,2067,0,2067,COST
06069820301300000,2021,5027,0,5027,COST
06069820301300000,2020,4657,0,4657,COST
06069820301300000,2019,4657,0,4657,COST
06069820401010000,2021,2768,0,2768,COST
06069820401010000,2020,1565,0,1565,COST
06069820401010000,2019,1565,0,1565,COST
06069820401200000,2021,14267,302950,317217,COST
06069820401200000,2020,13706,259130,272836,COST
06069820401200000,2019,13706,259130,272836,COST
06069820401400000,2021,145895,157220,303115,COST
06069820401400000,2020,146494,133800,280294,COST
06069820401400000,2019,146494,133800,280294,COST
06069821101010000,2021,196018,448770,644788,COST
06069821101010000,2020,39819,287630,327449,COST
06069821101010000,2019,39819,287630,327449,COST
06069821101040000,2021,54542,0,54542,COST
06069821101040000,2020,62994,0,62994,COST
06069821101040000,2019,62994,0,62994,COST
06069821201010000,2021,112038,213762,325800,MKT
06069821201010000,2020,116110,184090,300200,MKT
06069821201010000,2019,116110,184090,300200,MKT
06069821201020000,2021,153811,264889,418700,MKT
06069821201020000,2020,151975,231625,383600,MKT
06069821201020000,2019,151975,231625,383600,MKT
06069821201030000,2021,176355,238045,414400,MKT
06069821201030000,2020,177909,169290,347199,COST
06069821201030000,2019,177909,169290,347199,COST
06069821201040000,2021,210733,648690,859423,COST
06069821201040000,2020,198578,544390,742968,COST
06069821201040000,2019,198578,544390,742968,COST
06069821201050000,2021,258505,409510,668015,COST
06069821201050000,2020,236216,345440,581656,COST
06069821201050000,2019,236216,345440,581656,COST
06069821202020000,2021,207409,152930,360339,COST
06069821202020000,2020,145086,129630,274716,COST
06069821202020000,2019,145086,129630,274716,COST
06069821202100000,2021,412960,389080,802040,COST
06069821202100000,2020,288443,318460,606903,COST
06069821202100000,2019,288443,126430,414873,COST
06069821211120000,2021,204387,325113,529500,MKT
06069821211120000,2020,193487,271613,465100,OVR
06069821211120000,2019,193487,271613,465100,MKT
06069821301020000,2021,18620,533490,552110,COST
06069821301020000,2020,17422,454030,471452,COST
06069821301020000,2019,17422,454030,471452,COST
06069821301030000,2021,164572,216800,381372,COST
06069821301030000,2020,218710,194430,413140,OVR
06069821301030000,2019,218710,194430,413140,COST
06069821301030900,2021,164465,341740,506205,COST
06069821301030900,2020,218611,295240,513851,COST
06069821301030900,2019,218611,295240,513851,COST
06069821301040000,2021,326582,828450,1155032,COST
06069821301040000,2020,435037,454490,889527,COST
06069821301040000,2019,218102,90340,308442,COST
06069821301060000,2021,430749,208651,639400,MKT
06069821301060000,2020,496099,133890,629989,COST
06069821301060000,2019,496099,133890,629989,COST
06069821301200000,2021,145949,555010,700959,COST
06069821301200000,2020,145514,479150,624664,COST
06069821301200000,2019,145514,403710,549224,COST
06069821306010000,2021,145052,609740,754792,COST
06069821306010000,2020,144679,513870,658549,COST
06069821306010000,2019,144679,513870,658549,COST
06069821312010000,2021,145052,397040,542092,COST
06069821312010000,2020,144679,326950,471629,COST
06069821312010000,2019,144679,326950,471629,COST
06069821342070000,2021,1107,0,1107,COST
06069821342070000,2020,1031,0,1031,COST
06069821342070000,2019,1031,0,1031,COST
06069821406010000,2021,163936,848220,1012156,COST
06069821406010000,2020,218118,734670,952788,COST
06069821406010000,2019,218118,734670,952788,COST
06069821412030000,2021,198612,0,198612,COST
06069821412030000,2020,188832,0,188832,COST
06069821412030000,2019,188832,0,188832,COST
06069822101010000,2021,106281,0,106281,COST
06069822101010000,2020,57295,0,57295,COST
06069822101010000,2019,57295,0,57295,COST
06069823101010000,2021,271537,0,271537,COST
06069823101010000,2020,146367,0,146367,COST
06069823101010000,2019,146367,0,146367,COST
06069824101010000,2021,252687,0,252687,COST
06069824101010000,2020,135835,0,135835,COST
06069824101010000,2019,135835,0,135835,COST
06069825101010000,2021,268661,0,268661,COST
06069825101010000,2020,144453,0,144453,COST
06069825101010000,2019,144453,0,144453,COST
06069826101010000,2021,248436,0,248436,COST
06069826101010000,2020,133640,0,133640,COST
06069826101010000,2019,133640,0,133640,COST
06069827101010000,2021,163772,187930,351702,COST
06069827101010000,2020,217966,159330,377296,COST
06069827101010000,2019,217966,159330,377296,COST
06069827101020000,2021,408909,201650,610559,COST
06069827101020000,2020,474648,174100,648748,COST
06069827101020000,2019,474648,174100,648748,COST
06069827101030000,2021,164589,98980,263569,COST
06069827101030000,2020,218726,84420,303146,COST
06069827101030000,2019,218726,84420,303146,COST
06069827101050000,2021,47698,3358190,3405888,COST
06069827101050000,2020,28335,2865670,2894005,COST
06069827101050000,2019,28335,2865670,2894005,COST
06069827101080000,2021,153820,465970,619790,COST
06069827101080000,2020,149037,401640,550677,COST
06069827101080000,2019,149037,401640,550677,COST
06069827101200000,2021,154617,867350,1021967,COST
06069827101200000,2020,149434,731020,880454,COST
06069827101200000,2019,149434,731020,880454,COST
06069827101320000,2021,7458,0,7458,COST
06069827101320000,2020,4094,0,4094,COST
06069827101320000,2019,4094,0,4094,COST
06069827101440000,2021,14137,0,14137,COST
06069827101440000,2020,7705,0,7705,COST
06069827101440000,2019,7705,0,7705,COST
06069827101560000,2021,157352,584450,741802,COST
06069827101560000,2020,150882,397310,548192,COST
06069827101560000,2019,150882,349570,500452,COST
06069827101640000,2021,9788,0,9788,COST
06069827101640000,2020,5266,0,5266,COST
06069827101640000,2019,5266,0,5266,COST
06069827201150000,2021,1107,0,1107,COST
06069827201150000,2020,1030,0,1030,COST
06069827201150000,2019,1030,0,1030,COST
06069827301010000,2021,548823,1430180,1979003,COST
06069827301010000,2020,494136,1241270,1735406,COST
06069827301010000,2019,494136,1241270,1735406,COST
06069827301020000,2021,37836,211380,249216,COST
06069827301020000,2020,21578,179710,201288,COST
06069827301020000,2019,21578,181490,203068,COST
06069827301040000,2021,325888,262930,588818,COST
06069827301040000,2020,321437,221280,542717,COST
06069827301040000,2019,321437,221280,542717,COST
06069827301060000,2021,427800,151050,578850,COST
06069827301060000,2020,493212,129070,622282,COST
06069827301060000,2019,493212,129070,622282,COST
06069827301100000,2021,288996,865380,1154376,COST
06069827301100000,2020,288327,761880,1050207,COST
06069827301100000,2019,288327,761880,1050207,COST
06069827401010000,2021,163772,1449190,1612962,COST
06069827401010000,2020,217966,1235350,1453316,COST
06069827401010000,2019,217966,1235350,1453316,COST
06069827401130000,2021,107290,578740,686030,COST
06069827401130000,2020,148750,205780,354530,COST
06069827401130000,2019,5355,0,5355,COST
06069827401260000,2021,153339,1795880,1949219,COST
06069827401260000,2020,148798,1542280,1691078,COST
06069827401260000,2019,148798,1542280,1691078,COST
06069827401390000,2021,10000,0,10000,COST
06069827401390000,2020,5375,0,5375,COST
06069827401390000,2019,5375,0,5375,COST
06069827401520000,2021,154111,836150,990261,COST
06069827401520000,2020,149139,715070,864209,OVR
06069827401520000,2019,149139,715070,864209,COST
06069827401650000,2021,10284,0,10284,COST
06069827401650000,2020,5759,0,5759,COST
06069827401650000,2019,5759,0,5759,COST
06069827401780000,2021,1991,0,1991,COST
06069827401780000,2020,1853,0,1853,COST
06069827401780000,2019,1853,0,1853,COST
06069827401900000,2021,163810,834640,998450,COST
06069827401900000,2020,218001,707850,925851,COST
06069827401900000,2019,218001,707850,925851,COST
06069828101010000,2021,331850,1176060,1507910,COST
06069828101010000,2020,290802,1123530,1414332,COST
06069828101010000,2019,290802,1123530,1414332,COST
06069828101040000,2021,171986,2243440,2415426,COST
06069828101040000,2020,232172,2091330,2323502,COST
06069828101040000,2019,232172,180220,412392,COST
06069828142110000,2021,137509,8850,146359,COST
06069828142110000,2020,119540,7480,127020,COST
06069828142110000,2019,119540,7480,127020,COST
06069828148010000,2021,17729,0,17729,COST
06069828148010000,2020,9488,0,9488,COST
06069828148010000,2019,9488,0,9488,COST
06069828148130000,2021,152055,1162520,1314575,COST
06069828148130000,2020,148158,984980,1133138,COST
06069828148130000,2019,148158,984980,1133138,COST
06069828160050000,2021,203378,0,203378,COST
06069828160050000,2020,192675,0,192675,COST
06069828160050000,2019,192675,0,192675,COST
06069828160100000,2021,206091,228609,434700,MKT
06069828160100000,2020,194856,180844,375700,MKT
06069828160100000,2019,194856,180844,375700,MKT
06069828160150000,2021,192635,658680,851315,COST
06069828160150000,2020,183994,565040,749034,COST
06069828160150000,2019,183994,565040,749034,COST
06069828166030000,2021,226645,1660,228305,COST
06069828166030000,2020,211244,1710,212954,COST
06069828166030000,2019,211244,1710,212954,COST
06069828166050000,2021,226645,0,226645,COST
06069828166050000,2020,211244,0,211244,COST
06069828166050000,2019,211244,0,211244,COST
06069828166130000,2021,163477,227380,390857,COST
06069828166130000,2020,217692,185850,403542,COST
06069828166130000,2019,217692,185850,403542,COST
06069828181010000,2021,192635,362165,554800,MKT
06069828181010000,2020,183994,264806,448800,MKT
06069828181010000,2019,183994,264806,448800,MKT
06069828181130000,2021,192635,0,192635,COST
06069828181130000,2020,183994,0,183994,COST
06069828181130000,2019,183994,0,183994,COST
06069828201200000,2021,148355,1768810,1917165,COST
06069828201200000,2020,147753,1507930,1655683,COST
06069828201200000,2019,147753,1507930,1655683,COST
06069828218010000,2021,297817,2769110,3066927,COST
06069828218010000,2020,292647,2351430,2644077,COST
06069828218010000,2019,292647,2351430,2644077,COST
06069828224010000,2021,148279,473220,621499,COST
06069828224010000,2020,147682,405070,552752,COST
06069828224010000,2019,147682,405070,552752,COST
06069828236010000,2021,145052,538110,683162,COST
06069828236010000,2020,144679,459940,604619,COST
06069828236010000,2019,144679,459940,604619,COST
06069828248010000,2021,147990,425110,573100,COST
06069828248010000,2020,147413,362470,509883,COST
06069828248010000,2019,147413,362470,509883,COST
06069828272010000,2021,145052,1695460,1840512,COST
06069828272010000,2020,144679,1458490,1603169,COST
06069828272010000,2019,144679,1432030,1576709,COST
06069828348010000,2021,270,0,270,COST
06069828348010000,2020,251,0,251,COST
06069828348010000,2019,251,0,251,COST
06069828360010000,2021,15698,0,15698,COST
06069828360010000,2020,8546,0,8546,COST
06069828360010000,2019,8546,0,8546,COST
06069828372010000,2021,1448,0,1448,COST
06069828372010000,2020,1348,0,1348,COST
06069828372010000,2019,1348,0,1348,COST
06069828401010000,2021,127667,0,127667,COST
06069828401010000,2020,69122,0,69122,COST
06069828401010000,2019,69122,0,69122,COST
06069829101020000,2021,17219,939330,956549,COST
06069829101020000,2020,16803,815600,832403,COST
06069829101020000,2019,16803,831190,847993,COST
06069829202010000,2021,33200,0,33200,COST
06069829202010000,2020,30792,0,30792,COST
06069829202010000,2019,30792,0,30792,COST
06069829204010000,2021,17308,0,17308,COST
06069829204010000,2020,16067,0,16067,COST
06069829204010000,2019,16067,0,16067,COST
06069829301010000,2021,55721,0,55721,COST
06069829301010000,2020,37569,0,37569,COST
06069829301010000,2019,37569,0,37569,COST
06069830101010000,2021,6921,0,6921,COST
06069830101010000,2020,17257,0,17257,COST
06069830101010000,2019,17257,0,17257,COST
06069830101031001,2021,1780,18680,20460,COST
06069830101031001,2020,1656,19420,21076,COST
06069830101031001,2019,1656,19420,21076,COST
06069830101031002,2021,144211,277170,421381,COST
06069830101031002,2020,143896,241490,385386,COST
06069830101031002,2019,143896,241490,385386,COST
06069830201150000,2021,15374,680460,695834,COST
06069830201150000,2020,16291,570050,586341,COST
06069830201150000,2019,16291,570050,586341,COST
06069830201350000,2021,43850,0,43850,COST
06069830201350000,2020,53826,0,53826,COST
06069830201350000,2019,53826,0,53826,COST
06069830301010000,2021,85710,3489550,3575260,COST
06069830301010000,2020,86141,2497350,2583491,COST
06069830301010000,2019,84034,932880,1016914,COST
06069831101010000,2021,191419,147260,338679,COST
06069831101010000,2020,130192,124260,254452,COST
06069831101010000,2019,130301,137370,267671,COST
06069831101400000,2021,28304,0,28304,COST
06069831101400000,2020,17309,0,17309,COST
06069831101400000,2019,18969,0,18969,COST
06069832101010000,2021,194692,0,194692,COST
06069832101010000,2020,105114,0,105114,COST
06069832101010000,2019,105114,0,105114,COST
06069832201010000,2021,148629,118070,266699,COST
06069832201010000,2020,152685,102230,254915,COST
06069832201010000,2019,152685,102230,254915,COST
06069832301010000,2021,31571,0,31571,COST
06069832301010000,2020,17153,0,17153,COST
06069832301010000,2019,18139,0,18139,COST
06069832301050000,2021,37897,0,37897,COST
06069832301050000,2020,20762,0,20762,COST
06069832301050000,2019,20762,0,20762,COST
06069833101010000,2021,274653,0,274653,COST
06069833101010000,2020,147624,0,147624,COST
06069833101010000,2019,147624,0,147624,COST
06069834101050000,2021,927,0,927,COST
06069834101050000,2020,863,0,863,COST
06069834101050000,2019,863,0,863,COST
06069834148010000,2021,182744,429920,612664,COST
06069834148010000,2020,227849,363620,591469,COST
06069834148010000,2019,227849,314410,542259,COST
06069834181010000,2021,1247,0,1247,COST
06069834181010000,2020,1161,0,1161,COST
06069834181010000,2019,1161,0,1161,COST
06069834201050000,2021,18337,0,18337,COST
06069834201050000,2020,9875,0,9875,COST
06069834201050000,2019,9875,0,9875,COST
06069834301010000,2021,223159,0,223159,COST
06069834301010000,2020,120026,0,120026,COST
06069834301010000,2019,120026,0,120026,COST
06069835101010000,2021,280232,0,280232,COST
06069835101010000,2020,150728,0,150728,COST
06069835101010000,2019,150728,0,150728,COST
06069836101010000,2021,263642,0,263642,COST
06069836101010000,2020,141732,0,141732,COST
06069836101010000,2019,141732,0,141732,COST
06069901101010000,2021,617655,0,617655,COST
06069901101010000,2020,401129,0,401129,COST
06069901101010000,2019,437279,0,437279,COST
06069901101020000,2021,421746,0,421746,COST
06069901101040000,2021,246631,442100,688731,COST
06069901101040000,2020,185753,419840,605593,COST
06069901101040000,2019,185753,419840,605593,COST
06069901101060000,2021,374065,0,374065,COST
06069901101060000,2020,300255,0,300255,COST
06069901101060000,2019,300255,0,300255,COST
06069901101100000,2021,199184,452070,651254,COST
06069901101100000,2020,145197,444710,589907,COST
06069901101100000,2019,145197,444710,589907,COST
06069901101120000,2021,191496,379840,571336,COST
06069901101120000,2020,138755,368210,506965,COST
06069901101120000,2019,138755,368210,506965,COST
06069901101270000,2021,205493,608530,814023,COST
06069901101270000,2020,87297,543110,630407,COST
06069901101270000,2019,87297,543110,630407,COST
06069901102010000,2021,182112,0,182112,COST
06069901102010000,2020,130946,0,130946,COST
06069901102010000,2019,112876,0,112876,COST
06069901102020000,2021,221044,0,221044,COST
06069901102020000,2020,163717,0,163717,COST
06069901102020000,2019,193684,0,193684,COST
06069901102030000,2021,214746,0,214746,COST
06069901102030000,2020,158352,0,158352,COST
06069901102030000,2019,137076,0,137076,COST
06069901102050000,2021,224819,355190,580009,COST
06069901102050000,2020,166945,0,166945,COST
06069901102050000,2019,148268,0,148268,COST
06069902101010000,2021,268830,0,268830,COST
06069902101010000,2020,146486,0,146486,COST
06069902101010000,2019,146486,0,146486,COST
06069903101010000,2021,186576,0,186576,COST
06069903101010000,2020,103284,0,103284,COST
06069903101010000,2019,103284,0,103284,COST
06069904101020000,2021,1087,0,1087,COST
06069904101020000,2020,1012,0,1012,COST
06069904101020000,2019,1012,0,1012,COST
06069904101040000,2021,219500,33790,253290,COST
06069904101040000,2020,150000,33140,183140,COST
06069904101040000,2019,150000,33140,183140,COST
06069904101330000,2021,220552,828120,1048672,COST
06069904101330000,2020,150979,818690,969669,COST
06069904101330000,2019,150979,818690,969669,COST
06069904101340000,2021,1107,0,1107,COST
06069904101340000,2020,1030,0,1030,COST
06069904101340000,2019,1030,0,1030,COST
06069904101350000,2021,220552,1055180,1275732,COST
06069904101350000,2020,150979,1039900,1190879,COST
06069904101350000,2019,150979,1039900,1190879,COST
06069904101360000,2021,220552,944210,1164762,COST
06069904101360000,2020,150979,925950,1076929,COST
06069904101360000,2019,150979,925950,1076929,COST
06069904101370000,2021,11160,0,11160,COST
06069904101370000,2020,6025,0,6025,COST
06069904101370000,2019,6025,0,6025,COST
06069904101380000,2021,220552,5158420,5378972,COST
06069904101380000,2020,150979,5429450,5580429,COST
06069904101380000,2019,150979,5429450,5580429,COST
06069904201010000,2021,441792,0,441792,COST
06069904201010000,2020,450685,0,450685,COST
06069904201010000,2019,450685,0,450685,COST
06069904201040000,2021,450016,1092460,1542476,COST
06069904201040000,2020,462547,1063080,1525627,OVR
06069904201040000,2019,462547,1063080,1525627,COST
06069904201070000,2021,434608,982810,1417418,COST
06069904201070000,2020,440397,967910,1408307,COST
06069904201070000,2019,440397,967910,1408307,COST
06069904203010000,2021,439205,2031680,2470885,COST
06069904203010000,2020,446972,1580285,2027257,MRA
06069904203010000,2019,446972,1580285,2027257,MRA
06069904203030000,2021,401147,819570,1220717,COST
06069904203030000,2020,393399,791510,1184909,COST
06069904203030000,2019,393399,683890,1077289,COST
06069904203050000,2021,428565,603340,1031905,COST
06069904203050000,2020,431796,588310,1020106,COST
06069904203050000,2019,431796,588310,1020106,COST
06069904203070000,2021,397276,748460,1145736,COST
06069904203070000,2020,388063,727720,1115783,COST
06069904203070000,2019,388063,727720,1115783,COST
06069904203090000,2021,494954,1177500,1672454,COST
06069904203090000,2020,528912,1145540,1674452,COST
06069904203090000,2019,528912,1145540,1674452,COST
06069904203110000,2021,429244,2158390,2587634,COST
06069904203110000,2020,432760,2074150,2506910,COST
06069904203110000,2019,432760,2074150,2506910,COST
06069904203130000,2021,420257,1287743,1708000,MKT
06069904203130000,2020,420052,1279340,1699392,COST
06069904203130000,2019,420052,1279340,1699392,COST
06069904203150000,2021,420257,0,420257,COST
06069904203150000,2020,420052,0,420052,COST
06069904203150000,2019,420052,0,420052,COST
06069904203170000,2021,420257,1179180,1599437,COST
06069904203170000,2020,420052,1135820,1555872,COST
06069904203170000,2019,420052,1135820,1555872,COST
06069904203190000,2021,418843,2082810,2501653,COST
06069904203190000,2020,418063,2005000,2423063,COST
06069904203190000,2019,418063,2005000,2423063,COST
06069904203210000,2021,427201,1620110,2047311,COST
06069904203210000,2020,429861,1571340,2001201,COST
06069904203210000,2019,429861,1571340,2001201,COST
06069904203230000,2021,413824,1106150,1519974,COST
06069904203230000,2020,411023,1084370,1495393,COST
06069904203230000,2019,411023,1084370,1495393,COST
06069904203250000,2021,411638,2241000,2652638,COST
06069904203250000,2020,407969,1150887,1558856,OVR
06069904203250000,2019,407969,1150887,1558856,OVR
06069904203270000,2021,434608,0,434608,COST
06069904203270000,2020,440397,0,440397,COST
06069904203270000,2019,440397,0,440397,COST
06069904205010000,2021,770285,2432090,3202375,COST
06069904205010000,2020,986175,2308830,3295005,COST
06069904205010000,2019,986175,2308830,3295005,COST
06069904205150000,2021,841338,2064810,2906148,COST
06069904205150000,2020,1116683,2003450,3120133,OVR
06069904205150000,2019,1116683,2003450,3120133,COST
06069904205350000,2021,821044,0,821044,COST
06069904205350000,2020,1078930,0,1078930,COST
06069904205350000,2019,1078930,0,1078930,COST
06069904301010000,2021,164487,0,164487,COST
06069904301010000,2020,89339,0,89339,COST
06069904301010000,2019,89339,0,89339,COST
06069905101020000,2021,4089,197740,201829,COST
06069905101020000,2020,3046,191540,194586,COST
06069905101020000,2019,3046,191540,194586,COST
06069905101030000,2021,350416,608690,959106,COST
06069905101030000,2020,278478,601270,879748,COST
06069905101030000,2019,278478,601270,879748,COST
06069905101050000,2021,108056,601290,709346,COST
06069905101050000,2020,65194,589470,654664,COST
06069905101050000,2019,65194,589470,654664,COST
06069905101080000,2021,219500,378500,598000,MKT
06069905101080000,2020,162400,331700,494100,MKT
06069905101080000,2019,162400,331700,494100,MKT
06069905101090000,2021,358512,0,358512,COST
06069905101090000,2020,285908,0,285908,COST
06069905101090000,2019,285908,0,285908,COST
06069905101150000,2021,20662,0,20662,COST
06069905101150000,2020,14107,0,14107,COST
06069905101150000,2019,14107,0,14107,COST
06069905201200000,2021,57210,0,57210,COST
06069905201200000,2020,42375,0,42375,COST
06069905201200000,2019,42375,0,42375,COST
06069905201300000,2021,1292,25360,26652,COST
06069905201300000,2020,1193,24510,25703,COST
06069905201300000,2019,1193,24510,25703,COST
06069905301030000,2021,521758,0,521758,COST
06069905301030000,2020,440661,0,440661,COST
06069905301030000,2019,440661,0,440661,COST
06069905301050000,2021,521086,1128350,1649436,COST
06069905301050000,2020,440006,1098150,1538156,COST
06069905301050000,2019,440006,1098150,1538156,COST
06069905301070000,2021,516155,319050,835205,COST
06069905301070000,2020,435210,303250,738460,COST
06069905301070000,2019,435210,303250,738460,COST
06069905301100000,2021,526184,721830,1248014,COST
06069905301100000,2020,444973,698460,1143433,COST
06069905301100000,2019,444973,698460,1143433,COST
06069905301150000,2021,543393,1386640,1930033,COST
06069905301150000,2020,461792,1226580,1688372,COST
06069905301150000,2019,461792,1226580,1688372,COST
06069905301250000,2021,543393,397650,941043,COST
06069905301250000,2020,461792,379300,841092,COST
06069905301250000,2019,461792,379300,841092,COST
06069905302050000,2021,496340,0,496340,COST
06069905302050000,2020,517,0,517,COST
06069905302050000,2019,517,0,517,COST
06069905302060000,2021,220000,348210,568210,COST
06069905302060000,2020,162865,340410,503275,COST
06069905302060000,2019,162865,340410,503275,COST
06069905302080000,2021,495850,0,495850,COST
06069905302080000,2020,415531,0,415531,COST
06069905302080000,2019,415531,0,415531,COST
06069905302100000,2021,500287,428560,928847,COST
06069905302100000,2020,419822,416300,836122,COST
06069905302100000,2019,419822,416300,836122,COST
06069906101020000,2021,16844,10520,27364,COST
06069906101020000,2020,33079,10150,43229,COST
06069906101020000,2019,33079,10150,43229,COST
06069906101040000,2021,7641,343460,351101,COST
06069906101040000,2020,8238,334160,342398,COST
06069906101040000,2019,8238,334160,342398,COST
06069906101060000,2021,71820,187730,259550,COST
06069906101060000,2020,85250,181460,266710,COST
06069906101060000,2019,85250,181460,266710,COST
06069906101106500,2021,186246,0,186246,COST
06069906101106500,2020,1798,0,1798,COST
06069906101106500,2019,1798,0,1798,COST
06069906101120000,2021,358036,0,358036,COST
06069906101140000,2021,358036,0,358036,COST
06069906101160000,2021,359934,0,359934,COST
06069906101180000,2021,360532,0,360532,COST
06069906101200000,2021,3443,0,3443,COST
06069906101200000,2020,46589,0,46589,COST
06069906101200000,2019,46589,0,46589,COST
06069906101300000,2021,12532,0,12532,COST
06069906102050000,2021,2975,68920,71895,COST
06069906102050000,2020,3486,68070,71556,COST
06069906102050000,2019,3486,68070,71556,COST
06069906102060000,2021,2021,0,2021,COST
06069906102060000,2020,2444,0,2444,COST
06069906102060000,2019,2444,0,2444,COST
06069906102070000,2021,2021,0,2021,COST
06069906102070000,2020,2444,0,2444,COST
06069906102070000,2019,2444,0,2444,COST
06069906102080000,2021,2021,0,2021,COST
06069906102080000,2020,2444,0,2444,COST
06069906102080000,2019,2444,0,2444,COST
06069906201100000,2021,18389,0,18389,COST
06069906201100000,2020,22196,0,22196,COST
06069906201100000,2019,22196,0,22196,COST
06069906301080000,2021,32086,150120,182206,COST
06069906301080000,2020,39660,146550,186210,COST
06069906301080000,2019,39660,146550,186210,COST
06069906301100000,2021,4408,177040,181448,COST
06069906301100000,2020,5434,172520,177954,COST
06069906301100000,2019,5434,172520,177954,COST
06069906301120000,2021,303575,214625,518200,MKT
06069906301120000,2020,236018,155382,391400,MKT
06069906301120000,2019,236018,155382,391400,MKT
06069906301130000,2021,409990,761520,1171510,COST
06069906301130000,2020,333737,637410,971147,COST
06069906301130000,2019,333737,595740,929477,COST
06069906401010000,2021,264568,0,264568,COST
06069906401010000,2020,201413,0,201413,COST
06069906401010000,2019,201413,0,201413,COST
06069906401020000,2021,277313,0,277313,COST
06069906401020000,2020,212639,0,212639,COST
06069906401020000,2019,212639,0,212639,COST
06069906401040000,2021,348589,385380,733969,COST
06069906401040000,2020,276804,367200,644004,COST
06069906401040000,2019,276804,358860,635664,COST
06069906401060000,2021,276245,97570,373815,COST
06069906401060000,2020,211695,94490,306185,COST
06069906401060000,2019,211695,94490,306185,COST
06069906401070000,2021,399075,971850,1370925,COST
06069906401070000,2020,323515,956010,1279525,COST
06069906401070000,2019,323515,867950,1191465,COST
06069906401080000,2021,276194,317030,593224,COST
06069906401080000,2020,211650,314340,525990,COST
06069906401080000,2019,211650,314340,525990,COST
06069906401090000,2021,489978,0,489978,COST
06069906401090000,2020,409864,0,409864,COST
06069906401090000,2019,409864,0,409864,COST
06069906401100000,2021,263292,567130,830422,COST
06069906401100000,2020,200293,0,200293,COST
06069906401100000,2019,200293,0,200293,COST
06069906403010000,2021,4884,1116360,1121244,COST
06069906403010000,2020,4946,1104900,1109846,COST
06069906403010000,2019,4946,1104900,1109846,COST
06069906403030000,2021,5451,784190,789641,COST
06069906403030000,2020,5472,768200,773672,COST
06069906403030000,2019,5472,768200,773672,COST
06069906403050000,2021,5590,653030,658620,COST
06069906403050000,2020,5601,641460,647061,COST
06069906403050000,2019,415514,641950,1057464,COST
06069906403100000,2021,2610,0,2610,COST
06069906403100000,2020,2430,0,2430,COST
06069906403100000,2019,2430,0,2430,COST
06069906403150000,2021,495885,279650,775535,COST
06069906403150000,2020,415565,263460,679025,COST
06069906403150000,2019,415565,0,415565,COST
06069907101010000,2021,38321,477700,516021,COST
06069907101010000,2020,24251,473200,497451,COST
06069907101010000,2019,24251,473200,497451,COST
06069907201020000,2021,123418,0,123418,COST
06069907201020000,2020,100387,0,100387,COST
06069907201020000,2019,100387,0,100387,COST
06069907201040000,2021,198882,1158170,1357052,COST
06069907201040000,2020,198200,1122630,1320830,COST
06069907201040000,2019,198200,1122630,1320830,COST
06069907401010000,2021,171331,112380,283711,COST
06069907401010000,2020,133233,110300,243533,COST
06069907401010000,2019,133233,110300,243533,COST
06069907401150000,2021,43577,0,43577,COST
06069907401150000,2020,23532,0,23532,COST
06069907401150000,2019,23532,0,23532,COST
06069908101060000,2021,304551,415080,719631,COST
06069908101060000,2020,208354,406690,615044,COST
06069908101060000,2019,208354,406690,615044,COST
06069908301010000,2021,218830,0,218830,COST
06069908301010000,2020,118233,0,118233,COST
06069908301010000,2019,118233,0,118233,COST
06069909101010000,2021,351987,0,351987,COST
06069909101010000,2020,190002,0,190002,COST
06069909101010000,2019,190002,0,190002,COST
06069910101010000,2021,196819,0,196819,COST
06069910101010000,2020,107412,0,107412,COST
06069910101010000,2019,107412,0,107412,COST
06069911101010000,2021,145139,0,145139,COST
06069911101010000,2020,80056,0,80056,COST
06069911101010000,2019,80056,0,80056,COST
06069912101010000,2021,276607,0,276607,COST
06069912101010000,2020,148891,0,148891,COST
06069912101010000,2019,148891,0,148891,COST
06069913101010000,2021,65000,0,65000,COST
06069913101010000,2020,34920,0,34920,COST
06069913101010000,2019,34920,0,34920,COST
06069913201010000,2021,141893,0,141893,COST
06069913201010000,2020,76382,0,76382,COST
06069913201010000,2019,76382,0,76382,COST
06069913202010000,2021,66267,0,66267,COST
06069913202010000,2020,35701,0,35701,COST
06069913202010000,2019,35701,0,35701,COST
06069914101010000,2021,262137,0,262137,COST
06069914101010000,2020,140860,0,140860,COST
06069914101010000,2019,140860,0,140860,COST
06069915101010000,2021,260000,0,260000,COST
06069915101010000,2020,139680,0,139680,COST
06069915101010000,2019,139680,0,139680,COST
06069916101010000,2021,260498,0,260498,COST
06069916101010000,2020,139952,0,139952,COST
06069916101010000,2019,139952,0,139952,COST
06069917101010000,2021,224756,0,224756,COST
06069917101010000,2020,121027,0,121027,COST
06069917101010000,2019,121027,0,121027,COST
06069917201010000,2021,83911,0,83911,COST
06069917201010000,2020,45312,0,45312,COST
06069917201010000,2019,45312,0,45312,COST
06069918101050000,2021,77343,0,77343,COST
06069918101050000,2020,41668,0,41668,COST
06069918101050000,2019,41668,0,41668,COST
06069918201010000,2021,212586,0,212586,COST
06069918201010000,2020,114384,0,114384,COST
06069918201010000,2019,114384,0,114384,COST
06069919101010000,2021,260230,0,260230,COST
06069919101010000,2020,139857,0,139857,COST
06069919101010000,2019,139857,0,139857,COST
06069920101010000,2021,294989,0,294989,COST
06069920101010000,2020,158808,0,158808,COST
06069920101010000,2019,158808,0,158808,COST
06069921101010000,2021,315150,0,315150,COST
06069921101010000,2020,169818,0,169818,COST
06069921101010000,2019,169818,0,169818,COST
06069922101010000,2021,272848,0,272848,COST
06069922101010000,2020,146970,0,146970,COST
06069922101010000,2019,146970,0,146970,COST
06069923101010000,2021,252945,0,252945,COST
06069923101010000,2020,136102,0,136102,COST
06069923101010000,2019,136102,0,136102,COST
06069924101010000,2021,267604,0,267604,COST
06069924101010000,2020,143854,0,143854,COST
06069924101010000,2019,143854,0,143854,COST
06069925101010000,2021,250484,0,250484,COST
06069925101010000,2020,134748,0,134748,COST
06069925101010000,2019,134748,0,134748,COST
06069926101010000,2021,297051,0,297051,COST
06069926101010000,2020,159930,0,159930,COST
06069926101010000,2019,159930,0,159930,COST
06069927101010000,2021,286224,0,286224,COST
06069927101010000,2020,154250,0,154250,COST
06069927101010000,2019,154250,0,154250,COST
06069928101010000,2021,353829,0,353829,COST
06069928101010000,2020,190864,0,190864,COST
06069928101010000,2019,190864,0,190864,COST
06069929101010000,2021,331660,0,331660,COST
06069929101010000,2020,178591,0,178591,COST
06069929101010000,2019,178591,0,178591,COST
06069930101010000,2021,299940,0,299940,COST
06069930101010000,2020,161225,0,161225,COST
06069930101010000,2019,161225,0,161225,COST
06069931101010000,2021,265037,0,265037,COST
06069931101010000,2020,142429,0,142429,COST
06069931101010000,2019,142429,0,142429,COST
06069932101010000,2021,314993,0,314993,COST
06069932101010000,2020,170372,0,170372,COST
06069932101010000,2019,170372,0,170372,COST
06069933101010000,2021,287161,0,287161,COST
06069933101010000,2020,154603,0,154603,COST
06069933101010000,2019,154603,0,154603,COST
06069934101010000,2021,261034,0,261034,COST
06069934101010000,2020,140283,0,140283,COST
06069934101010000,2019,140283,0,140283,COST
06069935101010000,2021,239549,0,239549,COST
06069935101010000,2020,128922,0,128922,COST
06069935101010000,2019,128922,0,128922,COST
06069936101010000,2021,302529,0,302529,COST
06069936101010000,2020,162824,0,162824,COST
06069936101010000,2019,162824,0,162824,COST
06070001101360000,2021,6516,0,6516,COST
06070001101360000,2020,3640,0,3640,COST
06070001101360000,2019,3640,0,3640,COST
06070001101400000,2021,5467,0,5467,COST
06070001101400000,2020,3136,0,3136,COST
06070001101400000,2019,3136,0,3136,COST
06070001101600000,2021,8999,0,8999,COST
06070001101600000,2020,4843,0,4843,COST
06070001101600000,2019,4843,0,4843,COST
06070001101720000,2021,76263,95430,171693,COST
06070001101720000,2020,41224,82560,123784,COST
06070001101720000,2019,41224,82560,123784,COST
06070001178010000,2021,4436,0,4436,COST
06070001178010000,2020,2446,0,2446,COST
06070001178010000,2019,2446,0,2446,COST
06070001201010000,2021,1116,0,1116,COST
06070001201010000,2020,1038,0,1038,COST
06070001201010000,2019,1038,0,1038,COST
06070001201120000,2021,63513,370020,433533,COST
06070001201120000,2020,45098,307040,352138,COST
06070001201120000,2019,45098,307040,352138,COST
06070001201240000,2021,63035,330480,393515,COST
06070001201240000,2020,44837,278040,322877,COST
06070001201240000,2019,44837,278040,322877,COST
06070001201360000,2021,55562,122920,178482,COST
06070001201360000,2020,41233,105240,146473,COST
06070001201360000,2019,41233,105240,146473,COST
06070001201480000,2021,55563,410240,465803,COST
06070001201480000,2020,41233,342370,383603,COST
06070001201480000,2019,41233,342370,383603,COST
06070001201600000,2021,9005,0,9005,COST
06070001201600000,2020,4846,0,4846,COST
06070001201600000,2019,4846,0,4846,COST
06070001254450000,2021,76271,3012090,3088361,COST
06070001254450000,2020,41231,2513570,2554801,COST
06070001254450000,2019,41231,2513570,2554801,COST
06070001254600000,2021,1116,0,1116,COST
06070001254600000,2020,1039,0,1039,COST
06070001254600000,2019,1039,0,1039,COST
06070001254750000,2021,76271,502480,578751,COST
06070001254750000,2020,41231,432060,473291,COST
06070001254750000,2019,41231,432060,473291,COST
06070001301010000,2021,283,0,283,COST
06070001301010000,2020,264,0,264,COST
06070001301010000,2019,264,0,264,COST
06070001301100000,2021,238,0,238,COST
06070001301100000,2020,221,0,221,COST
06070001301100000,2019,221,0,221,COST
06070001301200000,2021,228,0,228,COST
06070001301200000,2020,213,0,213,COST
06070001301200000,2019,213,0,213,COST
06070001301300000,2021,5753,0,5753,COST
06070001301300000,2020,3145,0,3145,COST
06070001301300000,2019,3145,0,3145,COST
06070001301500000,2021,4762,0,4762,COST
06070001301500000,2020,2614,0,2614,COST
06070001301500000,2019,2614,0,2614,COST
06070001301600000,2021,3394,0,3394,COST
06070001301600000,2020,1883,0,1883,COST
06070001301600000,2019,1883,0,1883,COST
06070001301800000,2021,63298,420750,484048,COST
06070001301800000,2020,45026,360610,405636,COST
06070001301800000,2019,45026,360610,405636,COST
06070001301900000,2021,9334,0,9334,COST
06070001301900000,2020,5022,0,5022,COST
06070001301900000,2019,5022,0,5022,COST
06070001340010000,2021,56501,205930,262431,COST
06070001340010000,2020,42106,174370,216476,COST
06070001340010000,2019,42106,174370,216476,COST
06070001406050000,2021,67230,794860,862090,COST
06070001406050000,2020,47096,680480,727576,COST
06070001406050000,2019,47096,675010,722106,COST
06070001424010000,2021,96095,418300,514395,COST
06070001424010000,2020,62934,362030,424964,COST
06070001424010000,2019,62934,362030,424964,COST
06070002101010000,2021,1107,0,1107,COST
06070002101010000,2020,1030,0,1030,COST
06070002101010000,2019,1030,0,1030,COST
06070002101020000,2021,77572,300710,378282,COST
06070002101020000,2020,56721,223940,280661,OVR
06070002101020000,2019,56721,223940,280661,COST
06070002103010000,2021,1107,0,1107,COST
06070002103010000,2020,1030,0,1030,COST
06070002103010000,2019,1030,0,1030,COST
06070002140010000,2021,1096,0,1096,COST
06070002140010000,2020,1020,0,1020,COST
06070002140010000,2019,1020,0,1020,COST
06070002140100000,2021,2214,0,2214,COST
06070002140100000,2020,2060,0,2060,COST
06070002140100000,2019,2060,0,2060,COST
06070002140150000,2021,2161,0,2161,COST
06070002140150000,2020,2011,0,2011,COST
06070002140150000,2019,2011,0,2011,COST
06070002140200000,2021,1096,0,1096,COST
06070002140200000,2020,1020,0,1020,COST
06070002140200000,2019,1020,0,1020,COST
06070002201030000,2021,1113,470,1583,COST
06070002201030000,2020,1036,410,1446,COST
06070002201030000,2019,1036,410,1446,COST
06070002201200000,2021,262733,149160,411893,COST
06070002201200000,2020,215401,127080,342481,COST
06070002201200000,2019,215401,127080,342481,COST
06070002201400000,2021,1119,0,1119,COST
06070002201400000,2020,1042,0,1042,COST
06070002201400000,2019,1042,0,1042,COST
06070002203010000,2021,1114,0,1114,COST
06070002203010000,2020,1036,0,1036,COST
06070002203010000,2019,1036,0,1036,COST
06070002204010000,2021,77354,738520,815874,COST
06070002204010000,2020,56518,625440,681958,COST
06070002204010000,2019,56518,581350,637868,COST
06070002205200000,2021,77364,105220,182584,COST
06070002205200000,2020,56527,89280,145807,COST
06070002205200000,2019,56527,89280,145807,COST
06070002230010000,2021,55552,405670,461222,COST
06070002230010000,2020,41223,335280,376503,OVR
06070002230010000,2019,41223,335280,376503,COST
06070002301010000,2021,19479,0,19479,COST
06070002301010000,2020,10506,0,10506,COST
06070002301010000,2019,10506,0,10506,COST
06070002303010000,2021,20552,0,20552,COST
06070002303010000,2020,11136,0,11136,COST
06070002303010000,2019,11136,0,11136,COST
06070002320010000,2021,64892,293760,358652,COST
06070002320010000,2020,45853,246070,291923,COST
06070002320010000,2019,45853,246070,291923,COST
06070002340010000,2021,80665,195710,276375,COST
06070002340010000,2020,54354,169720,224074,COST
06070002340010000,2019,54354,169720,224074,COST
06070002401010000,2021,1015,0,1015,COST
06070002401010000,2020,945,0,945,COST
06070002401010000,2019,945,0,945,COST
06070002402010000,2021,16633,0,16633,COST
06070002402010000,2020,9177,0,9177,COST
06070002402010000,2019,9177,0,9177,COST
06070003102010000,2021,11432,0,11432,COST
06070003102010000,2020,6167,0,6167,COST
06070003102010000,2019,6167,0,6167,COST
06070003102050000,2021,11653,0,11653,COST
06070003102050000,2020,6290,0,6290,COST
06070003102050000,2019,6290,0,6290,COST
06070003102150000,2021,64697,69600,134297,COST
06070003102150000,2020,45744,59150,104894,COST
06070003102150000,2019,45744,59150,104894,COST
06070003102200000,2021,64521,229090,293611,COST
06070003102200000,2020,45650,195130,240780,COST
06070003102200000,2019,45642,195130,240772,COST
06070003102300000,2021,11155,0,11155,COST
06070003102300000,2020,6015,0,6015,COST
06070003102300000,2019,6048,0,6048,COST
06070003102350000,2021,64937,236190,301127,COST
06070003102350000,2020,45874,204180,250054,COST
06070003102350000,2019,45842,204180,250022,COST
06070003102400000,2021,55853,674550,730403,COST
06070003102400000,2020,41503,575070,616573,COST
06070003102400000,2019,41503,575070,616573,COST
06070003102450000,2021,63977,193420,257397,COST
06070003102450000,2020,45399,162600,207999,COST
06070003102450000,2019,45399,162600,207999,COST
06070003102550000,2021,64160,115900,180060,COST
06070003102550000,2020,45452,102920,148372,COST
06070003102550000,2019,45452,102920,148372,COST
06070003102600000,2021,1110,0,1110,COST
06070003102600000,2020,1033,0,1033,COST
06070003102600000,2019,1033,0,1033,COST
06070003102700000,2021,10472,0,10472,COST
06070003102700000,2020,5647,0,5647,COST
06070003102700000,2019,5647,0,5647,COST
06070003102750000,2021,55554,295290,350844,COST
06070003102750000,2020,41225,253320,294545,COST
06070003102750000,2019,41225,253320,294545,COST
06070003103050000,2021,62781,1567330,1630111,COST
06070003103050000,2020,44786,1318620,1363406,COST
06070003103050000,2019,44786,1318620,1363406,COST
06070003103100000,2021,8333,89830,98163,COST
06070003103100000,2020,4613,90550,95163,COST
06070003103100000,2019,4613,90550,95163,COST
06070003103150000,2021,10118,0,10118,COST
06070003103150000,2020,5454,0,5454,COST
06070003103150000,2019,5454,0,5454,COST
06070003103200000,2021,10482,0,10482,COST
06070003103200000,2020,5655,0,5655,COST
06070003103200000,2019,5655,0,5655,COST
06070003118010000,2021,64012,375160,439172,COST
06070003118010000,2020,45370,319550,364920,COST
06070003118010000,2019,45370,319550,364920,COST
06070003142010000,2021,63949,195210,259159,COST
06070003142010000,2020,45335,163540,208875,COST
06070003142010000,2019,45335,163540,208875,COST
06070003166010000,2021,9099,0,9099,COST
06070003166010000,2020,4983,0,4983,COST
06070003166010000,2019,4983,0,4983,COST
06070003166180000,2021,63998,453180,517178,COST
06070003166180000,2020,45399,387870,433269,COST
06070003166180000,2019,45399,387870,433269,COST
06070003301010000,2021,85019,0,85019,COST
06070003301010000,2020,45893,0,45893,COST
06070003301010000,2019,45893,0,45893,COST
06070003403200000,2021,80705,322720,403425,COST
06070003403200000,2020,54388,275700,330088,COST
06070003403200000,2019,54388,275700,330088,COST
06070003466010000,2021,75477,148670,224147,COST
06070003466010000,2020,51557,126630,178187,COST
06070003466010000,2019,51557,126630,178187,COST
06070004101010000,2021,123289,0,123289,COST
06070004101010000,2020,66473,0,66473,COST
06070004101010000,2019,66473,0,66473,COST
06070004301010000,2021,175494,0,175494,COST
06070004301010000,2020,94602,0,94602,COST
06070004301010000,2019,94602,0,94602,COST
06070005101010000,2021,197355,0,197355,COST
06070005101010000,2020,106301,0,106301,COST
06070005101010000,2019,106301,0,106301,COST
06070005301010000,2021,91687,0,91687,COST
06070005301010000,2020,49435,0,49435,COST
06070005301010000,2019,49435,0,49435,COST
06070006101010000,2021,291347,0,291347,COST
06070006101010000,2020,156957,0,156957,COST
06070006101010000,2019,156957,0,156957,COST
06070006201010000,2021,160593,0,160593,COST
06070006201010000,2020,116804,0,116804,COST
06070006201010000,2019,116804,0,116804,COST
06070007101010000,2021,281596,0,281596,COST
06070007101010000,2020,151509,0,151509,COST
06070007101010000,2019,151509,0,151509,COST
06070008101010000,2021,253082,0,253082,COST
06070008101010000,2020,136507,0,136507,COST
06070008101010000,2019,136507,0,136507,COST
06070008301010000,2021,38454,0,38454,COST
06070008301010000,2020,20766,0,20766,COST
06070008301010000,2019,20766,0,20766,COST
06070008301100000,2021,150313,0,150313,COST
06070008301100000,2020,122377,0,122377,COST
06070008301100000,2019,122377,0,122377,COST
06070008401100000,2021,43261,0,43261,COST
06070008401100000,2020,23361,0,23361,COST
06070008401100000,2019,23361,0,23361,COST
06070009101010000,2021,23468,0,23468,COST
06070009101010000,2020,12765,0,12765,COST
06070009101010000,2019,12765,0,12765,COST
06070009201010000,2021,197167,0,197167,COST
06070009201010000,2020,106590,0,106590,COST
06070009201010000,2019,106590,0,106590,COST
06070009401100000,2021,34074,0,34074,COST
06070009401100000,2020,18414,0,18414,COST
06070009401100000,2019,18414,0,18414,COST
06070010101010000,2021,158251,0,158251,COST
06070010101010000,2020,85328,0,85328,COST
06070010101010000,2019,85328,0,85328,COST
06070011102010000,2021,255884,312950,568834,COST
06070011102010000,2020,152513,268440,420953,COST
06070011102010000,2019,152513,268440,420953,COST
06070012101050000,2021,55552,498870,554422,COST
06070012101050000,2020,41223,430590,471813,COST
06070012101050000,2019,41223,430590,471813,COST
06070012101430000,2021,55557,407780,463337,COST
06070012101430000,2020,41227,351900,393127,COST
06070012101430000,2019,41227,351900,393127,COST
06070012112010000,2021,55643,290480,346123,COST
06070012112010000,2020,41308,244850,286158,COST
06070012112010000,2019,41308,244850,286158,COST
06070012124030000,2021,55552,811550,867102,COST
06070012124030000,2020,41223,687050,728273,COST
06070012124030000,2019,41223,687050,728273,COST
06070012136010000,2021,55950,359150,415100,COST
06070012136010000,2020,41594,303600,345194,COST
06070012136010000,2019,41594,303600,345194,COST
06070012148010000,2021,1179,0,1179,COST
06070012148010000,2020,715,0,715,COST
06070012148010000,2019,715,0,715,COST
06070012201010000,2021,308,0,308,COST
06070012201010000,2020,287,0,287,COST
06070012201010000,2019,287,0,287,COST
06070012202020000,2021,77541,488780,566321,COST
06070012202020000,2020,56691,430840,487531,COST
06070012202020000,2019,56691,430840,487531,COST
06070012202030000,2021,1298,0,1298,COST
06070012202030000,2020,1208,0,1208,COST
06070012202030000,2019,1208,0,1208,COST
06070012259010000,2021,230,0,230,COST
06070012259010000,2020,214,0,214,COST
06070012259010000,2019,214,0,214,COST
06070012260010000,2021,235,0,235,COST
06070012260010000,2020,219,0,219,COST
06070012260010000,2019,219,0,219,COST
06070012270010000,2021,282,20250,20532,COST
06070012270010000,2020,262,20170,20432,COST
06070012270010000,2019,262,20170,20432,COST
06070012270480000,2021,77615,309240,386855,COST
06070012270480000,2020,56761,267780,324541,COST
06070012270480000,2019,56761,267780,324541,COST
06070012270600000,2021,228,0,228,COST
06070012270600000,2020,213,0,213,COST
06070012270600000,2019,213,0,213,COST
06070016101010000,2021,348077,0,348077,COST
06070016101010000,2020,187958,0,187958,COST
06070016101010000,2019,187958,0,187958,COST
06070017101010000,2021,90480,0,90480,COST
06070017101010000,2020,48860,0,48860,COST
06070017101010000,2019,48860,0,48860,COST
06070017201010000,2021,75112,0,75112,COST
06070017201010000,2020,40443,0,40443,COST
06070017201010000,2019,40443,0,40443,COST
06070017201400000,2021,17329,0,17329,COST
06070017201400000,2020,9302,0,9302,COST
06070017201400000,2019,9302,0,9302,COST
06070017301010000,2021,132446,0,132446,COST
06070017301010000,2020,71327,0,71327,COST
06070017301010000,2019,71327,0,71327,COST
06070018101010000,2021,252324,0,252324,COST
06070018101010000,2020,135609,0,135609,COST
06070018101010000,2019,135609,0,135609,COST
06070019101010000,2021,250223,0,250223,COST
06070019101010000,2020,134667,0,134667,COST
06070019101010000,2019,134667,0,134667,COST
06070020101010000,2021,83861,0,83861,COST
06070020101010000,2020,45068,0,45068,COST
06070020101010000,2019,45068,0,45068,COST
06070020301010000,2021,143007,0,143007,COST
06070020301010000,2020,76865,0,76865,COST
06070020301010000,2019,76865,0,76865,COST
06070020401010000,2021,32500,0,32500,COST
06070020401010000,2020,17460,0,17460,COST
06070020401010000,2019,17460,0,17460,COST
06070021101010000,2021,253799,0,253799,COST
06070021101010000,2020,137075,0,137075,COST
06070021101010000,2019,137075,0,137075,COST
06070021201010000,2021,90480,0,90480,COST
06070021201010000,2020,48860,0,48860,COST
06070021201010000,2019,48860,0,48860,COST
06070028101010000,2021,136382,0,136382,COST
06070028101010000,2020,73397,0,73397,COST
06070028101010000,2019,73397,0,73397,COST
06070028301010000,2021,129986,0,129986,COST
06070028301010000,2020,69840,0,69840,COST
06070028301010000,2019,69840,0,69840,COST
06070029101010000,2021,246035,0,246035,COST
06070029101010000,2020,132402,0,132402,COST
06070029101010000,2019,132402,0,132402,COST
06070030101010000,2021,298700,0,298700,COST
06070030101010000,2020,161282,0,161282,COST
06070030101010000,2019,161282,0,161282,COST
06070031101010000,2021,134019,0,134019,COST
06070031101010000,2020,72124,0,72124,COST
06070031101010000,2019,72124,0,72124,COST
06070031301010000,2021,131702,0,131702,COST
06070031301010000,2020,70816,0,70816,COST
06070031301010000,2019,70816,0,70816,COST
06070032101010000,2021,269530,0,269530,COST
06070032101010000,2020,144814,0,144814,COST
06070032101010000,2019,144814,0,144814,COST
06070033101010000,2021,133598,0,133598,COST
06070033101010000,2020,71802,0,71802,COST
06070033101010000,2019,71802,0,71802,COST
06070033201010000,2021,64494,0,64494,COST
06070033201010000,2020,34654,0,34654,COST
06070033201010000,2019,34654,0,34654,COST
06070033301010000,2021,67300,0,67300,COST
06070033301010000,2020,36175,0,36175,COST
06070033301010000,2019,36175,0,36175,COST
06079201101010000,2021,23069,0,23069,COST
06079201101010000,2020,21483,0,21483,COST
06079201101010000,2019,21483,0,21483,COST
06079202101010000,2021,29062,0,29062,COST
06079202101010000,2020,27017,0,27017,COST
06079202101010000,2019,27017,0,27017,COST
06079203101010000,2021,20168,0,20168,COST
06079203101010000,2020,18751,0,18751,COST
06079203101010000,2019,18751,0,18751,COST
06079203201010000,2021,34188,0,34188,COST
06079203201010000,2020,35880,0,35880,COST
06079203201010000,2019,35880,0,35880,COST
06079211101010000,2021,29459,0,29459,COST
06079211101010000,2020,27360,0,27360,COST
06079211101010000,2019,27360,0,27360,COST
06079212101010000,2021,25728,0,25728,COST
06079212101010000,2020,23928,0,23928,COST
06079212101010000,2019,23928,0,23928,COST
06079213101010000,2021,25974,0,25974,COST
06079213101010000,2020,24154,0,24154,COST
06079213101010000,2019,24154,0,24154,COST
06079401101010000,2021,305726,11520,317246,COST
06079401101010000,2020,322334,11100,333434,COST
06079401101010000,2019,322334,11100,333434,COST
06079402201011001,2021,3839,0,3839,COST
06079402201011001,2020,4015,0,4015,COST
06079402201011001,2019,4015,0,4015,COST
06079402201011002,2021,17358,0,17358,COST
06079402201011002,2020,17469,0,17469,COST
06079402201011002,2019,17469,0,17469,COST
06079402401010000,2021,16672,0,16672,COST
06079402401010000,2020,16584,0,16584,COST
06079402401010000,2019,16584,0,16584,COST
06079402401030000,2021,88082,27780,115862,COST
06079402401030000,2020,92540,27860,120400,COST
06079402401030000,2019,92540,27860,120400,COST
06079403101010000,2021,48683,0,48683,COST
06079403101010000,2020,50855,0,50855,COST
06079403101010000,2019,50855,0,50855,COST
06079403201010000,2021,50643,0,50643,COST
06079403201010000,2020,53182,0,53182,COST
06079403201010000,2019,53182,0,53182,COST
06079403301011001,2021,7626,0,7626,COST
06079403301011001,2020,7101,0,7101,COST
06079403301011001,2019,7101,0,7101,COST
06079403301011002,2021,25306,4115120,4140426,COST
06079403301011002,2020,25324,3506010,3531334,COST
06079403301011002,2019,25324,3506010,3531334,COST
06079403302010000,2021,1266,0,1266,COST
06079403302010000,2020,1177,0,1177,COST
06079403302010000,2019,1177,0,1177,COST
06079404101010000,2021,98755,0,98755,COST
06079404101010000,2020,137066,0,137066,COST
06079404101010000,2019,137066,0,137066,COST
06079404301010000,2021,65311,0,65311,COST
06079404301010000,2020,79126,0,79126,COST
06079404301010000,2019,79126,0,79126,COST
06079405101010000,2021,104823,323120,427943,COST
06079405101010000,2020,150407,205630,356037,COST
06079405101010000,2019,150407,205630,356037,COST
06079405201010000,2021,148219,4560,152779,COST
06079405201010000,2020,104077,4380,108457,COST
06079405201010000,2019,104077,4380,108457,COST
06079405201020000,2021,148219,334081,482300,MKT
06079405201020000,2020,104077,301923,406000,MKT
06079405201020000,2019,104077,301923,406000,MKT
06079405201030000,2021,148361,292339,440700,MKT
06079405201030000,2020,104303,259797,364100,MKT
06079405201030000,2019,104303,259797,364100,MKT
06079405201040000,2021,148456,174244,322700,MKT
06079405201040000,2020,104454,83510,187964,COST
06079405201040000,2019,104454,83510,187964,COST
06079405201050000,2021,525,11860,12385,COST
06079405201050000,2020,489,11320,11809,COST
06079405201050000,2019,489,11320,11809,COST
06079405201060000,2021,148314,278186,426500,MKT
06079405201060000,2020,104228,218080,322308,COST
06079405201060000,2019,104228,218080,322308,COST
06079405201070000,2021,148171,0,148171,COST
06079405201070000,2020,104001,0,104001,COST
06079405201070000,2019,104001,0,104001,COST
06079405201080000,2021,148076,0,148076,COST
06079405201080000,2020,103850,0,103850,COST
06079405201080000,2019,103850,0,103850,COST
06079405201090000,2021,151052,250748,401800,MKT
06079405201090000,2020,108639,219861,328500,MKT
06079405201090000,2019,108639,219861,328500,MKT
06079405201100000,2021,151097,44540,195637,COST
06079405201100000,2020,108713,36230,144943,COST
06079405201100000,2019,108713,36230,144943,COST
06079405201110000,2021,75603,394700,470303,COST
06079405201110000,2020,22768,322060,344828,COST
06079405201110000,2019,22768,322060,344828,COST
06079405201120000,2021,559,400,959,COST
06079405201120000,2020,22769,24950,47719,COST
06079405201120000,2019,22769,24950,47719,COST
06079405201130000,2021,151143,24080,175223,COST
06079405201130000,2020,108787,23640,132427,COST
06079405201130000,2019,108787,23640,132427,COST
06079405201140000,2021,557,0,557,COST
06079405201140000,2020,519,0,519,COST
06079405201140000,2019,519,0,519,COST
06079405201150000,2021,151052,8570,159622,COST
06079405201150000,2020,108639,8820,117459,COST
06079405201150000,2019,108639,8820,117459,COST
06079405201160000,2021,151006,118590,269596,COST
06079405201160000,2020,108565,99470,208035,COST
06079405201160000,2019,108565,99470,208035,COST
06079405201170000,2021,150915,0,150915,COST
06079405201170000,2020,108417,0,108417,COST
06079405201170000,2019,108417,0,108417,COST
06079405201180000,2021,150915,190085,341000,MKT
06079405201180000,2020,108417,151183,259600,MKT
06079405201180000,2019,108417,151183,259600,MKT
06079405201190000,2021,150915,171060,321975,COST
06079405201190000,2020,108417,114483,222900,MKT
06079405201190000,2019,108417,114483,222900,MKT
06079405201200000,2021,150915,280585,431500,MKT
06079405201200000,2020,108417,245283,353700,MKT
06079405201200000,2019,108417,245283,353700,MKT
06079405201210000,2021,150870,280030,430900,MKT
06079405201210000,2020,108343,241857,350200,MKT
06079405201210000,2019,108343,241857,350200,MKT
06079405201220000,2021,123712,59020,182732,COST
06079405201220000,2020,108269,184190,292459,COST
06079405201220000,2019,108269,184190,292459,COST
06079405201230000,2021,150824,0,150824,COST
06079405201230000,2020,108269,0,108269,COST
06079405201230000,2019,108269,0,108269,COST
06079405201240000,2021,75599,240990,316589,COST
06079405201240000,2020,22764,190350,213114,COST
06079405201240000,2019,22764,190350,213114,COST
06079405201250000,2021,553,0,553,COST
06079405201250000,2020,515,0,515,COST
06079405201250000,2019,515,0,515,COST
06079405201260000,2021,150779,0,150779,COST
06079405201260000,2020,108194,0,108194,COST
06079405201260000,2019,108194,0,108194,COST
06079405201270000,2021,150779,147130,297909,COST
06079405201270000,2020,108194,169506,277700,MKT
06079405201270000,2019,108194,169506,277700,MKT
06079405201280000,2021,137192,19350,156542,COST
06079405201280000,2020,87352,19210,106562,COST
06079405201280000,2019,87352,19210,106562,COST
06079405201290000,2021,150687,423000,573687,COST
06079405201290000,2020,108046,349300,457346,COST
06079405201290000,2019,108046,349300,457346,COST
06079405201300000,2021,123600,208700,332300,MKT
06079405201300000,2020,108046,140010,248056,COST
06079405201300000,2019,108046,140010,248056,COST
06079405201310000,2021,150687,0,150687,COST
06079405201310000,2020,108046,0,108046,COST
06079405201310000,2019,108046,0,108046,COST
06079405201320000,2021,150687,218313,369000,MKT
06079405201320000,2020,108046,196754,304800,MKT
06079405201320000,2019,108046,196754,304800,MKT
06079405301280000,2021,101213,0,101213,COST
06079405301280000,2020,43849,0,43849,COST
06079405301280000,2019,43849,0,43849,COST
06079405401010000,2021,81224,0,81224,COST
06079405401010000,2020,114059,0,114059,COST
06079405401010000,2019,114059,0,114059,COST
06079406101011001,2021,5766,0,5766,COST
06079406101011001,2020,5364,0,5364,COST
06079406101011001,2019,5364,0,5364,COST
06079406101011002,2021,8901,0,8901,COST
06079406101011002,2020,8286,0,8286,COST
06079406101011002,2019,8286,0,8286,COST
06079406201020000,2021,89427,107890,197317,COST
06079406201020000,2020,93796,152370,246166,COST
06079406201020000,2019,93796,152370,246166,COST
06079407101010000,2021,3322,0,3322,COST
06079407101010000,2020,3091,0,3091,COST
06079407101010000,2019,3091,0,3091,COST
06079407201020000,2021,9647,0,9647,COST
06079407201020000,2020,8972,0,8972,COST
06079407201020000,2019,8972,0,8972,COST
06079407401010000,2021,17647,0,17647,COST
06079407401010000,2020,17751,0,17751,COST
06079407401010000,2019,17751,0,17751,COST
06079408101010000,2021,110765,0,110765,COST
06079408101010000,2020,115848,0,115848,COST
06079408101010000,2019,115848,0,115848,COST
06079408201010000,2021,5368,0,5368,COST
06079408201010000,2020,4991,0,4991,COST
06079408201010000,2019,4991,0,4991,COST
06079409101010000,2021,48482,0,48482,COST
06079409101010000,2020,50869,0,50869,COST
06079409101010000,2019,50869,0,50869,COST
06079409201010000,2021,25631,0,25631,COST
06079409201010000,2020,26630,0,26630,COST
06079409201010000,2019,26630,0,26630,COST
06079409401010000,2021,116756,580,117336,COST
06079409401010000,2020,123159,560,123719,COST
06079409401010000,2019,123159,560,123719,COST
06079410101010000,2021,91135,0,91135,COST
06079410101010000,2020,95588,0,95588,COST
06079410101010000,2019,95588,0,95588,COST
06079410301010000,2021,61816,0,61816,COST
06079410301010000,2020,65124,0,65124,COST
06079410301010000,2019,65124,0,65124,COST
06079410401010000,2021,47454,0,47454,COST
06079410401010000,2020,49796,0,49796,COST
06079410401010000,2019,49796,0,49796,COST
06079411101010000,2021,17253,0,17253,COST
06079411101010000,2020,16067,0,16067,COST
06079411101010000,2019,16067,0,16067,COST
06079411301010000,2021,8866,0,8866,COST
06079411301010000,2020,8258,0,8258,COST
06079411301010000,2019,8258,0,8258,COST
06079411401010000,2021,9493,0,9493,COST
06079411401010000,2020,8843,0,8843,COST
06079411401010000,2019,8843,0,8843,COST
06079412301010000,2021,94940,0,94940,COST
06079412301010000,2020,99085,0,99085,COST
06079412301010000,2019,99085,0,99085,COST
06079412401010000,2021,58103,0,58103,COST
06079412401010000,2020,60593,0,60593,COST
06079412401010000,2019,60593,0,60593,COST
06079413101010000,2021,111381,0,111381,COST
06079413101010000,2020,117106,0,117106,COST
06079413101010000,2019,117106,0,117106,COST
06079413301010000,2021,5266,0,5266,COST
06079413301010000,2020,4995,0,4995,COST
06079413301010000,2019,4995,0,4995,COST
06079413401010000,2021,9349,0,9349,COST
06079413401010000,2020,8707,0,8707,COST
06079413401010000,2019,8707,0,8707,COST
06079414101010000,2021,194555,0,194555,COST
06079414101010000,2020,203960,0,203960,COST
06079414101010000,2019,203960,0,203960,COST
06079415101010000,2021,66401,0,66401,COST
06079415101010000,2020,69997,0,69997,COST
06079415101010000,2019,69997,0,69997,COST
06079415201010000,2021,75195,0,75195,COST
06079415201010000,2020,79345,0,79345,COST
06079415201010000,2019,79345,0,79345,COST
06079415301010000,2021,34414,0,34414,COST
06079415301010000,2020,35640,0,35640,COST
06079415301010000,2019,35640,0,35640,COST
06079415401010000,2021,62059,0,62059,COST
06079415401010000,2020,65284,0,65284,COST
06079415401010000,2019,65284,0,65284,COST
06079416101010000,2021,170282,0,170282,COST
06079416101010000,2020,178090,0,178090,COST
06079416101010000,2019,178090,0,178090,COST
06079417101010000,2021,45352,0,45352,COST
06079417101010000,2020,46860,0,46860,COST
06079417101010000,2019,46860,0,46860,COST
06079417201200000,2021,750,0,750,COST
06079417201200000,2020,700,0,700,COST
06079417201200000,2019,700,0,700,COST
06079417301010000,2021,24164,0,24164,COST
06079417301010000,2020,24680,0,24680,COST
06079417301010000,2019,24680,0,24680,COST
06079418101010000,2021,10599,0,10599,COST
06079418101010000,2020,9880,0,9880,COST
06079418101010000,2019,9880,0,9880,COST
06079418201010000,2021,94930,332230,427160,COST
06079418201010000,2020,40931,263660,304591,COST
06079418201010000,2019,40931,263660,304591,COST
06079418201300000,2021,1135,0,1135,COST
06079418201300000,2020,1056,0,1056,COST
06079418201300000,2019,1056,0,1056,COST
06079418301010000,2021,67511,36020,103531,COST
06079418301010000,2020,70085,34550,104635,COST
06079418301010000,2019,70085,34550,104635,COST
06079418360010000,2021,94997,1282850,1377847,COST
06079418360010000,2020,47305,594690,641995,COST
06079418360010000,2019,47305,594690,641995,COST
06079418401010000,2021,2214,0,2214,COST
06079418401010000,2020,2060,0,2060,COST
06079418401010000,2019,2060,0,2060,COST
06079419101010000,2021,185514,0,185514,COST
06079419101010000,2020,187041,0,187041,COST
06079419101010000,2019,187041,0,187041,COST
06079419201010000,2021,11736,0,11736,COST
06079419201010000,2020,10910,0,10910,COST
06079419201010000,2019,10910,0,10910,COST
06079419301010000,2021,5559,0,5559,COST
06079419301010000,2020,5176,0,5176,COST
06079419301010000,2019,5176,0,5176,COST
06079419401010000,2021,2214,0,2214,COST
06079419401010000,2020,2060,0,2060,COST
06079419401010000,2019,2060,0,2060,COST
06079420101010000,2021,236262,328540,564802,COST
06079420101010000,2020,214376,260800,475176,COST
06079420101010000,2019,214376,260800,475176,COST
06079420301010000,2021,2048,0,2048,COST
06079420301010000,2020,1906,0,1906,COST
06079420301010000,2019,1906,0,1906,COST
06079421101010000,2021,124229,0,124229,COST
06079421101010000,2020,128626,0,128626,COST
06079421101010000,2019,128626,0,128626,COST
06079422101200000,2021,42237,0,42237,COST
06079422101200000,2020,44262,0,44262,COST
06079422101200000,2019,44262,0,44262,COST
06079422201010000,2021,12104,0,12104,COST
06079422201010000,2020,11288,0,11288,COST
06079422201010000,2019,11288,0,11288,COST
06079422301150000,2021,79096,965830,1044926,COST
06079422301150000,2020,26019,775670,801689,COST
06079422301150000,2019,26019,775670,801689,COST
06079422401010000,2021,1393,0,1393,COST
06079422401010000,2020,1296,0,1296,COST
06079422401010000,2019,1296,0,1296,COST
06079422401200000,2021,10051,0,10051,COST
06079422401200000,2020,9816,0,9816,COST
06079422401200000,2019,9816,0,9816,COST
06079422402200000,2021,75394,0,75394,COST
06079422402200000,2020,22498,0,22498,COST
06079422402200000,2019,22498,0,22498,COST
06079423101010000,2021,110445,1702360,1812805,COST
06079423101010000,2020,128621,871600,1000221,COST
06079423101010000,2019,133407,389660,523067,COST
06079423101100000,2021,35425,0,35425,COST
06079423101100000,2020,37171,0,37171,COST
06079423101100000,2019,37171,0,37171,COST
06079423101200000,2021,180261,741490,921751,COST
06079423101200000,2020,162165,577160,739325,COST
06079423101200000,2019,162165,0,162165,COST
06079423101400000,2021,1113,670,1783,COST
06079423101400000,2020,1035,680,1715,COST
06079423101400000,2019,1035,0,1035,COST
06079423201010000,2021,66325,0,66325,COST
06079423201010000,2020,69718,0,69718,COST
06079423201010000,2019,69718,0,69718,COST
06079423201100000,2021,180261,365139,545400,MKT
06079423201100000,2020,162165,247800,409965,COST
06079423201100000,2019,162165,0,162165,COST
06079424101020000,2021,8466,274060,282526,COST
06079424101020000,2020,8291,223930,232221,COST
06079424101020000,2019,8291,223930,232221,COST
06079424201010000,2021,40373,0,40373,COST
06079424201010000,2020,47889,0,47889,COST
06079424201010000,2019,47889,0,47889,COST
06079424201050000,2021,7099,0,7099,COST
06079424201050000,2020,7310,0,7310,COST
06079424201050000,2019,7310,0,7310,COST
06079424301020000,2021,17939,110690,128629,COST
06079424301020000,2020,16700,106400,123100,COST
06079424301020000,2019,16700,106400,123100,COST
06079601101010000,2021,116111,51140,167251,COST
06079601101010000,2020,157371,52790,210161,COST
06079601101010000,2019,157371,52790,210161,COST
06079601101030000,2021,176494,233330,409824,COST
06079601101030000,2020,179507,210290,389797,COST
06079601101030000,2019,179507,210290,389797,COST
06079601201010000,2021,3946,0,3946,COST
06079601201010000,2020,3695,0,3695,COST
06079601201010000,2019,3695,0,3695,COST
06079601301010000,2021,167685,232615,400300,MKT
06079601301010000,2020,159628,207572,367200,MKT
06079601301010000,2019,159628,207572,367200,MKT
06079601301030000,2021,134,0,134,COST
06079601301030000,2020,125,0,125,COST
06079601301030000,2019,125,0,125,COST
06079601404011001,2021,14631,0,14631,COST
06079601404011001,2020,15761,0,15761,COST
06079601404011001,2019,15761,0,15761,COST
06079601404011002,2021,1908,897380,899288,COST
06079601404011002,2020,2184,793390,795574,COST
06079601404011002,2019,2184,793390,795574,COST
06079602101010000,2021,42572,23450,66022,COST
06079602101010000,2020,54485,22450,76935,COST
06079602101010000,2019,54485,22450,76935,COST
06079602101030000,2021,70337,264390,334727,COST
06079602101030000,2020,90285,240020,330305,COST
06079602101030000,2019,90285,240020,330305,COST
06079602101040000,2021,94580,179020,273600,MKT
06079602101040000,2020,110871,153829,264700,MKT
06079602101040000,2019,110871,153829,264700,MKT
06079602101050000,2021,96304,245896,342200,MKT
06079602101050000,2020,112152,181748,293900,MKT
06079602101050000,2019,112152,181748,293900,MKT
06079602101060000,2021,102398,240510,342908,COST
06079602101060000,2020,129066,214680,343746,COST
06079602101060000,2019,129066,214680,343746,COST
06079602101080000,2021,95491,0,95491,COST
06079602101080000,2020,111549,0,111549,COST
06079602101080000,2019,111549,0,111549,COST
06079602101120000,2021,247506,257394,504900,MKT
06079602101120000,2020,204519,211170,415689,COST
06079602101120000,2019,204519,211170,415689,COST
06079602102030000,2021,258699,231801,490500,MKT
06079602102030000,2020,210359,242910,453269,COST
06079602102030000,2019,210359,242910,453269,COST
06079602201010000,2021,126238,0,126238,COST
06079602201010000,2020,160586,0,160586,COST
06079602201010000,2019,160586,0,160586,COST
06079602301010000,2021,3808,260030,263838,COST
06079602301010000,2020,4359,235720,240079,COST
06079602301010000,2019,4359,235720,240079,COST
06079602302010000,2021,103988,0,103988,COST
06079602302010000,2020,139045,0,139045,COST
06079602302010000,2019,139045,0,139045,COST
06079602438120000,2021,109073,0,109073,COST
06079602438120000,2020,121402,0,121402,COST
06079602438120000,2019,121402,0,121402,COST
06079603101010000,2021,267806,15440,283246,COST
06079603101010000,2020,329520,15090,344610,COST
06079603101010000,2019,329520,15090,344610,COST
06079603401200000,2021,7126,0,7126,COST
06079603401200000,2020,7496,0,7496,COST
06079603401200000,2019,7496,0,7496,COST
06079603401250000,2021,152,0,152,COST
06079603401250000,2020,141,0,141,COST
06079603401250000,2019,141,0,141,COST
06079604101010000,2021,39533,630,40163,COST
06079604101010000,2020,47803,610,48413,COST
06079604101010000,2019,47803,610,48413,COST
06079604201010000,2021,231747,0,231747,COST
06079604201010000,2020,305681,0,305681,COST
06079604201010000,2019,305681,0,305681,COST
06079605101010000,2021,267566,167490,435056,COST
06079605101010000,2020,300822,140360,441182,COST
06079605101010000,2019,300822,140360,441182,COST
06079606101010000,2021,54659,0,54659,COST
06079606101010000,2020,57518,0,57518,COST
06079606101010000,2019,57518,0,57518,COST
06079606201150000,2021,11130,0,11130,COST
06079606201150000,2020,10950,0,10950,COST
06079606201150000,2019,10950,0,10950,COST
06079606301010000,2021,18535,2180,20715,COST
06079606301010000,2020,19213,2100,21313,COST
06079606301010000,2019,19213,2100,21313,COST
06079606301150000,2021,9943,0,9943,COST
06079606301150000,2020,9890,0,9890,COST
06079606301150000,2019,9890,0,9890,COST
06079606401010000,2021,41779,3120,44899,COST
06079606401010000,2020,43999,3010,47009,COST
06079606401010000,2019,43999,3010,47009,COST
06079607101010000,2021,245697,18210,263907,COST
06079607101010000,2020,258458,17470,275928,COST
06079607101010000,2019,258458,17470,275928,COST
06079608101010000,2021,266792,409340,676132,COST
06079608101010000,2020,281418,350030,631448,COST
06079608101010000,2019,281418,350030,631448,COST
06079609101010000,2021,37989,0,37989,COST
06079609101010000,2020,39971,0,39971,COST
06079609101010000,2019,39971,0,39971,COST
06079609101020000,2021,143,0,143,COST
06079609101020000,2020,133,0,133,COST
06079609101020000,2019,133,0,133,COST
06079609101600000,2021,6539,370340,376879,COST
06079609101600000,2020,7053,344640,351693,COST
06079609101600000,2019,7053,344640,351693,COST
06079609101660000,2021,112246,293430,405676,COST
06079609101660000,2020,114681,261350,376031,COST
06079609101660000,2019,114681,261350,376031,COST
06079609201010000,2021,46541,0,46541,COST
06079609201010000,2020,48887,0,48887,COST
06079609201010000,2019,48887,0,48887,COST
06079609401010000,2021,2688,0,2688,COST
06079609401010000,2020,2500,0,2500,COST
06079609401010000,2019,2500,0,2500,COST
06079609401600000,2021,112260,337520,449780,COST
06079609401600000,2020,114694,301940,416634,COST
06079609401600000,2019,114694,301940,416634,COST
06079609402050000,2021,99660,223820,323480,COST
06079609402050000,2020,114873,207700,322573,COST
06079609402050000,2019,114873,207700,322573,COST
06079609402100000,2021,1107,7380,8487,COST
06079609402100000,2020,1030,7940,8970,OVR
06079609402100000,2019,1030,7940,8970,COST
06079609402150000,2021,1107,0,1107,COST
06079609402150000,2020,1030,0,1030,COST
06079609402150000,2019,1030,0,1030,COST
06079609402200000,2021,1107,0,1107,COST
06079609402200000,2020,1030,0,1030,COST
06079609402200000,2019,1030,0,1030,COST
06079609402400000,2021,2217,8820,11037,COST
06079609402400000,2020,2063,0,2063,COST
06079609402400000,2019,2063,0,2063,COST
06079609403100000,2021,222904,255100,478004,COST
06079609403100000,2020,177015,230580,407595,COST
06079609403100000,2019,177015,230580,407595,COST
06079610101010000,2021,61373,0,61373,COST
06079610101010000,2020,64625,0,64625,COST
06079610101010000,2019,64625,0,64625,COST
06079610201150000,2021,125,0,125,COST
06079610201150000,2020,116,0,116,COST
06079610201150000,2019,116,0,116,COST
06079610201400000,2021,9351,0,9351,COST
06079610201400000,2020,9807,0,9807,COST
06079610201400000,2019,9807,0,9807,COST
06079610203010000,2021,17008,222500,239508,COST
06079610203010000,2020,19970,195910,215880,COST
06079610203010000,2019,19970,195910,215880,COST
06079610203020000,2021,10047,6380,16427,COST
06079610203020000,2020,9359,6140,15499,COST
06079610203020000,2019,9359,6140,15499,COST
06079610401010000,2021,182197,0,182197,COST
06079610401010000,2020,188540,0,188540,COST
06079610401010000,2019,188540,0,188540,COST
06079611101010000,2021,182232,214580,396812,COST
06079611101010000,2020,225275,198250,423525,COST
06079611101010000,2019,225275,198250,423525,COST
06079611101020000,2021,103542,418070,521612,COST
06079611101020000,2020,117447,349353,466800,MKT
06079611101020000,2019,117447,349353,466800,MKT
06079611201100000,2021,9584,0,9584,COST
06079611201100000,2020,11507,0,11507,COST
06079611201100000,2019,11507,0,11507,COST
06079611202010000,2021,2389,0,2389,COST
06079611202010000,2020,2491,0,2491,COST
06079611202010000,2019,2491,0,2491,COST
06079611203030000,2021,100587,337540,438127,COST
06079611203030000,2020,104538,296300,400838,COST
06079611203030000,2019,104538,296300,400838,COST
06079611301010000,2021,100484,263230,363714,COST
06079611301010000,2020,115640,240250,355890,COST
06079611301010000,2019,115640,240250,355890,COST
06079611301100000,2021,99662,461500,561162,COST
06079611301100000,2020,114874,405530,520404,COST
06079611301100000,2019,114874,405530,520404,COST
06079612101010000,2021,28011,130550,158561,COST
06079612101010000,2020,33557,115780,149337,COST
06079612101010000,2019,33557,115780,149337,COST
06079612101020000,2021,108610,0,108610,COST
06079612101020000,2020,116899,0,116899,COST
06079612101020000,2019,116899,0,116899,COST
06079612101030000,2021,131634,179666,311300,MKT
06079612101030000,2020,136835,164065,300900,MKT
06079612101030000,2019,136835,164065,300900,MKT
06079612201010000,2021,153988,248712,402700,MKT
06079612201010000,2020,151200,252100,403300,MKT
06079612201010000,2019,151200,252100,403300,MKT
06079612202010000,2021,6788,0,6788,COST
06079612301010000,2021,70957,43860,114817,COST
06079612301010000,2020,86943,43700,130643,COST
06079612301010000,2019,86943,43700,130643,COST
06079612401010000,2021,38674,66800,105474,COST
06079612401010000,2020,48841,59010,107851,COST
06079612401010000,2019,48841,59010,107851,COST
06079613101010000,2021,64634,2740,67374,COST
06079613101010000,2020,82856,2630,85486,COST
06079613101010000,2019,82856,2630,85486,COST
06079613201010000,2021,63815,0,63815,COST
06079613201010000,2020,83306,0,83306,COST
06079613201010000,2019,83306,0,83306,COST
06079613201100000,2021,11098,0,11098,COST
06079613201100000,2020,12666,0,12666,COST
06079613201100000,2019,12666,0,12666,COST
06079613301010000,2021,39016,0,39016,COST
06079613301010000,2020,40865,0,40865,COST
06079613301010000,2019,40865,0,40865,COST
06079613301050000,2021,144603,255197,399800,MKT
06079613301050000,2020,114003,198797,312800,MKT
06079613301050000,2019,114003,198797,312800,MKT
06079613301100000,2021,228380,362190,590570,COST
06079613301100000,2020,152492,324708,477200,MKT
06079613301100000,2019,152492,324708,477200,MKT
06079613401010000,2021,49698,0,49698,COST
06079613401010000,2020,52114,0,52114,COST
06079613401010000,2019,52114,0,52114,COST
06079614101010000,2021,44850,0,44850,COST
06079614101010000,2020,47218,0,47218,COST
06079614101010000,2019,47218,0,47218,COST
06079614201011001,2021,30972,0,30972,COST
06079614201011001,2020,35174,0,35174,COST
06079614201011001,2019,35174,0,35174,COST
06079614201011002,2021,327912,7960,335872,COST
06079614201011002,2020,244622,8440,253062,COST
06079614201011002,2019,244622,8440,253062,COST
06079614201030000,2021,35921,450030,485951,COST
06079614201030000,2020,40737,395830,436567,COST
06079614201030000,2019,40737,395830,436567,COST
06079614201100000,2021,109144,253690,362834,COST
06079614201100000,2020,121453,224170,345623,COST
06079614201100000,2019,121453,224170,345623,COST
06079614202011001,2021,231060,972530,1203590,COST
06079614202011001,2020,251489,921520,1173009,COST
06079614202011001,2019,251489,921520,1173009,COST
06079614202011002,2021,66,0,66,COST
06079614202011002,2020,62,0,62,COST
06079614202011002,2019,62,0,62,COST
06079614301020000,2021,31196,0,31196,COST
06079614301020000,2020,32916,0,32916,COST
06079614301020000,2019,32916,0,32916,COST
06079614301150000,2021,310878,427560,738438,COST
06079614301150000,2020,185564,389620,575184,COST
06079614301150000,2019,185564,389620,575184,COST
06079614302010000,2021,192635,242465,435100,MKT
06079614302010000,2020,136835,204165,341000,MKT
06079614302010000,2019,136835,204165,341000,MKT
06079614302100000,2021,61397,0,61397,COST
06079614302100000,2020,83089,0,83089,COST
06079614302100000,2019,83089,0,83089,COST
06079614402010000,2021,56,0,56,COST
06079614402010000,2020,53,0,53,COST
06079614402010000,2019,53,0,53,COST
06079614403010000,2021,20610,7400,28010,COST
06079614403010000,2020,21610,7140,28750,COST
06079614403010000,2019,21610,7140,28750,COST
06079615101010000,2021,193401,0,193401,COST
06079615101010000,2020,174803,0,174803,COST
06079615101010000,2019,174803,0,174803,COST
06079615101050000,2021,195959,705080,901039,COST
06079615101050000,2020,176271,629070,805341,OVR
06079615101050000,2019,176271,629070,805341,COST
06079615106010000,2021,208402,510598,719000,MKT
06079615106010000,2020,183315,385985,569300,MKT
06079615106010000,2019,183315,369985,553300,MKT
06079615106100000,2021,208387,524313,732700,MKT
06079615106100000,2020,183307,463993,647300,MKT
06079615106100000,2019,183307,463993,647300,MKT
06079615112010000,2021,99564,221470,321034,COST
06079615112010000,2020,114783,201420,316203,COST
06079615112010000,2019,114783,201420,316203,COST
06079615116010000,2021,215971,354329,570300,MKT
06079615116010000,2020,187525,315475,503000,MKT
06079615116010000,2019,187525,315475,503000,MKT
06079615116060000,2021,215971,404929,620900,MKT
06079615116060000,2020,187525,321475,509000,MKT
06079615116060000,2019,187525,321475,509000,MKT
06079615116120000,2021,215971,337129,553100,MKT
06079615116120000,2020,187525,274720,462245,COST
06079615116120000,2019,187525,274720,462245,COST
06079615116200000,2021,1109,0,1109,COST
06079615116200000,2020,1033,0,1033,COST
06079615116200000,2019,1033,0,1033,COST
06079615120010000,2021,230975,738510,969485,COST
06079615120010000,2020,251411,721170,972581,COST
06079615120010000,2019,251411,721170,972581,COST
06079615124010000,2021,261341,556159,817500,MKT
06079615124010000,2020,211724,482776,694500,MKT
06079615124010000,2019,211724,482776,694500,MKT
06079615130010000,2021,183752,0,183752,COST
06079615130010000,2020,169200,0,169200,COST
06079615130010000,2019,169200,0,169200,COST
06079615130050000,2021,187599,760330,947929,COST
06079615130050000,2020,171447,664170,835617,COST
06079615130050000,2019,171447,664170,835617,COST
06079615160010000,2021,1192,0,1192,COST
06079615160010000,2020,1109,0,1109,COST
06079615160010000,2019,1109,0,1109,COST
06079615178010000,2021,266882,857810,1124692,COST
06079615178010000,2020,214570,770650,985220,COST
06079615178010000,2019,214570,770650,985220,COST
06079615178020000,2021,270999,628360,899359,COST
06079615178020000,2020,216671,557050,773721,COST
06079615178020000,2019,216671,557050,773721,COST
06079615201011000,2021,36479,0,36479,COST
06079615201011000,2020,38477,0,38477,COST
06079615201011000,2019,38477,0,38477,COST
06079615201011001,2021,47299,365080,412379,COST
06079615201011001,2020,49969,220370,270339,COST
06079615201011001,2019,49969,135370,185339,COST
06079615201200000,2021,3781,0,3781,COST
06079615201200000,2020,3519,0,3519,COST
06079615201200000,2019,3519,0,3519,COST
06079615301010000,2021,227852,566148,794000,MKT
06079615301010000,2020,194027,399360,593387,COST
06079615301010000,2019,194027,0,194027,COST
06079615301100000,2021,224583,377517,602100,MKT
06079615301100000,2020,192251,405749,598000,MKT
06079615301100000,2019,192251,405749,598000,MKT
06079615301200000,2021,235071,723429,958500,MKT
06079615301200000,2020,197918,727170,925088,COST
06079615301200000,2019,197918,452840,650758,COST
06079615301300000,2021,333711,411289,745000,MKT
06079615301300000,2020,247366,442940,690306,COST
06079615301300000,2019,247366,442940,690306,COST
06079615312010000,2021,258797,418803,677600,MKT
06079615312010000,2020,210409,411191,621600,MKT
06079615312010000,2019,210409,411191,621600,MKT
06079615312100000,2021,98903,370090,468993,COST
06079615312100000,2020,114168,320160,434328,COST
06079615312100000,2019,114168,320160,434328,COST
06079615312200000,2021,559,0,559,COST
06079615312200000,2020,520,0,520,COST
06079615312200000,2019,520,0,520,COST
06079615401010000,2021,242353,207470,449823,COST
06079615401010000,2020,201798,182550,384348,COST
06079615401010000,2019,201798,182550,384348,COST
06079615401050000,2021,1474,0,1474,COST
06079615401050000,2020,1372,0,1372,COST
06079615401050000,2019,1372,0,1372,COST
06079615401200000,2021,197472,599128,796600,MKT
06079615401200000,2020,183400,536830,720230,COST
06079615401200000,2019,183400,536830,720230,COST
06079615401600000,2021,569,0,569,COST
06079615401600000,2020,530,0,530,COST
06079615401600000,2019,530,0,530,COST
06079615407010000,2021,261502,437298,698800,MKT
06079615407010000,2020,211806,455994,667800,MKT
06079615407010000,2019,211806,455994,667800,MKT
06079615407050000,2021,261502,663498,925000,MKT
06079615407050000,2020,211806,579880,791686,OVR
06079615407050000,2019,211806,579880,791686,COST
06079615424010000,2021,99507,288600,388107,COST
06079615424010000,2020,114730,259900,374630,COST
06079615424010000,2019,114730,259900,374630,COST
06079615424600000,2021,205116,363084,568200,MKT
06079615424600000,2020,181470,338830,520300,MKT
06079615424600000,2019,181470,338830,520300,MKT
06079615430010000,2021,252740,563960,816700,MKT
06079615430010000,2020,207261,539030,746291,OVR
06079615430010000,2019,207261,539030,746291,COST
06079615430150000,2021,252740,1042140,1294880,COST
06079615430150000,2020,207261,923480,1130741,COST
06079615430150000,2019,207261,923480,1130741,COST
06079615454010000,2021,296909,870110,1167019,COST
06079615454010000,2020,229636,773570,1003206,OVR
06079615454010000,2019,229636,773570,1003206,COST
06079615454250000,2021,258699,560900,819599,COST
06079615454250000,2020,210359,498140,708499,COST
06079615454250000,2019,210359,498140,708499,COST
06079616101010100,2021,1633,0,1633,COST
06079616101010100,2020,1520,0,1520,COST
06079616101010100,2019,1520,0,1520,COST
06079616124110000,2021,112245,148240,260485,COST
06079616124110000,2020,114680,135530,250210,COST
06079616124110000,2019,114680,135530,250210,COST
06079616190090000,2021,99479,452510,551989,COST
06079616190090000,2020,114705,398020,512725,OVR
06079616190090000,2019,114705,398020,512725,COST
06079616201010000,2021,41458,108280,149738,COST
06079616201010000,2020,43895,88450,132345,COST
06079616201010000,2019,72768,66600,139368,COST
06079616201100000,2021,115570,100520,216090,COST
06079616201100000,2020,117774,92350,210124,COST
06079616201100000,2019,114684,92350,207034,COST
06079616201250000,2021,11,0,11,COST
06079616201250000,2020,10,0,10,COST
06079616201250000,2019,10,0,10,COST
06079616301240000,2021,1107,0,1107,COST
06079616301240000,2020,1031,0,1031,COST
06079616301240000,2019,1031,0,1031,COST
06079616301290000,2021,99452,599140,698592,COST
06079616301290000,2020,114679,517760,632439,COST
06079616301290000,2019,114679,517760,632439,COST
06079616301340000,2021,99452,990170,1089622,COST
06079616301340000,2020,114679,875430,990109,COST
06079616301340000,2019,114679,875430,990109,COST
06079616301390000,2021,99458,635830,735288,COST
06079616301390000,2020,114685,542100,656785,COST
06079616301390000,2019,114685,542100,656785,COST
06079616301440000,2021,99564,378840,478404,COST
06079616301440000,2020,114783,327430,442213,COST
06079616301440000,2019,114783,327430,442213,COST
06079616301490000,2021,99452,512400,611852,COST
06079616301490000,2020,114679,456530,571209,OVR
06079616301490000,2019,114679,456530,571209,COST
06079616301540000,2021,1174,0,1174,COST
06079616301540000,2020,1092,0,1092,COST
06079616301540000,2019,1092,0,1092,COST
06079616301590000,2021,1114,0,1114,COST
06079616301590000,2020,1036,0,1036,COST
06079616301590000,2019,1036,0,1036,COST
06079616301620000,2021,99454,418100,517554,COST
06079616301620000,2020,114681,373550,488231,COST
06079616301620000,2019,114681,373550,488231,COST
06079616401011000,2021,18263,193030,211293,COST
06079616401011000,2020,19020,170260,189280,COST
06079616401011000,2019,19020,170260,189280,COST
06079616401011001,2021,6115,0,6115,COST
06079616401011001,2020,6255,0,6255,COST
06079616401011001,2019,6255,0,6255,COST
06079616402010000,2021,249,0,249,COST
06079616402010000,2020,231,0,231,COST
06079616402010000,2019,231,0,231,COST
06079617101010000,2021,117105,0,117105,COST
06079617101010000,2020,123501,0,123501,COST
06079617101010000,2019,123501,0,123501,COST
06079617301010000,2021,71579,0,71579,COST
06079617301010000,2020,75482,0,75482,COST
06079617301010000,2019,75482,0,75482,COST
06079617401010000,2021,74938,0,74938,COST
06079617401010000,2020,79036,0,79036,COST
06079617401010000,2019,79036,0,79036,COST
06079618101010000,2021,152207,0,152207,COST
06079618101010000,2020,159384,0,159384,COST
06079618101010000,2019,159384,0,159384,COST
06079618201050000,2021,33467,0,33467,COST
06079618201050000,2020,34917,0,34917,COST
06079618201050000,2019,34917,0,34917,COST
06079619101010000,2021,98760,275320,374080,COST
06079619101010000,2020,103710,225730,329440,COST
06079619101010000,2019,103710,225730,329440,COST
06079619301020000,2021,39292,195000,234292,COST
06079619301020000,2020,40995,154970,195965,COST
06079619301020000,2019,40995,154970,195965,COST
06079619401010000,2021,68303,0,68303,COST
06079619401010000,2020,72034,0,72034,COST
06079619401010000,2019,72034,0,72034,COST
06079620101020000,2021,109735,0,109735,COST
06079620101020000,2020,115324,0,115324,COST
06079620101020000,2019,115324,0,115324,COST
06079620101400000,2021,7028,276930,283958,COST
06079620101400000,2020,7433,227980,235413,COST
06079620101400000,2019,7433,227980,235413,COST
06079620301010000,2021,71394,0,71394,COST
06079620301010000,2020,75340,0,75340,COST
06079620301010000,2019,75340,0,75340,COST
06079620418010000,2021,39427,0,39427,COST
06079620418010000,2020,41607,0,41607,COST
06079620418010000,2019,41607,0,41607,COST
06079620448010000,2021,26629,0,26629,COST
06079620448010000,2020,28101,0,28101,COST
06079620448010000,2019,28101,0,28101,COST
06079620466010000,2021,4482,336020,340502,COST
06079620466010000,2020,4767,269100,273867,COST
06079620466010000,2019,4767,269100,273867,COST
06079621130010000,2021,112639,480500,593139,COST
06079621130010000,2020,115047,425760,540807,OVR
06079621130010000,2019,115047,425760,540807,COST
06079621130350000,2021,1860,0,1860,COST
06079621130350000,2020,1731,0,1731,COST
06079621130350000,2019,1731,0,1731,COST
06079621201010000,2021,99443,504990,604433,COST
06079621201010000,2020,114671,442520,557191,COST
06079621201010000,2019,114671,442520,557191,COST
06079621201050000,2021,99452,407450,506902,COST
06079621201050000,2020,114679,289840,404519,COST
06079621201050000,2019,114679,289840,404519,COST
06079621201090000,2021,99453,651810,751263,COST
06079621201090000,2020,114680,576370,691050,COST
06079621201090000,2019,114680,576370,691050,COST
06079621201140000,2021,99455,512350,611805,COST
06079621201140000,2020,114682,452790,567472,COST
06079621201140000,2019,114682,452790,567472,COST
06079621201190000,2021,99459,1228640,1328099,COST
06079621201190000,2020,114685,1084340,1199025,COST
06079621201190000,2019,114685,1084340,1199025,COST
06079621201640000,2021,99453,433480,532933,COST
06079621201640000,2020,114680,396210,510890,COST
06079621201640000,2019,114680,396210,510890,COST
06079621201690000,2021,99455,554720,654175,COST
06079621201690000,2020,114682,485700,600382,COST
06079621201690000,2019,114682,475620,590302,COST
06079621201740000,2021,99550,507490,607040,COST
06079621201740000,2020,114770,430250,545020,OVR
06079621201740000,2019,114770,430250,545020,COST
06079621201790000,2021,1112,0,1112,COST
06079621201790000,2020,1035,0,1035,COST
06079621201790000,2019,1035,0,1035,COST
06079621201840000,2021,99455,371080,470535,COST
06079621201840000,2020,114682,324030,438712,COST
06079621201840000,2019,114682,324030,438712,COST
06079621201880000,2021,99454,1217360,1316814,COST
06079621201880000,2020,114681,1031670,1146351,COST
06079621201880000,2019,114681,998650,1113331,COST
06079621201920000,2021,1111,0,1111,COST
06079621201920000,2020,1034,0,1034,COST
06079621201920000,2019,1034,0,1034,COST
06079621201950000,2021,99452,722950,822402,COST
06079621201950000,2020,114679,640210,754889,COST
06079621201950000,2019,114679,540630,655309,COST
06079621301020000,2021,109323,216877,326200,MKT
06079621301020000,2020,121579,216921,338500,MKT
06079621301020000,2019,121579,216921,338500,MKT
06079621401032000,2021,144561,0,144561,COST
06079621401032000,2020,145241,0,145241,COST
06079621401032000,2019,145241,0,145241,COST
06079621401040000,2021,118,0,118,COST
06079621401040000,2020,125,0,125,COST
06079621401040000,2019,125,0,125,COST
06079621405010000,2021,33929,0,33929,COST
06079621405010000,2020,33689,0,33689,COST
06079621405010000,2019,33689,0,33689,COST
06079621405100000,2021,8985,0,8985,COST
06079621405100000,2020,9396,0,9396,COST
06079621405100000,2019,9396,0,9396,COST
06079622201020000,2021,99472,321450,420922,COST
06079622201020000,2020,114698,278810,393508,OVR
06079622201020000,2019,114698,266630,381328,COST
06079622201030000,2021,99696,48780,148476,COST
06079622201030000,2020,114906,47680,162586,COST
06079622201030000,2019,114906,47680,162586,COST
06079622201100000,2021,105416,312510,417926,COST
06079622201100000,2020,120229,278110,398339,COST
06079622201100000,2019,120229,278110,398339,COST
06079622201200000,2021,99463,819930,919393,COST
06079622201200000,2020,114689,717570,832259,COST
06079622201200000,2019,114689,717570,832259,COST
06079622203010000,2021,201187,281813,483000,MKT
06079622203010000,2020,179250,222150,401400,OVR
06079622203010000,2019,179250,222150,401400,MKT
06079622401100000,2021,86969,0,86969,COST
06079622401100000,2020,89987,0,89987,COST
06079622401100000,2019,89987,0,89987,COST
06079623101010000,2021,101693,18430,120123,COST
06079623101010000,2020,104457,19070,123527,COST
06079623101010000,2019,104457,19070,123527,COST
06079624101010000,2021,47086,0,47086,COST
06079624101010000,2020,35016,0,35016,COST
06079624101010000,2019,35016,0,35016,COST
06079624201010000,2021,68807,0,68807,COST
06079624201010000,2020,66079,0,66079,COST
06079624201010000,2019,66079,0,66079,COST
06079625101010000,2021,82469,0,82469,COST
06079625101010000,2020,85813,0,85813,COST
06079625101010000,2019,85813,0,85813,COST
06079625201010000,2021,8803,0,8803,COST
06079625201010000,2020,8189,0,8189,COST
06079625201010000,2019,8189,0,8189,COST
06079625301010000,2021,20970,0,20970,COST
06079625301010000,2020,21067,0,21067,COST
06079625301010000,2019,21067,0,21067,COST
06079626101010000,2021,30042,0,30042,COST
06079626101010000,2020,31144,0,31144,COST
06079626101010000,2019,31144,0,31144,COST
06079626201010000,2021,33338,20090,53428,COST
06079626201010000,2020,33121,19390,52511,COST
06079626201010000,2019,33121,19390,52511,COST
06079626301300000,2021,39381,0,39381,COST
06079626301300000,2020,37323,0,37323,COST
06079626301300000,2019,37323,0,37323,COST
06079626401010000,2021,19085,0,19085,COST
06079626401010000,2020,19234,0,19234,COST
06079626401010000,2019,19234,0,19234,COST
06079627101010000,2021,135807,9110,144917,COST
06079627101010000,2020,133412,8780,142192,COST
06079627101010000,2019,133412,8780,142192,COST
06079634101010000,2021,67751,0,67751,COST
06079634101010000,2020,67733,0,67733,COST
06079634101010000,2019,67733,0,67733,COST
06079634201010000,2021,66299,0,66299,COST
06079634201010000,2020,69591,0,69591,COST
06079634201010000,2019,69591,0,69591,COST
06079635101010000,2021,144366,3720,148086,COST
06079635101010000,2020,147994,3580,151574,COST
06079635101010000,2019,147994,3580,151574,COST
06079636101010000,2021,46072,0,46072,COST
06079636101010000,2020,42930,0,42930,COST
06079636101010000,2019,42930,0,42930,COST
06079701101010000,2021,259725,307260,566985,COST
06079701101010000,2020,223844,274640,498484,COST
06079701101010000,2019,223844,274640,498484,COST
06079701101020000,2021,287162,295390,582552,COST
06079701101020000,2020,250556,272720,523276,COST
06079701101020000,2019,250556,272720,523276,COST
06079701101030000,2021,269439,311280,580719,COST
06079701101030000,2020,233264,283630,516894,COST
06079701101030000,2019,233264,283630,516894,COST
06079701101040000,2021,246317,445000,691317,COST
06079701101040000,2020,210914,399220,610134,COST
06079701101040000,2019,210914,399220,610134,COST
06079701101060000,2021,304028,319280,623308,COST
06079701101060000,2020,267135,287180,554315,COST
06079701101060000,2019,267135,287180,554315,COST
06079701101080000,2021,248255,12690,260945,COST
06079701101080000,2020,212778,13000,225778,COST
06079701101080000,2019,212778,13000,225778,COST
06079701101100000,2021,246317,130860,377177,COST
06079701101100000,2020,210914,118460,329374,COST
06079701101100000,2019,210914,118460,329374,COST
06079701101110000,2021,222493,292670,515163,COST
06079701101110000,2020,188153,252347,440500,MKT
06079701101110000,2019,188153,252347,440500,MKT
06079701101300000,2021,272756,930450,1203206,COST
06079701101300000,2020,236490,767610,1004100,MKT
06079701101300000,2019,236490,767610,1004100,MKT
06079701102010000,2021,204863,754537,959400,MKT
06079701102010000,2020,171500,588200,759700,MKT
06079701102010000,2019,171500,588200,759700,MKT
06079701102030000,2021,204508,820392,1024900,MKT
06079701102030000,2020,171166,697334,868500,MKT
06079701102030000,2019,171166,697334,868500,MKT
06079701102050000,2021,212438,900162,1112600,MKT
06079701102050000,2020,178635,765865,944500,MKT
06079701102050000,2019,178635,765865,944500,MKT
06079701102070000,2021,210777,769823,980600,MKT
06079701102070000,2020,177068,628232,805300,MKT
06079701102070000,2019,177068,699632,876700,MKT
06079701102090000,2021,205453,849947,1055400,MKT
06079701102090000,2020,172054,796246,968300,MKT
06079701102090000,2019,172054,796246,968300,MKT
06079701102110000,2021,203014,902886,1105900,MKT
06079701102110000,2020,169763,740237,910000,MKT
06079701102110000,2019,169763,740237,910000,MKT
06079701102130000,2021,203074,0,203074,COST
06079701102130000,2020,169820,0,169820,COST
06079701102130000,2019,169820,0,169820,COST
06079701102156500,2021,165062,0,165062,COST
06079701102156500,2020,155786,0,155786,COST
06079701102156500,2019,155786,0,155786,COST
06079701103010000,2021,215736,992964,1208700,MKT
06079701103010000,2020,181751,829049,1010800,MKT
06079701103010000,2019,181751,829049,1010800,MKT
06079701103030000,2021,211887,721613,933500,MKT
06079701103030000,2020,178115,655785,833900,MKT
06079701103030000,2019,178115,655785,833900,MKT
06079701103050000,2021,216426,973874,1190300,MKT
06079701103050000,2020,182404,823296,1005700,MKT
06079701103050000,2019,182404,823296,1005700,MKT
06079701103070000,2021,216426,850874,1067300,MKT
06079701103070000,2020,182404,717396,899800,MKT
06079701103070000,2019,182404,717396,899800,MKT
06079701103116500,2021,21259,0,21259,COST
06079701103116500,2020,15607,0,15607,COST
06079701103116500,2019,15607,0,15607,COST
06079701104010000,2021,215095,969500,1184595,COST
06079701104010000,2020,181145,694255,875400,MKT
06079701104010000,2019,181145,545655,726800,MKT
06079701104040000,2021,210386,898814,1109200,MKT
06079701104040000,2020,176699,715601,892300,MKT
06079701104040000,2019,176699,715601,892300,MKT
06079701104070000,2021,210386,1008120,1218506,COST
06079701104070000,2020,176699,910240,1086939,COST
06079701104070000,2019,176699,910240,1086939,COST
06079701104100000,2021,210386,831214,1041600,MKT
06079701104100000,2020,176699,677701,854400,MKT
06079701104100000,2019,176699,716901,893600,MKT
06079701104130000,2021,210386,1042830,1253216,COST
06079701104130000,2020,176699,957240,1133939,OVR
06079701104130000,2019,176699,957240,1133939,COST
06079701104160000,2021,222293,844607,1066900,MKT
06079701104160000,2020,187963,704937,892900,OVR
06079701104160000,2019,187963,704937,892900,MKT
06079701104190000,2021,213422,985978,1199400,MKT
06079701104190000,2020,179564,820436,1000000,MKT
06079701104190000,2019,179564,820436,1000000,MKT
06079701104220000,2021,198013,883387,1081400,MKT
06079701104220000,2020,165076,720224,885300,MKT
06079701104220000,2019,165076,710524,875600,MKT
06079701104250000,2021,198013,983687,1181700,MKT
06079701104250000,2020,165076,840124,1005200,MKT
06079701104250000,2019,165076,840624,1005700,MKT
06079701104280000,2021,198013,899887,1097900,MKT
06079701104280000,2020,165076,732624,897700,MKT
06079701104280000,2019,165076,732624,897700,MKT
06079701104310000,2021,215095,862005,1077100,MKT
06079701104310000,2020,181145,716055,897200,MKT
06079701104310000,2019,181145,716055,897200,MKT
06079701104340000,2021,198013,0,198013,COST
06079701104340000,2020,165076,0,165076,COST
06079701104340000,2019,165076,0,165076,COST
06079701104370000,2021,198013,865287,1063300,MKT
06079701104370000,2020,165076,718824,883900,MKT
06079701104370000,2019,165076,718824,883900,MKT
06079701105300000,2021,4221,0,4221,COST
06079701105300000,2020,3927,0,3927,COST
06079701105300000,2019,3927,0,3927,COST
06079701148010000,2021,274302,0,274302,COST
06079701148010000,2020,237996,0,237996,COST
06079701148010000,2019,237996,0,237996,COST
06079701148020000,2021,264461,0,264461,COST
06079701148020000,2020,228432,0,228432,COST
06079701148020000,2019,228432,0,228432,COST
06079701148030000,2021,245501,1490,246991,COST
06079701148030000,2020,210130,1270,211400,COST
06079701148030000,2019,210130,1270,211400,COST
06079701148040000,2021,233893,329707,563600,MKT
06079701148040000,2020,199009,312891,511900,MKT
06079701148040000,2019,199009,312891,511900,MKT
06079701148050000,2021,228810,489110,717920,COST
06079701148050000,2020,194161,449460,643621,COST
06079701148050000,2019,194161,400300,594461,COST
06079701148060000,2021,220982,310570,531552,COST
06079701148060000,2020,186720,282480,469200,OVR
06079701148060000,2019,186720,282480,469200,COST
06079701148070000,2021,225453,333270,558723,COST
06079701148070000,2020,190966,336034,527000,MKT
06079701148070000,2019,190966,336034,527000,MKT
06079701148080000,2021,225453,272447,497900,MKT
06079701148080000,2020,190966,235234,426200,MKT
06079701148080000,2019,190966,235234,426200,MKT
06079701148090000,2021,225939,0,225939,COST
06079701148090000,2020,191428,0,191428,COST
06079701148090000,2019,191428,0,191428,COST
06079701148100000,2021,225453,273347,498800,MKT
06079701148100000,2020,190966,246434,437400,OVR
06079701148100000,2019,190966,246434,437400,MKT
06079701151010000,2021,414916,0,414916,COST
06079701151010000,2020,378731,0,378731,COST
06079701151010000,2019,378731,0,378731,COST
06079701151150000,2021,414789,928370,1343159,COST
06079701151150000,2020,378601,842770,1221371,COST
06079701151150000,2019,378601,803600,1182201,COST
06079701151250000,2021,287489,793410,1080899,COST
06079701151250000,2020,250877,696790,947667,COST
06079701151250000,2019,250877,599240,850117,COST
06079701151300000,2021,354108,411610,765718,COST
06079701151300000,2020,317008,378590,695598,COST
06079701151300000,2019,317008,378590,695598,COST
06079701151400000,2021,318945,893370,1212315,COST
06079701151400000,2020,281892,810650,1092542,COST
06079701151400000,2019,281892,810650,1092542,COST
06079701151450000,2021,313849,360451,674300,MKT
06079701151450000,2020,276841,279490,556331,COST
06079701151450000,2019,276841,279490,556331,COST
06079701201010000,2021,393145,8490,401635,COST
06079701201010000,2020,356495,8470,364965,COST
06079701201010000,2019,356495,8470,364965,COST
06079701201030000,2021,268212,166510,434722,COST
06079701201030000,2020,232072,152490,384562,COST
06079701201030000,2019,232072,152490,384562,COST
06079701201040000,2021,431216,221650,652866,COST
06079701201040000,2020,395473,199990,595463,COST
06079701201040000,2019,395473,199990,595463,COST
06079701201050000,2021,424289,290290,714579,COST
06079701201050000,2020,388349,277880,666229,COST
06079701201050000,2019,388349,277880,666229,COST
06079701201060000,2021,312448,1033800,1346248,COST
06079701201060000,2020,275454,960250,1235704,COST
06079701201060000,2019,275454,960250,1235704,COST
06079701202010000,2021,333759,569080,902839,COST
06079701202010000,2020,296631,509850,806481,COST
06079701202010000,2019,296631,480980,777611,COST
06079701202050000,2021,285814,0,285814,COST
06079701202050000,2020,249236,0,249236,COST
06079701202050000,2019,249236,0,249236,COST
06079701202100000,2021,285723,559777,845500,MKT
06079701202100000,2020,249148,539250,788398,COST
06079701202100000,2019,249148,539250,788398,COST
06079701202150000,2021,299087,564613,863700,MKT
06079701202150000,2020,262266,519860,782126,COST
06079701202150000,2019,262266,519860,782126,COST
06079701202200000,2021,289057,0,289057,COST
06079701202200000,2020,252414,0,252414,COST
06079701202200000,2019,252414,0,252414,COST
06079701203050000,2021,333407,265110,598517,COST
06079701203050000,2020,296280,304820,601100,MKT
06079701203050000,2019,296280,304820,601100,MKT
06079701301010000,2021,4497,0,4497,COST
06079701301010000,2020,4185,0,4185,COST
06079701301010000,2019,4185,0,4185,COST
06079701301040000,2021,246399,0,246399,COST
06079701301040000,2020,210992,0,210992,COST
06079701301040000,2019,210992,0,210992,COST
06079701301100000,2021,5585,0,5585,COST
06079701301100000,2020,5197,0,5197,COST
06079701301100000,2019,5197,0,5197,COST
06079701301350000,2021,8781,0,8781,COST
06079701301350000,2020,11104,0,11104,COST
06079701301350000,2019,11104,0,11104,COST
06079701301450000,2021,10532,0,10532,COST
06079701301450000,2020,13499,0,13499,COST
06079701301450000,2019,13499,0,13499,COST
06079701301550000,2021,10935,0,10935,COST
06079701301550000,2020,14199,0,14199,COST
06079701301550000,2019,14199,0,14199,COST
06079701301650000,2021,11505,0,11505,COST
06079701301650000,2020,14466,0,14466,COST
06079701301650000,2019,14466,0,14466,COST
06079701302010000,2021,246358,0,246358,COST
06079701302010000,2020,210953,0,210953,COST
06079701302010000,2019,210953,0,210953,COST
06079701302100000,2021,253393,214590,467983,COST
06079701302100000,2020,217728,195950,413678,COST
06079701302100000,2019,217728,195950,413678,COST
06079701302200000,2021,253700,0,253700,COST
06079701302200000,2020,218024,0,218024,COST
06079701302200000,2019,218024,0,218024,COST
06079701302300000,2021,250399,0,250399,COST
06079701302300000,2020,214842,0,214842,COST
06079701302300000,2019,214842,0,214842,COST
06079701302400000,2021,250949,390420,641369,COST
06079701302400000,2020,215371,351340,566711,COST
06079701302400000,2019,215371,351340,566711,COST
06079701401010000,2021,207453,0,207453,COST
06079701401010000,2020,338135,0,338135,COST
06079701401010000,2019,338135,0,338135,COST
06079701401040000,2021,275281,437700,712981,COST
06079701401060000,2021,271993,0,271993,COST
06079701401080000,2021,235686,0,235686,COST
06079701401080000,2020,200723,0,200723,COST
06079701401080000,2019,190502,0,190502,COST
06079701401100000,2021,330662,1319780,1650442,COST
06079701401100000,2020,253391,1199010,1452401,COST
06079701401100000,2019,226019,833600,1059619,COST
06079701401130000,2021,298237,955210,1253447,COST
06079701401130000,2020,225670,472730,698400,COST
06079701401130000,2019,199009,0,199009,COST
06079701401160000,2021,235686,870330,1106016,COST
06079701401160000,2020,200723,0,200723,COST
06079701401160000,2019,190502,0,190502,COST
06079701401180000,2021,250320,0,250320,COST
06079701401200000,2021,254197,0,254197,COST
06079701401200000,2020,11659,0,11659,COST
06079701401200000,2019,11659,0,11659,COST
06079701401220000,2021,322113,204450,526563,COST
06079701401220000,2020,246049,172800,418849,OVR
06079701401220000,2019,246049,172800,418849,COST
06079701401230000,2021,250320,0,250320,COST
06079701401250000,2021,242178,0,242178,COST
06079701401280000,2021,246317,0,246317,COST
06079701401300000,2021,242598,0,242598,COST
06079701401300000,2020,10005,0,10005,COST
06079701401300000,2019,10005,0,10005,COST
06079701401340000,2021,277855,0,277855,COST
06079701401380000,2021,269642,0,269642,COST
06079701401420000,2021,273647,0,273647,COST
06079701415010000,2021,2856,0,2856,COST
06079701415010000,2020,2659,0,2659,COST
06079701415010000,2019,2659,0,2659,COST
06079701460010000,2021,21710,0,21710,COST
06079701460010000,2020,28024,0,28024,COST
06079701460010000,2019,28024,0,28024,COST
06079702101011001,2021,1306,0,1306,COST
06079702101011001,2020,1218,0,1218,COST
06079702101011001,2019,1218,0,1218,COST
06079702101011002,2021,138975,19100,158075,COST
06079702101011002,2020,132305,18850,151155,COST
06079702101011002,2019,132305,18850,151155,COST
06079702101020000,2021,10969,0,10969,COST
06079702101020000,2020,16909,0,16909,COST
06079702101020000,2019,16909,0,16909,COST
06079702101200000,2021,10528,0,10528,COST
06079702101200000,2020,16474,0,16474,COST
06079702101200000,2019,16474,0,16474,COST
06079702101400000,2021,9353,0,9353,COST
06079702101400000,2020,14564,0,14564,COST
06079702101400000,2019,14564,0,14564,COST
06079702101600000,2021,7578,0,7578,COST
06079702101600000,2020,8805,0,8805,COST
06079702101600000,2019,8805,0,8805,COST
06079702301010000,2021,20729,117610,138339,COST
06079702301010000,2020,19658,107790,127448,COST
06079702301010000,2019,19658,107790,127448,COST
06079702401010000,2021,9960,0,9960,COST
06079702401010000,2020,10503,0,10503,COST
06079702401010000,2019,10503,0,10503,COST
06079702401031001,2021,968,0,968,COST
06079702401031001,2020,902,0,902,COST
06079702401031001,2019,902,0,902,COST
06079702401031002,2021,406,0,406,COST
06079702401031002,2020,378,0,378,COST
06079702401031002,2019,378,0,378,COST
06079702401200000,2021,9870,0,9870,COST
06079702401200000,2020,10407,0,10407,COST
06079702401200000,2019,10407,0,10407,COST
06079702401400000,2021,9777,0,9777,COST
06079702401400000,2020,10306,0,10306,COST
06079702401400000,2019,10306,0,10306,COST
06079703101010000,2021,9479,0,9479,COST
06079703101010000,2020,8842,0,8842,COST
06079703101010000,2019,8842,0,8842,COST
06079703101100000,2021,4492,0,4492,COST
06079703101100000,2020,4180,0,4180,COST
06079703101100000,2019,4180,0,4180,COST
06079703201020000,2021,260708,368090,628798,COST
06079703201020000,2020,211397,323420,534817,COST
06079703201020000,2019,211397,323420,534817,COST
06079703201150000,2021,166889,281510,448399,COST
06079703201150000,2020,227592,259380,486972,COST
06079703201150000,2019,227592,259380,486972,COST
06079703301010000,2021,186968,196932,383900,MKT
06079703301010000,2020,184073,95070,279143,COST
06079703301010000,2019,184073,95070,279143,COST
06079703301050000,2021,132489,0,132489,COST
06079703301050000,2020,179523,0,179523,COST
06079703301050000,2019,179523,0,179523,COST
06079703401010000,2021,4057,0,4057,COST
06079703401010000,2020,4313,0,4313,COST
06079703401010000,2019,4313,0,4313,COST
06079703401030000,2021,284885,611315,896200,MKT
06079703401030000,2020,223673,486410,710083,COST
06079703401030000,2019,223673,486410,710083,COST
06079703401050000,2021,153453,285247,438700,MKT
06079703401050000,2020,150866,209234,360100,MKT
06079703401050000,2019,150866,209234,360100,MKT
06079703401070000,2021,193385,367215,560600,MKT
06079703401070000,2020,174793,350050,524843,COST
06079703401070000,2019,174793,350050,524843,COST
06079703401090000,2021,821205,434495,1255700,INCOME
06079703401090000,2020,204209,986191,1190400,INCOME
06079703401090000,2019,204209,986191,1190400,INCOME
06079703401150000,2021,1344,0,1344,COST
06079703401150000,2020,1253,0,1253,COST
06079703401150000,2019,1253,0,1253,COST
06079703402030000,2021,156060,289140,445200,MKT
06079703402030000,2020,152492,218600,371092,OVR
06079703402030000,2019,152492,218600,371092,COST
06079704101010000,2021,114375,0,114375,COST
06079704101010000,2020,136271,0,136271,COST
06079704101010000,2019,136271,0,136271,COST
06079704101040000,2021,193084,344120,537204,COST
06079704101040000,2020,220775,306690,527465,COST
06079704101040000,2019,220775,306690,527465,COST
06079704301010000,2021,119768,251232,371000,MKT
06079704301010000,2020,128850,220650,349500,MKT
06079704301010000,2019,128850,220650,349500,MKT
06079704401010000,2021,86485,0,86485,COST
06079704401010000,2020,117037,0,117037,COST
06079704401010000,2019,117037,0,117037,COST
06079704401100000,2021,102970,339980,442950,COST
06079704401100000,2020,117953,298170,416123,COST
06079704401100000,2019,117953,298170,416123,COST
06079705101010000,2021,144989,0,144989,COST
06079705101010000,2020,151642,0,151642,COST
06079705101010000,2019,196360,0,196360,COST
06079705101030000,2021,202034,73950,275984,COST
06079705101030000,2020,257670,67630,325300,COST
06079705101030000,2019,257670,67630,325300,COST
06079705201010000,2021,1877,182560,184437,COST
06079705201010000,2020,2154,163850,166004,COST
06079705201010000,2019,2154,163850,166004,COST
06079705201030000,2021,113735,343565,457300,MKT
06079705201030000,2020,124680,302840,427520,OVR
06079705201030000,2019,124680,302840,427520,COST
06079705302050000,2021,5611,0,5611,COST
06079705302050000,2020,7215,0,7215,COST
06079705302050000,2019,7215,0,7215,COST
06079705401010000,2021,144358,0,144358,COST
06079705401010000,2020,196045,0,196045,COST
06079705401010000,2019,196045,0,196045,COST
06079705401100000,2021,6550,44760,51310,COST
06079705401100000,2020,8165,45380,53545,COST
06079705401100000,2019,8165,45380,53545,COST
06079706101010000,2021,70135,191465,261600,MKT
06079706101010000,2020,87797,105850,193647,COST
06079706101010000,2019,87797,105850,193647,COST
06079706101030000,2021,176461,2530,178991,COST
06079706101030000,2020,164896,2560,167456,COST
06079706101030000,2019,164896,2560,167456,COST
06079706101100000,2021,132636,550590,683226,COST
06079706101100000,2020,142041,241920,383961,OVR
06079706101100000,2019,142041,241920,383961,COST
06079706301010000,2021,244872,968010,1212882,COST
06079706301010000,2020,335369,965930,1301299,COST
06079706301010000,2019,335369,965930,1301299,COST
06079706401010000,2021,245162,19060,264222,COST
06079706401010000,2020,336739,18450,355189,COST
06079706401010000,2019,336739,18450,355189,COST
06079706401050000,2021,59360,323900,383260,COST
06079706401050000,2020,82423,281520,363943,COST
06079706401050000,2019,82423,281520,363943,COST
06079706403010000,2021,28646,648810,677456,COST
06079706403010000,2020,38536,585170,623706,COST
06079706403010000,2019,38536,585170,623706,COST
06079707101010000,2021,90468,163640,254108,COST
06079707101010000,2020,113605,145520,259125,COST
06079707101010000,2019,113605,145520,259125,COST
06079707101050000,2021,113056,316944,430000,MKT
06079707101050000,2020,124206,211194,335400,MKT
06079707101050000,2019,124206,211194,335400,MKT
06079707101100000,2021,187582,425540,613122,COST
06079707101100000,2020,129236,351564,480800,MKT
06079707101100000,2019,129236,351564,480800,MKT
06079707102010000,2021,110027,0,110027,COST
06079707102010000,2020,69519,0,69519,COST
06079707102050000,2021,146485,0,146485,COST
06079707102050000,2020,75647,0,75647,COST
06079707102050000,2019,141360,0,141360,COST
06079707201010000,2021,112882,1830,114712,COST
06079707201010000,2020,150136,1770,151906,COST
06079707201010000,2019,150136,1770,151906,COST
06079707201150000,2021,876,0,876,COST
06079707201150000,2020,896,0,896,COST
06079707201150000,2019,896,0,896,COST
06079707401010000,2021,111502,0,111502,COST
06079707401010000,2020,139712,0,139712,COST
06079707401010000,2019,139712,0,139712,COST
06079708101010000,2021,283397,329420,612817,COST
06079708101010000,2020,375036,284780,659816,COST
06079708101010000,2019,375036,284780,659816,COST
06079708101020000,2021,17902,144920,162822,COST
06079708101020000,2020,20976,129720,150696,COST
06079708101020000,2019,20976,129720,150696,COST
06079708201020000,2021,4730,140390,145120,COST
06079708201020000,2020,5396,124030,129426,COST
06079708201020000,2019,5517,124030,129547,COST
06079708201100000,2021,83271,0,83271,COST
06079708201100000,2020,107251,0,107251,COST
06079708201100000,2019,107251,0,107251,COST
06079708201150000,2021,124815,494685,619500,MKT
06079708201150000,2020,132280,357320,489600,OVR
06079708201150000,2019,132280,357320,489600,MKT
06079708301010000,2021,33970,0,33970,COST
06079708301010000,2020,35682,0,35682,COST
06079708301010000,2019,35682,0,35682,COST
06079708301100000,2021,1353,0,1353,COST
06079708301100000,2020,1427,0,1427,COST
06079708301100000,2019,1427,0,1427,COST
06079708302010000,2021,1866,284600,286466,COST
06079708302010000,2020,2144,254970,257114,COST
06079708302010000,2019,2144,254970,257114,COST
06079708304010000,2021,3409,625970,629379,COST
06079708304010000,2020,3621,573820,577441,COST
06079708304010000,2019,3621,483090,486711,COST
06079709101010000,2021,230165,398320,628485,COST
06079709101010000,2020,195279,368420,563699,COST
06079709101010000,2019,195279,368420,563699,COST
06079709101040000,2021,194517,261283,455800,MKT
06079709101040000,2020,175444,275156,450600,MKT
06079709101040000,2019,175444,275156,450600,MKT
06079709101080000,2021,100195,298905,399100,MKT
06079709101080000,2020,115016,227540,342556,COST
06079709101080000,2019,115016,227540,342556,COST
06079709101100000,2021,100297,480380,580677,COST
06079709101100000,2020,115466,423830,539296,COST
06079709101100000,2019,115466,423830,539296,COST
06079709101200000,2021,1304,0,1304,COST
06079709101200000,2020,1213,0,1213,COST
06079709101200000,2019,1213,0,1213,COST
06079709101300000,2021,3725,0,3725,COST
06079709101300000,2020,3467,0,3467,COST
06079709101300000,2019,3467,0,3467,COST
06079709101400000,2021,276354,484146,760500,MKT
06079709101400000,2020,219386,472190,691576,COST
06079709101400000,2019,219386,472190,691576,COST
06079709201010000,2021,134510,762580,897090,COST
06079709201010000,2020,178174,664430,842604,COST
06079709201010000,2019,178174,664430,842604,COST
06079709301010000,2021,122533,0,122533,COST
06079709301010000,2020,126825,0,126825,COST
06079709301010000,2019,126825,0,126825,COST
06079709401010000,2021,121692,639780,761472,COST
06079709401010000,2020,161933,558070,720003,COST
06079709401010000,2019,161933,580870,742803,COST
06079709401030000,2021,90535,291665,382200,MKT
06079709401030000,2020,107828,218772,326600,MKT
06079709401030000,2019,107828,218772,326600,MKT
06079709401040000,2021,95447,293053,388500,MKT
06079709401040000,2020,111516,283484,395000,MKT
06079709401040000,2019,111516,283484,395000,MKT
06079709401050000,2021,98400,394300,492700,MKT
06079709401050000,2020,113700,318800,432500,MKT
06079709401050000,2019,113700,318800,432500,MKT
06079710201010000,2021,115437,279640,395077,COST
06079710201010000,2020,148175,245250,393425,COST
06079710201010000,2019,148175,245250,393425,COST
06079710201500000,2021,84826,344310,429136,COST
06079710201500000,2020,78367,310280,388647,COST
06079710201500000,2019,78367,310280,388647,COST
06079710301010000,2021,144318,0,144318,COST
06079710301010000,2020,145086,0,145086,COST
06079710301010000,2019,145086,0,145086,COST
06079710301030000,2021,216319,0,216319,COST
06079710301030000,2020,187718,0,187718,COST
06079710301030000,2019,187718,0,187718,COST
06079710303010000,2021,1008108,4013900,5022008,COST
06079710303010000,2020,795127,3040330,3835457,COST
06079710303010000,2019,795127,3040330,3835457,COST
06079710401010000,2021,342653,67830,410483,COST
06079710401010000,2020,258271,49400,307671,COST
06079710401010000,2019,258271,49400,307671,COST
06079710401020000,2021,1916352,3180848,5097200,INCOME
06079710401020000,2020,1180643,3205057,4385700,INCOME
06079710401020000,2019,1180643,3205057,4385700,INCOME
06079710401030000,2021,213400,380740,594140,COST
06079710401030000,2020,185895,281030,466925,COST
06079710401030000,2019,185895,281030,466925,COST
06079710401040000,2021,613570,0,613570,COST
06079710401040000,2020,387046,0,387046,COST
06079710401040000,2019,387046,0,387046,COST
06079710402010000,2021,293808,511970,805778,COST
06079710402010000,2020,258814,367610,626424,COST
06079710402010000,2019,258814,367610,626424,COST
06079710402020000,2021,95920,272380,368300,MKT
06079710402020000,2020,111867,241233,353100,MKT
06079710402020000,2019,111867,241233,353100,MKT
06079710402030000,2021,88749,0,88749,COST
06079710402030000,2020,106470,0,106470,COST
06079710402030000,2019,106470,0,106470,COST
06079710402040000,2021,86667,299733,386400,MKT
06079710402040000,2020,104873,269927,374800,MKT
06079710402040000,2019,104873,269927,374800,MKT
06079710402050000,2021,181906,299820,481726,COST
06079710402050000,2020,166385,181060,347445,COST
06079710402050000,2019,166385,181060,347445,COST
06079710402060000,2021,181906,493840,675746,COST
06079710402060000,2020,166385,357790,524175,COST
06079710402060000,2019,166385,357790,524175,COST
06079710402070000,2021,173170,200470,373640,COST
06079710402070000,2020,160795,146770,307565,COST
06079710402070000,2019,160795,146770,307565,COST
06079710402080000,2021,175014,356840,531854,COST
06079710402080000,2020,161982,285518,447500,MKT
06079710402080000,2019,161982,225518,387500,MKT
06079710402090000,2021,176627,215530,392157,COST
06079710402090000,2020,163017,243683,406700,OVR
06079710402090000,2019,163017,243683,406700,MKT
06079710402106500,2021,74273,0,74273,COST
06079710402106500,2020,38874,0,38874,COST
06079710402106500,2019,38874,0,38874,COST
06079710402221001,2021,47621,960490,1008111,COST
06079710402221001,2020,43174,678540,721714,COST
06079710402221001,2019,43174,678540,721714,COST
06079710402221002,2021,5356,0,5356,COST
06079710402221002,2020,4989,0,4989,COST
06079710402221002,2019,4989,0,4989,COST
06079710403020000,2021,77610,0,77610,COST
06079710403020000,2020,80666,0,80666,COST
06079710403020000,2019,80666,0,80666,COST
06079710404020000,2021,223792,216510,440302,COST
06079710404020000,2020,192136,157150,349286,COST
06079710404020000,2019,192136,153460,345596,COST
06079710404030000,2021,223724,190600,414324,COST
06079710404030000,2020,192095,202205,394300,OVR
06079710404030000,2019,192095,202205,394300,MKT
06079710404030900,2021,261420,389230,650650,COST
06079710404030900,2020,214030,289250,503280,COST
06079710404030900,2019,214030,206250,420280,COST
06079710404040000,2021,209648,150840,360488,COST
06079710404040000,2020,183620,95900,279520,COST
06079710404040000,2019,183620,95900,279520,COST
06079710404050000,2021,58605,37830,96435,COST
06079710404050000,2020,81755,37230,118985,COST
06079710404050000,2019,81755,37230,118985,COST
06079710404101001,2021,39419,0,39419,COST
06079710404101001,2020,32169,0,32169,COST
06079710404101001,2019,32169,0,32169,COST
06079710404101002,2021,140558,127780,268338,COST
06079710404101002,2020,111963,114940,226903,COST
06079710404101002,2019,111963,114940,226903,COST
06079710405200000,2021,137615,0,137615,COST
06079710405200000,2020,94851,0,94851,COST
06079710405200000,2019,94851,0,94851,COST
06079710406010000,2021,369,28750,29119,COST
06079710406010000,2020,343,27550,27893,COST
06079710406010000,2019,343,27550,27893,COST
06079711101050000,2021,312217,313510,625727,COST
06079711101050000,2020,216052,284010,500062,COST
06079711101050000,2019,216052,284010,500062,COST
06079711101050900,2021,290078,0,290078,COST
06079711101050900,2020,204127,0,204127,COST
06079711101050900,2019,204127,0,204127,COST
06079711101060000,2021,8518,198270,206788,COST
06079711101060000,2020,8742,177570,186312,COST
06079711101060000,2019,8742,177570,186312,COST
06079711101076500,2021,125201,27800,153001,COST
06079711101076500,2020,114228,27410,141638,COST
06079711101076500,2019,114228,27410,141638,COST
06079711101080000,2021,360991,467910,828901,COST
06079711101080000,2020,323934,374490,698424,COST
06079711101080000,2019,323934,210150,534084,COST
06079711102016500,2021,174369,0,174369,COST
06079711102016500,2020,165679,0,165679,COST
06079711102016500,2019,165679,0,165679,COST
06079711102070000,2021,126792,278108,404900,MKT
06079711102070000,2020,132106,230594,362700,MKT
06079711102070000,2019,132106,230594,362700,MKT
06079711102090000,2021,123088,337112,460200,MKT
06079711102090000,2020,127782,318918,446700,MKT
06079711102090000,2019,127782,284118,411900,MKT
06079711102110000,2021,122588,329212,451800,MKT
06079711102110000,2020,127199,255801,383000,MKT
06079711102110000,2019,127199,255801,383000,MKT
06079711102130000,2021,123912,325788,449700,MKT
06079711102130000,2020,128743,282557,411300,OVR
06079711102130000,2019,128743,282557,411300,MKT
06079711102150000,2021,156987,344613,501600,MKT
06079711102150000,2020,139436,302464,441900,OVR
06079711102150000,2019,139436,302464,441900,MKT
06079711102170000,2021,156987,299313,456300,MKT
06079711102170000,2020,139436,251664,391100,MKT
06079711102170000,2019,139436,251664,391100,MKT
06079711102190000,2021,123584,398110,521694,COST
06079711102190000,2020,97242,363720,460962,COST
06079711102190000,2019,97242,363720,460962,COST
06079711103010000,2021,119497,283103,402600,MKT
06079711103010000,2020,93640,250860,344500,OVR
06079711103010000,2019,93640,250860,344500,MKT
06079711103030000,2021,109720,304780,414500,MKT
06079711103030000,2020,85083,258117,343200,MKT
06079711103030000,2019,85083,258117,343200,MKT
06079711103050000,2021,109720,258480,368200,MKT
06079711103050000,2020,85083,234717,319800,MKT
06079711103050000,2019,85083,234717,319800,MKT
06079711103070000,2021,109720,283180,392900,MKT
06079711103070000,2020,85083,237017,322100,MKT
06079711103070000,2019,85083,237017,322100,MKT
06079711103090000,2021,109720,274180,383900,MKT
06079711103090000,2020,85083,241017,326100,MKT
06079711103090000,2019,85083,241017,326100,MKT
06079711103110000,2021,109720,262380,372100,MKT
06079711103110000,2020,85083,227717,312800,MKT
06079711103110000,2019,85083,227717,312800,MKT
06079711103130000,2021,109720,329780,439500,MKT
06079711103130000,2020,85083,292317,377400,MKT
06079711103130000,2019,85083,292317,377400,MKT
06079711103150000,2021,109720,283880,393600,MKT
06079711103150000,2020,85083,248017,333100,MKT
06079711103150000,2019,85083,248017,333100,MKT
06079711103170000,2021,110552,366348,476900,MKT
06079711103170000,2020,85808,344392,430200,MKT
06079711103170000,2019,85808,344392,430200,MKT
06079711103190000,2021,120023,263877,383900,MKT
06079711103190000,2020,94103,233697,327800,OVR
06079711103190000,2019,94103,233697,327800,MKT
06079711103210000,2021,117343,289057,406400,MKT
06079711103210000,2020,91747,248453,340200,MKT
06079711103210000,2019,91747,248453,340200,MKT
06079711103230000,2021,109720,258680,368400,MKT
06079711103230000,2020,85083,231617,316700,MKT
06079711103230000,2019,85083,231617,316700,MKT
06079711103250000,2021,109720,302280,412000,MKT
06079711103250000,2020,85083,273617,358700,MKT
06079711103250000,2019,85083,273617,358700,MKT
06079711103270000,2021,109720,267880,377600,MKT
06079711103270000,2020,85083,231717,316800,MKT
06079711103270000,2019,85083,231717,316800,MKT
06079711103290000,2021,109720,325480,435200,MKT
06079711103290000,2020,85083,293417,378500,MKT
06079711103290000,2019,85083,293417,378500,MKT
06079711103310000,2021,109720,273180,382900,MKT
06079711103310000,2020,85083,241317,326400,OVR
06079711103310000,2019,85083,241317,326400,MKT
06079711103330000,2021,109720,311680,421400,MKT
06079711103330000,2020,85083,283517,368600,MKT
06079711103330000,2019,85083,283517,368600,MKT
06079711103350000,2021,109720,272380,382100,MKT
06079711103350000,2020,85083,231617,316700,MKT
06079711103350000,2019,85083,231617,316700,MKT
06079711103370000,2021,109720,269680,379400,MKT
06079711103370000,2020,85083,230217,315300,MKT
06079711103370000,2019,85083,230217,315300,MKT
06079711103390000,2021,109720,328380,438100,MKT
06079711103390000,2020,85083,323917,409000,MKT
06079711103390000,2019,85083,323917,409000,MKT
06079711103410000,2021,117343,294457,411800,MKT
06079711103410000,2020,91747,251553,343300,MKT
06079711103410000,2019,91747,251553,343300,MKT
06079711104010000,2021,136937,408163,545100,MKT
06079711104010000,2020,119607,399593,519200,MKT
06079711104010000,2019,119607,399593,519200,MKT
06079711104030000,2021,132606,391194,523800,MKT
06079711104030000,2020,115369,330831,446200,OVR
06079711104030000,2019,115369,330831,446200,MKT
06079711104050000,2021,132606,307994,440600,MKT
06079711104050000,2020,115369,259231,374600,MKT
06079711104050000,2019,115369,259231,374600,MKT
06079711104070000,2021,132606,295894,428500,MKT
06079711104070000,2020,115369,259131,374500,OVR
06079711104070000,2019,115369,259131,374500,MKT
06079711104090000,2021,132606,258494,391100,MKT
06079711104090000,2020,115369,233531,348900,OVR
06079711104090000,2019,115369,233531,348900,MKT
06079711104110000,2021,136937,421720,558657,COST
06079711104110000,2020,119607,370693,490300,MKT
06079711104110000,2019,119607,370693,490300,MKT
06079711105010000,2021,120023,399777,519800,MKT
06079711105010000,2020,94103,401297,495400,MKT
06079711105010000,2019,94103,401297,495400,MKT
06079711105030000,2021,109720,328880,438600,MKT
06079711105030000,2020,85083,311617,396700,OVR
06079711105030000,2019,85083,311617,396700,MKT
06079711105050000,2021,109720,326580,436300,MKT
06079711105050000,2020,85083,315517,400600,MKT
06079711105050000,2019,85083,315517,400600,MKT
06079711105070000,2021,109720,304180,413900,MKT
06079711105070000,2020,85083,279217,364300,MKT
06079711105070000,2019,85083,279217,364300,MKT
06079711105090000,2021,109720,342280,452000,MKT
06079711105090000,2020,85083,314217,399300,MKT
06079711105090000,2019,85083,271417,356500,MKT
06079711105110000,2021,109720,318480,428200,MKT
06079711105110000,2020,85083,292017,377100,OVR
06079711105110000,2019,85083,292017,377100,MKT
06079711105130000,2021,109720,338380,448100,MKT
06079711105130000,2020,85083,288417,373500,OVR
06079711105130000,2019,85083,288417,373500,MKT
06079711105150000,2021,109720,270680,380400,MKT
06079711105150000,2020,85083,231717,316800,OVR
06079711105150000,2019,85083,231717,316800,MKT
06079711105170000,2021,109720,288780,398500,MKT
06079711105170000,2020,85083,242617,327700,MKT
06079711105170000,2019,85083,242617,327700,MKT
06079711105190000,2021,119497,311303,430800,MKT
06079711105190000,2020,93640,295160,388800,MKT
06079711105190000,2019,93640,295160,388800,MKT
06079711105210000,2021,116976,332624,449600,MKT
06079711105210000,2020,91425,298375,389800,MKT
06079711105210000,2019,91425,298375,389800,MKT
06079711105230000,2021,109720,284580,394300,MKT
06079711105230000,2020,85083,247717,332800,MKT
06079711105230000,2019,85083,247717,332800,MKT
06079711105250000,2021,109720,277380,387100,MKT
06079711105250000,2020,85083,244017,329100,MKT
06079711105250000,2019,85083,244017,329100,MKT
06079711105270000,2021,109720,290080,399800,MKT
06079711105270000,2020,85083,246917,332000,MKT
06079711105270000,2019,85083,246917,332000,MKT
06079711105290000,2021,109720,273580,383300,MKT
06079711105290000,2020,85083,253817,338900,MKT
06079711105290000,2019,85083,231717,316800,MKT
06079711105310000,2021,109720,270180,379900,MKT
06079711105310000,2020,85083,235717,320800,MKT
06079711105310000,2019,85083,235717,320800,MKT
06079711105330000,2021,109720,283580,393300,MKT
06079711105330000,2020,85083,259217,344300,MKT
06079711105330000,2019,85083,259217,344300,MKT
06079711105350000,2021,109720,262580,372300,MKT
06079711105350000,2020,85083,243817,328900,OVR
06079711105350000,2019,85083,243817,328900,MKT
06079711105370000,2021,109720,284880,394600,MKT
06079711105370000,2020,85083,240217,325300,MKT
06079711105370000,2019,85083,240217,325300,MKT
06079711105390000,2021,109720,320580,430300,MKT
06079711105390000,2020,85083,304517,389600,MKT
06079711105390000,2019,85083,304517,389600,MKT
06079711105410000,2021,116976,304824,421800,MKT
06079711105410000,2020,91425,284175,375600,MKT
06079711105410000,2019,91425,284175,375600,MKT
06079711106010000,2021,152862,293038,445900,MKT
06079711106010000,2020,135330,243170,378500,OVR
06079711106010000,2019,135330,243170,378500,MKT
06079711106030000,2021,154952,443030,597982,COST
06079711106030000,2020,137409,407940,545349,COST
06079711106030000,2019,137409,407940,545349,COST
06079711106050000,2021,162322,414078,576400,MKT
06079711106050000,2020,144767,366533,511300,MKT
06079711106050000,2019,144767,366533,511300,MKT
06079711106070000,2021,149244,274956,424200,MKT
06079711106070000,2020,131740,227460,359200,MKT
06079711106070000,2019,131740,227960,359700,MKT
06079711106090000,2021,145829,370671,516500,MKT
06079711106090000,2020,128360,333840,462200,OVR
06079711106090000,2019,128360,333840,462200,MKT
06079711106110000,2021,145634,295866,441500,MKT
06079711106110000,2020,128168,246832,375000,OVR
06079711106110000,2019,128168,246832,375000,MKT
06079711106130000,2021,150165,351635,501800,MKT
06079711106130000,2020,132653,315747,448400,MKT
06079711106130000,2019,132653,315747,448400,MKT
06079711107030000,2021,141833,339567,481400,MKT
06079711107030000,2020,124419,292481,416900,OVR
06079711107030000,2019,124419,292481,416900,MKT
06079711107050000,2021,139747,232653,372400,MKT
06079711107050000,2020,122366,190234,312600,MKT
06079711107050000,2019,122366,190234,312600,MKT
06079711107070000,2021,137377,389123,526500,MKT
06079711107070000,2020,120039,401861,521900,MKT
06079711107070000,2019,120039,401861,521900,MKT
06079711107090000,2021,138248,335052,473300,MKT
06079711107090000,2020,120894,292306,413200,OVR
06079711107090000,2019,120894,292306,413200,MKT
06079711107110000,2021,154088,256512,410600,MKT
06079711107110000,2020,136549,210551,347100,MKT
06079711107110000,2019,136549,210551,347100,MKT
06079711107130000,2021,156145,287655,443800,MKT
06079711107130000,2020,138597,245003,383600,MKT
06079711107130000,2019,138597,245003,383600,MKT
06079711107150000,2021,146794,298706,445500,MKT
06079711107150000,2020,129314,245986,375300,MKT
06079711107150000,2019,129314,245986,375300,MKT
06079711108030000,2021,148123,299377,447500,MKT
06079711108030000,2020,130630,281970,412600,MKT
06079711108030000,2019,130630,281970,412600,MKT
06079711108050000,2021,158642,299458,458100,MKT
06079711108050000,2020,141087,255213,396300,OVR
06079711108050000,2019,141087,255213,396300,MKT
06079711108070000,2021,156987,278413,435400,MKT
06079711108070000,2020,139436,232964,372400,MKT
06079711108070000,2019,139436,232964,372400,MKT
06079711108090000,2021,138248,377352,515600,MKT
06079711108090000,2020,120894,371606,492500,MKT
06079711108090000,2019,120894,371606,492500,MKT
06079711108110000,2021,139747,249153,388900,MKT
06079711108110000,2020,122366,221434,343800,MKT
06079711108110000,2019,122366,231634,354000,MKT
06079711108130000,2021,140169,305431,445600,MKT
06079711108130000,2020,122781,266819,389600,OVR
06079711108130000,2019,122781,266819,389600,MKT
06079711109010000,2021,137596,401204,538800,MKT
06079711109010000,2020,120253,376047,496300,MKT
06079711109010000,2019,120253,376047,496300,MKT
06079711109030000,2021,133309,328691,462000,MKT
06079711109030000,2020,116056,293044,409100,OVR
06079711109030000,2019,116056,293044,409100,MKT
06079711109050000,2021,133309,357091,490400,MKT
06079711109050000,2020,116056,340044,456100,MKT
06079711109050000,2019,116056,340044,456100,MKT
06079711109090000,2021,133309,393691,527000,MKT
06079711109090000,2020,116056,248944,365000,OVR
06079711109090000,2019,116056,248944,365000,OVR
06079711109110000,2021,137596,271904,409500,MKT
06079711109110000,2020,120253,268147,388400,OVR
06079711109110000,2019,120253,268147,388400,MKT
06079711110030000,2021,124726,293974,418700,MKT
06079711110030000,2020,129692,241508,371200,MKT
06079711110030000,2019,129692,241508,371200,MKT
06079711110050000,2021,124401,299299,423700,MKT
06079711110050000,2020,129314,245286,374600,MKT
06079711110050000,2019,129314,245286,374600,MKT
06079711110070000,2021,124076,343424,467500,MKT
06079711110070000,2020,128934,304066,433000,MKT
06079711110070000,2019,128934,304066,433000,MKT
06079711110090000,2021,152508,280792,433300,MKT
06079711110090000,2020,134978,235722,370700,MKT
06079711110090000,2019,134978,235722,370700,MKT
06079711110110000,2021,151974,262826,414800,MKT
06079711110110000,2020,134448,242152,376600,MKT
06079711110110000,2019,134448,242152,376600,MKT
06079711110130000,2021,146794,254806,401600,MKT
06079711110130000,2020,129314,223286,352600,OVR
06079711110130000,2019,129314,223286,352600,MKT
06079711111030000,2021,148123,343577,491700,MKT
06079711111030000,2020,130630,321270,451900,OVR
06079711111030000,2019,130630,321270,451900,MKT
06079711111050000,2021,164177,273023,437200,MKT
06079711111050000,2020,146625,231375,378000,MKT
06079711111050000,2019,146625,231375,378000,MKT
06079711111070000,2021,165390,332110,497500,MKT
06079711111070000,2020,147842,284958,432800,OVR
06079711111070000,2019,147842,284958,432800,MKT
06079711111090000,2021,124239,262561,386800,MKT
06079711111090000,2020,129124,210476,339600,MKT
06079711111090000,2019,129124,207576,336700,MKT
06079711111110000,2021,122252,324248,446500,MKT
06079711111110000,2020,126808,268992,395800,MKT
06079711111110000,2019,126808,268992,395800,MKT
06079711111130000,2021,122252,338648,460900,MKT
06079711111130000,2020,126808,307792,434600,OVR
06079711111130000,2019,126808,307792,434600,MKT
06079711111150000,2021,128030,279770,407800,MKT
06079711111150000,2020,133555,221045,354600,MKT
06079711111150000,2019,133555,221045,354600,MKT
06079711112010000,2021,137596,311604,449200,MKT
06079711112010000,2020,120253,288847,409100,MKT
06079711112010000,2019,120253,241747,362000,MKT
06079711112030000,2021,133309,339691,473000,MKT
06079711112030000,2020,116056,310844,426900,OVR
06079711112030000,2019,116056,310844,426900,MKT
06079711112050000,2021,133309,330491,463800,MKT
06079711112050000,2020,116056,317344,433400,MKT
06079711112050000,2019,116056,273244,389300,MKT
06079711112070000,2021,133309,287491,420800,MKT
06079711112070000,2020,116056,272144,388200,MKT
06079711112070000,2019,116056,253644,369700,MKT
06079711112090000,2021,133309,250291,383600,MKT
06079711112090000,2020,116056,224744,340800,MKT
06079711112090000,2019,116056,224744,340800,MKT
06079711112110000,2021,137596,301704,439300,MKT
06079711112110000,2020,120253,267847,388100,MKT
06079711112110000,2019,120253,267847,388100,MKT
06079711113010000,2021,120023,324677,444700,MKT
06079711113010000,2020,94103,314397,408500,MKT
06079711113010000,2019,94103,314397,408500,MKT
06079711113030000,2021,109929,295771,405700,MKT
06079711113030000,2020,85266,250334,335600,MKT
06079711113030000,2019,85266,291134,376400,MKT
06079711113050000,2021,109720,287880,397600,MKT
06079711113050000,2020,85083,239817,324900,MKT
06079711113050000,2019,85083,239817,324900,MKT
06079711113070000,2021,109720,339180,448900,MKT
06079711113070000,2020,85083,304817,389900,MKT
06079711113070000,2019,85083,304817,389900,MKT
06079711113090000,2021,109720,312680,422400,MKT
06079711113090000,2020,85083,275017,360100,MKT
06079711113090000,2019,85083,275017,360100,MKT
06079711113110000,2021,109720,317380,427100,MKT
06079711113110000,2020,85083,303217,388300,MKT
06079711113110000,2019,85083,326817,411900,MKT
06079711113130000,2021,109720,293480,403200,MKT
06079711113130000,2020,85083,244417,329500,MKT
06079711113130000,2019,85083,244417,329500,MKT
06079711113150000,2021,109720,285180,394900,MKT
06079711113150000,2020,85083,247317,332400,MKT
06079711113150000,2019,85083,247317,332400,MKT
06079711113170000,2021,109720,269080,378800,MKT
06079711113170000,2020,85083,235617,320700,MKT
06079711113170000,2019,85083,235617,320700,MKT
06079711113190000,2021,119320,291880,411200,MKT
06079711113190000,2020,93485,253115,346600,OVR
06079711113190000,2019,93485,253115,346600,MKT
06079711113210000,2021,116976,304224,421200,MKT
06079711113210000,2020,91425,259775,351200,MKT
06079711113210000,2019,91425,259775,351200,MKT
06079711113230000,2021,109720,309580,419300,MKT
06079711113230000,2020,85083,273117,358200,MKT
06079711113230000,2019,85083,273117,358200,MKT
06079711113250000,2021,109720,409980,519700,MKT
06079711113250000,2020,85083,353417,438500,MKT
06079711113250000,2019,85083,353417,438500,MKT
06079711113270000,2021,109720,284580,394300,MKT
06079711113270000,2020,85083,260717,345800,MKT
06079711113270000,2019,85083,260717,345800,MKT
06079711113290000,2021,109720,355580,465300,MKT
06079711113290000,2020,85083,317717,402800,OVR
06079711113290000,2019,85083,317717,402800,MKT
06079711113310000,2021,109720,321480,431200,MKT
06079711113310000,2020,85083,260917,346000,OVR
06079711113310000,2019,85083,260917,346000,MKT
06079711113330000,2021,109720,325080,434800,MKT
06079711113330000,2020,85083,284017,369100,OVR
06079711113330000,2019,85083,284017,369100,MKT
06079711113350000,2021,109720,316780,426500,MKT
06079711113350000,2020,85083,287317,372400,MKT
06079711113350000,2019,85083,287317,372400,MKT
06079711113370000,2021,109720,281980,391700,MKT
06079711113370000,2020,85083,244317,329400,MKT
06079711113370000,2019,85083,244317,329400,MKT
06079711113390000,2021,109720,309280,419000,MKT
06079711113390000,2020,85083,270517,355600,OVR
06079711113390000,2019,85083,270517,355600,MKT
06079711113410000,2021,116976,256924,373900,MKT
06079711113410000,2020,91425,232475,323900,MKT
06079711113410000,2019,91425,232475,323900,MKT
06079711114010000,2021,116976,310524,427500,MKT
06079711114010000,2020,91425,286175,377600,MKT
06079711114010000,2019,91425,286175,377600,MKT
06079711114030000,2021,109720,290580,400300,MKT
06079711114030000,2020,85083,237917,323000,OVR
06079711114030000,2019,85083,237917,323000,MKT
06079711114050000,2021,109720,275280,385000,MKT
06079711114050000,2020,85083,243517,328600,MKT
06079711114050000,2019,85083,243517,328600,MKT
06079711114070000,2021,109720,327580,437300,MKT
06079711114070000,2020,85083,281817,366900,MKT
06079711114070000,2019,85083,281817,366900,MKT
06079711114090000,2021,109720,308380,418100,MKT
06079711114090000,2020,85083,292417,377500,MKT
06079711114090000,2019,85083,292417,377500,MKT
06079711114110000,2021,109720,311680,421400,MKT
06079711114110000,2020,85083,291717,376800,MKT
06079711114110000,2019,85083,291717,376800,MKT
06079711114130000,2021,109720,275780,385500,MKT
06079711114130000,2020,85083,237917,323000,MKT
06079711114130000,2019,85083,237917,323000,MKT
06079711114150000,2021,109720,307680,417400,MKT
06079711114150000,2020,85083,275817,360900,MKT
06079711114150000,2019,85083,275817,360900,MKT
06079711114170000,2021,109720,298880,408600,MKT
06079711114170000,2020,85083,253117,338200,MKT
06079711114170000,2019,85083,253117,338200,MKT
06079711114190000,2021,109720,293180,402900,MKT
06079711114190000,2020,85083,253917,339000,MKT
06079711114190000,2019,85083,253917,339000,MKT
06079711114210000,2021,116976,346024,463000,MKT
06079711114210000,2020,91425,324375,415800,MKT
06079711114210000,2019,91425,324375,415800,MKT
06079711114230000,2021,116976,326024,443000,MKT
06079711114230000,2020,91425,301275,392700,OVR
06079711114230000,2019,91425,301275,392700,MKT
06079711114250000,2021,109720,328080,437800,MKT
06079711114250000,2020,85083,310417,395500,MKT
06079711114250000,2019,85083,262217,347300,MKT
06079711114270000,2021,109720,402080,511800,MKT
06079711114270000,2020,85083,360617,445700,MKT
06079711114270000,2019,85083,360617,445700,MKT
06079711114290000,2021,109720,307880,417600,MKT
06079711114290000,2020,85083,293217,378300,MKT
06079711114290000,2019,85083,293217,378300,MKT
06079711114310000,2021,109720,329180,438900,MKT
06079711114310000,2020,85083,281217,366300,MKT
06079711114310000,2019,85083,281217,366300,MKT
06079711114330000,2021,109720,328180,437900,MKT
06079711114330000,2020,85083,294317,379400,OVR
06079711114330000,2019,85083,294317,379400,MKT
06079711114350000,2021,109720,395380,505100,MKT
06079711114350000,2020,85083,378917,464000,OVR
06079711114350000,2019,85083,378917,464000,MKT
06079711114370000,2021,109720,418080,527800,MKT
06079711114370000,2020,85083,372460,457543,OVR
06079711114370000,2019,85083,372460,457543,COST
06079711114390000,2021,109720,347580,457300,MKT
06079711114390000,2020,85083,306417,391500,OVR
06079711114390000,2019,85083,306417,391500,MKT
06079711114410000,2021,109720,297680,407400,MKT
06079711114410000,2020,85083,249417,334500,MKT
06079711114410000,2019,85083,249417,334500,MKT
06079711114430000,2021,116976,337924,454900,MKT
06079711114430000,2020,91425,299475,390900,MKT
06079711114430000,2019,91425,299475,390900,MKT
06079711115010000,2021,116976,333024,450000,MKT
06079711115010000,2020,91425,311975,403400,MKT
06079711115010000,2019,91425,292075,383500,MKT
06079711115030000,2021,109720,292480,402200,MKT
06079711115030000,2020,85083,265317,350400,MKT
06079711115030000,2019,85083,238317,323400,MKT
06079711115050000,2021,109720,296880,406600,MKT
06079711115050000,2020,85083,251617,336700,MKT
06079711115050000,2019,85083,251617,336700,MKT
06079711115070000,2021,109720,268280,378000,MKT
06079711115070000,2020,85083,218917,304000,MKT
06079711115070000,2019,85083,218917,304000,MKT
06079711115090000,2021,109720,283980,393700,MKT
06079711115090000,2020,85083,246017,331100,MKT
06079711115090000,2019,85083,246017,331100,MKT
06079711115110000,2021,109720,283980,393700,MKT
06079711115110000,2020,85083,246017,331100,MKT
06079711115110000,2019,85083,246017,331100,MKT
06079711115130000,2021,109720,294180,403900,MKT
06079711115130000,2020,85083,244317,329400,MKT
06079711115130000,2019,85083,244317,329400,MKT
06079711115150000,2021,109720,313580,423300,MKT
06079711115150000,2020,85083,270617,355700,MKT
06079711115150000,2019,85083,270617,355700,MKT
06079711115170000,2021,109720,295280,405000,MKT
06079711115170000,2020,85083,252717,337800,MKT
06079711115170000,2019,85083,252717,337800,MKT
06079711115190000,2021,109720,275180,384900,MKT
06079711115190000,2020,85083,241517,326600,MKT
06079711115190000,2019,85083,241517,326600,MKT
06079711115210000,2021,116976,236424,353400,MKT
06079711115210000,2020,91425,216075,307500,MKT
06079711115210000,2019,91425,216075,307500,MKT
06079711115230000,2021,120023,340877,460900,MKT
06079711115230000,2020,94103,324497,418600,MKT
06079711115230000,2019,94103,324497,418600,MKT
06079711115250000,2021,109720,298280,408000,MKT
06079711115250000,2020,85083,251617,336700,MKT
06079711115250000,2019,85083,251617,336700,MKT
06079711115270000,2021,109720,308580,418300,MKT
06079711115270000,2020,85083,276017,361100,MKT
06079711115270000,2019,85083,276017,361100,MKT
06079711115290000,2021,109720,317480,427200,MKT
06079711115290000,2020,85083,284817,369900,MKT
06079711115290000,2019,85083,284817,369900,MKT
06079711115310000,2021,109720,332680,442400,MKT
06079711115310000,2020,85083,307517,392600,MKT
06079711115310000,2019,85083,307517,392600,MKT
06079711115330000,2021,109720,324830,434550,COST
06079711115330000,2020,85083,297190,382273,COST
06079711115330000,2019,85083,297190,382273,COST
06079711115350000,2021,109720,330380,440100,MKT
06079711115350000,2020,85083,317917,403000,MKT
06079711115350000,2019,85083,317917,403000,MKT
06079711115370000,2021,109720,314080,423800,MKT
06079711115370000,2020,85083,297217,382300,MKT
06079711115370000,2019,85083,297217,382300,MKT
06079711115390000,2021,109720,320780,430500,MKT
06079711115390000,2020,85083,307517,392600,MKT
06079711115390000,2019,85083,307517,392600,MKT
06079711115410000,2021,119320,333680,453000,MKT
06079711115410000,2020,93485,295715,389200,MKT
06079711115410000,2019,93485,295715,389200,MKT
06079711116010000,2021,117343,314357,431700,MKT
06079711116010000,2020,91747,275853,367600,MKT
06079711116010000,2019,91747,275853,367600,MKT
06079711116030000,2021,109720,319180,428900,MKT
06079711116030000,2020,85083,268517,353600,MKT
06079711116030000,2019,85083,268517,353600,MKT
06079711116050000,2021,109720,300280,410000,MKT
06079711116050000,2020,85083,258117,343200,MKT
06079711116050000,2019,85083,258117,343200,MKT
06079711116070000,2021,109720,320580,430300,MKT
06079711116070000,2020,85083,285717,370800,MKT
06079711116070000,2019,85083,285717,370800,MKT
06079711116090000,2021,109720,341680,451400,MKT
06079711116090000,2020,85083,307717,392800,MKT
06079711116090000,2019,85083,307717,392800,MKT
06079711116110000,2021,109720,333380,443100,MKT
06079711116110000,2020,85083,312417,397500,MKT
06079711116110000,2019,85083,312417,397500,MKT
06079711116130000,2021,109720,273280,383000,MKT
06079711116130000,2020,85083,239717,324800,MKT
06079711116130000,2019,85083,239717,324800,MKT
06079711116150000,2021,109720,279480,389200,MKT
06079711116150000,2020,85083,233517,318600,MKT
06079711116150000,2019,85083,233517,318600,MKT
06079711116170000,2021,109720,389380,499100,MKT
06079711116170000,2020,85083,369717,454800,MKT
06079711116170000,2019,85083,369717,454800,MKT
06079711116190000,2021,109720,269280,379000,MKT
06079711116190000,2020,85083,238317,323400,MKT
06079711116190000,2019,85083,238317,323400,MKT
06079711116210000,2021,117159,372841,490000,MKT
06079711116210000,2020,91586,342914,434500,MKT
06079711116210000,2019,91586,342914,434500,MKT
06079711116230000,2021,117159,278441,395600,MKT
06079711116230000,2020,91586,242414,334000,MKT
06079711116230000,2019,91586,242414,334000,MKT
06079711116250000,2021,109720,269680,379400,MKT
06079711116250000,2020,85083,230217,315300,MKT
06079711116250000,2019,85083,230217,315300,MKT
06079711116270000,2021,109720,246380,356100,MKT
06079711116270000,2020,85083,231717,316800,MKT
06079711116270000,2019,85083,231717,316800,MKT
06079711116290000,2021,109720,317980,427700,MKT
06079711116290000,2020,85083,277617,362700,MKT
06079711116290000,2019,85083,277617,362700,MKT
06079711116310000,2021,109720,324280,434000,MKT
06079711116310000,2020,85083,285517,370600,MKT
06079711116310000,2019,85083,285517,370600,MKT
06079711116330000,2021,109720,317280,427000,MKT
06079711116330000,2020,85083,276017,361100,MKT
06079711116330000,2019,85083,276017,361100,MKT
06079711116350000,2021,109720,349980,459700,MKT
06079711116350000,2020,85083,331217,416300,MKT
06079711116350000,2019,85083,331217,416300,MKT
06079711116370000,2021,109720,300880,410600,MKT
06079711116370000,2020,85083,258217,343300,MKT
06079711116370000,2019,85083,258217,343300,MKT
06079711116390000,2021,109720,305180,414900,MKT
06079711116390000,2020,85083,262717,347800,MKT
06079711116390000,2019,85083,262717,347800,MKT
06079711116410000,2021,109720,263080,372800,MKT
06079711116410000,2020,85083,234517,319600,MKT
06079711116410000,2019,85083,234517,319600,MKT
06079711116430000,2021,117159,302041,419200,MKT
06079711116430000,2020,91586,259314,350900,MKT
06079711116430000,2019,91586,259314,350900,MKT
06079711117016500,2021,120078,0,120078,COST
06079711117016500,2020,108995,0,108995,COST
06079711117016500,2019,108995,0,108995,COST
06079711117030000,2021,130288,247412,377700,MKT
06079711117030000,2020,136203,205097,341300,MKT
06079711117030000,2019,136203,205097,341300,MKT
06079711117050000,2021,127103,275297,402400,MKT
06079711117050000,2020,132471,229129,361600,MKT
06079711117050000,2019,132471,229129,361600,MKT
06079711117070000,2021,128336,353764,482100,MKT
06079711117070000,2020,133913,315387,449300,MKT
06079711117070000,2019,133913,315387,449300,MKT
06079711117090000,2021,160583,428817,589400,MKT
06079711117090000,2020,143027,454073,597100,MKT
06079711117090000,2019,143027,454073,597100,MKT
06079711117110000,2021,157819,345881,503700,MKT
06079711117110000,2020,140266,302534,442800,MKT
06079711117110000,2019,140266,302534,442800,MKT
06079711117130000,2021,148686,336314,485000,MKT
06079711117130000,2020,131187,302013,433200,MKT
06079711117130000,2019,131187,302013,433200,MKT
06079711118010000,2021,138248,330252,468500,MKT
06079711118010000,2020,120894,318406,439300,MKT
06079711118010000,2019,120894,318406,439300,MKT
06079711118030000,2021,133542,247858,381400,MKT
06079711118030000,2020,116283,221517,337800,MKT
06079711118030000,2019,116283,221517,337800,MKT
06079711118050000,2021,133773,247927,381700,MKT
06079711118050000,2020,116510,217290,333800,MKT
06079711118050000,2019,116510,217290,333800,MKT
06079711118070000,2021,133773,331827,465600,MKT
06079711118070000,2020,116510,317890,434400,MKT
06079711118070000,2019,116510,317890,434400,MKT
06079711118090000,2021,133773,283227,417000,MKT
06079711118090000,2020,116510,265990,382500,MKT
06079711118090000,2019,116510,265990,382500,MKT
06079711118110000,2021,137596,321604,459200,MKT
06079711118110000,2020,120253,289047,409300,MKT
06079711118110000,2019,120253,289047,409300,MKT
06079711119010000,2021,147746,356854,504600,MKT
06079711119010000,2020,130256,317544,447800,MKT
06079711119010000,2019,130256,295144,425400,MKT
06079711119030000,2021,160743,507757,668500,MKT
06079711119030000,2020,143187,454313,597500,MKT
06079711119030000,2019,143187,454313,597500,MKT
06079711119050000,2021,160743,348357,509100,MKT
06079711119050000,2020,143187,325013,468200,MKT
06079711119050000,2019,143187,325013,468200,MKT
06079711119070000,2021,146409,264691,411100,MKT
06079711119070000,2020,128934,233466,362400,MKT
06079711119070000,2019,128934,233466,362400,MKT
06079711119090000,2021,146794,362206,509000,MKT
06079711119090000,2020,129314,322186,451500,MKT
06079711119090000,2019,129314,322186,451500,MKT
06079711119110000,2021,149798,345702,495500,MKT
06079711119110000,2020,132289,307811,440100,MKT
06079711119110000,2019,132289,242711,375000,MKT
06079711201010000,2021,28284,0,28284,COST
06079711201010000,2020,26256,0,26256,COST
06079711201010000,2019,26256,0,26256,COST
06079711202010000,2021,251779,0,251779,COST
06079711202010000,2020,187457,0,187457,COST
06079711202010000,2019,187457,0,187457,COST
06079711202097000,2021,408421,0,408421,COST
06079711202097000,2020,372082,0,372082,COST
06079711202097000,2019,372082,0,372082,COST
06079711202130000,2021,337412,0,337412,COST
06079711202130000,2020,236527,0,236527,COST
06079711202130000,2019,236527,0,236527,COST
06079711202150000,2021,202075,819925,1022000,MKT
06079711202150000,2020,136012,692288,828300,MKT
06079711202150000,2019,136012,697888,833900,MKT
06079711202170000,2021,194783,0,194783,COST
06079711202170000,2020,130723,0,130723,COST
06079711202170000,2019,130723,0,130723,COST
06079711202190000,2021,200896,852604,1053500,MKT
06079711202190000,2020,135156,631744,766900,MKT
06079711202190000,2019,135156,631744,766900,MKT
06079711202210000,2021,202075,0,202075,COST
06079711202210000,2020,136012,0,136012,COST
06079711202210000,2019,136012,0,136012,COST
06079711203010000,2021,200119,14601720,14801839,COST
06079711203010000,2020,229991,14217510,14447501,COST
06079711203010000,2019,229991,14217510,14447501,COST
06079711203050000,2021,232248,0,232248,COST
06079711203050000,2020,244381,0,244381,COST
06079711203050000,2019,244381,0,244381,COST
06079711203090000,2021,811073,1607040,2418113,COST
06079711203090000,2020,392936,1558890,1951826,COST
06079711203090000,2019,350984,1558890,1909874,COST
06079711203130000,2021,609695,3001005,3610700,INCOME
06079711203130000,2020,325486,2942714,3268200,INCOME
06079711203130000,2019,325486,2942714,3268200,INCOME
06079711203170000,2021,214807,0,214807,COST
06079711203170000,2020,236727,0,236727,COST
06079711203170000,2019,236727,0,236727,COST
06079711203210000,2021,184513,0,184513,COST
06079711203210000,2020,222504,0,222504,COST
06079711203210000,2019,222504,0,222504,COST
06079711204010000,2021,186893,0,186893,COST
06079711204010000,2020,125016,0,125016,COST
06079711204010000,2019,125016,0,125016,COST
06079711204030000,2021,213058,475042,688100,MKT
06079711204030000,2020,188775,376425,565200,MKT
06079711204030000,2019,188775,376425,565200,MKT
06079711204050000,2021,223482,760318,983800,MKT
06079711204050000,2020,198763,668337,867100,MKT
06079711204050000,2019,198763,668337,867100,MKT
06079711204070000,2021,224893,774507,999400,MKT
06079711204070000,2020,200117,578283,778400,MKT
06079711204070000,2019,200117,578283,778400,MKT
06079711204090000,2021,186893,697707,884600,MKT
06079711204090000,2020,125016,0,125016,COST
06079711204090000,2019,125016,0,125016,COST
06079711204110000,2021,182681,459730,642411,COST
06079711204110000,2020,121978,0,121978,COST
06079711204110000,2019,121978,0,121978,COST
06079711204130000,2021,189597,462703,652300,MKT
06079711204130000,2020,126970,419930,546900,MKT
06079711204130000,2019,126970,419930,546900,MKT
06079711204150000,2021,185510,576790,762300,MKT
06079711204150000,2020,124018,514982,639000,MKT
06079711204150000,2019,124018,514982,639000,MKT
06079711204170000,2021,169241,833959,1003200,MKT
06079711204170000,2020,134290,680410,814700,MKT
06079711204170000,2019,134290,680410,814700,MKT
06079711204190000,2021,161797,0,161797,COST
06079711204190000,2020,127927,0,127927,COST
06079711204190000,2019,127927,0,127927,COST
06079711204210000,2021,169241,1221420,1390661,COST
06079711204210000,2020,134290,299240,433530,COST
06079711204210000,2019,134290,0,134290,COST
06079711204230000,2021,172237,0,172237,COST
06079711204230000,2020,136858,0,136858,COST
06079711204230000,2019,136858,0,136858,COST
06079711204250000,2021,167182,767418,934600,MKT
06079711204250000,2020,132528,614572,747100,MKT
06079711204250000,2019,132528,393300,525828,COST
06079711204270000,2021,169241,1250210,1419451,COST
06079711204270000,2020,134290,1063210,1197500,COST
06079711204270000,2019,134290,1063210,1197500,COST
06079711204290000,2021,153586,828414,982000,MKT
06079711204290000,2020,120934,632666,753600,MKT
06079711204290000,2019,120934,632666,753600,MKT
06079711205010000,2021,229696,900404,1130100,MKT
06079711205010000,2020,156181,756319,912500,MKT
06079711205010000,2019,156181,756319,912500,MKT
06079711205030000,2021,211036,797950,1008986,COST
06079711205030000,2020,142533,653967,796500,MKT
06079711205030000,2019,142533,653967,796500,MKT
06079711205050000,2021,226022,1258178,1484200,MKT
06079711205050000,2020,153487,1228350,1381837,COST
06079711205050000,2019,153487,1228350,1381837,COST
