id,year,land,building,total,method
06079803405070000,2021,128998,268002,397000,MKT
06079803405070000,2020,80126,253774,333900,MKT
06079803405070000,2019,80126,253774,333900,MKT
06079803405090000,2021,128998,270902,399900,MKT
06079803405090000,2020,80126,253574,333700,MKT
06079803405090000,2019,80126,253574,333700,MKT
06079803405110000,2021,128998,269302,398300,MKT
06079803405110000,2020,80126,250674,330800,MKT
06079803405110000,2019,80126,250674,330800,MKT
06079803405130000,2021,128684,274016,402700,MKT
06079803405130000,2020,79746,257554,337300,MKT
06079803405130000,2019,79746,257554,337300,MKT
06079803405150000,2021,129314,274286,403600,MKT
06079803405150000,2020,80510,256590,337100,MKT
06079803405150000,2019,80510,256590,337100,MKT
06079803405170000,2021,140629,286871,427500,MKT
06079803405170000,2020,94831,274969,369800,MKT
06079803405170000,2019,94831,274969,369800,MKT
06079803405190000,2021,129813,257887,387700,MKT
06079803405190000,2020,94264,244136,338400,MKT
06079803405190000,2019,94264,244136,338400,MKT
06079803405210000,2021,121041,272959,394000,MKT
06079803405210000,2020,82232,257668,339900,MKT
06079803405210000,2019,82232,257668,339900,MKT
06079803405230000,2021,119152,268748,387900,MKT
06079803405230000,2020,79746,250454,330200,MKT
06079803405230000,2019,79746,250454,330200,MKT
06079803405250000,2021,119443,294457,413900,MKT
06079803405250000,2020,80126,282874,363000,MKT
06079803405250000,2019,80126,231874,312000,MKT
06079803405270000,2021,119443,276457,395900,MKT
06079803405270000,2020,80126,253674,333800,MKT
06079803405270000,2019,80126,253674,333800,MKT
06079803405290000,2021,119443,276557,396000,MKT
06079803405290000,2020,80126,253774,333900,MKT
06079803405290000,2019,80126,253774,333900,MKT
06079803406057000,2021,288094,0,288094,COST
06079803406057000,2020,398161,0,398161,COST
06079803406057000,2019,398161,0,398161,COST
06079803407010000,2021,135859,289841,425700,MKT
06079803407010000,2020,88654,267646,356300,MKT
06079803407010000,2019,88654,267646,356300,MKT
06079803407030000,2021,125822,272078,397900,MKT
06079803407030000,2020,88692,253908,342600,MKT
06079803407030000,2019,88692,253908,342600,MKT
06079803407050000,2021,125822,303578,429400,MKT
06079803407050000,2020,88692,279708,368400,MKT
06079803407050000,2019,88692,279708,368400,MKT
06079803407070000,2021,123178,258322,381500,MKT
06079803407070000,2020,85089,231611,316700,MKT
06079803407070000,2019,85089,231611,316700,MKT
06079803407090000,2021,123272,258428,381700,MKT
06079803407090000,2020,85217,229083,314300,MKT
06079803407090000,2019,85217,237583,322800,MKT
06079803407110000,2021,129458,337342,466800,MKT
06079803407110000,2020,93762,352138,445900,MKT
06079803407110000,2019,93762,352138,445900,MKT
06079803407130000,2021,140398,274802,415200,MKT
06079803407130000,2020,94528,268372,362900,MKT
06079803407130000,2019,94528,268372,362900,MKT
06079803407150000,2021,137704,297596,435300,MKT
06079803407150000,2020,91020,280780,371800,MKT
06079803407150000,2019,91020,280780,371800,MKT
06079803407170000,2021,132894,259606,392500,MKT
06079803407170000,2020,84917,236383,321300,MKT
06079803407170000,2019,84917,236383,321300,MKT
06079803408010000,2021,122513,277287,399800,MKT
06079803408010000,2020,84195,299005,383200,MKT
06079803408010000,2019,84195,299005,383200,MKT
06079803408030000,2021,122513,272087,394600,MKT
06079803408030000,2020,84195,254605,338800,MKT
06079803408030000,2019,84195,254605,338800,MKT
06079803408050000,2021,122513,261987,384500,MKT
06079803408050000,2020,84195,237805,322000,MKT
06079803408050000,2019,84195,237805,322000,MKT
06079803408070000,2021,112331,241369,353700,MKT
06079803408070000,2020,71078,235522,306600,MKT
06079803408070000,2019,71078,235522,306600,MKT
06079803408090000,2021,105414,252086,357500,MKT
06079803408090000,2020,62786,249514,312300,MKT
06079803408090000,2019,62786,249514,312300,MKT
06079803408110000,2021,105414,242186,347600,MKT
06079803408110000,2020,62786,258014,320800,MKT
06079803408110000,2019,62786,258014,320800,MKT
06079803408130000,2021,105414,264486,369900,MKT
06079803408130000,2020,62786,260714,323500,MKT
06079803408130000,2019,62786,258814,321600,MKT
06079803408150000,2021,111619,252881,364500,MKT
06079803408150000,2020,70202,256198,326400,MKT
06079803408150000,2019,70202,256198,326400,MKT
06079803408170000,2021,112067,271333,383400,MKT
06079803408170000,2020,70752,261748,332500,MKT
06079803408170000,2019,70752,261748,332500,MKT
06079803408190000,2021,105414,262686,368100,MKT
06079803408190000,2020,62786,257514,320300,MKT
06079803408190000,2019,62786,257514,320300,MKT
06079803408210000,2021,105414,261386,366800,MKT
06079803408210000,2020,62786,256714,319500,MKT
06079803408210000,2019,62786,256714,319500,MKT
06079803408230000,2021,105414,264686,370100,MKT
06079803408230000,2020,62786,257714,320500,MKT
06079803408230000,2019,62786,257714,320500,MKT
06079803408250000,2021,111958,228042,340000,MKT
06079803408250000,2020,70618,230082,300700,MKT
06079803408250000,2019,70618,230082,300700,MKT
06079803409010000,2021,131554,1016646,1148200,INCOME
06079803409010000,2020,98899,745701,844600,INCOME
06079803409010000,2019,98899,745701,844600,INCOME
06079803409037000,2021,121483,0,121483,COST
06079803409037000,2020,82819,0,82819,COST
06079803409037000,2019,82819,0,82819,COST
06079803409050000,2021,131554,649546,781100,INCOME
06079803409050000,2020,98899,615901,714800,INCOME
06079803409050000,2019,98899,615901,714800,INCOME
06079803409077000,2021,121483,0,121483,COST
06079803409077000,2020,82819,0,82819,COST
06079803409077000,2019,82819,0,82819,COST
06079803409090000,2021,131554,811346,942900,INCOME
06079803409090000,2020,98899,745701,844600,INCOME
06079803409090000,2019,98899,745701,844600,INCOME
06079803411010000,2021,113961,278639,392600,MKT
06079803411010000,2020,76130,278770,354900,MKT
06079803411010000,2019,76130,278470,354600,MKT
06079803411030000,2021,114076,332224,446300,MKT
06079803411030000,2020,76280,323520,399800,MKT
06079803411030000,2019,76280,323520,399800,MKT
06079803411050000,2021,114186,275114,389300,MKT
06079803411050000,2020,76423,269277,345700,MKT
06079803411050000,2019,76423,269277,345700,MKT
06079803411070000,2021,114301,292799,407100,MKT
06079803411070000,2020,76573,300827,377400,MKT
06079803411070000,2019,76573,300827,377400,MKT
06079803411090000,2021,119829,273471,393300,MKT
06079803411090000,2020,83968,297232,381200,MKT
06079803411090000,2019,83968,297232,381200,MKT
06079803411110000,2021,119824,289676,409500,MKT
06079803411110000,2020,83961,274539,358500,MKT
06079803411110000,2019,83961,274539,358500,MKT
06079803411130000,2021,114295,304705,419000,MKT
06079803411130000,2020,76566,293734,370300,MKT
06079803411130000,2019,76566,293734,370300,MKT
06079803411150000,2021,114186,281314,395500,MKT
06079803411150000,2020,76423,293277,369700,MKT
06079803411150000,2019,76423,293277,369700,MKT
06079803411170000,2021,114071,273729,387800,MKT
06079803411170000,2020,76273,261627,337900,MKT
06079803411170000,2019,76273,261627,337900,MKT
06079803411190000,2021,113961,347439,461400,MKT
06079803411190000,2020,76130,338970,415100,MKT
06079803411190000,2019,76130,338970,415100,MKT
06079803411250000,2021,104122,269478,373600,MKT
06079803411270000,2021,103758,269342,373100,MKT
06079803412010000,2021,104650,279350,384000,MKT
06079803412010000,2020,72429,273971,346400,MKT
06079803412010000,2019,72429,273971,346400,MKT
06079803412030000,2021,112736,278464,391200,MKT
06079803412030000,2020,74540,260660,335200,MKT
06079803412030000,2019,74540,260660,335200,MKT
06079803412050000,2021,112736,265864,378600,MKT
06079803412050000,2020,74540,289860,364400,MKT
06079803412050000,2019,74540,289860,364400,MKT
06079803412070000,2021,112736,288164,400900,MKT
06079803412070000,2020,74540,262160,336700,MKT
06079803412070000,2019,74540,262160,336700,MKT
06079803412090000,2021,112736,268864,381600,MKT
06079803412090000,2020,74540,265060,339600,MKT
06079803412090000,2019,74540,265060,339600,MKT
06079803412110000,2021,112736,278564,391300,MKT
06079803412110000,2020,74540,275660,350200,MKT
06079803412110000,2019,74540,275660,350200,MKT
06079803412130000,2021,112736,274864,387600,MKT
06079803412130000,2020,74540,267660,342200,MKT
06079803412130000,2019,74540,267660,342200,MKT
06079803412150000,2021,112736,288464,401200,MKT
06079803412150000,2020,74540,301660,376200,MKT
06079803412150000,2019,74540,301660,376200,MKT
06079803412170000,2021,113244,278356,391600,MKT
06079803412170000,2020,75198,281102,356300,MKT
06079803412170000,2019,75198,281102,356300,MKT
06079803412190000,2021,114858,284042,398900,MKT
06079803412190000,2020,77304,304196,381500,MKT
06079803412190000,2019,77304,304196,381500,MKT
06079803412216500,2021,35528,0,35528,COST
06079803412216500,2020,24619,0,24619,COST
06079803412216500,2019,24619,0,24619,COST
06079803412230000,2021,115875,269225,385100,MKT
06079803412230000,2020,78645,273255,351900,MKT
06079803412230000,2019,78645,273255,351900,MKT
06079803412250000,2021,113718,292782,406500,MKT
06079803412250000,2020,75813,266787,342600,MKT
06079803412250000,2019,75813,266787,342600,MKT
06079803412270000,2021,114082,268518,382600,MKT
06079803412270000,2020,76288,265512,341800,MKT
06079803412270000,2019,76288,265512,341800,MKT
06079803412290000,2021,118919,318081,437000,MKT
06079803412290000,2020,82728,290372,373100,MKT
06079803412290000,2019,82728,290372,373100,MKT
06079803420010000,2021,115591,293809,409400,INCOME
06079803420010000,2020,84350,264250,348600,INCOME
06079803420010000,2019,84350,264250,348600,INCOME
06079803420030000,2021,124177,281923,406100,INCOME
06079803420030000,2020,86441,282059,368500,INCOME
06079803420030000,2019,86441,282059,368500,INCOME
06079803420050000,2021,124102,281998,406100,INCOME
06079803420050000,2020,86339,282161,368500,INCOME
06079803420050000,2019,86339,282161,368500,INCOME
06079803420070000,2021,124102,281998,406100,INCOME
06079803420070000,2020,86339,282161,368500,INCOME
06079803420070000,2019,86339,282161,368500,INCOME
06079803420090000,2021,124080,282020,406100,INCOME
06079803420090000,2020,86310,282190,368500,INCOME
06079803420090000,2019,86310,282190,368500,INCOME
06079803423010000,2021,114129,320171,434300,INCOME
06079803423010000,2020,82280,287820,370100,INCOME
06079803423010000,2019,82280,287820,370100,INCOME
06079803423027000,2021,124535,0,124535,COST
06079803423027000,2020,86929,0,86929,COST
06079803423027000,2019,86929,0,86929,COST
06079803423040000,2021,131511,274589,406100,INCOME
06079803423040000,2020,96686,271814,368500,INCOME
06079803423040000,2019,96686,271814,368500,INCOME
06079803423060000,2021,131511,339989,471500,INCOME
06079803423060000,2020,96686,325614,422300,INCOME
06079803423060000,2019,96686,325614,422300,INCOME
06079803423080000,2021,131511,470689,602200,INCOME
06079803423080000,2020,96686,325614,422300,INCOME
06079803423080000,2019,96686,325614,422300,INCOME
06079803430016500,2021,118996,0,118996,COST
06079803430016500,2020,214311,0,214311,COST
06079803430016500,2019,214311,0,214311,COST
06079803431017000,2021,143538,0,143538,COST
06079803431017000,2020,98238,0,98238,COST
06079803431017000,2019,98238,0,98238,COST
06079803431037000,2021,143900,0,143900,COST
06079803431037000,2020,98722,0,98722,COST
06079803431037000,2019,98722,0,98722,COST
06079803431050000,2021,143911,392889,536800,INCOME
06079803431050000,2020,98736,407964,506700,INCOME
06079803431050000,2019,98736,407964,506700,INCOME
06079803431070000,2021,143922,392878,536800,INCOME
06079803431070000,2020,98751,407949,506700,INCOME
06079803431070000,2019,98751,407949,506700,INCOME
06079803431097000,2021,149096,0,149096,COST
06079803431097000,2020,105799,0,105799,COST
06079803431097000,2019,105799,0,105799,COST
06079803431117000,2021,149116,0,149116,COST
06079803431117000,2020,105827,0,105827,COST
06079803431117000,2019,105827,0,105827,COST
06079803431137000,2021,143969,0,143969,COST
06079803431137000,2020,98815,0,98815,COST
06079803431137000,2019,98815,0,98815,COST
06079803431157000,2021,149805,0,149805,COST
06079803431157000,2020,106784,0,106784,COST
06079803431157000,2019,106784,0,106784,COST
06079803432010000,2021,138467,249033,387500,MKT
06079803432010000,2020,91578,237922,329500,MKT
06079803432010000,2019,91578,237922,329500,MKT
06079803432030000,2021,135356,240444,375800,MKT
06079803432030000,2020,87605,234495,322100,MKT
06079803432030000,2019,87605,234495,322100,MKT
06079803432050000,2021,135365,228235,363600,MKT
06079803432050000,2020,87616,241684,329300,MKT
06079803432050000,2019,87616,241684,329300,MKT
06079803432070000,2021,135373,221727,357100,MKT
06079803432070000,2020,87627,233673,321300,MKT
06079803432070000,2019,87627,233673,321300,MKT
06079803432090000,2021,141439,267761,409200,MKT
06079803432090000,2020,95454,262046,357500,MKT
06079803432090000,2019,95454,262046,357500,MKT
06079803432110000,2021,141455,252545,394000,MKT
06079803432110000,2020,95474,226026,321500,MKT
06079803432110000,2019,95474,226026,321500,MKT
06079803432130000,2021,135408,288392,423800,MKT
06079803432130000,2020,87671,300129,387800,MKT
06079803432130000,2019,87671,300129,387800,MKT
06079803432150000,2021,135417,0,135417,COST
06079803432150000,2020,87682,0,87682,COST
06079803432150000,2019,87682,0,87682,COST
06079803432170000,2021,135430,294570,430000,MKT
06079803432170000,2020,87698,311402,399100,MKT
06079803432170000,2019,87698,311402,399100,MKT
06079803432190000,2021,138492,359008,497500,MKT
06079803432190000,2020,91610,338490,430100,MKT
06079803432190000,2019,91610,338490,430100,MKT
06079803433010000,2021,129370,283630,413000,MKT
06079803433010000,2020,80203,280397,360600,MKT
06079803433010000,2019,80203,280397,360600,MKT
06079803433030000,2021,120147,260353,380500,MKT
06079803433030000,2020,69421,251179,320600,MKT
06079803433030000,2019,69421,251179,320600,MKT
06079803433050000,2021,119886,257114,377000,MKT
06079803433050000,2020,69127,283173,352300,MKT
06079803433050000,2019,69127,283173,352300,MKT
06079803433070000,2021,118443,258157,376600,MKT
06079803433070000,2020,67512,267888,335400,MKT
06079803433070000,2019,67512,267888,335400,MKT
06079803433090000,2021,131865,251335,383200,MKT
06079803433090000,2020,83249,231551,314800,MKT
06079803433090000,2019,83249,231551,314800,MKT
06079803433110000,2021,130163,256837,387000,MKT
06079803433110000,2020,81165,244835,326000,MKT
06079803433110000,2019,81165,244835,326000,MKT
06079803433130000,2021,118443,237657,356100,MKT
06079803433130000,2020,67512,252088,319600,MKT
06079803433130000,2019,67512,270588,338100,MKT
06079803433150000,2021,118443,263557,382000,MKT
06079803433150000,2020,67512,254988,322500,MKT
06079803433150000,2019,67512,254988,322500,MKT
06079803433170000,2021,118443,271057,389500,MKT
06079803433170000,2020,67512,258588,326100,MKT
06079803433170000,2019,67512,257088,324600,MKT
06079803433190000,2021,130076,240024,370100,MKT
06079803433190000,2020,81059,238741,319800,MKT
06079803433190000,2019,81059,238741,319800,MKT
06079803434010000,2021,138126,440374,578500,MKT
06079803434010000,2020,91139,369861,461000,MKT
06079803434010000,2019,91139,369861,461000,MKT
06079803434030000,2021,131499,234601,366100,MKT
06079803434030000,2020,82798,233902,316700,MKT
06079803434030000,2019,82798,233902,316700,MKT
06079803434050000,2021,131508,237992,369500,MKT
06079803434050000,2020,82810,235590,318400,MKT
06079803434050000,2019,82810,235590,318400,MKT
06079803434070000,2021,131513,302587,434100,MKT
06079803434070000,2020,82815,298285,381100,MKT
06079803434070000,2019,82815,298285,381100,MKT
06079803434090000,2021,131522,262378,393900,MKT
06079803434090000,2020,82827,249073,331900,MKT
06079803434090000,2019,82827,249073,331900,MKT
06079803434110000,2021,131532,330368,461900,MKT
06079803434110000,2020,82839,322061,404900,MKT
06079803434110000,2019,82839,321861,404700,MKT
06079803434130000,2021,131537,239063,370600,MKT
06079803434130000,2020,82844,232556,315400,MKT
06079803434130000,2019,82844,232556,315400,MKT
06079803434150000,2021,131546,304854,436400,MKT
06079803434150000,2020,82856,315944,398800,MKT
06079803434150000,2019,82856,315944,398800,MKT
06079803434170000,2021,131555,251345,382900,MKT
06079803434170000,2020,82868,238132,321000,MKT
06079803434170000,2019,82868,238132,321000,MKT
06079803434190000,2021,131560,221140,352700,MKT
06079803434190000,2020,82873,238027,320900,MKT
06079803434190000,2019,82873,238027,320900,MKT
06079803434210000,2021,138106,274294,412400,MKT
06079803434210000,2020,91112,298688,389800,MKT
06079803434210000,2019,91112,298688,389800,MKT
06079803434235001,2021,121129,253071,374200,MKT
06079803434235001,2020,70533,273567,344100,MKT
06079803434235001,2019,70533,273567,344100,MKT
06079803434255002,2021,109432,248268,357700,MKT
06079803434255002,2020,57850,269550,327400,MKT
06079803434255002,2019,57850,269550,327400,MKT
06079803434275001,2021,109432,259068,368500,MKT
06079803434275001,2020,57850,274050,331900,MKT
06079803434275001,2019,57850,274050,331900,MKT
06079803434295002,2021,109439,251161,360600,MKT
06079803434295002,2020,57858,252742,310600,MKT
06079803434295002,2019,57858,252742,310600,MKT
06079803434315001,2021,109439,237761,347200,MKT
06079803434315001,2020,57858,259842,317700,MKT
06079803434315001,2019,57858,259842,317700,MKT
06079803434335002,2021,115817,237783,353600,MKT
06079803434335002,2020,76366,263834,340200,MKT
06079803434335002,2019,76366,263834,340200,MKT
06079803435010000,2021,108794,0,108794,COST
06079803435010000,2020,67589,0,67589,COST
06079803435010000,2019,67589,0,67589,COST
06079803435030000,2021,94701,0,94701,COST
06079803435030000,2020,51556,0,51556,COST
06079803435030000,2019,51556,0,51556,COST
06079803435050000,2021,100300,0,100300,COST
06079803435050000,2020,57672,0,57672,COST
06079803435050000,2019,57672,0,57672,COST
06079803435075001,2021,96836,218764,315600,MKT
06079803435075001,2020,53848,232752,286600,MKT
06079803435075001,2019,53848,232752,286600,MKT
06079803435095002,2021,96836,218764,315600,MKT
06079803435095002,2020,53848,232752,286600,MKT
06079803435095002,2019,53848,232752,286600,MKT
06079803435115001,2021,96836,218764,315600,MKT
06079803435115001,2020,53848,232752,286600,MKT
06079803435115001,2019,53848,232752,286600,MKT
06079803435135002,2021,96844,218756,315600,MKT
06079803435135002,2020,53857,232743,286600,MKT
06079803435135002,2019,53857,232743,286600,MKT
06079803435155001,2021,96844,250956,347800,MKT
06079803435155001,2020,53857,266143,320000,MKT
06079803435155001,2019,53857,266143,320000,MKT
06079803435175002,2021,96844,250956,347800,MKT
06079803435175002,2020,53857,266143,320000,MKT
06079803435175002,2019,53857,266143,320000,MKT
06079803435195001,2021,96844,222256,319100,MKT
06079803435195001,2020,53857,257543,311400,MKT
06079803435195001,2019,53857,257543,311400,MKT
06079803435215002,2021,96844,202056,298900,MKT
06079803435215002,2020,53857,234243,288100,OVR
06079803435215002,2019,53857,234243,288100,MKT
06079803435235003,2021,96852,233848,330700,MKT
06079803435235003,2020,53865,261835,315700,MKT
06079803435235003,2019,53865,261835,315700,MKT
06079803435255001,2021,96852,247148,344000,MKT
06079803435255001,2020,53865,267035,320900,MKT
06079803435255001,2019,53865,267035,320900,MKT
06079803435275002,2021,96852,234448,331300,MKT
06079803435275002,2020,53865,251535,305400,MKT
06079803435275002,2019,53865,241035,294900,MKT
06079803435295001,2021,96852,232748,329600,MKT
06079803435295001,2020,53865,249735,303600,MKT
06079803435295001,2019,53865,249735,303600,MKT
06079803435315002,2021,96852,241048,337900,MKT
06079803435315002,2020,53865,253835,307700,MKT
06079803435315002,2019,53865,253835,307700,MKT
06079803435335001,2021,96860,232740,329600,MKT
06079803435335001,2020,53874,249826,303700,MKT
06079803435335001,2019,53874,249826,303700,MKT
06079803435355002,2021,110134,240766,350900,MKT
06079803435355002,2020,69223,249277,318500,MKT
06079803435355002,2019,69223,249277,318500,MKT
06079803436010000,2021,133744,284656,418400,MKT
06079803436010000,2020,85579,277721,363300,MKT
06079803436010000,2019,85579,277721,363300,MKT
06079803436030000,2021,127327,428173,555500,MKT
06079803436030000,2020,77748,352852,430600,MKT
06079803436030000,2019,77748,352852,430600,MKT
06079803436050000,2021,127327,272373,399700,MKT
06079803436050000,2020,77748,263652,341400,MKT
06079803436050000,2019,77748,263652,341400,MKT
06079803436070000,2021,127327,333873,461200,MKT
06079803436070000,2020,77748,333952,411700,MKT
06079803436070000,2019,77748,333952,411700,MKT
06079803436090000,2021,127327,275773,403100,MKT
06079803436090000,2020,77748,273052,350800,MKT
06079803436090000,2019,77748,273052,350800,MKT
06079803436110000,2021,118443,250057,368500,MKT
06079803436110000,2020,67512,252588,320100,MKT
06079803436110000,2019,67512,252588,320100,MKT
06079803436130000,2021,118443,255457,373900,MKT
06079803436130000,2020,67512,257488,325000,MKT
06079803436130000,2019,67512,257488,325000,MKT
06079803436150000,2021,127327,249973,377300,MKT
06079803436150000,2020,77748,228852,306600,MKT
06079803436150000,2019,77748,228852,306600,MKT
06079803436170000,2021,132650,306450,439100,MKT
06079803436170000,2020,84219,349381,433600,MKT
06079803436170000,2019,84219,349381,433600,MKT
06079803436190000,2021,133495,329505,463000,MKT
06079803436190000,2020,85270,325730,411000,MKT
06079803436190000,2019,85270,325730,411000,MKT
06079803436210000,2021,127327,284073,411400,MKT
06079803436210000,2020,77748,272252,350000,MKT
06079803436210000,2019,77748,272252,350000,MKT
06079803436230000,2021,118443,256657,375100,MKT
06079803436230000,2020,67512,251188,318700,MKT
06079803436230000,2019,67512,251188,318700,MKT
06079803436250000,2021,118443,273857,392300,MKT
06079803436250000,2020,67512,261988,329500,MKT
06079803436250000,2019,67512,261088,328600,MKT
06079803436270000,2021,127327,263573,390900,MKT
06079803436270000,2020,77748,251652,329400,MKT
06079803436270000,2019,77748,251652,329400,MKT
06079803436290000,2021,127327,293373,420700,MKT
06079803436290000,2020,77748,290052,367800,MKT
06079803436290000,2019,77748,290052,367800,MKT
06079803436310000,2021,127327,403773,531100,MKT
06079803436310000,2020,77748,342152,419900,MKT
06079803436310000,2019,77748,342152,419900,MKT
06079803436330000,2021,127327,277373,404700,MKT
06079803436330000,2020,77748,276152,353900,MKT
06079803436330000,2019,77748,276152,353900,MKT
06079803436350000,2021,132738,303562,436300,MKT
06079803436350000,2020,84328,298572,382900,MKT
06079803436350000,2019,84328,298572,382900,MKT
06079803437010000,2021,135872,370128,506000,MKT
06079803437010000,2020,88258,351142,439400,MKT
06079803437010000,2019,88258,351142,439400,MKT
06079803437030000,2021,128899,314401,443300,MKT
06079803437030000,2020,79633,309467,389100,MKT
06079803437030000,2019,79633,309467,389100,MKT
06079803437050000,2021,128899,340901,469800,MKT
06079803437050000,2020,79633,336767,416400,MKT
06079803437050000,2019,79633,336767,416400,MKT
06079803437070000,2021,128899,334401,463300,MKT
06079803437070000,2020,79633,320067,399700,MKT
06079803437070000,2019,79633,320067,399700,MKT
06079803437090000,2021,128899,293301,422200,MKT
06079803437090000,2020,79633,286367,366000,MKT
06079803437090000,2019,79633,286367,366000,MKT
06079803437110000,2021,128899,346201,475100,MKT
06079803437110000,2020,79633,334967,414600,MKT
06079803437110000,2019,79633,334967,414600,MKT
06079803437130000,2021,128899,427001,555900,MKT
06079803437130000,2020,79633,361867,441500,MKT
06079803437130000,2019,79633,361867,441500,MKT
06079803437150000,2021,128899,318001,446900,MKT
06079803437150000,2020,79633,304067,383700,MKT
06079803437150000,2019,79633,304067,383700,MKT
06079803437170000,2021,134610,289090,423700,MKT
06079803437170000,2020,86664,281836,368500,MKT
06079803437170000,2019,86664,281836,368500,MKT
06079803437190000,2021,135599,354601,490200,MKT
06079803437190000,2020,87913,348487,436400,MKT
06079803437190000,2019,87913,348487,436400,MKT
06079803437210000,2021,128899,0,128899,COST
06079803437210000,2020,79633,0,79633,COST
06079803437210000,2019,79633,0,79633,COST
06079803437230000,2021,128899,323601,452500,MKT
06079803437230000,2020,79633,339067,418700,MKT
06079803437230000,2019,79633,339067,418700,MKT
06079803437250000,2021,128899,241601,370500,MKT
06079803437250000,2020,79633,244267,323900,MKT
06079803437250000,2019,79633,244267,323900,MKT
06079803437270000,2021,128899,247501,376400,MKT
06079803437270000,2020,79633,245167,324800,MKT
06079803437270000,2019,79633,245167,324800,MKT
06079803437290000,2021,128899,323101,452000,MKT
06079803437290000,2020,79633,329767,409400,MKT
06079803437290000,2019,79633,305867,385500,MKT
06079803437310000,2021,128899,268201,397100,MKT
06079803437310000,2020,79633,258467,338100,MKT
06079803437310000,2019,79633,258467,338100,MKT
06079803437330000,2021,128899,319201,448100,MKT
06079803437330000,2020,79633,328567,408200,MKT
06079803437330000,2019,79633,328567,408200,MKT
06079803437350000,2021,134698,302302,437000,MKT
06079803437350000,2020,86775,310525,397300,MKT
06079803437350000,2019,86775,310525,397300,MKT
06079803438010000,2021,130125,272375,402500,MKT
06079803438010000,2020,81118,251382,332500,MKT
06079803438010000,2019,81118,251382,332500,MKT
06079803438030000,2021,124994,269406,394400,MKT
06079803438030000,2020,74992,253308,328300,MKT
06079803438030000,2019,74992,253308,328300,MKT
06079803438050000,2021,128939,258961,387900,MKT
06079803438050000,2020,79681,245719,325400,MKT
06079803438050000,2019,79681,245719,325400,MKT
06079803438070000,2021,124972,299028,424000,MKT
06079803438070000,2020,74966,280734,355700,MKT
06079803438070000,2019,74966,280734,355700,MKT
06079803438090000,2021,122596,274104,396700,MKT
06079803438090000,2020,72210,275490,347700,MKT
06079803438090000,2019,72210,275490,347700,MKT
06079803438110000,2021,130401,347299,477700,MKT
06079803438110000,2020,81454,329646,411100,MKT
06079803438110000,2019,81454,329646,411100,MKT
06079803438130000,2021,138435,330065,468500,MKT
06079803438130000,2020,91536,321364,412900,OVR
06079803438130000,2019,91536,321364,412900,MKT
06079803438150000,2021,118443,261057,379500,MKT
06079803438150000,2020,67512,255088,322600,MKT
06079803438150000,2019,67512,255088,322600,MKT
06079803438170000,2021,118443,259657,378100,MKT
06079803438170000,2020,67512,255488,323000,MKT
06079803438170000,2019,67512,255488,323000,MKT
06079803439015001,2021,105938,262362,368300,MKT
06079803439015001,2020,64170,319530,383700,MKT
06079803439015001,2019,64170,319530,383700,MKT
06079803439035002,2021,96875,247725,344600,MKT
06079803439035002,2020,53891,268109,322000,MKT
06079803439035002,2019,53891,265809,319700,MKT
06079803439036500,2021,78071,0,78071,COST
06079803439036500,2020,94141,0,94141,COST
06079803439036500,2019,94141,0,94141,COST
06079803439055001,2021,96883,245817,342700,MKT
06079803439055001,2020,53900,278300,332200,MKT
06079803439055001,2019,53900,275900,329800,MKT
06079803439075002,2021,96883,260917,357800,MKT
06079803439075002,2020,53900,276900,330800,MKT
06079803439075002,2019,53900,275900,329800,MKT
06079803439095001,2021,96883,251417,348300,MKT
06079803439095001,2020,53900,272000,325900,MKT
06079803439095001,2019,53900,272000,325900,MKT
06079803439115002,2021,96883,247117,344000,MKT
06079803439115002,2020,53900,275900,329800,MKT
06079803439115002,2019,53900,275900,329800,MKT
06079803439135003,2021,96891,251409,348300,MKT
06079803439135003,2020,53909,271991,325900,MKT
06079803439135003,2019,53909,271991,325900,MKT
06079803439155001,2021,96891,238609,335500,MKT
06079803439155001,2020,53909,268191,322100,MKT
06079803439155001,2019,53909,268191,322100,MKT
06079803439175002,2021,96306,238594,334900,MKT
06079803439175002,2020,53275,268225,321500,MKT
06079803439175002,2019,53275,268225,321500,MKT
06079803439190000,2021,129098,387602,516700,MKT
06079803439190000,2020,94391,350009,444400,MKT
06079803439190000,2019,94391,350009,444400,MKT
06079803439210000,2021,148210,0,148210,COST
06079803439210000,2020,122216,0,122216,COST
06079803439210000,2019,122216,0,122216,COST
06079803439230000,2021,134694,270806,405500,MKT
06079803439230000,2020,101407,268793,370200,MKT
06079803439230000,2019,101407,268793,370200,MKT
06079803439250000,2021,146148,254352,400500,MKT
06079803439250000,2020,105602,232898,338500,MKT
06079803439250000,2019,105602,232898,338500,MKT
06079803439270000,2021,142367,268233,410600,MKT
06079803439270000,2020,100335,255965,356300,MKT
06079803439270000,2019,100335,255965,356300,MKT
06079803439290000,2021,137475,289425,426900,MKT
06079803439290000,2020,93716,309884,403600,MKT
06079803439290000,2019,93716,309884,403600,MKT
06079803439310000,2021,136953,375047,512000,MKT
06079803439310000,2020,93022,342978,436000,MKT
06079803439310000,2019,93022,342978,436000,MKT
06079803439330000,2021,138410,377890,516300,MKT
06079803439330000,2020,94964,389636,484600,OVR
06079803439330000,2019,94964,389636,484600,MKT
06079803439350000,2021,137630,340070,477700,MKT
06079803439350000,2020,93922,317478,411400,MKT
06079803439350000,2019,93922,317478,411400,MKT
06079803439370000,2021,149771,282729,432500,MKT
06079803439370000,2020,110772,315128,425900,MKT
06079803439370000,2019,110772,315128,425900,MKT
06079803439390000,2021,135247,279053,414300,MKT
06079803439390000,2020,87467,298333,385800,MKT
06079803439390000,2019,87467,298333,385800,MKT
06079803439410000,2021,118987,261613,380600,MKT
06079803439410000,2020,68119,255381,323500,MKT
06079803439410000,2019,68119,255381,323500,MKT
06079803439430000,2021,118950,261650,380600,MKT
06079803439430000,2020,68077,255423,323500,MKT
06079803439430000,2019,68077,255423,323500,MKT
06079803439450000,2021,125726,274174,399900,MKT
06079803439450000,2020,75852,258248,334100,MKT
06079803439450000,2019,75852,258248,334100,MKT
06079803439470000,2021,135034,220666,355700,MKT
06079803439470000,2020,75036,234064,309100,MKT
06079803439470000,2019,75036,234064,309100,MKT
06079803439490000,2021,128210,279490,407700,MKT
06079803439490000,2020,67813,270487,338300,MKT
06079803439490000,2019,67813,270487,338300,MKT
06079803439510000,2021,128108,307792,435900,MKT
06079803439510000,2020,67708,314792,382500,MKT
06079803439510000,2019,67708,314792,382500,MKT
06079803439530000,2021,128000,300000,428000,MKT
06079803439530000,2020,67596,315604,383200,MKT
06079803439530000,2019,67596,315604,383200,MKT
06079803439550000,2021,147523,462477,610000,MKT
06079803439550000,2020,92548,412252,504800,MKT
06079803439550000,2019,92548,412252,504800,MKT
06079803440010000,2021,125801,241999,367800,MKT
06079803440010000,2020,75940,239060,315000,MKT
06079803440010000,2019,75940,239060,315000,MKT
06079803440030000,2021,118443,250457,368900,MKT
06079803440030000,2020,67512,261588,329100,MKT
06079803440030000,2019,67512,261588,329100,MKT
06079803440050000,2021,118443,225757,344200,MKT
06079803440050000,2020,67512,245188,312700,MKT
06079803440050000,2019,67512,245188,312700,MKT
06079803440070000,2021,118443,252257,370700,MKT
06079803440070000,2020,67512,258788,326300,MKT
06079803440070000,2019,67512,258788,326300,MKT
06079803440090000,2021,128934,251166,380100,MKT
06079803440090000,2020,79675,243725,323400,MKT
06079803440090000,2019,79675,243725,323400,MKT
06079803440110000,2021,141835,277465,419300,MKT
06079803440110000,2020,82589,277011,359600,MKT
06079803440110000,2019,82589,277011,359600,MKT
06079803440130000,2021,128594,0,128594,COST
06079803440130000,2020,68209,0,68209,COST
06079803440130000,2019,68209,0,68209,COST
06079803440150000,2021,131202,274498,405700,MKT
06079803440150000,2020,70935,320065,391000,OVR
06079803440150000,2019,70935,320065,391000,MKT
06079803440170000,2021,133553,304847,438400,MKT
06079803440170000,2020,73438,303862,377300,MKT
06079803440170000,2019,73438,303862,377300,MKT
06079803440190000,2021,140382,252418,392800,MKT
06079803440190000,2020,80946,248354,329300,MKT
06079803440190000,2019,80946,248354,329300,MKT
06079803441015001,2021,121927,206573,328500,MKT
06079803441015001,2020,71442,212158,283600,MKT
06079803441015001,2019,71442,212158,283600,MKT
06079803441035002,2021,104528,224572,329100,MKT
06079803441035002,2020,52898,228902,281800,MKT
06079803441035002,2019,52898,228902,281800,MKT
06079803441055003,2021,104528,207172,311700,MKT
06079803441055003,2020,52898,211902,264800,MKT
06079803441055003,2019,52898,211902,264800,MKT
06079803441075001,2021,104537,194663,299200,MKT
06079803441075001,2020,52907,205193,258100,MKT
06079803441075001,2019,52907,205193,258100,MKT
06079803441095002,2021,104528,194672,299200,MKT
06079803441095002,2020,52898,205202,258100,MKT
06079803441095002,2019,52898,205202,258100,MKT
06079803441115001,2021,104528,227272,331800,MKT
06079803441115001,2020,52898,235802,288700,MKT
06079803441115001,2019,52898,235802,288700,MKT
06079803441135002,2021,104528,226872,331400,MKT
06079803441135002,2020,52898,244602,297500,MKT
06079803441135002,2019,52898,244602,297500,MKT
06079803441155001,2021,104528,222872,327400,MKT
06079803441155001,2020,52898,232902,285800,MKT
06079803441155001,2019,52898,232902,285800,MKT
06079803441175002,2021,104528,224372,328900,MKT
06079803441175002,2020,52898,236102,289000,MKT
06079803441175002,2019,52898,236102,289000,MKT
06079803441195001,2021,104528,261172,365700,MKT
06079803441195001,2020,52898,283802,336700,MKT
06079803441195001,2019,52898,283802,336700,MKT
06079803441215002,2021,104528,261172,365700,MKT
06079803441215002,2020,52898,283802,336700,MKT
06079803441215002,2019,52898,283802,336700,MKT
06079803441235001,2021,104395,214305,318700,MKT
06079803441235001,2020,52766,228134,280900,MKT
06079803441235001,2019,52766,228134,280900,MKT
06079803441255002,2021,103810,214290,318100,MKT
06079803441255002,2020,52191,228109,280300,MKT
06079803441255002,2019,52191,228109,280300,MKT
06079803441275001,2021,102985,253415,356400,MKT
06079803441275001,2020,51385,272015,323400,MKT
06079803441275001,2019,51385,272015,323400,MKT
06079803441295002,2021,123177,289823,413000,MKT
06079803441295002,2020,72879,326321,399200,MKT
06079803441295002,2019,72879,326321,399200,MKT
06079803450015001,2021,120509,192691,313200,MKT
06079803450015001,2020,69830,201470,271300,MKT
06079803450015001,2019,69830,201470,271300,MKT
06079803450026500,2021,65787,0,65787,COST
06079803450026500,2020,67400,0,67400,COST
06079803450026500,2019,67400,0,67400,COST
06079803450035002,2021,104528,160372,264900,MKT
06079803450035002,2020,52898,176702,229600,MKT
06079803450035002,2019,52898,176702,229600,MKT
06079803450055001,2021,104528,160372,264900,MKT
06079803450055001,2020,52898,176702,229600,MKT
06079803450055001,2019,52898,176702,229600,MKT
06079803450075002,2021,104528,160372,264900,MKT
06079803450075002,2020,52898,176702,229600,MKT
06079803450075002,2019,52898,176702,229600,MKT
06079803450085001,2021,104528,160172,264700,MKT
06079803450085001,2020,52898,176402,229300,MKT
06079803450085001,2019,52898,176402,229300,MKT
06079803450095002,2021,104528,160172,264700,MKT
06079803450095002,2020,52898,176402,229300,MKT
06079803450095002,2019,52898,176402,229300,MKT
06079803450115001,2021,104528,189172,293700,MKT
06079803450115001,2020,52898,195402,248300,MKT
06079803450115001,2019,52898,195402,248300,MKT
06079803450135002,2021,104528,227972,332500,MKT
06079803450135002,2020,52898,246702,299600,MKT
06079803450135002,2019,52898,246702,299600,MKT
06079803450155003,2021,104528,191872,296400,MKT
06079803450155003,2020,52898,198002,250900,MKT
06079803450155003,2019,52898,198002,250900,MKT
06079803450175001,2021,104528,184972,289500,MKT
06079803450175001,2020,52898,203502,256400,MKT
06079803450175001,2019,52898,203502,256400,MKT
06079803450195002,2021,104528,188472,293000,MKT
06079803450195002,2020,52898,207002,259900,MKT
06079803450195002,2019,52898,207002,259900,MKT
06079803450215001,2021,104528,184972,289500,MKT
06079803450215001,2020,52898,202502,255400,MKT
06079803450215001,2019,52898,202502,255400,MKT
06079803450235002,2021,104528,184972,289500,MKT
06079803450235002,2020,52898,202402,255300,MKT
06079803450235002,2019,52898,202402,255300,MKT
06079803450255001,2021,104528,216372,320900,MKT
06079803450255001,2020,52898,231302,284200,MKT
06079803450255001,2019,52898,231302,284200,MKT
06079803450275002,2021,119180,214820,334000,MKT
06079803450275002,2020,68334,231366,299700,MKT
06079803450275002,2019,68334,231366,299700,MKT
06079803450290000,2021,131082,279918,411000,MKT
06079803450290000,2020,82286,258714,341000,MKT
06079803450290000,2019,82286,258714,341000,MKT
06079803450310000,2021,124819,271281,396100,MKT
06079803450310000,2020,74788,266912,341700,MKT
06079803450310000,2019,74788,266912,341700,MKT
06079803450330000,2021,124721,274079,398800,MKT
06079803450330000,2020,74673,266827,341500,MKT
06079803450330000,2019,74673,266827,341500,MKT
06079803450350000,2021,123571,376329,499900,MKT
06079803450350000,2020,73334,372466,445800,MKT
06079803450350000,2019,73334,372466,445800,MKT
06079803450370000,2021,121295,262405,383700,MKT
06079803450370000,2020,70721,250379,321100,MKT
06079803450370000,2019,70721,250379,321100,MKT
06079803450390000,2021,133128,271472,404600,MKT
06079803450390000,2020,72983,257817,330800,MKT
06079803450390000,2019,72983,257817,330800,MKT
06079803450410000,2021,139297,270603,409900,MKT
06079803450410000,2020,79729,259871,339600,MKT
06079803450410000,2019,79729,259871,339600,MKT
06079803450420000,2021,136936,278664,415600,MKT
06079803450420000,2020,77113,265887,343000,MKT
06079803450420000,2019,77113,265887,343000,MKT
06079803450430000,2021,135169,299131,434300,MKT
06079803450430000,2020,75182,322918,398100,MKT
06079803450430000,2019,75182,322918,398100,MKT
06079803450450000,2021,136460,286140,422600,MKT
06079803450450000,2020,76591,282109,358700,MKT
06079803450450000,2019,76591,282109,358700,MKT
06079803450470000,2021,144807,269493,414300,MKT
06079803450470000,2020,86000,251700,337700,MKT
06079803450470000,2019,86000,251700,337700,MKT
06079803453010000,2021,136278,263522,399800,MKT
06079803453010000,2020,76391,259409,335800,MKT
06079803453010000,2019,76391,259409,335800,MKT
06079803453030000,2021,123357,244143,367500,MKT
06079803453030000,2020,73087,244713,317800,MKT
06079803453030000,2019,73087,244713,317800,MKT
06079803453050000,2021,123526,249074,372600,MKT
06079803453050000,2020,73282,252618,325900,MKT
06079803453050000,2019,73282,252618,325900,MKT
06079803453070000,2021,118443,228557,347000,MKT
06079803453070000,2020,67512,231188,298700,MKT
06079803453070000,2019,67512,231188,298700,MKT
06079803453090000,2021,118443,220757,339200,MKT
06079803453090000,2020,67512,221788,289300,MKT
06079803453090000,2019,67512,221788,289300,MKT
06079803453110000,2021,133486,309814,443300,MKT
06079803453110000,2020,85258,311642,396900,MKT
06079803453110000,2019,85258,311642,396900,MKT
06079803453130000,2021,128829,236771,365600,MKT
06079803453130000,2020,79549,243151,322700,MKT
06079803453130000,2019,79549,243151,322700,MKT
06079803453150000,2021,124056,241044,365100,MKT
06079803453150000,2020,73897,243703,317600,MKT
06079803453150000,2019,73897,243703,317600,MKT
06079803453170000,2021,118443,239857,358300,MKT
06079803453170000,2020,67512,249288,316800,MKT
06079803453170000,2019,67512,249288,316800,MKT
06079803453190000,2021,118443,217157,335600,MKT
06079803453190000,2020,67512,222488,290000,MKT
06079803453190000,2019,67512,222488,290000,MKT
06079803453210000,2021,118443,243057,361500,MKT
06079803453210000,2020,67512,257288,324800,MKT
06079803453210000,2019,67512,257288,324800,MKT
06079803453230000,2021,124056,231344,355400,MKT
06079803453230000,2020,73897,239703,313600,MKT
06079803453230000,2019,73897,239703,313600,MKT
06079803453240000,2021,129749,281251,411000,MKT
06079803453240000,2020,80661,261739,342400,MKT
06079803453240000,2019,80661,261739,342400,MKT
06079803453260000,2021,129749,257551,387300,MKT
06079803453260000,2020,80661,236039,316700,MKT
06079803453260000,2019,80661,236039,316700,MKT
06079803453280000,2021,124056,237744,361800,MKT
06079803453280000,2020,73897,240803,314700,MKT
06079803453280000,2019,73897,240803,314700,MKT
06079803453300000,2021,118443,238457,356900,MKT
06079803453300000,2020,67512,255088,322600,MKT
06079803453300000,2019,67512,255088,322600,MKT
06079803453320000,2021,118443,248857,367300,MKT
06079803453320000,2020,67512,247588,315100,MKT
06079803453320000,2019,67512,247588,315100,MKT
06079803453340000,2021,118443,224257,342700,MKT
06079803453340000,2020,67512,219188,286700,MKT
06079803453340000,2019,67512,219188,286700,MKT
06079803453360000,2021,124056,248744,372800,MKT
06079803453360000,2020,73897,253803,327700,MKT
06079803453360000,2019,73897,253803,327700,MKT
06079803453380000,2021,128829,259771,388600,MKT
06079803453380000,2020,79549,256551,336100,MKT
06079803453380000,2019,79549,256551,336100,MKT
06079803453400000,2021,124326,256674,381000,MKT
06079803453400000,2020,74212,241788,316000,MKT
06079803453400000,2019,74212,241788,316000,MKT
06079803453420000,2021,118443,225857,344300,MKT
06079803453420000,2020,67512,221088,288600,MKT
06079803453420000,2019,67512,218488,286000,MKT
06079803453440000,2021,118443,218657,337100,MKT
06079803453440000,2020,67512,209488,277000,MKT
06079803453440000,2019,67512,209488,277000,MKT
06079803453460000,2021,118443,220657,339100,MKT
06079803453460000,2020,67512,216888,284400,MKT
06079803453460000,2019,67512,216888,284400,MKT
06079803453480000,2021,120147,266753,386900,MKT
06079803453480000,2020,69421,254979,324400,MKT
06079803453480000,2019,69421,254979,324400,MKT
06079803453500000,2021,119340,239660,359000,MKT
06079803453500000,2020,68514,246986,315500,MKT
06079803453500000,2019,68514,246986,315500,MKT
06079803453520000,2021,135034,244866,379900,MKT
06079803453520000,2020,75036,244564,319600,MKT
06079803453520000,2019,75036,244564,319600,MKT
06079803454010000,2021,139328,297872,437200,MKT
06079803454010000,2020,96197,320903,417100,MKT
06079803454010000,2019,96197,320903,417100,MKT
06079803454030000,2021,130287,273913,404200,MKT
06079803454030000,2020,84390,257610,342000,MKT
06079803454030000,2019,84390,257610,342000,MKT
06079803454050000,2021,131545,297355,428900,MKT
06079803454050000,2020,85988,300812,386800,MKT
06079803454050000,2019,85988,300812,386800,MKT
06079803454070000,2021,121135,351465,472600,MKT
06079803454070000,2020,70539,314261,384800,MKT
06079803454070000,2019,70539,308661,379200,MKT
06079803454110000,2021,120407,345893,466300,MKT
06079803454110000,2020,69714,308586,378300,MKT
06079803454110000,2019,69714,308586,378300,MKT
06079803454135001,2021,104953,232347,337300,MKT
06079803454135001,2020,53319,249181,302500,MKT
06079803454135001,2019,53319,249181,302500,MKT
06079803454155002,2021,104723,232177,336900,MKT
06079803454155002,2020,53091,249009,302100,MKT
06079803454155002,2019,53091,249009,302100,MKT
06079803454175001,2021,104581,232319,336900,MKT
06079803454175001,2020,52951,249249,302200,MKT
06079803454175001,2019,52951,249249,302200,MKT
06079803454195002,2021,104528,232372,336900,MKT
06079803454195002,2020,52898,249202,302100,MKT
06079803454195002,2019,52898,249202,302100,MKT
06079803454215001,2021,104528,225272,329800,MKT
06079803454215001,2020,52898,230702,283600,MKT
06079803454215001,2019,52898,230702,283600,MKT
06079803454235002,2021,104528,232272,336800,MKT
06079803454235002,2020,52898,249102,302000,MKT
06079803454235002,2019,52898,249102,302000,MKT
06079803454255001,2021,104528,232272,336800,MKT
06079803454255001,2020,52898,249102,302000,MKT
06079803454255001,2019,52898,249102,302000,MKT
06079803454275002,2021,115300,232000,347300,MKT
06079803454275002,2020,64059,244541,308600,MKT
06079803454275002,2019,64059,244541,308600,MKT
06079803454295001,2021,119629,174071,293700,MKT
06079803454295001,2020,68838,188662,257500,MKT
06079803454295001,2019,68838,188662,257500,MKT
06079803454315002,2021,104528,213772,318300,MKT
06079803454315002,2020,52898,219802,272700,MKT
06079803454315002,2019,52898,219802,272700,MKT
06079803454335003,2021,104528,213772,318300,MKT
06079803454335003,2020,52898,219802,272700,MKT
06079803454335003,2019,52898,219802,272700,MKT
06079803454355004,2021,104528,189872,294400,MKT
06079803454355004,2020,52898,192302,245200,MKT
06079803454355004,2019,52898,192302,245200,MKT
06079803454375001,2021,104528,217072,321600,MKT
06079803454375001,2020,52898,232702,285600,MKT
06079803454375001,2019,52898,232702,285600,MKT
06079803454395002,2021,104528,217072,321600,MKT
06079803454395002,2020,52898,232702,285600,MKT
06079803454395002,2019,52898,232702,285600,MKT
06079803454415001,2021,104528,217072,321600,MKT
06079803454415001,2020,52898,232702,285600,MKT
06079803454415001,2019,52898,232702,285600,MKT
06079803454435002,2021,104528,217072,321600,MKT
06079803454435002,2020,52898,232702,285600,MKT
06079803454435002,2019,52898,232702,285600,MKT
06079803454455001,2021,104528,217072,321600,MKT
06079803454455001,2020,52898,232702,285600,MKT
06079803454455001,2019,52898,232702,285600,MKT
06079803454475002,2021,104528,217072,321600,MKT
06079803454475002,2020,52898,232702,285600,MKT
06079803454475002,2019,52898,232702,285600,MKT
06079803454495001,2021,104528,211472,316000,MKT
06079803454495001,2020,52898,227102,280000,MKT
06079803454495001,2019,52898,227102,280000,MKT
06079803454515002,2021,104528,211472,316000,MKT
06079803454515002,2020,52898,227102,280000,MKT
06079803454515002,2019,52898,227102,280000,MKT
06079803454535001,2021,104528,231972,336500,MKT
06079803454535001,2020,52898,248802,301700,MKT
06079803454535001,2019,52898,248802,301700,MKT
06079803454555002,2021,104528,231972,336500,MKT
06079803454555002,2020,52898,248802,301700,MKT
06079803454555002,2019,52898,248802,301700,MKT
06079803454575001,2021,119629,239771,359400,MKT
06079803454575001,2020,68838,243062,311900,MKT
06079803454575001,2019,68838,243062,311900,MKT
06079803455015001,2021,119715,231185,350900,MKT
06079803455015001,2020,68935,244165,313100,MKT
06079803455015001,2019,68935,244165,313100,MKT
06079803455035002,2021,104608,231592,336200,MKT
06079803455035002,2020,52977,248923,301900,MKT
06079803455035002,2019,52977,248923,301900,MKT
06079803455055001,2021,104608,231592,336200,MKT
06079803455055001,2020,52977,248923,301900,MKT
06079803455055001,2019,52977,248923,301900,MKT
06079803455075002,2021,104608,231592,336200,MKT
06079803455075002,2020,52977,248923,301900,MKT
06079803455075002,2019,52977,248923,301900,MKT
06079803455095001,2021,104608,231592,336200,MKT
06079803455095001,2020,52977,248923,301900,MKT
06079803455095001,2019,52977,248923,301900,MKT
06079803455115002,2021,104608,231392,336000,MKT
06079803455115002,2020,52977,248723,301700,MKT
06079803455115002,2019,52977,248723,301700,MKT
06079803455135001,2021,104608,231492,336100,MKT
06079803455135001,2020,52977,248723,301700,MKT
06079803455135001,2019,52977,248723,301700,MKT
06079803455155002,2021,104608,231592,336200,MKT
06079803455155002,2020,52977,248923,301900,MKT
06079803455155002,2019,52977,248923,301900,MKT
06079803455175001,2021,104608,231792,336400,MKT
06079803455175001,2020,52977,249123,302100,MKT
06079803455175001,2019,52977,249123,302100,MKT
06079803455195002,2021,104608,231792,336400,MKT
06079803455195002,2020,52977,249123,302100,MKT
06079803455195002,2019,52977,249123,302100,MKT
06079803455215001,2021,104608,231792,336400,MKT
06079803455215001,2020,52977,249123,302100,MKT
06079803455215001,2019,52977,249123,302100,MKT
06079803455235002,2021,104608,231792,336400,MKT
06079803455235002,2020,52977,249123,302100,MKT
06079803455235002,2019,52977,249123,302100,MKT
06079803455255001,2021,104608,232392,337000,MKT
06079803455255001,2020,52977,249323,302300,MKT
06079803455255001,2019,52977,249323,302300,MKT
06079803455275002,2021,104608,232392,337000,MKT
06079803455275002,2020,52977,249323,302300,MKT
06079803455275002,2019,52977,249323,302300,MKT
06079803455290000,2021,119721,279279,399000,MKT
06079803455290000,2020,68941,278359,347300,MKT
06079803455290000,2019,68941,278359,347300,MKT
06079803455315001,2021,115395,231805,347200,MKT
06079803455315001,2020,64162,244338,308500,MKT
06079803455315001,2019,64162,244338,308500,MKT
06079803455335002,2021,104608,232092,336700,MKT
06079803455335002,2020,52977,248923,301900,MKT
06079803455335002,2019,52977,248923,301900,MKT
06079803455355001,2021,104608,242492,347100,MKT
06079803455355001,2020,52977,257223,310200,MKT
06079803455355001,2019,52977,253023,306000,MKT
06079803455375002,2021,104608,232092,336700,MKT
06079803455375002,2020,52977,248923,301900,MKT
06079803455375002,2019,52977,248923,301900,MKT
06079803455395001,2021,104608,232092,336700,MKT
06079803455395001,2020,52977,248923,301900,MKT
06079803455395001,2019,52977,248923,301900,MKT
06079803455415002,2021,104608,232092,336700,MKT
06079803455415002,2020,52977,248923,301900,MKT
06079803455415002,2019,52977,248923,301900,MKT
06079803455435001,2021,104608,232092,336700,MKT
06079803455435001,2020,52977,248923,301900,MKT
06079803455435001,2019,52977,248923,301900,MKT
06079803455455002,2021,104608,232092,336700,MKT
06079803455455002,2020,52977,248923,301900,MKT
06079803455455002,2019,52977,248923,301900,MKT
06079803455470000,2021,121182,340218,461400,MKT
06079803455470000,2020,70593,297307,367900,MKT
06079803455470000,2019,70593,297307,367900,MKT
06079803455510000,2021,122591,273509,396100,MKT
06079803455510000,2020,72203,263997,336200,MKT
06079803455510000,2019,72203,263997,336200,MKT
06079803456010000,2021,137529,268871,406400,MKT
06079803456010000,2020,93787,248013,341800,MKT
06079803456010000,2019,93787,248013,341800,MKT
06079803456030000,2021,140122,286578,426700,MKT
06079803456030000,2020,97270,274530,371800,MKT
06079803456030000,2019,97270,274530,371800,MKT
06079803456056500,2021,31326,0,31326,COST
06079803456056500,2020,15838,0,15838,COST
06079803456056500,2019,15838,0,15838,COST
06079803456070000,2021,147988,281812,429800,MKT
06079803456070000,2020,108212,301888,410100,MKT
06079803456070000,2019,108212,309488,417700,MKT
06079803456090000,2021,141176,273524,414700,MKT
06079803456090000,2020,98704,277196,375900,MKT
06079803456090000,2019,98704,277196,375900,MKT
06079803456110000,2021,140708,285492,426200,MKT
06079803456110000,2020,98066,272234,370300,MKT
06079803456110000,2019,98066,272234,370300,MKT
06079803456130000,2021,137945,281355,419300,MKT
06079803456130000,2020,94342,269858,364200,MKT
06079803456130000,2019,94342,269858,364200,MKT
06079803456150000,2021,141415,287385,428800,MKT
06079803456150000,2020,99029,304771,403800,MKT
06079803456150000,2019,99029,304771,403800,MKT
06079803456170000,2021,138784,275216,414000,MKT
06079803456170000,2020,95465,279235,374700,MKT
06079803456170000,2019,95465,279235,374700,MKT
06079803456190000,2021,149931,274269,424200,MKT
06079803456190000,2020,111003,256497,367500,MKT
06079803456190000,2019,111003,256497,367500,MKT
06079803456210000,2021,113678,263922,377600,MKT
06079803456210000,2020,70171,249029,319200,MKT
06079803456210000,2019,70171,249029,319200,MKT
06079803456230000,2021,100676,297224,397900,MKT
06079803456230000,2020,55360,276840,332200,MKT
06079803456230000,2019,55360,276840,332200,MKT
06079803456250000,2021,100676,263224,363900,MKT
06079803456250000,2020,55360,267240,322600,MKT
06079803456250000,2019,55360,267240,322600,MKT
06079803456270000,2021,100676,264624,365300,MKT
06079803456270000,2020,55360,269040,324400,MKT
06079803456270000,2019,55360,269040,324400,MKT
06079803456290000,2021,100676,257324,358000,MKT
06079803456290000,2020,55360,264040,319400,MKT
06079803456290000,2019,55360,264040,319400,MKT
06079803456310000,2021,100676,257924,358600,MKT
06079803456310000,2020,55360,265740,321100,MKT
06079803456310000,2019,55360,265740,321100,MKT
06079803456330000,2021,106106,262794,368900,MKT
06079803456330000,2020,61337,262463,323800,MKT
06079803456330000,2019,61337,262463,323800,MKT
06079803456356500,2021,78619,0,78619,COST
06079803456356500,2020,95434,0,95434,COST
06079803456356500,2019,95434,0,95434,COST
06079803457010000,2021,105682,261018,366700,MKT
06079803457010000,2020,60859,260441,321300,MKT
06079803457010000,2019,60859,260441,321300,MKT
06079803457030000,2021,100676,289424,390100,MKT
06079803457030000,2020,55360,279540,334900,MKT
06079803457030000,2019,55360,279540,334900,MKT
06079803457050000,2021,109424,268876,378300,MKT
06079803457050000,2020,65136,268264,333400,MKT
06079803457050000,2019,65136,268264,333400,MKT
06079803457070000,2021,122199,280901,403100,MKT
06079803457070000,2020,80802,286798,367600,MKT
06079803457070000,2019,80802,286798,367600,MKT
06079803457090000,2021,130003,272697,402700,MKT
06079803457090000,2020,80970,262530,343500,MKT
06079803457090000,2019,80970,262530,343500,MKT
06079803457110000,2021,144296,365604,509900,MKT
06079803457110000,2020,99252,387248,486500,MKT
06079803457110000,2019,99252,366148,465400,MKT
06079803457130000,2021,145458,354442,499900,MKT
06079803457130000,2020,100820,349080,449900,MKT
06079803457130000,2019,100820,349080,449900,MKT
06079803457150000,2021,131588,288312,419900,MKT
06079803457150000,2020,82908,291692,374600,MKT
06079803457150000,2019,82908,291692,374600,MKT
06079803457170000,2021,131029,278371,409400,MKT
06079803457170000,2020,82222,257278,339500,MKT
06079803457170000,2019,82222,257278,339500,MKT
06079803457190000,2021,135971,292829,428800,MKT
06079803457190000,2020,88383,305717,394100,MKT
06079803457190000,2019,88383,305717,394100,MKT
06079803457210000,2021,127229,299371,426600,MKT
06079803457210000,2020,77631,312369,390000,MKT
06079803457210000,2019,77631,311169,388800,MKT
06079803457230000,2021,123800,384300,508100,MKT
06079803457230000,2020,73600,347600,421200,MKT
06079803457230000,2019,73600,347600,421200,MKT
06079803457250000,2021,118443,269657,388100,MKT
06079803457250000,2020,67512,262088,329600,MKT
06079803457250000,2019,67512,262088,329600,MKT
06079803457270000,2021,118443,266057,384500,MKT
06079803457270000,2020,67512,252088,319600,MKT
06079803457270000,2019,67512,252088,319600,MKT
06079803458010000,2021,127461,281039,408500,MKT
06079803458010000,2020,77908,274392,352300,MKT
06079803458010000,2019,77908,274392,352300,MKT
06079803458030000,2021,124814,316386,441200,MKT
06079803458030000,2020,74782,311618,386400,MKT
06079803458030000,2019,74782,311618,386400,MKT
06079803458050000,2021,124814,294686,419500,MKT
06079803458050000,2020,74782,299518,374300,MKT
06079803458050000,2019,74782,294218,369000,MKT
06079803458070000,2021,128794,270506,399300,MKT
06079803458070000,2020,79507,258693,338200,MKT
06079803458070000,2019,79507,258693,338200,MKT
06079803458090000,2021,123273,273527,396800,MKT
06079803458090000,2020,72990,265010,338000,MKT
06079803458090000,2019,72990,265010,338000,MKT
06079803458110000,2021,123284,276616,399900,MKT
06079803458110000,2020,73003,265397,338400,MKT
06079803458110000,2019,73003,265397,338400,MKT
06079803458130000,2021,128784,309516,438300,MKT
06079803458130000,2020,79495,290905,370400,MKT
06079803458130000,2019,79495,290905,370400,MKT
06079803458150000,2021,124814,267986,392800,MKT
06079803458150000,2020,74782,252218,327000,MKT
06079803458150000,2019,74782,252218,327000,MKT
06079803458170000,2021,124814,249686,374500,MKT
06079803458170000,2020,74782,243118,317900,MKT
06079803458170000,2019,74782,243118,317900,MKT
06079803458190000,2021,127461,334439,461900,MKT
06079803458190000,2020,77908,347092,425000,MKT
06079803458190000,2019,77908,347092,425000,MKT
06079803458210000,2021,122003,295897,417900,MKT
06079803458210000,2020,71529,291371,362900,MKT
06079803458210000,2019,71529,291371,362900,MKT
06079803458230000,2021,122003,278597,400600,MKT
06079803458230000,2020,71529,271971,343500,MKT
06079803458230000,2019,71529,271971,343500,MKT
06079804101010000,2021,94239,241480,335719,COST
06079804101010000,2020,125209,216110,341319,COST
06079804101010000,2019,125209,216110,341319,COST
06079804101020000,2021,198059,109110,307169,COST
06079804101020000,2020,165109,106310,271419,COST
06079804101020000,2019,165109,106310,271419,COST
06079804101030000,2021,138307,241393,379700,MKT
06079804101030000,2020,106784,236316,343100,MKT
06079804101030000,2019,106784,236316,343100,MKT
06079804101047000,2021,2201665,44180,2245845,COST
06079804101047000,2020,1298831,45430,1344261,COST
06079804101047000,2019,608818,5461890,6070708,COST
06079804101057000,2021,280632,8790,289422,COST
06079804101057000,2020,363583,10380,373963,COST
06079804101057000,2019,363583,10380,373963,COST
06079804201010000,2021,11598,0,11598,COST
06079804201010000,2020,10799,0,10799,COST
06079804201010000,2019,10799,0,10799,COST
06079804201050000,2021,8737,0,8737,COST
06079804201050000,2020,9069,0,9069,COST
06079804201050000,2019,9069,0,9069,COST
06079804201100000,2021,16881,0,16881,COST
06079804201100000,2020,17103,0,17103,COST
06079804201100000,2019,17103,0,17103,COST
06079804301100000,2021,2158,0,2158,COST
06079804301100000,2020,2010,0,2010,COST
06079804301100000,2019,2010,0,2010,COST
06079804302017000,2021,248399,0,248399,COST
06079804302017000,2020,196112,0,196112,COST
06079804302017000,2019,196112,0,196112,COST
06079804303017000,2021,157482,0,157482,COST
06079804303017000,2020,117725,0,117725,COST
06079804303017000,2019,117725,0,117725,COST
06079804304017000,2021,314048,0,314048,COST
06079804304017000,2020,452864,0,452864,COST
06079804304017000,2019,452864,0,452864,COST
06079804305010000,2021,141083,368417,509500,MKT
06079804305010000,2020,94985,346015,441000,MKT
06079804305010000,2019,94985,346015,441000,MKT
06079804305030000,2021,143981,336619,480600,MKT
06079804305030000,2020,98830,341370,440200,MKT
06079804305030000,2019,98830,341370,440200,MKT
06079804305050000,2021,141555,250945,392500,MKT
06079804305050000,2020,95606,259994,355600,OVR
06079804305050000,2019,95606,259994,355600,MKT
06079804305070000,2021,141555,312845,454400,MKT
06079804305070000,2020,95606,332294,427900,MKT
06079804305070000,2019,95606,332294,427900,MKT
06079804305090000,2021,140351,229749,370100,MKT
06079804305090000,2020,94025,226475,320500,OVR
06079804305090000,2019,94025,226475,320500,MKT
06079804305110000,2021,141377,384223,525600,MKT
06079804305110000,2020,95372,341528,436900,MKT
06079804305110000,2019,95372,341528,436900,MKT
06079804305130000,2021,141555,280845,422400,MKT
06079804305130000,2020,95606,293794,389400,MKT
06079804305130000,2019,95606,293794,389400,MKT
06079804305150000,2021,141555,249945,391500,MKT
06079804305150000,2020,95606,259994,355600,MKT
06079804305150000,2019,95606,259994,355600,MKT
06079804305170000,2021,143981,268019,412000,MKT
06079804305170000,2020,98830,272770,371600,MKT
06079804305170000,2019,98830,272770,371600,MKT
06079804305190000,2021,136997,365503,502500,MKT
06079804305190000,2020,89690,348210,437900,MKT
06079804305190000,2019,89690,348210,437900,MKT
06079804306017000,2021,152959,0,152959,COST
06079804306017000,2020,111216,0,111216,COST
06079804306017000,2019,111216,0,111216,COST
06079804306037000,2021,179743,0,179743,COST
06079804306037000,2020,152386,0,152386,COST
06079804306037000,2019,152386,0,152386,COST
06079804306077000,2021,149488,0,149488,COST
06079804306077000,2020,106343,0,106343,COST
06079804306077000,2019,106343,0,106343,COST
06079804306097000,2021,185461,0,185461,COST
06079804306097000,2020,161992,0,161992,COST
06079804306097000,2019,161992,0,161992,COST
06079804306137000,2021,150959,0,150959,COST
06079804306137000,2020,108395,0,108395,COST
06079804306137000,2019,108395,0,108395,COST
06079804306157000,2021,149488,0,149488,COST
06079804306157000,2020,106343,0,106343,COST
06079804306157000,2019,106343,0,106343,COST
06079804306177000,2021,149488,0,149488,COST
06079804306177000,2020,106343,0,106343,COST
06079804306177000,2019,106343,0,106343,COST
06079804306197000,2021,152959,0,152959,COST
06079804306197000,2020,111216,0,111216,COST
06079804306197000,2019,111216,0,111216,COST
06079804307017000,2021,155899,0,155899,COST
06079804307017000,2020,115427,0,115427,COST
06079804307017000,2019,115427,0,115427,COST
06079804307030000,2021,183533,700067,883600,INCOME
06079804307030000,2020,108042,530658,638700,INCOME
06079804307030000,2019,108042,530658,638700,INCOME
06079804307057000,2021,150431,0,150431,COST
06079804307057000,2020,107656,0,107656,COST
06079804307057000,2019,107656,0,107656,COST
06079804307070000,2021,182020,823980,1006000,INCOME
06079804307070000,2020,107269,666331,773600,INCOME
06079804307070000,2019,107269,666331,773600,INCOME
06079804307090000,2021,194446,617754,812200,INCOME
06079804307090000,2020,113593,623307,736900,INCOME
06079804307090000,2019,113593,623307,736900,INCOME
06079804308017000,2021,256828,20030,276858,COST
06079804308017000,2020,253906,20210,274116,COST
06079804308017000,2019,253906,20210,274116,COST
06079804308036500,2021,89495,0,89495,COST
06079804308036500,2020,122897,0,122897,COST
06079804308036500,2019,122897,0,122897,COST
06079804309017000,2021,344763,0,344763,COST
06079804309017000,2020,451103,0,451103,COST
06079804309017000,2019,451103,0,451103,COST
06079804310017000,2021,163655,0,163655,COST
06079804310017000,2020,126900,0,126900,COST
06079804310017000,2019,126900,0,126900,COST
06079804310057000,2021,133635,0,133635,COST
06079804310057000,2020,85444,0,85444,COST
06079804310057000,2019,85444,0,85444,COST
06079804310070000,2021,135312,270788,406100,INCOME
06079804310070000,2020,87550,280950,368500,INCOME
06079804310070000,2019,87550,280950,368500,INCOME
06079804310090000,2021,135312,401488,536800,INCOME
06079804310090000,2020,87550,334750,422300,INCOME
06079804310090000,2019,87550,334750,422300,INCOME
06079804310117000,2021,135312,0,135312,COST
06079804310117000,2020,87550,0,87550,COST
06079804310117000,2019,87550,0,87550,COST
06079804310137000,2021,184077,0,184077,COST
06079804310137000,2020,159641,0,159641,COST
06079804310137000,2019,159641,0,159641,COST
06079804310157000,2021,135312,0,135312,COST
06079804310157000,2020,87550,0,87550,COST
06079804310157000,2019,87550,0,87550,COST
06079804310170000,2021,135312,401488,536800,INCOME
06079804310170000,2020,87550,419150,506700,INCOME
06079804310170000,2019,87550,419150,506700,INCOME
06079804310197000,2021,135312,0,135312,COST
06079804310197000,2020,87550,0,87550,COST
06079804310197000,2019,87550,0,87550,COST
06079804310217000,2021,138480,0,138480,COST
06079804310217000,2020,91594,0,91594,COST
06079804310217000,2019,91594,0,91594,COST
06079804310250000,2021,138480,365720,504200,INCOME
06079804310250000,2020,91594,330706,422300,INCOME
06079804310250000,2019,91594,330706,422300,INCOME
06079804310290000,2021,138480,365720,504200,INCOME
06079804310290000,2020,91594,330706,422300,INCOME
06079804310290000,2019,91594,330706,422300,INCOME
06079804310310000,2021,138480,365720,504200,INCOME
06079804310310000,2020,91594,330706,422300,INCOME
06079804310310000,2019,91594,330706,422300,INCOME
06079804310330000,2021,138480,435620,574100,INCOME
06079804310330000,2020,91594,330706,422300,INCOME
06079804310330000,2019,91594,330706,422300,INCOME
06079804310350000,2021,136765,367435,504200,INCOME
06079804310350000,2020,89393,332907,422300,INCOME
06079804310350000,2019,89393,332907,422300,INCOME
06079804310370000,2021,130502,373698,504200,INCOME
06079804310370000,2020,81578,340722,422300,INCOME
06079804310370000,2019,81578,340722,422300,INCOME
06079804310390000,2021,142765,501235,644000,INCOME
06079804310390000,2020,97208,409492,506700,INCOME
06079804310390000,2019,97208,409492,506700,INCOME
06079804311010000,2021,139400,407800,547200,MKT
06079804311010000,2020,92786,364114,456900,MKT
06079804311010000,2019,92786,364114,456900,MKT
06079804311030000,2021,143278,266722,410000,MKT
06079804311030000,2020,97890,268210,366100,OVR
06079804311030000,2019,97890,268210,366100,MKT
06079804311050000,2021,136263,237537,373800,MKT
06079804311050000,2020,88754,239546,328300,MKT
06079804311050000,2019,88754,239546,328300,MKT
06079804311070000,2021,136263,257937,394200,MKT
06079804311070000,2020,88754,258746,347500,MKT
06079804311070000,2019,88754,270946,359700,MKT
06079804311090000,2021,136263,260837,397100,MKT
06079804311090000,2020,88754,261746,350500,MKT
06079804311090000,2019,88754,261746,350500,MKT
06079804311110000,2021,136263,304437,440700,MKT
06079804311110000,2020,88754,312646,401400,MKT
06079804311110000,2019,88754,311346,400100,MKT
06079804311130000,2021,136263,257137,393400,MKT
06079804311130000,2020,88754,256846,345600,MKT
06079804311130000,2019,88754,256846,345600,MKT
06079804311150000,2021,136263,347137,483400,MKT
06079804311150000,2020,88754,351646,440400,MKT
06079804311150000,2019,88754,351646,440400,MKT
06079804311170000,2021,135312,387088,522400,MKT
06079804311170000,2020,87550,360550,448100,MKT
06079804311170000,2019,87550,360550,448100,MKT
06079804311190000,2021,135312,295888,431200,MKT
06079804311190000,2020,87550,301550,389100,MKT
06079804311190000,2019,87550,301550,389100,MKT
06079804311210000,2021,136263,338537,474800,MKT
06079804311210000,2020,88754,337946,426700,MKT
06079804311210000,2019,88754,337946,426700,MKT
06079804311230000,2021,136263,343037,479300,MKT
06079804311230000,2020,88754,331546,420300,MKT
06079804311230000,2019,88754,331546,420300,MKT
06079804311250000,2021,136263,277037,413300,MKT
06079804311250000,2020,88754,272246,361000,MKT
06079804311250000,2019,88754,272246,361000,MKT
06079804311270000,2021,136263,331737,468000,MKT
06079804311270000,2020,88754,329846,418600,MKT
06079804311270000,2019,88754,317146,405900,MKT
06079804311290000,2021,136263,300737,437000,MKT
06079804311290000,2020,88754,319046,407800,MKT
06079804311290000,2019,88754,319046,407800,MKT
06079804311310000,2021,136263,332537,468800,MKT
06079804311310000,2020,88754,338746,427500,MKT
06079804311310000,2019,88754,338746,427500,MKT
06079804311330000,2021,136035,299965,436000,MKT
06079804311330000,2020,88465,280235,368700,OVR
06079804311330000,2019,88465,280235,368700,MKT
06079804311350000,2021,139211,345389,484600,MKT
06079804311350000,2020,92540,329560,422100,MKT
06079804311350000,2019,92540,329560,422100,MKT
06079804312010000,2021,254575,0,254575,COST
06079804312010000,2020,300607,0,300607,COST
06079804312010000,2019,300607,0,300607,COST
06079804312037000,2021,172141,0,172141,COST
06079804312037000,2020,140060,0,140060,COST
06079804312037000,2019,140060,0,140060,COST
06079804312070000,2021,138891,365309,504200,INCOME
06079804312070000,2020,92126,330174,422300,INCOME
06079804312070000,2019,92126,330174,422300,INCOME
06079804313017000,2021,181338,0,181338,COST
06079804313017000,2020,155037,0,155037,COST
06079804313017000,2019,155037,0,155037,COST
06079804314010000,2021,139892,251808,391700,MKT
06079804314010000,2020,93426,256874,350300,MKT
06079804314010000,2019,93426,276174,369600,MKT
06079804314030000,2021,137928,264872,402800,MKT
06079804314030000,2020,90884,278616,369500,MKT
06079804314030000,2019,90884,278616,369500,MKT
06079804314050000,2021,130333,284467,414800,MKT
06079804314050000,2020,81371,245729,327100,OVR
06079804314050000,2019,81371,245729,327100,MKT
06079804314070000,2021,135312,239688,375000,MKT
06079804314070000,2020,87550,243050,330600,MKT
06079804314070000,2019,87550,243050,330600,MKT
06079804315017000,2021,168573,0,168573,COST
06079804315017000,2020,111626,0,111626,COST
06079804315017000,2019,111626,0,111626,COST
06079804315036500,2021,52689,0,52689,COST
06079804315036500,2020,43698,0,43698,COST
06079804315036500,2019,43698,0,43698,COST
06079804315050000,2021,144871,296629,441500,MKT
06079804315050000,2020,83047,297853,380900,MKT
06079804315050000,2019,83047,297853,380900,MKT
06079804315070000,2021,128079,291221,419300,MKT
06079804315070000,2020,78647,282153,360800,MKT
06079804315070000,2019,78647,282153,360800,MKT
06079804315090000,2021,128079,295021,423100,MKT
06079804315090000,2020,78647,299153,377800,OVR
06079804315090000,2019,78647,299153,377800,MKT
06079804315110000,2021,128079,285721,413800,MKT
06079804315110000,2020,78647,290353,369000,OVR
06079804315110000,2019,78647,290353,369000,MKT
06079804315130000,2021,128079,274721,402800,MKT
06079804315130000,2020,78647,277253,355900,MKT
06079804315130000,2019,78647,277253,355900,MKT
06079804315150000,2021,128079,313621,441700,MKT
06079804315150000,2020,78647,298853,377500,MKT
06079804315150000,2019,78647,298853,377500,MKT
06079804315170000,2021,128079,295721,423800,MKT
06079804315170000,2020,78647,301353,380000,MKT
06079804315170000,2019,78647,301353,380000,MKT
06079804315190000,2021,128079,234821,362900,MKT
06079804315190000,2020,78647,243353,322000,MKT
06079804315190000,2019,78647,243353,322000,MKT
06079804315210000,2021,127517,322983,450500,MKT
06079804315210000,2020,77976,302224,380200,MKT
06079804315210000,2019,77976,317424,395400,MKT
06079804315230000,2021,127517,246183,373700,MKT
06079804315230000,2020,77976,253324,331300,MKT
06079804315230000,2019,77976,253324,331300,MKT
06079804315250000,2021,133250,293750,427000,MKT
06079804315250000,2020,84964,294536,379500,MKT
06079804315250000,2019,84964,294536,379500,MKT
06079804315270000,2021,133250,278550,411800,MKT
06079804315270000,2020,84964,279836,364800,OVR
06079804315270000,2019,84964,279836,364800,MKT
06079804315290000,2021,130790,276210,407000,MKT
06079804315290000,2020,81930,264370,346300,MKT
06079804315290000,2019,81930,264370,346300,MKT
06079804315310000,2021,130790,276210,407000,MKT
06079804315310000,2020,81930,264370,346300,MKT
06079804315310000,2019,81930,264370,346300,MKT
06079804315330000,2021,130790,256510,387300,MKT
06079804315330000,2020,81930,253370,335300,MKT
06079804315330000,2019,81930,253370,335300,MKT
06079804315350000,2021,130790,311910,442700,MKT
06079804315350000,2020,81930,330470,412400,OVR
06079804315350000,2019,81930,330470,412400,MKT
06079804315370000,2021,130790,276710,407500,MKT
06079804315370000,2020,81930,273970,355900,MKT
06079804315370000,2019,81930,273970,355900,MKT
06079804315390000,2021,130790,287310,418100,MKT
06079804315390000,2020,81930,283770,365700,MKT
06079804315390000,2019,81930,268070,350000,MKT
06079804315410000,2021,130790,300910,431700,MKT
06079804315410000,2020,81930,324470,406400,MKT
06079804315410000,2019,81930,324470,406400,MKT
06079804315430000,2021,130790,259110,389900,MKT
06079804315430000,2020,81930,248470,330400,MKT
06079804315430000,2019,81930,248470,330400,MKT
06079804315450000,2021,146964,295336,442300,MKT
06079804315450000,2020,85405,295395,380800,MKT
06079804315450000,2019,85405,295395,380800,MKT
06079804315477000,2021,174033,0,174033,COST
06079804315477000,2020,118792,0,118792,COST
06079804315477000,2019,118792,0,118792,COST
06079804316017000,2021,142334,0,142334,COST
06079804316017000,2020,96637,0,96637,COST
06079804316017000,2019,96637,0,96637,COST
06079804316037000,2021,149733,0,149733,COST
06079804316037000,2020,106683,0,106683,COST
06079804316037000,2019,106683,0,106683,COST
06079804316057000,2021,150084,0,150084,COST
06079804316057000,2020,107173,0,107173,COST
06079804316057000,2019,107173,0,107173,COST
06079804316077000,2021,150434,0,150434,COST
06079804316077000,2020,107660,0,107660,COST
06079804316077000,2019,107660,0,107660,COST
06079804316090000,2021,132790,656710,789500,INCOME
06079804316090000,2020,87912,606688,694600,INCOME
06079804316090000,2019,87912,606688,694600,INCOME
06079804317010000,2021,153754,660546,814300,INCOME
06079804317010000,2020,99832,497468,597300,INCOME
06079804317010000,2019,99832,497468,597300,INCOME
06079804317036500,2021,50482,0,50482,COST
06079804317036500,2020,40197,0,40197,COST
06079804317036500,2019,40197,0,40197,COST
06079804317057000,2021,175190,0,175190,COST
06079804317057000,2020,120339,0,120339,COST
06079804317057000,2019,120339,0,120339,COST
06079804317077000,2021,155001,0,155001,COST
06079804317077000,2020,114133,0,114133,COST
06079804317077000,2019,114133,0,114133,COST
06079804317097000,2021,142840,0,142840,COST
06079804317097000,2020,97308,0,97308,COST
06079804317097000,2019,97308,0,97308,COST
06079804317110000,2021,118681,385519,504200,INCOME
06079804317110000,2020,76324,345976,422300,INCOME
06079804317110000,2019,76324,345976,422300,INCOME
06079804317130000,2021,120338,453762,574100,INCOME
06079804317130000,2020,78418,428282,506700,INCOME
06079804317130000,2019,78418,428282,506700,INCOME
06079804317150000,2021,121824,325576,447400,MKT
06079804317150000,2020,80319,295481,375800,OVR
06079804317150000,2019,80319,295481,375800,MKT
06079804317170000,2021,121200,340500,461700,MKT
06079804317170000,2020,79518,329982,409500,MKT
06079804317170000,2019,79518,329982,409500,MKT
06079804317190000,2021,120566,285734,406300,MKT
06079804317190000,2020,78709,277091,355800,MKT
06079804317190000,2019,78709,277091,355800,MKT
06079804317210000,2021,119924,258476,378400,MKT
06079804317210000,2020,77892,256608,334500,MKT
06079804317210000,2019,77892,256608,334500,MKT
06079804317230000,2021,129782,273118,402900,MKT
06079804317230000,2020,90879,263021,353900,MKT
06079804317230000,2019,90879,263021,353900,MKT
06079804318010000,2021,162308,0,162308,COST
06079804318010000,2020,124870,0,124870,COST
06079804318010000,2019,124870,0,124870,COST
06079804318030000,2021,210257,724743,935000,INCOME
06079804318030000,2020,121564,691336,812900,INCOME
06079804318030000,2019,121564,691336,812900,INCOME
06079804318057000,2021,190668,0,190668,COST
06079804318057000,2020,170987,0,170987,COST
06079804318057000,2019,170987,0,170987,COST
06079804318090000,2021,187710,693390,881100,MKT
06079804318090000,2020,165848,604752,770600,MKT
06079804318090000,2019,165848,604752,770600,MKT
06079804318110000,2021,131527,336273,467800,MKT
06079804318110000,2020,82833,325267,408100,MKT
06079804318110000,2019,82833,325267,408100,MKT
06079804318130000,2021,136824,306676,443500,MKT
06079804318130000,2020,89469,299031,388500,MKT
06079804318130000,2019,89469,299031,388500,MKT
06079804318150000,2021,137149,303651,440800,MKT
06079804318150000,2020,89884,294716,384600,MKT
06079804318150000,2019,89884,294716,384600,MKT
06079804318170000,2021,137346,316054,453400,MKT
06079804318170000,2020,90136,307464,397600,MKT
06079804318170000,2019,90136,307464,397600,MKT
06079804318190000,2021,137546,328454,466000,MKT
06079804318190000,2020,90393,319807,410200,MKT
06079804318190000,2019,90393,319807,410200,MKT
06079804318210000,2021,137746,326454,464200,MKT
06079804318210000,2020,90649,317251,407900,MKT
06079804318210000,2019,90649,317251,407900,MKT
06079804318230000,2021,137945,332655,470600,MKT
06079804318230000,2020,90905,322695,413600,MKT
06079804318230000,2019,90905,322695,413600,MKT
06079804318250000,2021,138139,263661,401800,MKT
06079804318250000,2020,91155,256845,348000,MKT
06079804318250000,2019,91155,256845,348000,MKT
06079804318270000,2021,146820,258580,405400,MKT
06079804318270000,2020,102669,233731,336400,MKT
06079804318270000,2019,102669,233731,336400,MKT
06079804319010000,2021,148848,355352,504200,INCOME
06079804319010000,2020,105457,316843,422300,INCOME
06079804319010000,2019,105457,316843,422300,INCOME
06079804319037000,2021,212443,0,212443,COST
06079804319037000,2020,211170,0,211170,COST
06079804319037000,2019,211170,0,211170,COST
06079804319090000,2021,146945,288055,435000,MKT
06079804319090000,2020,102840,271260,374100,MKT
06079804319090000,2019,102840,271260,374100,MKT
06079804319110000,2021,146945,281455,428400,MKT
06079804319110000,2020,102840,258460,361300,MKT
06079804319110000,2019,102840,258460,361300,MKT
06079804319130000,2021,150473,363427,513900,MKT
06079804319130000,2020,107715,343485,451200,MKT
06079804319130000,2019,107715,343485,451200,MKT
06079804319150000,2021,150473,369527,520000,MKT
06079804319150000,2020,107715,347585,455300,MKT
06079804319150000,2019,107715,347585,455300,MKT
06079804319177000,2021,146945,0,146945,COST
06079804319177000,2020,102840,0,102840,COST
06079804319177000,2019,102840,0,102840,COST
06079804319190000,2021,146945,276555,423500,MKT
06079804319190000,2020,102840,253360,356200,MKT
06079804319190000,2019,102840,253360,356200,MKT
06079804319210000,2021,138480,333020,471500,INCOME
06079804319210000,2020,91594,330706,422300,INCOME
06079804319210000,2019,91594,330706,422300,INCOME
06079804319277000,2021,148848,0,148848,COST
06079804319277000,2020,105457,0,105457,COST
06079804319277000,2019,105457,0,105457,COST
06079804320010000,2021,201465,741435,942900,INCOME
06079804320010000,2020,117142,727458,844600,INCOME
06079804320010000,2019,117142,727458,844600,INCOME
06079804320030000,2021,195928,812472,1008400,INCOME
06079804320030000,2020,114344,730256,844600,INCOME
06079804320030000,2019,114344,730256,844600,INCOME
06079804320057000,2021,155148,0,155148,COST
06079804320057000,2020,114344,0,114344,COST
06079804320057000,2019,114344,953756,1068100,INCOME
06079804320070000,2021,200772,807628,1008400,INCOME
06079804320070000,2020,116792,727808,844600,INCOME
06079804320070000,2019,116792,727808,844600,INCOME
06079804320090000,2021,195928,877672,1073600,INCOME
06079804320090000,2020,114344,730256,844600,INCOME
06079804320090000,2019,114344,0,114344,COST
06079804320110000,2021,195928,672672,868600,INCOME
06079804320110000,2020,114344,622556,736900,INCOME
06079804320110000,2019,114344,622556,736900,INCOME
06079804320130000,2021,201465,806935,1008400,INCOME
06079804320130000,2020,117142,727458,844600,INCOME
06079804320130000,2019,117142,727458,844600,INCOME
06079804321017000,2021,243996,11900,255896,COST
06079804321017000,2020,276705,14050,290755,COST
06079804321017000,2019,276705,14050,290755,COST
06079804321057000,2021,243696,11900,255596,COST
06079804321057000,2020,276043,14050,290093,COST
06079804321057000,2019,276043,14050,290093,COST
06079804322010000,2021,526461,5160839,5687300,INCOME
06079804322010000,2020,269517,2792283,3061800,INCOME
06079804322010000,2019,269517,2792283,3061800,INCOME
06079804322036500,2021,47002,0,47002,COST
06079804322036500,2020,34965,0,34965,COST
06079804322036500,2019,34965,0,34965,COST
06079804322050000,2021,219964,0,219964,COST
06079804322050000,2020,224532,0,224532,COST
06079804322050000,2019,224532,0,224532,COST
06079804322207000,2021,322226,0,322226,COST
06079804322207000,2020,191481,0,191481,COST
06079804322207000,2019,191481,0,191481,COST
06079804401016500,2021,113333,0,113333,COST
06079804401016500,2020,753,0,753,COST
06079804401016500,2019,753,0,753,COST
06079804401026500,2021,84066,0,84066,COST
06079804401026500,2020,108765,0,108765,COST
06079804401026500,2019,108765,0,108765,COST
06079804402010000,2021,239085,0,239085,COST
06079804402010000,2020,265940,0,265940,COST
06079804402010000,2019,265940,0,265940,COST
06079804402030000,2021,235335,0,235335,COST
06079804402030000,2020,257858,0,257858,COST
06079804402030000,2019,257858,0,257858,COST
06079804402050000,2021,220781,0,220781,COST
06079804402050000,2020,227650,0,227650,COST
06079804402050000,2019,227650,0,227650,COST
06079804402070000,2021,230609,777791,1008400,INCOME
06079804402070000,2020,131708,712892,844600,INCOME
06079804402070000,2019,131708,712892,844600,INCOME
06079804402090000,2021,244266,764134,1008400,INCOME
06079804402090000,2020,138448,706152,844600,INCOME
06079804402090000,2019,138448,706152,844600,INCOME
06079804402116500,2021,56510,0,56510,COST
06079804402116500,2020,50097,0,50097,COST
06079804402116500,2019,50097,0,50097,COST
06079804403017000,2021,185263,11770,197033,COST
06079804403017000,2020,161655,12820,174475,COST
06079804403017000,2019,161655,1121000,1282655,COST
06079804403030000,2021,229710,778690,1008400,INCOME
06079804403030000,2020,131262,713338,844600,INCOME
06079804403030000,2019,131262,713338,844600,INCOME
06079804403050000,2021,224556,783844,1008400,INCOME
06079804403050000,2020,128704,715896,844600,INCOME
06079804403050000,2019,128704,715896,844600,INCOME
06079804404015001,2021,118241,229159,347400,MKT
06079804404015001,2020,67287,238213,305500,MKT
06079804404015001,2019,67287,238213,305500,MKT
06079804404035002,2021,105831,228769,334600,MKT
06079804404035002,2020,54193,238207,292400,MKT
06079804404035002,2019,54193,238207,292400,MKT
06079804404055001,2021,103400,164000,267400,MKT
06079804404055001,2020,51789,177011,228800,MKT
06079804404055001,2019,51789,177011,228800,MKT
06079804404075002,2021,103400,162100,265500,MKT
06079804404075002,2020,51789,177911,229700,MKT
06079804404075002,2019,51789,177911,229700,MKT
06079804404095001,2021,103400,169600,273000,MKT
06079804404095001,2020,51789,179011,230800,MKT
06079804404095001,2019,51789,179011,230800,MKT
06079804404115002,2021,103400,169500,272900,MKT
06079804404115002,2020,51789,178911,230700,MKT
06079804404115002,2019,51789,178911,230700,MKT
06079804404135001,2021,103400,169500,272900,MKT
06079804404135001,2020,51789,178911,230700,MKT
06079804404135001,2019,51789,178911,230700,MKT
06079804404155002,2021,103400,169500,272900,MKT
06079804404155002,2020,51789,178911,230700,MKT
06079804404155002,2019,51789,178911,230700,MKT
06079804404175001,2021,103400,174600,278000,MKT
06079804404175001,2020,51789,181411,233200,MKT
06079804404175001,2019,51789,181411,233200,MKT
06079804404195002,2021,103400,173800,277200,MKT
06079804404195002,2020,51789,190211,242000,MKT
06079804404195002,2019,51789,190211,242000,MKT
06079804404215001,2021,103400,169500,272900,MKT
06079804404215001,2020,51789,178911,230700,MKT
06079804404215001,2019,51789,178911,230700,MKT
06079804404235002,2021,103400,169500,272900,MKT
06079804404235002,2020,51789,178911,230700,MKT
06079804404235002,2019,51789,178911,230700,MKT
06079804404255001,2021,103400,169500,272900,MKT
06079804404255001,2020,51789,178911,230700,MKT
06079804404255001,2019,51789,178911,230700,MKT
06079804404275002,2021,103400,169500,272900,MKT
06079804404275002,2020,51789,178911,230700,MKT
06079804404275002,2019,51789,178911,230700,MKT
06079804404295001,2021,103400,166400,269800,MKT
06079804404295001,2020,51789,184711,236500,MKT
06079804404295001,2019,51789,184711,236500,MKT
06079804404315002,2021,103400,166400,269800,MKT
06079804404315002,2020,51789,184711,236500,MKT
06079804404315002,2019,51789,184711,236500,MKT
06079804404335001,2021,103400,160900,264300,MKT
06079804404335001,2020,51789,183611,235400,MKT
06079804404335001,2019,51789,183611,235400,MKT
06079804404355002,2021,103400,160900,264300,MKT
06079804404355002,2020,51789,172611,224400,MKT
06079804404355002,2019,51789,172611,224400,MKT
06079804404375001,2021,110376,292124,402500,MKT
06079804404375001,2020,58829,334671,393500,OVR
06079804404375001,2019,58829,340971,399800,MKT
06079804404395002,2021,133818,320282,454100,MKT
06079804404395002,2020,73723,319777,393500,OVR
06079804404395002,2019,73723,341777,415500,MKT
06079804404415001,2021,123748,216752,340500,MKT
06079804404415001,2020,63282,248818,312100,OVR
06079804404415001,2019,63282,248818,312100,MKT
06079804404435002,2021,100642,228358,329000,MKT
06079804404435002,2020,49128,243472,292600,OVR
06079804404435002,2019,49128,243472,292600,MKT
06079804404455003,2021,100642,227758,328400,MKT
06079804404455003,2020,49128,243472,292600,OVR
06079804404455003,2019,49128,243472,292600,MKT
06079804404475004,2021,114512,220288,334800,MKT
06079804404475004,2020,63208,241592,304800,OVR
06079804404475004,2019,63208,241592,304800,MKT
06079804404490000,2021,124315,263485,387800,MKT
06079804404490000,2020,74199,247201,321400,MKT
06079804404490000,2019,74199,247201,321400,MKT
06079804404530000,2021,124392,272208,396600,MKT
06079804404530000,2020,74289,271011,345300,MKT
06079804404530000,2019,74289,265611,339900,MKT
06079804404570000,2021,124277,261123,385400,MKT
06079804404570000,2020,74154,252046,326200,MKT
06079804404570000,2019,74154,252046,326200,MKT
06079804404610000,2021,124376,263424,387800,MKT
06079804404610000,2020,74270,247230,321500,MKT
06079804404610000,2019,74270,247230,321500,MKT
06079804404650000,2021,124293,261107,385400,MKT
06079804404650000,2020,74174,252026,326200,MKT
06079804404650000,2019,74174,252026,326200,MKT
06079804404690000,2021,124359,271341,395700,MKT
06079804404690000,2020,74251,270049,344300,MKT
06079804404690000,2019,74251,265649,339900,MKT
06079804404730000,2021,130154,259946,390100,MKT
06079804404730000,2020,81153,249747,330900,MKT
06079804404730000,2019,81153,249747,330900,MKT
06079804404770000,2021,134830,267670,402500,MKT
06079804404770000,2020,86942,252258,339200,MKT
06079804404770000,2019,86942,249258,336200,MKT
06079804405015001,2021,120280,234120,354400,MKT
06079804405015001,2020,69571,266029,335600,MKT
06079804405015001,2019,69571,266029,335600,MKT
06079804405035002,2021,112500,225700,338200,MKT
06079804405035002,2020,61059,261441,322500,MKT
06079804405035002,2019,61059,261441,322500,MKT
06079804405055001,2021,112500,226600,339100,MKT
06079804405055001,2020,61059,262141,323200,MKT
06079804405055001,2019,61059,262141,323200,MKT
06079804405075002,2021,112500,226000,338500,MKT
06079804405075002,2020,61059,261541,322600,MKT
06079804405075002,2019,61059,261541,322600,MKT
06079804405095001,2021,112500,226000,338500,MKT
06079804405095001,2020,61059,262041,323100,MKT
06079804405095001,2019,61059,262041,323100,MKT
06079804405115002,2021,112500,225100,337600,MKT
06079804405115002,2020,61059,261241,322300,MKT
06079804405115002,2019,61059,261241,322300,MKT
06079804405135001,2021,112500,225100,337600,MKT
06079804405135001,2020,61059,261241,322300,MKT
06079804405135001,2019,61059,261241,322300,MKT
06079804405155002,2021,112500,226000,338500,MKT
06079804405155002,2020,61059,262041,323100,MKT
06079804405155002,2019,61059,262041,323100,MKT
06079804405175001,2021,112500,222500,335000,MKT
06079804405175001,2020,61059,258541,319600,MKT
06079804405175001,2019,61059,258541,319600,MKT
06079804405195002,2021,112500,221600,334100,MKT
06079804405195002,2020,61059,257741,318800,MKT
06079804405195002,2019,61059,257741,318800,MKT
06079804405215001,2021,112500,221600,334100,MKT
06079804405215001,2020,61059,257741,318800,MKT
06079804405215001,2019,61059,257741,318800,MKT
06079804405235002,2021,112500,222500,335000,MKT
06079804405235002,2020,61059,258541,319600,MKT
06079804405235002,2019,61059,258541,319600,MKT
06079804405255001,2021,112500,228500,341000,MKT
06079804405255001,2020,61059,262841,323900,MKT
06079804405255001,2019,61059,262841,323900,MKT
06079804405275002,2021,112500,225100,337600,MKT
06079804405275002,2020,61059,261241,322300,MKT
06079804405275002,2019,61059,261241,322300,MKT
06079804405295001,2021,112500,224700,337200,MKT
06079804405295001,2020,61059,261841,322900,OVR
06079804405295001,2019,61059,261841,322900,MKT
06079804405315002,2021,120334,233466,353800,MKT
06079804405315002,2020,69632,265868,335500,MKT
06079804405315002,2019,69632,265868,335500,MKT
06079804405335001,2021,120461,227139,347600,MKT
06079804405335001,2020,69775,252425,322200,MKT
06079804405335001,2019,69775,252425,322200,MKT
06079804405355002,2021,112500,220200,332700,MKT
06079804405355002,2020,61059,248841,309900,MKT
06079804405355002,2019,61059,248841,309900,MKT
06079804405375001,2021,112500,228300,340800,MKT
06079804405375001,2020,61059,248841,309900,MKT
06079804405375001,2019,61059,248841,309900,MKT
06079804405395002,2021,112500,220200,332700,MKT
06079804405395002,2020,61059,248841,309900,MKT
06079804405395002,2019,61059,248841,309900,MKT
06079804405415002,2021,112500,220200,332700,MKT
06079804405415002,2020,61059,248841,309900,MKT
06079804405415002,2019,61059,248841,309900,MKT
06079804405435001,2021,112500,225200,337700,MKT
06079804405435001,2020,61059,253841,314900,MKT
06079804405435001,2019,61059,253841,314900,MKT
06079804405455002,2021,112500,221400,333900,MKT
06079804405455002,2020,61059,249341,310400,MKT
06079804405455002,2019,61059,249341,310400,MKT
06079804405475001,2021,112500,221400,333900,MKT
06079804405475001,2020,61059,249341,310400,MKT
06079804405475001,2019,61059,249341,310400,MKT
06079804405495002,2021,112500,229600,342100,MKT
06079804405495002,2020,61059,253641,314700,MKT
06079804405495002,2019,61059,249341,310400,MKT
06079804405515001,2021,112500,221400,333900,MKT
06079804405515001,2020,61059,249341,310400,MKT
06079804405515001,2019,61059,249341,310400,MKT
06079804405535002,2021,112500,221400,333900,MKT
06079804405535002,2020,61059,249341,310400,MKT
06079804405535002,2019,61059,249341,310400,MKT
06079804405555001,2021,112500,221400,333900,MKT
06079804405555001,2020,61059,249341,310400,MKT
06079804405555001,2019,61059,249341,310400,MKT
06079804405575002,2021,112500,221400,333900,MKT
06079804405575002,2020,61059,249341,310400,MKT
06079804405575002,2019,61059,249341,310400,MKT
06079804405595001,2021,112500,221400,333900,MKT
06079804405595001,2020,61059,249341,310400,MKT
06079804405595001,2019,61059,249341,310400,MKT
06079804405615002,2021,112500,221400,333900,MKT
06079804405615002,2020,61059,249341,310400,MKT
06079804405615002,2019,61059,249341,310400,MKT
06079804405635001,2021,120280,221420,341700,MKT
06079804405635001,2020,69571,249429,319000,MKT
06079804405635001,2019,69571,249429,319000,MKT
06079804406010000,2021,140224,280376,420600,MKT
06079804406010000,2020,80768,260532,341300,MKT
06079804406010000,2019,80768,260532,341300,MKT
06079804406030000,2021,133000,349900,482900,MKT
06079804406030000,2020,72846,350654,423500,MKT
06079804406030000,2019,72846,350654,423500,MKT
06079804406050000,2021,120298,284502,404800,MKT
06079804406050000,2020,69592,0,69592,COST
06079804406050000,2019,69592,0,69592,COST
06079804406070000,2021,127918,256282,384200,MKT
06079804406070000,2020,67512,255488,323000,MKT
06079804406070000,2019,67512,255488,323000,MKT
06079804406090000,2021,127918,257182,385100,MKT
06079804406090000,2020,67512,253088,320600,OVR
06079804406090000,2019,67512,253088,320600,MKT
06079804406110000,2021,127918,263582,391500,MKT
06079804406110000,2020,67512,259788,327300,MKT
06079804406110000,2019,67512,259788,327300,MKT
06079804406130000,2021,134272,275428,409700,MKT
06079804406130000,2020,74212,265988,340200,MKT
06079804406130000,2019,74212,265988,340200,MKT
06079804406150000,2021,129837,308063,437900,MKT
06079804406150000,2020,80768,294132,374900,MKT
06079804406150000,2019,80768,294132,374900,MKT
06079804406170000,2021,123688,263512,387200,MKT
06079804406170000,2020,73471,255729,329200,MKT
06079804406170000,2019,73471,255729,329200,MKT
06079804406190000,2021,123688,251312,375000,MKT
06079804406190000,2020,73471,243029,316500,MKT
06079804406190000,2019,73471,243029,316500,MKT
06079804406210000,2021,123688,260512,384200,MKT
06079804406210000,2020,73471,252229,325700,MKT
06079804406210000,2019,73471,252229,325700,MKT
06079804406230000,2021,123688,326212,449900,INCOME
06079804406230000,2020,73471,296229,369700,INCOME
06079804406230000,2019,73471,296229,369700,INCOME
06079804406250000,2021,123688,326212,449900,INCOME
06079804406250000,2020,73471,296229,369700,INCOME
06079804406250000,2019,73471,296229,369700,INCOME
06079804406270000,2021,129837,374863,504700,INCOME
06079804406270000,2020,80768,288932,369700,INCOME
06079804406270000,2019,80768,288932,369700,INCOME
06079804407010000,2021,134272,290228,424500,MKT
06079804407010000,2020,74212,295588,369800,MKT
06079804407010000,2019,74212,295588,369800,MKT
06079804407030000,2021,127918,256482,384400,MKT
06079804407030000,2020,67512,257388,324900,OVR
06079804407030000,2019,67512,257388,324900,MKT
06079804407050000,2021,127918,253382,381300,MKT
06079804407050000,2020,67512,250488,318000,MKT
06079804407050000,2019,67512,250488,318000,MKT
06079804407070000,2021,127918,288482,416400,MKT
06079804407070000,2020,67512,288788,356300,MKT
06079804407070000,2019,67512,288788,356300,MKT
06079804407090000,2021,127918,287682,415600,MKT
06079804407090000,2020,67512,289388,356900,MKT
06079804407090000,2019,67512,289388,356900,MKT
06079804407110000,2021,127918,291782,419700,MKT
06079804407110000,2020,67512,293488,361000,MKT
06079804407110000,2019,67512,293488,361000,MKT
06079804407130000,2021,134272,290228,424500,MKT
06079804407130000,2020,74212,295588,369800,MKT
06079804407130000,2019,74212,295588,369800,MKT
06079804407150000,2021,129837,264863,394700,MKT
06079804407150000,2020,80768,249732,330500,MKT
06079804407150000,2019,80768,249732,330500,MKT
06079804407170000,2021,123688,263612,387300,MKT
06079804407170000,2020,73471,266129,339600,MKT
06079804407170000,2019,73471,266129,339600,MKT
06079804407190000,2021,123688,264112,387800,MKT
06079804407190000,2020,73471,268729,342200,MKT
06079804407190000,2019,73471,268729,342200,MKT
06079804407210000,2021,123688,256512,380200,MKT
06079804407210000,2020,73471,249729,323200,MKT
06079804407210000,2019,73471,249729,323200,MKT
06079804407230000,2021,123688,267612,391300,MKT
06079804407230000,2020,73471,270729,344200,MKT
06079804407230000,2019,73471,268729,342200,MKT
06079804407250000,2021,123688,258812,382500,MKT
06079804407250000,2020,73471,251629,325100,MKT
06079804407250000,2019,73471,251629,325100,MKT
06079804407270000,2021,129837,309463,439300,MKT
06079804407270000,2020,80768,323632,404400,MKT
06079804407270000,2019,80768,323632,404400,MKT
06079804408016500,2021,70035,0,70035,COST
06079804408016500,2020,76155,0,76155,COST
06079804408016500,2019,76155,0,76155,COST
06079804408050000,2021,162376,0,162376,COST
06079804408100000,2021,146934,0,146934,COST
06079804408100000,2020,498740,0,498740,COST
06079804408100000,2019,498740,0,498740,COST
06079804408150000,2021,149478,0,149478,COST
06079804409036500,2021,94756,0,94756,COST
06079804409036500,2020,137391,0,137391,COST
06079804409036500,2019,137391,0,137391,COST
06079804409056500,2021,76318,0,76318,COST
06079804409056500,2020,90059,0,90059,COST
06079804409056500,2019,90059,0,90059,COST
06079804409100000,2021,147256,0,147256,COST
06079804409150000,2021,137734,0,137734,COST
06079804409200000,2021,135893,0,135893,COST
06079804410016500,2021,95805,0,95805,COST
06079804410016500,2020,140374,0,140374,COST
06079804410016500,2019,140374,0,140374,COST
06079804410026500,2021,75265,0,75265,COST
06079804410026500,2020,87649,0,87649,COST
06079804410026500,2019,87649,0,87649,COST
06079804410030000,2021,215033,332420,547453,COST
06079804410030000,2020,147548,329850,477398,COST
06079804410030000,2019,147548,329850,477398,COST
06079804410040000,2021,149999,251801,401800,INCOME
06079804410040000,2020,107054,262746,369800,INCOME
06079804410040000,2019,107054,262746,369800,INCOME
06079804410065001,2021,103427,245673,349100,MKT
06079804410065001,2020,51816,260384,312200,MKT
06079804410065001,2019,51816,258584,310400,MKT
06079804410075002,2021,103400,267000,370400,MKT
06079804410075002,2020,51789,310011,361800,MKT
06079804410075002,2019,51789,310011,361800,MKT
06079804410085003,2021,103400,262400,365800,MKT
06079804410085003,2020,51789,313411,365200,MKT
06079804410085003,2019,51789,313411,365200,MKT
06079804410095004,2021,107914,207886,315800,MKT
06079804410095004,2020,56294,211906,268200,MKT
06079804410095004,2019,56294,211206,267500,MKT
06079804410110000,2021,138899,505101,644000,INCOME
06079804410110000,2020,92137,414563,506700,INCOME
06079804410110000,2019,92137,414563,506700,INCOME
06079804410137000,2021,264135,0,264135,COST
06079804410137000,2020,268197,0,268197,COST
06079804410137000,2019,268197,0,268197,COST
06079804410300000,2021,146765,0,146765,COST
06079804410350000,2021,147596,0,147596,COST
06079804410400000,2021,134958,0,134958,COST
06079804411025002,2021,129116,334484,463600,MKT
06079804411025002,2020,66332,377168,443500,MKT
06079804411025002,2019,66332,377168,443500,MKT
06079804411035001,2021,120701,272599,393300,MKT
06079804411035001,2020,58156,285344,343500,MKT
06079804411035001,2019,58156,285344,343500,MKT
06079804411045002,2021,120701,306499,427200,MKT
06079804411045002,2020,58156,339744,397900,MKT
06079804411045002,2019,58156,339744,397900,MKT
06079804411065001,2021,120701,246399,367100,MKT
06079804411065001,2020,58156,282944,341100,MKT
06079804411065001,2019,58156,282944,341100,MKT
06079804411075002,2021,120701,306499,427200,MKT
06079804411075002,2020,58156,339744,397900,MKT
06079804411075002,2019,58156,339744,397900,MKT
06079804411085001,2021,120701,247499,368200,MKT
06079804411085001,2020,58156,283844,342000,MKT
06079804411085001,2019,58156,283844,342000,MKT
06079804411105002,2021,120701,303699,424400,MKT
06079804411105002,2020,58156,330444,388600,MKT
06079804411105002,2019,58156,330444,388600,MKT
06079804411115001,2021,109728,260772,370500,MKT
06079804411115001,2020,58156,279944,338100,MKT
06079804411115001,2019,58156,279944,338100,MKT
06079804411145002,2021,128529,253971,382500,MKT
06079804411145002,2020,65746,265354,331100,MKT
06079804411145002,2019,65746,265354,331100,MKT
06079804411155001,2021,120701,256999,377700,MKT
06079804411155001,2020,58156,268644,326800,MKT
06079804411155001,2019,58156,268644,326800,MKT
06079804411165002,2021,120701,267299,388000,MKT
06079804411165002,2020,58156,302344,360500,MKT
06079804411165002,2019,58156,302344,360500,MKT
06079804411175001,2021,120701,266299,387000,MKT
06079804411175001,2020,58156,300244,358400,MKT
06079804411175001,2019,58156,300244,358400,MKT
06079804411185002,2021,120701,265199,385900,MKT
06079804411185002,2020,58156,286744,344900,MKT
06079804411185002,2019,58156,286744,344900,MKT
06079804411195001,2021,128529,256371,384900,MKT
06079804411195001,2020,65746,285154,350900,OVR
06079804411195001,2019,65746,285154,350900,MKT
06079804411205002,2021,120701,255099,375800,MKT
06079804411205002,2020,58156,292444,350600,MKT
06079804411205002,2019,58156,292444,350600,MKT
06079804411235001,2021,127928,278372,406300,MKT
06079804411235001,2020,65147,312953,378100,MKT
06079804411235001,2019,65147,312953,378100,MKT
06079804412015001,2021,111067,205833,316900,MKT
06079804412015001,2020,59549,209151,268700,MKT
06079804412015001,2019,59549,209151,268700,MKT
06079804412025002,2021,103400,229300,332700,MKT
06079804412025002,2020,51789,237411,289200,MKT
06079804412025002,2019,51789,237411,289200,MKT
06079804412045001,2021,111672,161428,273100,MKT
06079804412045001,2020,51789,180511,232300,OVR
06079804412045001,2019,51789,180511,232300,MKT
06079804412055002,2021,111672,163328,275000,MKT
06079804412055002,2020,51789,180511,232300,MKT
06079804412055002,2019,51789,180511,232300,MKT
06079804412065001,2021,111672,163328,275000,MKT
06079804412065001,2020,51789,180511,232300,MKT
06079804412065001,2019,51789,180511,232300,MKT
06079804412075002,2021,111672,163328,275000,MKT
06079804412075002,2020,51789,180511,232300,MKT
06079804412075002,2019,51789,180511,232300,MKT
06079804412085001,2021,111672,163328,275000,MKT
06079804412085001,2020,51789,180511,232300,MKT
06079804412085001,2019,51789,180511,232300,MKT
06079804412095002,2021,111672,163328,275000,MKT
06079804412095002,2020,51789,180511,232300,MKT
06079804412095002,2019,51789,180511,232300,MKT
06079804412105001,2021,111672,161328,273000,MKT
06079804412105001,2020,51789,178911,230700,MKT
06079804412105001,2019,51789,178911,230700,MKT
06079804412115002,2021,111672,163428,275100,MKT
06079804412115002,2020,51789,180611,232400,MKT
06079804412115002,2019,51789,180611,232400,MKT
06079804412140000,2021,156408,599892,756300,INCOME
06079804412140000,2020,99961,563239,663200,INCOME
06079804412140000,2019,99961,563239,663200,INCOME
06079804412160000,2021,134610,509390,644000,INCOME
06079804412160000,2020,74577,432123,506700,INCOME
06079804412160000,2019,74577,432123,506700,INCOME
06079804412187000,2021,200380,0,200380,COST
06079804412187000,2020,188400,0,188400,COST
06079804412187000,2019,188400,0,188400,COST
06079804412305005,2021,110417,0,110417,COST
06079804412305005,2020,69571,0,69571,COST
06079804412305005,2019,69571,0,69571,COST
06079804412315004,2021,94921,0,94921,COST
06079804412315004,2020,51789,0,51789,COST
06079804412315004,2019,51789,0,51789,COST
06079804412325003,2021,94921,0,94921,COST
06079804412325003,2020,51789,0,51789,COST
06079804412325003,2019,51789,0,51789,COST
06079804412335002,2021,94921,0,94921,COST
06079804412335002,2020,51789,0,51789,COST
06079804412335002,2019,51789,0,51789,COST
06079804412345001,2021,102967,0,102967,COST
06079804412345001,2020,60704,0,60704,COST
06079804412345001,2019,60704,0,60704,COST
06079804412355004,2021,100009,184891,284900,MKT
06079804412355004,2020,57346,198854,256200,MKT
06079804412355004,2019,57346,198854,256200,MKT
06079804412385003,2021,94921,169079,264000,MKT
06079804412385003,2020,51789,182311,234100,MKT
06079804412385003,2019,51789,182311,234100,MKT
06079804412405002,2021,94921,169079,264000,MKT
06079804412405002,2020,51789,182311,234100,MKT
06079804412405002,2019,51789,182311,234100,MKT
06079804412425001,2021,103831,185169,289000,MKT
06079804412425001,2020,61702,199098,260800,MKT
06079804412425001,2019,61702,199098,260800,MKT
06079804412445005,2021,101142,215958,317100,MKT
06079804412445005,2020,58621,224879,283500,MKT
06079804412445005,2019,58621,224879,283500,MKT
06079804412465004,2021,94921,174679,269600,MKT
06079804412465004,2020,51789,183511,235300,MKT
06079804412465004,2019,51789,183511,235300,MKT
06079804412485003,2021,94921,183779,278700,MKT
06079804412485003,2020,51789,199711,251500,MKT
06079804412485003,2019,51789,199711,251500,MKT
06079804412505002,2021,94921,174479,269400,MKT
06079804412505002,2020,51789,183311,235100,MKT
06079804412505002,2019,51789,183311,235100,MKT
06079804412525001,2021,102779,266421,369200,MKT
06079804412525001,2020,60487,284913,345400,OVR
06079804412525001,2019,60487,284913,345400,MKT
06079804412545005,2021,99951,220649,320600,MKT
06079804412545005,2020,57281,234519,291800,OVR
06079804412545005,2019,57281,234519,291800,MKT
06079804412565004,2021,94921,219379,314300,MKT
06079804412565004,2020,51789,228611,280400,MKT
06079804412565004,2019,51789,236011,287800,MKT
06079804412585003,2021,94921,224879,319800,MKT
06079804412585003,2020,51789,238711,290500,MKT
06079804412585003,2019,51789,244211,296000,MKT
06079804412605002,2021,94921,222379,317300,MKT
06079804412605002,2020,51789,235211,287000,MKT
06079804412605002,2019,51789,240411,292200,MKT
06079804412625001,2021,112512,261788,374300,MKT
06079804412625001,2020,72171,282729,354900,MKT
06079804412625001,2019,72171,282729,354900,MKT
06079804413010000,2021,134223,469377,603600,INCOME
06079804413010000,2020,86179,412021,498200,INCOME
06079804413010000,2019,86179,412021,498200,INCOME
06079804413037000,2021,128044,0,128044,COST
06079804413037000,2020,78605,0,78605,COST
06079804413037000,2019,78605,0,78605,COST
06079804413050000,2021,128044,515956,644000,INCOME
06079804413050000,2020,78605,428095,506700,INCOME
06079804413050000,2019,78605,428095,506700,INCOME
06079804413070000,2021,128044,515956,644000,INCOME
06079804413070000,2020,78605,343695,422300,INCOME
06079804413070000,2019,78605,343695,422300,INCOME
06079804413090000,2021,128044,515956,644000,INCOME
06079804413090000,2020,78605,343695,422300,INCOME
06079804413090000,2019,78605,343695,422300,INCOME
06079804413110000,2021,128044,515956,644000,INCOME
06079804413110000,2020,78605,428095,506700,INCOME
06079804413110000,2019,78605,428095,506700,INCOME
06079804413130000,2021,128044,515956,644000,INCOME
06079804413130000,2020,78605,428095,506700,INCOME
06079804413130000,2019,78605,428095,506700,INCOME
06079804413150000,2021,128044,515956,644000,INCOME
06079804413150000,2020,78605,428095,506700,INCOME
06079804413150000,2019,78605,428095,506700,INCOME
06079804413170000,2021,128044,515956,644000,INCOME
06079804413170000,2020,78605,428095,506700,INCOME
06079804413170000,2019,78605,428095,506700,INCOME
06079804413190000,2021,128044,515956,644000,INCOME
06079804413190000,2020,78605,428095,506700,INCOME
06079804413190000,2019,78605,428095,506700,INCOME
06079804413210000,2021,144908,499092,644000,INCOME
06079804413210000,2020,86118,420582,506700,INCOME
06079804413210000,2019,86118,420582,506700,INCOME
06079804413230000,2021,144797,499203,644000,INCOME
06079804413230000,2020,85989,420711,506700,INCOME
06079804413230000,2019,85989,420711,506700,INCOME
06079804413250000,2021,138287,423613,561900,INCOME
06079804413250000,2020,78605,342495,421100,INCOME
06079804413250000,2019,78605,342495,421100,INCOME
06079804413270000,2021,138287,505713,644000,INCOME
06079804413270000,2020,78605,428095,506700,INCOME
06079804413270000,2019,78605,428095,506700,INCOME
06079804413290000,2021,138287,505713,644000,INCOME
06079804413290000,2020,78605,428095,506700,INCOME
06079804413290000,2019,78605,428095,506700,INCOME
06079804413317000,2021,138287,0,138287,COST
06079804413317000,2020,78605,0,78605,COST
06079804413317000,2019,78605,0,78605,COST
06079804413330000,2021,128044,515956,644000,INCOME
06079804413330000,2020,78605,428095,506700,INCOME
06079804413330000,2019,78605,428095,506700,INCOME
06079804413350000,2021,128044,515956,644000,INCOME
06079804413350000,2020,78605,428095,506700,INCOME
06079804413350000,2019,78605,428095,506700,INCOME
06079804413370000,2021,128044,515956,644000,INCOME
06079804413370000,2020,78605,497695,576300,INCOME
06079804413370000,2019,78605,497695,576300,INCOME
06079804413397000,2021,128044,0,128044,COST
06079804413397000,2020,78605,0,78605,COST
06079804413397000,2019,78605,0,78605,COST
06079804413410000,2021,128044,515956,644000,INCOME
06079804413410000,2020,78605,428095,506700,INCOME
06079804413410000,2019,78605,428095,506700,INCOME
06079804413430000,2021,134223,509777,644000,INCOME
06079804413430000,2020,86179,420521,506700,INCOME
06079804413430000,2019,86179,420521,506700,INCOME
06079804414010000,2021,147341,496659,644000,INCOME
06079804414010000,2020,107290,399410,506700,INCOME
06079804414010000,2019,107290,399410,506700,INCOME
06079804414037000,2021,147341,0,147341,COST
06079804414037000,2020,107290,0,107290,COST
06079804414037000,2019,107290,0,107290,COST
06079804414050000,2021,147341,496659,644000,INCOME
06079804414050000,2020,107290,469010,576300,INCOME
06079804414050000,2019,107290,469010,576300,INCOME
06079804414077000,2021,152328,0,152328,COST
06079804414077000,2020,114492,0,114492,COST
06079804414077000,2019,114492,0,114492,COST
06079804414096500,2021,87776,0,87776,COST
06079804414096500,2020,118330,0,118330,COST
06079804414096500,2019,118330,0,118330,COST
06079804414116500,2021,65415,0,65415,COST
06079804414116500,2020,66658,0,66658,COST
06079804414116500,2019,66658,0,66658,COST
06079804415020000,2021,114109,237891,352000,MKT
06079804415020000,2020,70690,235810,306500,MKT
06079804415020000,2019,70690,235810,306500,MKT
06079804415040000,2021,112351,301849,414200,MKT
06079804415040000,2020,68581,277319,345900,MKT
06079804415040000,2019,68581,277319,345900,MKT
06079804415060000,2021,112284,319216,431500,MKT
06079804415060000,2020,68501,300699,369200,MKT
06079804415060000,2019,68501,300699,369200,MKT
06079804415080000,2021,112217,256983,369200,MKT
06079804415080000,2020,68420,255480,323900,MKT
06079804415080000,2019,68420,255480,323900,MKT
06079804415100000,2021,112153,237547,349700,MKT
06079804415100000,2020,68345,235455,303800,MKT
06079804415100000,2019,68345,235455,303800,MKT
06079804415120000,2021,112086,211014,323100,MKT
06079804415120000,2020,68264,201336,269600,MKT
06079804415120000,2019,68264,201336,269600,MKT
06079804415140000,2021,111225,194075,305300,MKT
06079804415140000,2020,67245,182855,250100,MKT
06079804415140000,2019,67245,182855,250100,MKT
06079804415160000,2021,111180,211220,322400,MKT
06079804415160000,2020,67192,201608,268800,MKT
06079804415160000,2019,67192,201608,268800,MKT
06079804415180000,2021,111168,200732,311900,MKT
06079804415180000,2020,67178,189522,256700,MKT
06079804415180000,2019,67178,189522,256700,MKT
06079804415200000,2021,113621,211379,325000,MKT
06079804415200000,2020,70101,201799,271900,MKT
06079804415200000,2019,70101,201799,271900,MKT
06079804415220000,2021,167640,336160,503800,MKT
06079804415220000,2020,138030,324270,462300,MKT
06079804415220000,2019,138030,324270,462300,MKT
06079804416020000,2021,138944,252956,391900,MKT
06079804416020000,2020,92194,256506,348700,MKT
06079804416020000,2019,92194,256506,348700,MKT
06079804416040000,2021,127952,296648,424600,MKT
06079804416040000,2020,78495,289405,367900,MKT
06079804416040000,2019,78495,289405,367900,MKT
06079804416060000,2021,130139,338961,469100,MKT
06079804416060000,2020,81135,347265,428400,MKT
06079804416060000,2019,81135,347265,428400,MKT
06079804416080000,2021,123239,293961,417200,MKT
06079804416080000,2020,72951,295349,368300,MKT
06079804416080000,2019,72951,295349,368300,MKT
06079804416100000,2021,130139,292861,423000,MKT
06079804416100000,2020,81135,277365,358500,MKT
06079804416100000,2019,81135,277365,358500,MKT
06079804416120000,2021,127952,389148,517100,MKT
06079804416120000,2020,78495,370405,448900,MKT
06079804416120000,2019,78495,370405,448900,MKT
06079804416146500,2021,38392,0,38392,COST
06079804416146500,2020,23556,0,23556,COST
06079804416146500,2019,23556,0,23556,COST
06079804416160000,2021,127962,286338,414300,MKT
06079804416160000,2020,78507,261393,339900,MKT
06079804416160000,2019,78507,261393,339900,MKT
06079804416180000,2021,130139,301061,431200,MKT
06079804416180000,2020,81135,284165,365300,MKT
06079804416180000,2019,81135,284165,365300,MKT
06079804416200000,2021,125635,291865,417500,MKT
06079804416200000,2020,75745,285255,361000,MKT
06079804416200000,2019,75745,285255,361000,MKT
06079804416220000,2021,127671,200429,328100,MKT
06079804416220000,2020,78159,191041,269200,MKT
06079804416220000,2019,78159,191041,269200,MKT
06079804416240000,2021,132853,282147,415000,MKT
06079804416240000,2020,84470,261590,346060,COST
06079804416240000,2019,84470,0,84470,COST
06079804416260000,2021,127952,294748,422700,MKT
06079804416260000,2020,78495,289905,368400,MKT
06079804416260000,2019,78495,289905,368400,MKT
06079804416280000,2021,127952,308948,436900,MKT
06079804416280000,2020,78495,328705,407200,MKT
06079804416280000,2019,78495,328705,407200,MKT
06079804416300000,2021,127962,292138,420100,MKT
06079804416300000,2020,78507,286393,364900,MKT
06079804416300000,2019,78507,286393,364900,MKT
06079804416320000,2021,125544,281756,407300,MKT
06079804416320000,2020,75638,280162,355800,MKT
06079804416320000,2019,75638,280162,355800,MKT
06079804416340000,2021,125555,0,125555,COST
06079804416340000,2020,75650,0,75650,COST
06079804416340000,2019,75650,0,75650,COST
06079804416360000,2021,128964,280836,409800,MKT
06079804416360000,2020,79711,279689,359400,MKT
06079804416360000,2019,79711,279689,359400,MKT
06079804416380000,2021,125555,298845,424400,MKT
06079804416380000,2020,75650,292350,368000,MKT
06079804416380000,2019,75650,292350,368000,MKT
06079804416400000,2021,125555,363845,489400,MKT
06079804416400000,2020,75650,336950,412600,MKT
06079804416400000,2019,75650,336950,412600,MKT
06079804416420000,2021,136701,276799,413500,MKT
06079804416420000,2020,89312,263988,353300,MKT
06079804416420000,2019,89312,263988,353300,MKT
06079804417020000,2021,136701,295899,432600,MKT
06079804417020000,2020,89312,280388,369700,MKT
06079804417020000,2019,89312,280388,369700,MKT
06079804417040000,2021,127517,273083,400600,MKT
06079804417040000,2020,77976,257224,335200,MKT
06079804417040000,2019,77976,257224,335200,MKT
06079804417060000,2021,127517,301183,428700,MKT
06079804417060000,2020,77976,289924,367900,MKT
06079804417060000,2019,77976,289924,367900,MKT
06079804417080000,2021,127517,283583,411100,MKT
06079804417080000,2020,77976,285624,363600,MKT
06079804417080000,2019,77976,285624,363600,MKT
06079804417100000,2021,127517,300183,427700,MKT
06079804417100000,2020,77976,323624,401600,MKT
06079804417100000,2019,77976,323624,401600,MKT
06079804417120000,2021,128514,292986,421500,MKT
06079804417120000,2020,79169,278031,357200,MKT
06079804417120000,2019,79169,278031,357200,MKT
06079804417140000,2021,128514,280186,408700,MKT
06079804417140000,2020,79169,270531,349700,MKT
06079804417140000,2019,79169,270531,349700,MKT
06079804417160000,2021,128514,280186,408700,MKT
06079804417160000,2020,79169,280431,359600,MKT
06079804417160000,2019,79169,280431,359600,MKT
06079804417180000,2021,132853,300447,433300,MKT
06079804417180000,2020,84470,304430,388900,MKT
06079804417180000,2019,84470,304430,388900,MKT
06079804417200000,2021,132600,333700,466300,MKT
06079804417200000,2020,84157,319943,404100,MKT
06079804417200000,2019,84157,319943,404100,MKT
06079804417220000,2021,128509,302991,431500,MKT
06079804417220000,2020,79163,281337,360500,MKT
06079804417220000,2019,79163,281337,360500,MKT
06079804417240000,2021,128514,302986,431500,MKT
06079804417240000,2020,79169,281331,360500,MKT
06079804417240000,2019,79169,281331,360500,MKT
06079804417260000,2021,128514,350586,479100,MKT
06079804417260000,2020,79169,333931,413100,MKT
06079804417260000,2019,79169,333931,413100,MKT
06079804417280000,2021,132080,293120,425200,MKT
06079804417280000,2020,83514,287186,370700,MKT
06079804417280000,2019,83514,287186,370700,MKT
06079804417300000,2021,132080,293120,425200,MKT
06079804417300000,2020,83514,284786,368300,MKT
06079804417300000,2019,83514,284786,368300,MKT
06079804417320000,2021,132080,296520,428600,MKT
06079804417320000,2020,83514,285186,368700,MKT
06079804417320000,2019,83514,285186,368700,MKT
06079804417340000,2021,140654,395546,536200,MKT
06079804417340000,2020,94422,357678,452100,MKT
06079804417340000,2019,94422,357678,452100,MKT
06079804418020000,2021,148284,273616,421900,MKT
06079804418020000,2020,149189,0,149189,COST
06079804418020000,2019,149189,0,149189,COST
06079804418040000,2021,161540,497660,659200,MKT
06079804418040000,2020,128396,478104,606500,MKT
06079804418040000,2019,128396,0,128396,COST
06079804418060000,2021,166539,473161,639700,MKT
06079804418060000,2020,136265,372835,509100,MKT
06079804418060000,2019,136265,372835,509100,MKT
06079804418080000,2021,169689,341311,511000,MKT
06079804418080000,2020,159165,319135,478300,MKT
06079804418080000,2019,159165,0,159165,COST
06079804418100000,2021,140393,323807,464200,MKT
06079804418100000,2020,97638,340762,438400,OVR
06079804418100000,2019,97638,340762,438400,MKT
06079804418120000,2021,141459,488441,629900,MKT
06079804418120000,2020,99090,465510,564600,MKT
06079804418120000,2019,99090,330730,429820,COST
06079804418140000,2021,141459,325841,467300,MKT
06079804418140000,2020,99090,317010,416100,MKT
06079804418140000,2019,99090,306710,405800,MKT
06079804418160000,2021,141459,289441,430900,MKT
06079804418160000,2020,99090,278710,377800,MKT
06079804418160000,2019,99090,278710,377800,MKT
06079804418180000,2021,145824,404976,550800,MKT
06079804418180000,2020,105146,401854,507000,MKT
06079804418180000,2019,105146,0,105146,COST
06079804418200000,2021,145824,487976,633800,MKT
06079804418200000,2020,105146,465254,570400,MKT
06079804418200000,2019,105146,330730,435876,COST
06079804418220000,2021,141459,290241,431700,MKT
06079804418220000,2020,99090,285210,384300,MKT
06079804418220000,2019,99090,285210,384300,MKT
06079804418240000,2021,141459,326541,468000,MKT
06079804418240000,2020,99090,312610,411700,MKT
06079804418240000,2019,99090,312610,411700,MKT
06079804418260000,2021,148647,302353,451000,MKT
06079804418260000,2020,109155,320845,430000,MKT
06079804418260000,2019,109155,320845,430000,MKT
06079804418286500,2021,124416,0,124416,COST
06079804418286500,2020,89115,0,89115,COST
06079804418286500,2019,89115,0,89115,COST
06079804418306500,2021,232824,0,232824,COST
06079804418306500,2020,165292,0,165292,COST
06079804418306500,2019,165292,0,165292,COST
06079804418350000,2021,130226,0,130226,COST
06079804418400000,2021,153207,0,153207,COST
06079804418450000,2021,148565,0,148565,COST
06079804418500000,2021,154016,0,154016,COST
06079804418556500,2021,73925,0,73925,COST
06079804419030000,2021,138964,505036,644000,INCOME
06079804419030000,2020,95707,480593,576300,INCOME
06079804419030000,2019,95707,278450,374157,COST
06079804419057000,2021,214421,0,214421,COST
06079804419057000,2020,200295,0,200295,COST
06079804419057000,2019,95356,278450,373806,COST
06079804419070000,2021,138434,611590,750024,COST
06079804419070000,2020,94995,518320,613315,COST
06079804419070000,2019,7,0,7,COST
06079804419090000,2021,138163,611590,749753,COST
06079804419090000,2020,94634,518320,612954,COST
06079804419090000,2019,7,0,7,COST
06079804419116500,2021,37462,0,37462,COST
06079804419116500,2020,22456,0,22456,COST
06079804419116500,2019,22456,0,22456,COST
06079804419130000,2021,137761,0,137761,COST
06079804419130000,2020,94096,0,94096,COST
06079804419130000,2019,94096,0,94096,COST
06079804419177000,2021,137211,0,137211,COST
06079804419177000,2020,93365,0,93365,COST
06079804419177000,2019,93365,0,93365,COST
06079804419190000,2021,141646,611590,753236,COST
06079804419190000,2020,99346,518320,617666,COST
06079804419190000,2019,99346,0,99346,COST
06079804420030000,2021,124326,519674,644000,INCOME
06079804420030000,2020,74212,502088,576300,INCOME
06079804420030000,2019,74212,0,74212,COST
06079804420070000,2021,124326,0,124326,COST
06079804420070000,2020,74212,0,74212,COST
06079804420070000,2019,74212,0,74212,COST
06079804420090000,2021,124326,650200,774526,COST
06079804420090000,2020,74212,562730,636942,COST
06079804420090000,2019,74212,289330,363542,COST
06079804420117000,2021,124326,0,124326,COST
06079804420117000,2020,74212,0,74212,COST
06079804420117000,2019,74212,0,74212,COST
06079804420137000,2021,149488,0,149488,COST
06079804420137000,2020,74212,0,74212,COST
06079804420137000,2019,74212,197380,271592,COST
06079804420170000,2021,128619,640570,769189,COST
06079804420170000,2020,79296,0,79296,COST
06079804420170000,2019,79296,0,79296,COST
06079804420197000,2021,138909,0,138909,COST
06079804420197000,2020,79296,0,79296,COST
06079804420197000,2019,79296,0,79296,COST
06079804420217000,2021,134272,0,134272,COST
06079804420217000,2020,74212,0,74212,COST
06079804420217000,2019,74212,0,74212,COST
06079804420237000,2021,134272,0,134272,COST
06079804420237000,2020,74212,0,74212,COST
06079804420237000,2019,74212,0,74212,COST
06079804420250000,2021,134272,509728,644000,INCOME
06079804420250000,2020,74212,502088,576300,INCOME
06079804420250000,2019,74212,0,74212,COST
06079804420270000,2021,124326,519674,644000,INCOME
06079804420270000,2020,74212,502088,576300,INCOME
06079804420270000,2019,74212,0,74212,COST
06079804420290000,2021,124326,519674,644000,INCOME
06079804420290000,2020,74212,502088,576300,INCOME
06079804420290000,2019,74212,0,74212,COST
06079804420310000,2021,124326,519674,644000,INCOME
06079804420310000,2020,74212,502088,576300,INCOME
06079804420310000,2019,74212,0,74212,COST
06079804420330000,2021,124326,519674,644000,INCOME
06079804420330000,2020,74212,502088,576300,INCOME
06079804420330000,2019,74212,0,74212,COST
06079804420350000,2021,128619,515381,644000,INCOME
06079804420350000,2020,79296,497004,576300,INCOME
06079804420350000,2019,8,0,8,COST
06079804421010000,2021,136759,507241,644000,INCOME
06079804421010000,2020,7,0,7,COST
06079804421010000,2019,7,0,7,COST
06079804421030000,2021,136759,0,136759,COST
06079804421030000,2020,74212,0,74212,COST
06079804421030000,2019,7,0,7,COST
06079804421050000,2021,136759,0,136759,COST
06079804421050000,2020,92765,0,92765,COST
06079804421050000,2019,7,0,7,COST
06079804421070000,2021,136759,507241,644000,INCOME
06079804421070000,2020,74212,0,74212,COST
06079804421070000,2019,7,0,7,COST
06079804421097000,2021,128619,0,128619,COST
06079804421097000,2020,79296,214670,293966,COST
06079804421097000,2019,10,0,10,COST
06079804421110000,2021,136759,0,136759,COST
06079804421130000,2021,136759,0,136759,COST
06079804421150000,2021,136686,0,136686,COST
06079804422017000,2021,126980,0,126980,COST
06079804422017000,2020,77335,0,77335,COST
06079804422017000,2019,8,0,8,COST
06079804422030000,2021,130348,513652,644000,INCOME
06079804422030000,2020,8,0,8,COST
06079804422030000,2019,8,0,8,COST
06079804422050000,2021,129341,514659,644000,INCOME
06079804422050000,2020,8,0,8,COST
06079804422050000,2019,8,0,8,COST
06079804422070000,2021,128160,515840,644000,INCOME
06079804422070000,2020,8,0,8,COST
06079804422070000,2019,8,0,8,COST
06079804422090000,2021,132581,607319,739900,INCOME
06079804422090000,2020,84134,494966,579100,INCOME
06079804422090000,2019,84134,0,84134,COST
06079804422110000,2021,135893,466407,602300,INCOME
06079804422110000,2020,88285,415915,504200,INCOME
06079804422110000,2019,88285,0,88285,COST
06079804422130000,2021,130497,0,130497,COST
06079804422150000,2021,125881,0,125881,COST
06079804422170000,2021,126526,0,126526,COST
06079804422190000,2021,129321,0,129321,COST
06079804422210000,2021,133300,0,133300,COST
06079804422230000,2021,134259,0,134259,COST
06079804423010000,2021,244416,0,244416,COST
06079804423010000,2020,63,0,63,COST
06079804423010000,2019,63,0,63,COST
06079804423040000,2021,245853,0,245853,COST
06079804423040000,2020,64,0,64,COST
06079804423040000,2019,64,0,64,COST
06079804423070000,2021,244032,0,244032,COST
06079804423070000,2020,63,0,63,COST
06079804423070000,2019,63,0,63,COST
06079804423100000,2021,248652,0,248652,COST
06079804423100000,2020,67,0,67,COST
06079804423100000,2019,67,0,67,COST
06079804423156500,2021,69869,0,69869,COST
06079804423156500,2020,75803,0,75803,COST
06079804423156500,2019,75803,0,75803,COST
06079804424010000,2021,133309,0,133309,COST
06079804424030000,2021,124326,327074,451400,MKT
06079804424050000,2021,124326,298674,423000,MKT
06079804424070000,2021,125172,0,125172,COST
06079804424090000,2021,142335,0,142335,COST
06079804424110000,2021,140014,0,140014,COST
06079804424130000,2021,148978,0,148978,COST
06079804424150000,2021,151758,0,151758,COST
06079804424170000,2021,155930,0,155930,COST
06079804424190000,2021,149710,0,149710,COST
06079804424210000,2021,151516,0,151516,COST
06079804424230000,2021,156975,0,156975,COST
06079805101010000,2021,34987,0,34987,COST
06079805101010000,2020,44816,0,44816,COST
06079805101010000,2019,44816,0,44816,COST
06079805101030000,2021,62024,2650,64674,COST
06079805101030000,2020,60304,2560,62864,COST
06079805101030000,2019,60304,2560,62864,COST
06079805101050000,2021,195900,264200,460100,MKT
06079805101050000,2020,163100,218300,381400,MKT
06079805101050000,2019,163100,218300,381400,MKT
06079805102010000,2021,344259,210041,554300,MKT
06079805102010000,2020,307127,163780,470907,COST
06079805102010000,2019,307127,163780,470907,COST
06079805102030000,2021,321787,307313,629100,MKT
06079805102030000,2020,284713,272630,557343,COST
06079805102030000,2019,284713,272630,557343,COST
06079805201010000,2021,57915,0,57915,COST
06079805201010000,2020,56101,0,56101,COST
06079805201010000,2019,56101,0,56101,COST
06079805201100000,2021,2104,0,2104,COST
06079805201100000,2020,28351,0,28351,COST
06079805201100000,2019,28351,0,28351,COST
06079805301010000,2021,162454,86690,249144,COST
06079805301010000,2020,152641,89760,242401,COST
06079805301010000,2019,152641,89760,242401,COST
06079805401010000,2021,3321,0,3321,COST
06079805401010000,2020,3090,0,3090,COST
06079805401010000,2019,3090,0,3090,COST
06079805401350000,2021,419213,309920,729133,COST
06079805401350000,2020,383137,280160,663297,COST
06079805401350000,2019,383137,280160,663297,COST
06079805401400000,2021,554,0,554,COST
06079805401400000,2020,515,0,515,COST
06079805401400000,2019,515,0,515,COST
06079805406010000,2021,310348,387680,698028,COST
06079805406010000,2020,273377,347510,620887,COST
06079805406010000,2019,273377,347510,620887,COST
06079806101020000,2021,353071,876930,1230001,COST
06079806101020000,2020,315967,797320,1113287,COST
06079806101020000,2019,315967,797320,1113287,COST
06079806101050000,2021,543013,1471820,2014833,COST
06079806101050000,2020,377693,1389490,1767183,COST
06079806101050000,2019,377693,1389490,1767183,COST
06079806101200000,2021,733,0,733,COST
06079806101200000,2020,937,0,937,COST
06079806101200000,2019,937,0,937,COST
06079806102010000,2021,35,0,35,COST
06079806102010000,2020,32,0,32,COST
06079806102010000,2019,32,0,32,COST
06079806102030000,2021,43,0,43,COST
06079806102030000,2020,40,0,40,COST
06079806102030000,2019,40,0,40,COST
06079806102050000,2021,38,0,38,COST
06079806102050000,2020,35,0,35,COST
06079806102050000,2019,35,0,35,COST
06079806102070000,2021,253328,0,253328,COST
06079806102070000,2020,252900,0,252900,COST
06079806102070000,2019,252900,0,252900,COST
06079806102090000,2021,264128,0,264128,COST
06079806102090000,2020,262386,0,262386,COST
06079806102090000,2019,262386,0,262386,COST
06079806102110000,2021,269544,1832100,2101644,COST
06079806102110000,2020,267125,1717260,1984385,COST
06079806102110000,2019,267125,871850,1138975,COST
06079806102130000,2021,30,0,30,COST
06079806102130000,2020,28,0,28,COST
06079806102130000,2019,28,0,28,COST
06079806102150000,2021,37,0,37,COST
06079806102150000,2020,35,0,35,COST
06079806102150000,2019,35,0,35,COST
06079806102170000,2021,38,0,38,COST
06079806102170000,2020,35,0,35,COST
06079806102170000,2019,35,0,35,COST
06079806103030000,2021,140651,697520,838171,COST
06079806103030000,2020,139007,670480,809487,COST
06079806103030000,2019,139007,670480,809487,COST
06079806103050000,2021,156984,927816,1084800,MKT
06079806103050000,2020,153150,847750,1000900,MKT
06079806103050000,2019,153150,847750,1000900,MKT
06079806103070000,2021,156443,1011557,1168000,MKT
06079806103070000,2020,152685,347630,500315,COST
06079806103070000,2019,152685,0,152685,COST
06079806103090000,2021,145538,0,145538,COST
06079806103090000,2020,143259,0,143259,COST
06079806103090000,2019,143259,0,143259,COST
06079806103110000,2021,150864,873436,1024300,MKT
06079806103110000,2020,147872,830400,978272,COST
06079806103110000,2019,147872,830400,978272,COST
06079806103130000,2021,221529,812971,1034500,MKT
06079806103130000,2020,157215,840685,997900,MKT
06079806103130000,2019,157215,840685,997900,MKT
06079806103150000,2021,199367,0,199367,COST
06079806103150000,2020,143259,0,143259,COST
06079806103150000,2019,143259,0,143259,COST
06079806103170000,2021,212211,840989,1053200,MKT
06079806103170000,2020,151368,866420,1017788,COST
06079806103170000,2019,151368,869140,1020508,COST
06079806103190000,2021,204759,836241,1041000,MKT
06079806103190000,2020,146670,726930,873600,MKT
06079806103190000,2019,146670,726930,873600,MKT
06079806103210000,2021,204117,0,204117,COST
06079806103210000,2020,146265,0,146265,COST
06079806103210000,2019,146265,0,146265,COST
06079806103230000,2021,209775,0,209775,COST
06079806103230000,2020,149834,0,149834,COST
06079806103230000,2019,149834,0,149834,COST
06079806103250000,2021,199367,0,199367,COST
06079806103250000,2020,143259,0,143259,COST
06079806103250000,2019,143259,0,143259,COST
06079806103270000,2021,203634,936366,1140000,MKT
06079806103270000,2020,145960,853940,999900,MKT
06079806103270000,2019,145960,853940,999900,MKT
06079806103290000,2021,202010,771190,973200,MKT
06079806103290000,2020,144933,712567,857500,MKT
06079806103290000,2019,144933,712567,857500,MKT
06079806103310000,2021,202663,897450,1100113,COST
06079806103310000,2020,145345,897690,1043035,OVR
06079806103310000,2019,145345,897690,1043035,COST
06079806103330000,2021,204117,0,204117,COST
06079806103330000,2020,146265,0,146265,COST
06079806103330000,2019,146265,0,146265,COST
06079806103350000,2021,152686,0,152686,COST
06079806103350000,2020,149446,0,149446,COST
06079806103350000,2019,149446,0,149446,COST
06079806103370000,2021,144926,0,144926,COST
06079806103370000,2020,142728,0,142728,COST
06079806103370000,2019,142728,0,142728,COST
06079806103390000,2021,146145,0,146145,COST
06079806103390000,2020,143786,0,143786,COST
06079806103390000,2019,143786,0,143786,COST
06079806103410000,2021,143258,0,143258,COST
06079806103410000,2020,112889,0,112889,COST
06079806103410000,2019,112889,0,112889,COST
06079806103430000,2021,258408,0,258408,COST
06079806103430000,2020,180083,0,180083,COST
06079806103430000,2019,180083,0,180083,COST
06079806103450000,2021,197682,0,197682,COST
06079806103450000,2020,113619,0,113619,COST
06079806103450000,2019,113619,0,113619,COST
06079806103470000,2021,138305,0,138305,COST
06079806103470000,2020,109440,0,109440,COST
06079806103470000,2019,109440,0,109440,COST
06079806103490000,2021,128692,0,128692,COST
06079806103490000,2020,102703,0,102703,COST
06079806103490000,2019,102703,0,102703,COST
06079806104010000,2021,243687,0,243687,COST
06079806104010000,2020,195284,0,195284,COST
06079806104010000,2019,195284,0,195284,COST
06079806104030000,2021,229059,477530,706589,COST
06079806104030000,2020,184909,0,184909,COST
06079806104030000,2019,184909,0,184909,COST
06079806104050000,2021,210423,0,210423,COST
06079806104050000,2020,171575,0,171575,COST
06079806104050000,2019,171575,0,171575,COST
06079806104070000,2021,199089,0,199089,COST
06079806104070000,2020,163398,0,163398,COST
06079806104070000,2019,163398,0,163398,COST
06079806104090000,2021,242155,1212945,1455100,MKT
06079806104090000,2020,194201,1111640,1305841,COST
06079806104090000,2019,194201,1095580,1289781,COST
06079806104110000,2021,362254,2086720,2448974,COST
06079806104110000,2020,346689,1976260,2322949,COST
06079806104110000,2019,346689,1976260,2322949,COST
06079806104150000,2021,215782,973518,1189300,MKT
06079806104150000,2020,153612,902688,1056300,MKT
06079806104150000,2019,153612,902688,1056300,MKT
06079806104170000,2021,210082,1186518,1396600,MKT
06079806104170000,2020,150028,1344072,1494100,MKT
06079806104170000,2019,150028,1344072,1494100,MKT
06079806104190000,2021,286651,0,286651,COST
06079806104190000,2020,282022,0,282022,COST
06079806104190000,2019,282022,0,282022,COST
06079806104210000,2021,269176,0,269176,COST
06079806104210000,2020,266804,0,266804,COST
06079806104210000,2019,266804,0,266804,COST
06079806104230000,2021,235903,0,235903,COST
06079806104230000,2020,237494,0,237494,COST
06079806104230000,2019,237494,0,237494,COST
06079806104250000,2021,274253,938347,1212600,MKT
06079806104250000,2020,271237,826620,1097857,COST
06079806104250000,2019,271237,826620,1097857,COST
06079806104270000,2021,205237,991763,1197000,MKT
06079806104270000,2020,146973,960427,1107400,MKT
06079806104270000,2019,146973,960427,1107400,MKT
06079806104290000,2021,212813,0,212813,COST
06079806104290000,2020,151747,0,151747,COST
06079806104290000,2019,151747,0,151747,COST
06079806104310000,2021,194425,0,194425,COST
06079806104310000,2020,140122,0,140122,COST
06079806104310000,2019,140122,0,140122,COST
06079806104330000,2021,188539,865361,1053900,MKT
06079806104330000,2020,136374,730326,866700,MKT
06079806104330000,2019,136374,730326,866700,MKT
06079806104350000,2021,250249,0,250249,COST
06079806104350000,2020,250187,0,250187,COST
06079806104350000,2019,250187,0,250187,COST
06079806104370000,2021,342673,0,342673,COST
06079806104370000,2020,243812,0,243812,COST
06079806104370000,2019,243812,0,243812,COST
06079806104390000,2021,259310,0,259310,COST
06079806104390000,2020,258160,0,258160,COST
06079806104390000,2019,258160,0,258160,COST
06079806104410000,2021,223067,920333,1143400,MKT
06079806104410000,2020,158177,882523,1040700,MKT
06079806104410000,2019,158177,882523,1040700,MKT
06079806104430000,2021,268623,712777,981400,MKT
06079806104430000,2020,266320,731400,997720,COST
06079806104430000,2019,266320,731400,997720,COST
06079806104450000,2021,245404,814896,1060300,MKT
06079806104450000,2020,245911,716130,962041,COST
06079806104450000,2019,245911,0,245911,COST
06079806201070000,2021,10946,309120,320066,COST
06079806201070000,2020,10593,280030,290623,COST
06079806201070000,2019,10593,280030,290623,COST
06079806201200000,2021,196175,670400,866575,COST
06079806201200000,2020,163356,596828,760184,OVR
06079806201200000,2019,164554,595630,760184,COST
06079806201400000,2021,1858,0,1858,COST
06079806201400000,2020,1729,0,1729,COST
06079806201400000,2019,608,0,608,COST
06079806201600000,2021,1195,23470,24665,COST
06079806201600000,2020,1112,0,1112,COST
06079806201600000,2019,1035,0,1035,COST
06079806201650000,2021,284331,688169,972500,MKT
06079806201650000,2020,247785,547115,794900,OVR
06079806201650000,2019,247785,566620,814405,COST
06079806301010000,2021,48758,0,48758,COST
06079806301010000,2020,66787,0,66787,COST
06079806301010000,2019,66787,0,66787,COST
06079806301040000,2021,123637,0,123637,COST
06079806301040000,2020,99137,0,99137,COST
06079806301040000,2019,99137,0,99137,COST
06079806301060000,2021,126061,0,126061,COST
06079806301060000,2020,100849,0,100849,COST
06079806301060000,2019,100849,0,100849,COST
06079806301080000,2021,133045,801655,934700,MKT
06079806301080000,2020,105761,689339,795100,MKT
06079806301080000,2019,105761,642539,748300,MKT
06079806301100000,2021,153248,0,153248,COST
06079806301100000,2020,149931,0,149931,COST
06079806301100000,2019,149931,0,149931,COST
06079806301120000,2021,146989,0,146989,COST
06079806301120000,2020,144518,0,144518,COST
06079806301120000,2019,144518,0,144518,COST
06079806301140000,2021,150749,753951,904700,MKT
06079806301140000,2020,147773,719027,866800,MKT
06079806301140000,2019,147773,719027,866800,MKT
06079806301160000,2021,164250,1646800,1811050,COST
06079806301160000,2020,159386,1551460,1710846,COST
06079806301160000,2019,159386,1551460,1710846,COST
06079806301180000,2021,155791,1237140,1392931,COST
06079806301180000,2020,152123,1166777,1318900,MKT
06079806301180000,2019,152123,1166777,1318900,MKT
06079806301206500,2021,63468,39310,102778,COST
06079806301206500,2020,45260,38020,83280,COST
06079806301206500,2019,45260,38020,83280,COST
06079806301220000,2021,284646,0,284646,COST
06079806301220000,2020,280281,0,280281,COST
06079806301220000,2019,280281,0,280281,COST
06079806301240000,2021,276206,0,276206,COST
06079806301240000,2020,272940,0,272940,COST
06079806301240000,2019,272940,0,272940,COST
06079806301260000,2021,265641,0,265641,COST
06079806301260000,2020,263710,0,263710,COST
06079806301260000,2019,263710,0,263710,COST
06079806301280000,2021,388992,1664800,2053792,COST
06079806301280000,2020,369161,1562130,1931291,COST
06079806301280000,2019,369161,1562130,1931291,COST
06079806301306500,2021,60139,0,60139,COST
06079806301306500,2020,43160,0,43160,COST
06079806301306500,2019,43160,0,43160,COST
06079806301320000,2021,214899,0,214899,COST
06079806301320000,2020,153057,0,153057,COST
06079806301320000,2019,153057,0,153057,COST
06079806301340000,2021,311023,0,311023,COST
06079806301340000,2020,303067,0,303067,COST
06079806301340000,2019,303067,0,303067,COST
06079806301360000,2021,289454,0,289454,COST
06079806301360000,2020,284453,0,284453,COST
06079806301360000,2019,284453,0,284453,COST
06079806302010000,2021,244761,825739,1070500,MKT
06079806302010000,2020,245342,790758,1036100,MKT
06079806302010000,2019,245342,533190,778532,COST
06079806302030000,2021,257143,998957,1256100,MKT
06079806302030000,2020,256256,980044,1236300,MKT
06079806302030000,2019,256256,980044,1236300,MKT
06079806302050000,2021,248372,1108928,1357300,MKT
06079806302050000,2020,248531,1026469,1275000,OVR
06079806302050000,2019,248531,1026469,1275000,OVR
06079806302070000,2021,261255,0,261255,COST
06079806302070000,2020,259867,0,259867,COST
06079806302070000,2019,259867,0,259867,COST
06079806302090000,2021,256547,1004253,1260800,MKT
06079806302090000,2020,255732,843750,1099482,COST
06079806302090000,2019,255732,0,255732,COST
06079806302110000,2021,244330,0,244330,COST
06079806302110000,2020,244961,0,244961,COST
06079806302110000,2019,244961,0,244961,COST
06079806302130000,2021,249626,0,249626,COST
06079806302130000,2020,249638,0,249638,COST
06079806302130000,2019,249638,0,249638,COST
06079806302150000,2021,300554,0,300554,COST
06079806302150000,2020,294051,0,294051,COST
06079806302150000,2019,294051,0,294051,COST
06079806302170000,2021,243682,745718,989400,MKT
06079806302170000,2020,244388,746350,990738,COST
06079806302170000,2019,244388,746350,990738,COST
06079806302190000,2021,238840,0,238840,COST
06079806302190000,2020,160000,0,160000,COST
06079806302190000,2019,160000,0,160000,COST
06079806302210000,2021,250663,0,250663,COST
06079806302210000,2020,250553,0,250553,COST
06079806302210000,2019,250553,0,250553,COST
06079806302230000,2021,258722,0,258722,COST
06079806302230000,2020,160000,0,160000,COST
06079806302230000,2019,160000,0,160000,COST
06079806302250000,2021,266016,0,266016,COST
06079806302250000,2020,264039,0,264039,COST
06079806302250000,2019,264039,0,264039,COST
06079806302270000,2021,286983,0,286983,COST
06079806302270000,2020,282310,0,282310,COST
06079806302270000,2019,282310,0,282310,COST
06079806302290000,2021,281764,0,281764,COST
06079806302290000,2020,277778,0,277778,COST
06079806302290000,2019,277778,0,277778,COST
06079806303010000,2021,254139,0,254139,COST
06079806303010000,2020,253614,0,253614,COST
06079806303010000,2019,253614,0,253614,COST
06079806303030000,2021,258525,0,258525,COST
06079806303030000,2020,257471,0,257471,COST
06079806303030000,2019,257471,0,257471,COST
06079806303050000,2021,214306,0,214306,COST
06079806303050000,2020,152685,0,152685,COST
06079806303050000,2019,152685,0,152685,COST
06079806303070000,2021,274788,0,274788,COST
06079806303070000,2020,271703,0,271703,COST
06079806303070000,2019,271703,0,271703,COST
06079806303090000,2021,254139,904561,1158700,MKT
06079806303090000,2020,253614,849580,1103194,COST
06079806303090000,2019,253614,849580,1103194,COST
06079806303110000,2021,263176,0,263176,COST
06079806303110000,2020,261552,0,261552,COST
06079806303110000,2019,261552,0,261552,COST
06079806303130000,2021,237266,1198760,1436026,COST
06079806303130000,2020,238704,1148160,1386864,COST
06079806303130000,2019,238704,1148160,1386864,COST
06079806402010000,2021,206578,796340,1002918,COST
06079806402010000,2020,195796,761850,957646,COST
06079806402010000,2019,195796,761850,957646,COST
06079806402030000,2021,210084,719616,929700,MKT
06079806402030000,2020,198723,682777,881500,MKT
06079806402030000,2019,198723,682777,881500,MKT
06079806402050000,2021,204065,740135,944200,MKT
06079806402050000,2020,193693,755207,948900,MKT
06079806402050000,2019,193693,755207,948900,MKT
06079806402070000,2021,205148,599800,804948,COST
06079806402070000,2020,194600,0,194600,COST
06079806402070000,2019,194600,0,194600,COST
06079806402090000,2021,202606,551740,754346,COST
06079806402090000,2020,192471,0,192471,COST
06079806402090000,2019,192471,0,192471,COST
06079806402110000,2021,203702,708798,912500,MKT
06079806402110000,2020,193389,781111,974500,MKT
06079806402110000,2019,193389,781111,974500,MKT
06079806402130000,2021,196975,776725,973700,MKT
06079806402130000,2020,187746,744554,932300,MKT
06079806402130000,2019,187746,551420,739166,COST
06079806402150000,2021,196591,769809,966400,MKT
06079806402150000,2020,187423,741177,928600,MKT
06079806402150000,2019,187423,741177,928600,MKT
06079806402170000,2021,202606,743194,945800,MKT
06079806402170000,2020,192471,786530,979001,COST
06079806402170000,2019,192471,787000,979471,COST
06079806402190000,2021,212483,784917,997400,MKT
06079806402190000,2020,200723,760877,961600,MKT
06079806402190000,2019,200723,760877,961600,MKT
06079806402210000,2021,217152,0,217152,COST
06079806402210000,2020,204608,0,204608,COST
06079806402210000,2019,204608,0,204608,COST
06079806402230000,2021,213834,807966,1021800,MKT
06079806402230000,2020,201848,760652,962500,MKT
06079806402230000,2019,201848,760652,962500,MKT
06079806402250000,2021,213497,835103,1048600,MKT
06079806402250000,2020,201568,853632,1055200,MKT
06079806402250000,2019,201568,853632,1055200,MKT
06079806402270000,2021,196591,777809,974400,MKT
06079806402270000,2020,187423,746177,933600,MKT
06079806402270000,2019,187423,746177,933600,MKT
06079806402290000,2021,202972,789328,992300,MKT
06079806402290000,2020,192778,791622,984400,MKT
06079806402290000,2019,192778,791622,984400,MKT
06079806402310000,2021,192101,633599,825700,MKT
06079806402310000,2020,198145,877444,1075589,OVR
06079806402310000,2019,198145,877444,1075589,OVR
06079806402330000,2021,210153,1025147,1235300,MKT
06079806402330000,2020,214478,908750,1123228,COST
06079806402330000,2019,123263,908750,1032013,COST
06079806402350000,2021,153681,0,153681,COST
06079806402350000,2020,113876,0,113876,COST
06079806402350000,2019,113876,0,113876,COST
06079806402370000,2021,160335,0,160335,COST
06079806402370000,2020,118214,0,118214,COST
06079806402370000,2019,118214,0,118214,COST
06079806402390000,2021,158411,0,158411,COST
06079806402390000,2020,116962,0,116962,COST
06079806402390000,2019,116962,0,116962,COST
06079806402410000,2021,185575,0,185575,COST
06079806402410000,2020,134481,0,134481,COST
06079806402410000,2019,134481,0,134481,COST
06079806402430000,2021,184063,0,184063,COST
06079806402430000,2020,133515,0,133515,COST
06079806402430000,2019,133515,0,133515,COST
06079806402450000,2021,179005,697795,876800,MKT
06079806402450000,2020,130274,0,130274,COST
06079806402450000,2019,130274,0,130274,COST
06079806402470000,2021,164761,0,164761,COST
06079806402470000,2020,121087,0,121087,COST
06079806402470000,2019,121087,0,121087,COST
06079806402490000,2021,176793,0,176793,COST
06079806402490000,2020,128853,0,128853,COST
06079806402490000,2019,128853,0,128853,COST
06079806402510000,2021,238840,0,238840,COST
06079806402510000,2020,240101,0,240101,COST
06079806402510000,2019,240101,0,240101,COST
06079806402530000,2021,178576,0,178576,COST
06079806402530000,2020,185789,0,185789,COST
06079806402530000,2019,185789,0,185789,COST
06079806402550000,2021,186213,0,186213,COST
06079806402550000,2020,192778,0,192778,COST
06079806402550000,2019,192778,0,192778,COST
06079806402570000,2021,201604,0,201604,COST
06079806402570000,2020,206764,0,206764,COST
06079806402570000,2019,206764,0,206764,COST
06079806402590000,2021,200121,0,200121,COST
06079806402590000,2020,205422,0,205422,COST
06079806402590000,2019,205422,0,205422,COST
06079806402610000,2021,189194,0,189194,COST
06079806402610000,2020,195498,0,195498,COST
06079806402610000,2019,195498,0,195498,COST
06079806402630000,2021,204230,0,204230,COST
06079806402630000,2020,209138,0,209138,COST
06079806402630000,2019,209138,0,209138,COST
06079806402650000,2021,176765,0,176765,COST
06079806402650000,2020,184125,0,184125,COST
06079806402650000,2019,184125,0,184125,COST
06079806402670000,2021,201604,0,201604,COST
06079806402670000,2020,206764,0,206764,COST
06079806402670000,2019,206764,0,206764,COST
06079806402690000,2021,197405,0,197405,COST
06079806402690000,2020,202961,0,202961,COST
06079806402690000,2019,202961,0,202961,COST
06079806402710000,2021,187215,951085,1138300,MKT
06079806402710000,2020,193693,0,193693,COST
06079806402710000,2019,193693,0,193693,COST
06079806402730000,2021,207648,0,207648,COST
06079806402730000,2020,212222,0,212222,COST
06079806402730000,2019,212222,0,212222,COST
06079806402750000,2021,202778,777022,979800,MKT
06079806402750000,2020,207826,827374,1035200,MKT
06079806402750000,2019,207826,827374,1035200,MKT
06079806402770000,2021,211523,579377,790900,MKT
06079806402770000,2020,215711,601290,817001,COST
06079806402770000,2019,215711,601290,817001,COST
06079806402790000,2021,148008,0,148008,COST
06079806402790000,2020,149357,0,149357,COST
06079806402790000,2019,149357,0,149357,COST
06079806403010000,2021,214838,768462,983300,MKT
06079806403010000,2020,202684,846716,1049400,MKT
06079806403010000,2019,202684,846716,1049400,MKT
06079806403030000,2021,157887,782513,940400,MKT
06079806403030000,2020,108085,285460,393545,COST
06079806403030000,2019,108085,0,108085,COST
06079806403055001,2021,148128,595890,744018,COST
06079806403055001,2020,96215,662080,758295,COST
06079806403055001,2019,96215,540300,636515,COST
06079806403075002,2021,146693,595890,742583,COST
06079806403075002,2020,95169,662080,757249,COST
06079806403075002,2019,95169,540300,635469,COST
06079806403090000,2021,158498,711070,869568,COST
06079806403090000,2020,108454,678340,786794,COST
06079806403090000,2019,108454,678340,786794,COST
06079806403110000,2021,204788,778612,983400,MKT
06079806403110000,2020,194298,754410,948708,COST
06079806403110000,2019,111666,618650,730316,COST
06079806403130000,2021,211460,753640,965100,MKT
06079806403130000,2020,199871,747029,946900,MKT
06079806403130000,2019,199871,734229,934100,MKT
06079806403150000,2021,191070,641730,832800,MKT
06079806403150000,2020,182773,600027,782800,MKT
06079806403150000,2019,182773,600027,782800,MKT
06079806403170000,2021,209738,440070,649808,COST
06079806403170000,2020,198434,419080,617514,COST
06079806403170000,2019,198434,419080,617514,COST
06079806403190000,2021,228162,926338,1154500,MKT
06079806403190000,2020,213731,868169,1081900,MKT
06079806403190000,2019,213731,868169,1081900,MKT
06079806403210000,2021,158802,725598,884400,MKT
06079806403210000,2020,108637,634363,743000,MKT
06079806403210000,2019,108637,634363,743000,MKT
06079806403230000,2021,162961,487039,650000,MKT
06079806403230000,2020,111143,543457,654600,MKT
06079806403230000,2019,111143,543457,654600,MKT
06079806403250000,2021,176823,665977,842800,MKT
06079806403250000,2020,119440,601660,721100,MKT
06079806403250000,2019,119440,601660,721100,MKT
06079806403270000,2021,225091,521720,746811,COST
06079806403270000,2020,147773,584395,732168,OVR
06079806403270000,2019,147773,584395,732168,OVR
06079806403310000,2021,173984,763716,937700,MKT
06079806403310000,2020,117747,725553,843300,MKT
06079806403310000,2019,117747,725553,843300,MKT
06079806403330000,2021,165262,0,165262,COST
06079806403330000,2020,112526,0,112526,COST
06079806403330000,2019,112526,0,112526,COST
06079806403350000,2021,169168,0,169168,COST
06079806403350000,2020,114868,0,114868,COST
06079806403350000,2019,114868,0,114868,COST
06079806403370000,2021,165262,0,165262,COST
06079806403370000,2020,112526,0,112526,COST
06079806403370000,2019,112526,0,112526,COST
06079806403390000,2021,159407,0,159407,COST
06079806403390000,2020,109002,0,109002,COST
06079806403390000,2019,109002,0,109002,COST
06079806403410000,2021,158498,0,158498,COST
06079806403410000,2020,108454,0,108454,COST
06079806403410000,2019,108454,0,108454,COST
06079806403430000,2021,164978,0,164978,COST
06079806403430000,2020,112355,0,112355,COST
06079806403430000,2019,112355,0,112355,COST
06079806403450000,2021,173459,0,173459,COST
06079806403450000,2020,117434,0,117434,COST
06079806403450000,2019,117434,0,117434,COST
06079806403470000,2021,170798,0,170798,COST
06079806403470000,2020,115844,0,115844,COST
06079806403470000,2019,115844,0,115844,COST
06079806403490000,2021,176567,0,176567,COST
06079806403490000,2020,119288,0,119288,COST
06079806403490000,2019,119288,0,119288,COST
06079806403510000,2021,182530,0,182530,COST
06079806403510000,2020,122834,0,122834,COST
06079806403510000,2019,122834,0,122834,COST
06079806403530000,2021,603201,3126500,3729701,COST
06079806403530000,2020,543555,1771790,2315345,COST
06079806403530000,2019,543555,1771790,2315345,COST
06079806404030000,2021,224995,833505,1058500,MKT
06079806404030000,2020,227782,845818,1073600,MKT
06079806404030000,2019,227782,845818,1073600,MKT
06079806404050000,2021,222003,813897,1035900,MKT
06079806404050000,2020,225109,780291,1005400,OVR
06079806404050000,2019,225109,780291,1005400,MKT
06079806404070000,2021,226466,895734,1122200,MKT
06079806404070000,2020,229096,779710,1008806,OVR
06079806404070000,2019,229096,779710,1008806,COST
06079806404090000,2021,218945,1007055,1226000,MKT
06079806404090000,2020,222372,848950,1071322,COST
06079806404090000,2019,222372,848950,1071322,COST
06079806404110000,2021,218457,748643,967100,MKT
06079806404110000,2020,205692,874108,1079800,MKT
06079806404110000,2019,205692,874108,1079800,MKT
06079806404130000,2021,206578,823622,1030200,MKT
06079806404130000,2020,195796,827504,1023300,MKT
06079806404130000,2019,195796,827504,1023300,MKT
06079806404150000,2021,207640,768760,976400,MKT
06079806404150000,2020,196683,820917,1017600,MKT
06079806404150000,2019,196683,817417,1014100,MKT
06079806404170000,2021,215835,766465,982300,MKT
06079806404170000,2020,203513,903590,1107103,OVR
06079806404170000,2019,203513,903590,1107103,COST
06079806404190000,2021,234662,855938,1090600,MKT
06079806404190000,2020,219092,813308,1032400,MKT
06079806404190000,2019,219092,813308,1032400,MKT
06079806404210000,2021,247379,557321,804700,MKT
06079806404210000,2020,229530,580080,809610,COST
06079806404210000,2019,229530,580080,809610,COST
06079806404230000,2021,262756,740844,1003600,MKT
06079806404230000,2020,242068,769832,1011900,MKT
06079806404230000,2019,242068,769832,1011900,MKT
06079806404250000,2021,263714,630486,894200,MKT
06079806404250000,2020,242846,674254,917100,MKT
06079806404250000,2019,242846,674254,917100,MKT
06079806404270000,2021,246848,846952,1093800,MKT
06079806404270000,2020,229096,809604,1038700,MKT
06079806404270000,2019,229096,802304,1031400,MKT
06079806404290000,2021,241433,604867,846300,MKT
06079806404290000,2020,224658,603130,827788,OVR
06079806404290000,2019,224658,603130,827788,COST
06079806404310000,2021,250527,850273,1100800,MKT
06079806404310000,2020,232104,812096,1044200,MKT
06079806404310000,2019,232104,812096,1044200,MKT
06079806404330000,2021,236670,604030,840700,MKT
06079806404330000,2020,220744,670856,891600,MKT
06079806404330000,2019,220744,612220,832964,COST
06079806404350000,2021,204788,723412,928200,MKT
06079806404350000,2020,194298,690302,884600,MKT
06079806404350000,2019,194298,690302,884600,MKT
06079806404370000,2021,196975,672825,869800,MKT
06079806404370000,2020,187746,647354,835100,MKT
06079806404370000,2019,187746,647354,835100,MKT
06079806404390000,2021,201129,754971,956100,MKT
06079806404390000,2020,191234,807666,998900,MKT
06079806404390000,2019,191234,807666,998900,MKT
06079806404410000,2021,209042,566760,775802,COST
06079806404410000,2020,197854,607746,805600,MKT
06079806404410000,2019,197854,607746,805600,MKT
06079806405010000,2021,161496,0,161496,COST
06079806405010000,2020,110261,0,110261,COST
06079806405010000,2019,110261,0,110261,COST
06079806405030000,2021,164118,0,164118,COST
06079806405030000,2020,111839,0,111839,COST
06079806405030000,2019,111839,0,111839,COST
06079806405050000,2021,141412,0,141412,COST
06079806405050000,2020,105819,0,105819,COST
06079806405050000,2019,105819,0,105819,COST
06079806405070000,2021,141994,0,141994,COST
06079806405070000,2020,106204,0,106204,COST
06079806405070000,2019,106204,0,106204,COST
06079806405090000,2021,144851,0,144851,COST
06079806405090000,2020,108085,0,108085,COST
06079806405090000,2019,108085,0,108085,COST
06079806405110000,2021,158193,551307,709500,MKT
06079806405110000,2020,108270,579430,687700,MKT
06079806405110000,2019,108270,0,108270,COST
06079806405130000,2021,153820,572880,726700,MKT
06079806405130000,2020,105626,505230,610856,COST
06079806405130000,2019,105626,0,105626,COST
06079806405150000,2021,157887,575513,733400,MKT
06079806405150000,2020,108085,0,108085,COST
06079806405150000,2019,108085,0,108085,COST
06079806405170000,2021,170258,613442,783700,MKT
06079806405170000,2020,115520,506200,621720,COST
06079806405170000,2019,115520,0,115520,COST
06079806405190000,2021,156964,0,156964,COST
06079806405190000,2020,107528,0,107528,COST
06079806405190000,2019,107528,0,107528,COST
06079806405210000,2021,157580,572620,730200,MKT
06079806405210000,2020,107900,173290,281190,COST
06079806405210000,2019,107900,0,107900,COST
06079806405230000,2021,154139,0,154139,COST
06079806405230000,2020,105819,0,105819,COST
06079806405230000,2019,105819,0,105819,COST
06079806405250000,2021,150567,0,150567,COST
06079806405250000,2020,103654,0,103654,COST
06079806405250000,2019,103654,0,103654,COST
06079806405270000,2021,154139,0,154139,COST
06079806405270000,2020,105819,0,105819,COST
06079806405270000,2019,105819,0,105819,COST
06079806405290000,2021,163541,0,163541,COST
06079806405290000,2020,111492,0,111492,COST
06079806405290000,2019,111492,0,111492,COST
06079806405310000,2021,165262,0,165262,COST
06079806405310000,2020,112526,0,112526,COST
06079806405310000,2019,112526,0,112526,COST
06079806405330000,2021,166112,0,166112,COST
06079806405330000,2020,113036,0,113036,COST
06079806405330000,2019,113036,0,113036,COST
06079806405350000,2021,157887,0,157887,COST
06079806405350000,2020,108085,0,108085,COST
06079806405350000,2019,108085,0,108085,COST
06079806407017000,2021,686104,0,686104,COST
06079806407017000,2020,608932,0,608932,COST
06079806407017000,2019,61194,103260,164454,COST
06079807101010000,2021,319618,258400,578018,COST
06079807101010000,2020,282560,234710,517270,COST
06079807101010000,2019,282560,234710,517270,COST
06079807101050000,2021,1107,0,1107,COST
06079807101050000,2020,1030,0,1030,COST
06079807101050000,2019,1030,0,1030,COST
06079807101090000,2021,267250,822350,1089600,INCOME
06079807101090000,2020,231137,779263,1010400,INCOME
06079807101090000,2019,231137,779263,1010400,INCOME
06079807101100000,2021,358726,2091200,2449926,COST
06079807101100000,2020,321653,1322270,1643923,COST
06079807101100000,2019,321653,127620,449273,COST
06079807102030000,2021,364625,2298420,2663045,COST
06079807102030000,2020,348689,1449886,1798575,MRA
06079807102030000,2019,348689,1449886,1798575,MRA
06079807102050000,2021,260480,1244800,1505280,COST
06079807102050000,2020,259187,546720,805907,COST
06079807102050000,2019,259187,0,259187,COST
06079807102070000,2021,161285,0,161285,COST
06079807102070000,2020,153150,0,153150,COST
06079807102070000,2019,153150,0,153150,COST
06079807102090000,2021,206663,0,206663,COST
06079807102090000,2020,147872,0,147872,COST
06079807102090000,2019,147872,0,147872,COST
06079807102110000,2021,266578,899922,1166500,MKT
06079807102110000,2020,264531,854869,1119400,MKT
06079807102110000,2019,264531,854869,1119400,MKT
06079807102130000,2021,276559,1023140,1299699,COST
06079807102130000,2020,273247,978580,1251827,COST
06079807102130000,2019,273247,978580,1251827,COST
06079807102150000,2021,224863,0,224863,COST
06079807102150000,2020,159300,0,159300,COST
06079807102150000,2019,159300,0,159300,COST
06079807102170000,2021,185032,0,185032,COST
06079807102170000,2020,172873,0,172873,COST
06079807102170000,2019,172873,0,172873,COST
06079807102190000,2021,279528,0,279528,COST
06079807102190000,2020,275832,0,275832,COST
06079807102190000,2019,275832,0,275832,COST
06079807103016500,2021,220676,0,220676,COST
06079807103016500,2020,135836,0,135836,COST
06079807103016500,2019,135836,0,135836,COST
06079807103030000,2021,255695,0,255695,COST
06079807103030000,2020,271852,0,271852,COST
06079807103030000,2019,271852,0,271852,COST
06079807103050000,2021,213263,0,213263,COST
06079807103050000,2020,152029,0,152029,COST
06079807103050000,2019,152029,0,152029,COST
06079807103070000,2021,290504,0,290504,COST
06079807103070000,2020,258079,0,258079,COST
06079807103070000,2019,258079,0,258079,COST
06079807103100000,2021,296863,0,296863,COST
06079807103100000,2020,263055,0,263055,COST
06079807103100000,2019,263055,0,263055,COST
06079807103110000,2021,286212,0,286212,COST
06079807103110000,2020,254713,0,254713,COST
06079807103110000,2019,254713,0,254713,COST
06079807103130000,2021,295131,1186770,1481901,COST
06079807103130000,2020,261701,961740,1223441,MRA
06079807103130000,2019,261701,961740,1223441,MRA
06079807103150000,2021,224451,919949,1144400,MKT
06079807103150000,2020,159042,864858,1023900,MKT
06079807103150000,2019,159042,0,159042,COST
06079807103170000,2021,285295,655305,940600,MKT
06079807103170000,2020,253993,682840,936833,COST
06079807103170000,2019,253993,680160,934153,COST
06079807103190000,2021,286669,0,286669,COST
06079807103190000,2020,255072,0,255072,COST
06079807103190000,2019,255072,0,255072,COST
06079807103210000,2021,213562,763538,977100,MKT
06079807103210000,2020,152217,716783,869000,MKT
06079807103210000,2019,152217,716783,869000,MKT
06079807103230000,2021,286669,0,286669,COST
06079807103230000,2020,255072,0,255072,COST
06079807103230000,2019,255072,0,255072,COST
06079807103250000,2021,294695,0,294695,COST
06079807103250000,2020,261360,0,261360,COST
06079807103250000,2019,261360,0,261360,COST
06079807103270000,2021,320701,0,320701,COST
06079807103270000,2020,281598,0,281598,COST
06079807103270000,2019,281598,0,281598,COST
06079807103290000,2021,298792,678408,977200,MKT
06079807103290000,2020,264562,709340,973902,COST
06079807103290000,2019,264562,709340,973902,COST
06079807103310000,2021,229188,0,229188,COST
06079807103310000,2020,161999,0,161999,COST
06079807103310000,2019,161999,0,161999,COST
06079807103330000,2021,320130,1084940,1405070,COST
06079807103330000,2020,281156,1032020,1313176,COST
06079807103330000,2019,281156,1032020,1313176,COST
06079807103350000,2021,316476,0,316476,COST
06079807103350000,2020,278324,0,278324,COST
06079807103350000,2019,278324,0,278324,COST
06079807103370000,2021,319175,0,319175,COST
06079807103370000,2020,280416,0,280416,COST
06079807103370000,2019,280416,0,280416,COST
06079807103390000,2021,299855,0,299855,COST
06079807103390000,2020,265391,0,265391,COST
06079807103390000,2019,265391,0,265391,COST
06079807103410000,2021,309156,0,309156,COST
06079807103410000,2020,272639,0,272639,COST
06079807103410000,2019,272639,0,272639,COST
06079807103430000,2021,290281,0,290281,COST
06079807103430000,2020,257904,0,257904,COST
06079807103430000,2019,257904,0,257904,COST
06079807103450000,2021,292060,966740,1258800,MKT
06079807103450000,2020,259298,936802,1196100,MKT
06079807103450000,2019,259298,936802,1196100,MKT
06079807103470000,2021,291395,788705,1080100,MKT
06079807103470000,2020,258777,770623,1029400,MKT
06079807103470000,2019,258777,0,258777,COST
06079807103490000,2021,297937,0,297937,COST
06079807103490000,2020,263894,0,263894,COST
06079807103490000,2019,263894,0,263894,COST
06079807103510000,2021,221670,0,221670,COST
06079807103510000,2020,157303,0,157303,COST
06079807103510000,2019,157303,0,157303,COST
06079807103530000,2021,291617,0,291617,COST
06079807103530000,2020,258951,0,258951,COST
06079807103530000,2019,258951,0,258951,COST
06079807103550000,2021,315308,0,315308,COST
06079807103550000,2020,277418,0,277418,COST
06079807103550000,2019,277418,0,277418,COST
06079807103570000,2021,305902,1100830,1406732,COST
06079807103570000,2020,270106,315600,585706,COST
06079807103570000,2019,270106,0,270106,COST
06079807103610000,2021,472234,3027766,3500000,OVR
06079807103610000,2020,396137,3103863,3500000,OVR
06079807103610000,2019,396137,3103863,3500000,OVR
06079807103650000,2021,379139,3501290,3880429,COST
06079807103650000,2020,326396,3533950,3860346,COST
06079807103650000,2019,326396,3533950,3860346,COST
06079807103690000,2021,282515,0,282515,COST
06079807103690000,2020,251809,0,251809,COST
06079807103690000,2019,251809,0,251809,COST
06079807103710000,2021,211303,0,211303,COST
06079807103710000,2020,150797,0,150797,COST
06079807103710000,2019,150797,0,150797,COST
06079807103730000,2021,298365,0,298365,COST
06079807103730000,2020,264228,0,264228,COST
06079807103730000,2019,264228,0,264228,COST
06079807103750000,2021,293382,2126230,2419612,COST
06079807103750000,2020,260333,1634667,1895000,OVR
06079807103750000,2019,260333,1634667,1895000,OVR
06079807103770000,2021,290504,0,290504,COST
06079807103770000,2020,258079,0,258079,COST
06079807103770000,2019,258079,0,258079,COST
06079807103790000,2021,209467,880933,1090400,MKT
06079807103790000,2020,149640,853760,1003400,MKT
06079807103790000,2019,149640,853760,1003400,MKT
06079807103810000,2021,300911,0,300911,COST
06079807103810000,2020,266216,0,266216,COST
06079807103810000,2019,266216,0,266216,COST
06079807103830000,2021,259353,736510,995863,COST
06079807103830000,2020,275280,0,275280,COST
06079807103830000,2019,275280,0,275280,COST
06079807104010000,2021,347526,1038889,1386415,MRA
06079807104010000,2020,279818,955182,1235000,OVR
06079807104010000,2019,279818,955182,1235000,OVR
06079807104050000,2021,368635,0,368635,COST
06079807104050000,2020,294755,0,294755,COST
06079807104050000,2019,294755,0,294755,COST
06079807104090000,2021,370744,0,370744,COST
06079807104090000,2020,296242,0,296242,COST
06079807104090000,2019,296242,0,296242,COST
06079807104130000,2021,366658,0,366658,COST
06079807104130000,2020,293360,0,293360,COST
06079807104130000,2019,293360,0,293360,COST
06079807104170000,2021,382156,1370550,1752706,COST
06079807104170000,2020,304269,1311030,1615299,COST
06079807104170000,2019,304269,1311030,1615299,COST
06079807104210000,2021,371493,1012160,1383653,COST
06079807104210000,2020,296769,1074931,1371700,MKT
06079807104210000,2019,296769,496410,793179,COST
06079807104476500,2021,1576750,7238720,8815470,COST
06079807104476500,2020,1743700,1256300,3000000,OVR
06079807104476500,2019,1743700,1256300,3000000,OVR
06079807110100000,2021,25848,0,25848,COST
06079807110100000,2020,33248,0,33248,COST
06079807110100000,2019,33248,0,33248,COST
06079807201010000,2021,258918,0,258918,COST
06079807201010000,2020,257816,0,257816,COST
06079807201010000,2019,257816,0,257816,COST
06079807201030000,2021,238840,0,238840,COST
06079807201030000,2020,240101,0,240101,COST
06079807201030000,2019,240101,0,240101,COST
06079807201050000,2021,264128,0,264128,COST
06079807201050000,2020,262386,0,262386,COST
06079807201050000,2019,262386,0,262386,COST
06079807201070000,2021,257934,0,257934,COST
06079807201070000,2020,256952,0,256952,COST
06079807201070000,2019,256952,0,256952,COST
06079807201090000,2021,206348,730152,936500,MKT
06079807201090000,2020,147673,752730,900403,COST
06079807201090000,2019,147673,752730,900403,COST
06079807201110000,2021,275676,807624,1083300,MKT
06079807201110000,2020,272477,516920,789397,COST
06079807201110000,2019,272477,0,272477,COST
06079807201130000,2021,245832,760268,1006100,MKT
06079807201130000,2020,246288,779412,1025700,MKT
06079807201130000,2019,246288,779412,1025700,MKT
06079807201150000,2021,259506,698594,958100,MKT
06079807201150000,2020,258332,764880,1023212,COST
06079807201150000,2019,258332,764880,1023212,COST
06079807201170000,2021,187989,0,187989,COST
06079807201170000,2020,136023,0,136023,COST
06079807201170000,2019,136023,0,136023,COST
06079807201190000,2021,204918,0,204918,COST
06079807201190000,2020,146771,0,146771,COST
06079807201190000,2019,146771,0,146771,COST
06079807201210000,2021,221950,0,221950,COST
06079807201210000,2020,157478,0,157478,COST
06079807201210000,2019,157478,0,157478,COST
06079807202010000,2021,190575,0,190575,COST
06079807202010000,2020,259697,0,259697,COST
06079807202010000,2019,259697,0,259697,COST
06079807202030000,2021,167598,1931920,2099518,COST
06079807202030000,2020,162247,1830830,1993077,COST
06079807202030000,2019,162247,1830830,1993077,COST
06079807203010000,2021,192720,0,192720,COST
06079807203010000,2020,183516,0,183516,COST
06079807203010000,2019,183516,0,183516,COST
06079807203030000,2021,179146,0,179146,COST
06079807203030000,2020,172067,0,172067,COST
06079807203030000,2019,172067,0,172067,COST
06079807203050000,2021,176150,0,176150,COST
06079807203050000,2020,169527,0,169527,COST
06079807203050000,2019,169527,0,169527,COST
06079807203070000,2021,164250,0,164250,COST
06079807203070000,2020,159386,0,159386,COST
06079807203070000,2019,159386,0,159386,COST
06079807203090000,2021,162432,0,162432,COST
06079807203090000,2020,157829,0,157829,COST
06079807203090000,2019,157829,0,157829,COST
06079807203110000,2021,165247,753153,918400,MKT
06079807203110000,2020,160238,791362,951600,MKT
06079807203110000,2019,160238,791362,951600,MKT
06079807203130000,2021,179493,0,179493,COST
06079807203130000,2020,172361,0,172361,COST
06079807203130000,2019,172361,0,172361,COST
06079807203150000,2021,264633,0,264633,COST
06079807203150000,2020,183903,0,183903,COST
06079807203150000,2019,183903,0,183903,COST
06079807203170000,2021,236071,0,236071,COST
06079807203170000,2020,166282,0,166282,COST
06079807203170000,2019,166282,0,166282,COST
06079807203190000,2021,222928,0,222928,COST
06079807203190000,2020,158090,0,158090,COST
06079807203190000,2019,158090,0,158090,COST
06079807203210000,2021,224175,0,224175,COST
06079807203210000,2020,158870,0,158870,COST
06079807203210000,2019,158870,0,158870,COST
06079807203230000,2021,177570,0,177570,COST
06079807203230000,2020,170732,0,170732,COST
06079807203230000,2019,170732,0,170732,COST
06079807203250000,2021,174802,0,174802,COST
06079807203250000,2020,168383,0,168383,COST
06079807203250000,2019,168383,0,168383,COST
06079807203270000,2021,153583,0,153583,COST
06079807203270000,2020,150221,0,150221,COST
06079807203270000,2019,150221,0,150221,COST
06079807203290000,2021,150056,0,150056,COST
06079807203290000,2020,147173,0,147173,COST
06079807203290000,2019,147173,0,147173,COST
06079807203310000,2021,151551,0,151551,COST
06079807203310000,2020,148466,0,148466,COST
06079807203310000,2019,148466,0,148466,COST
06079807203330000,2021,166820,0,166820,COST
06079807203330000,2020,161583,0,161583,COST
06079807203330000,2019,161583,0,161583,COST
06079807203350000,2021,211909,0,211909,COST
06079807203350000,2020,151178,0,151178,COST
06079807203350000,2019,151178,0,151178,COST
06079807203370000,2021,204438,0,204438,COST
06079807203370000,2020,146468,0,146468,COST
06079807203370000,2019,146468,0,146468,COST
06079807203390000,2021,154473,533227,687700,MKT
06079807203390000,2020,150988,567800,718788,COST
06079807203390000,2019,150988,567800,718788,COST
06079807203410000,2021,152460,962940,1115400,MKT
06079807203410000,2020,149251,860649,1009900,MKT
06079807203410000,2019,149251,860649,1009900,MKT
06079807203430000,2021,194945,0,194945,COST
06079807203430000,2020,140453,0,140453,COST
06079807203430000,2019,140453,0,140453,COST
06079807203450000,2021,199033,0,199033,COST
06079807203450000,2020,143047,0,143047,COST
06079807203450000,2019,143047,0,143047,COST
06079807203470000,2021,154583,768417,923000,MKT
06079807203470000,2020,151083,709817,860900,MKT
06079807203470000,2019,151083,709817,860900,MKT
06079807203490000,2021,155682,718618,874300,MKT
06079807203490000,2020,152029,687071,839100,MKT
06079807203490000,2019,152029,687071,839100,MKT
06079807203510000,2021,214454,0,214454,COST
06079807203510000,2020,152778,0,152778,COST
06079807203510000,2019,152778,0,152778,COST
06079807203530000,2021,215782,0,215782,COST
06079807203530000,2020,153612,0,153612,COST
06079807203530000,2019,153612,0,153612,COST
06079807203550000,2021,161098,821302,982400,MKT
06079807203550000,2020,156685,749415,906100,MKT
06079807203550000,2019,156685,749415,906100,MKT
06079807203570000,2021,160580,0,160580,COST
06079807203570000,2020,156240,0,156240,COST
06079807203570000,2019,156240,0,156240,COST
06079807203590000,2021,239331,0,239331,COST
06079807203590000,2020,168306,0,168306,COST
06079807203590000,2019,168306,0,168306,COST
06079807203610000,2021,251243,0,251243,COST
06079807203610000,2020,175672,0,175672,COST
06079807203610000,2019,175672,0,175672,COST
06079807301010000,2021,209333,815867,1025200,MKT
06079807301010000,2020,151545,788555,940100,OVR
06079807301010000,2019,151545,788555,940100,MKT
06079807301030000,2021,292732,559140,851872,COST
06079807301030000,2020,216845,0,216845,COST
06079807301030000,2019,216845,0,216845,COST
06079807301050000,2021,311497,1073090,1384587,COST
06079807301050000,2020,232510,979370,1211880,COST
06079807301050000,2019,232510,979370,1211880,COST
06079807301070000,2021,205755,909400,1115155,COST
06079807301070000,2020,148640,823850,972490,COST
06079807301070000,2019,148640,823850,972490,COST
06079807301090000,2021,223569,0,223569,COST
06079807301090000,2020,163161,0,163161,COST
06079807301090000,2019,163161,0,163161,COST
06079807301116500,2021,1996,5120,7116,COST
06079807301116500,2020,1858,4950,6808,COST
06079807301116500,2019,1858,4950,6808,COST
06079807301130000,2021,198193,458907,657100,MKT
06079807301130000,2020,142521,439479,582000,MKT
06079807301130000,2019,142521,439479,582000,MKT
06079807301150000,2021,253078,643222,896300,MKT
06079807301150000,2020,184156,582244,766400,MKT
06079807301150000,2019,184156,582244,766400,MKT
06079807301170000,2021,246957,653843,900800,MKT
06079807301170000,2020,179163,625037,804200,MKT
06079807301170000,2019,179163,625037,804200,MKT
06079807301190000,2021,179425,684375,863800,MKT
06079807301190000,2020,127461,654860,782321,COST
06079807301190000,2019,127461,654860,782321,COST
06079807302010000,2021,164409,439991,604400,MKT
06079807302010000,2020,115550,454050,569600,MKT
06079807302010000,2019,115550,454050,569600,MKT
06079807302036500,2021,163692,0,163692,COST
06079807302036500,2020,107466,0,107466,COST
06079807302036500,2019,107466,0,107466,COST
06079807302040000,2021,156366,479034,635400,MKT
06079807302040000,2020,109223,466877,576100,MKT
06079807302040000,2019,109223,466877,576100,MKT
06079807302050000,2021,168512,489888,658400,MKT
06079807302050000,2020,118792,482808,601600,MKT
06079807302050000,2019,118792,482808,601600,MKT
06079807302060000,2021,169776,394224,564000,MKT
06079807302060000,2020,119793,333507,453300,MKT
06079807302060000,2019,119793,333507,453300,MKT
06079807302070000,2021,164217,434483,598700,MKT
06079807302070000,2020,115398,407702,523100,MKT
06079807302070000,2019,115398,407702,523100,MKT
06079807302080000,2021,159479,534621,694100,MKT
06079807302080000,2020,111667,520733,632400,MKT
06079807302080000,2019,111667,520733,632400,MKT
06079807302090000,2021,159479,576821,736300,MKT
06079807302090000,2020,111667,574033,685700,MKT
06079807302090000,2019,111667,574033,685700,MKT
06079807302100000,2021,159479,414021,573500,MKT
06079807302100000,2020,111667,378133,489800,MKT
06079807302100000,2019,111667,363233,474900,MKT
06079807302110000,2021,159479,556321,715800,MKT
06079807302110000,2020,111667,524633,636300,MKT
06079807302110000,2019,111667,524633,636300,MKT
06079807302120000,2021,159479,498921,658400,MKT
06079807302120000,2020,111667,508333,620000,MKT
06079807302120000,2019,111667,508333,620000,MKT
06079807302130000,2021,159479,471921,631400,MKT
06079807302130000,2020,111667,440533,552200,MKT
06079807302130000,2019,111667,436133,547800,MKT
06079807302150000,2021,167413,484787,652200,MKT
06079807302150000,2020,117923,464877,582800,MKT
06079807302150000,2019,117923,464877,582800,MKT
06079807302170000,2021,167413,632887,800300,MKT
06079807302170000,2020,117923,607777,725700,MKT
06079807302170000,2019,117923,607777,725700,MKT
06079807302190000,2021,194182,594318,788500,MKT
06079807302190000,2020,139288,567912,707200,MKT
06079807302190000,2019,139288,567912,707200,MKT
06079807303010000,2021,158248,413852,572100,MKT
06079807303010000,2020,110701,420599,531300,MKT
06079807303010000,2019,110701,420599,531300,MKT
06079807303020000,2021,162669,421631,584300,MKT
06079807303020000,2020,114178,437422,551600,MKT
06079807303020000,2019,114178,437422,551600,MKT
06079807303030000,2021,169955,454945,624900,MKT
06079807303030000,2020,119934,457666,577600,MKT
06079807303030000,2019,119934,457666,577600,MKT
06079807303040000,2021,157626,451474,609100,MKT
06079807303040000,2020,110212,430488,540700,MKT
06079807303040000,2019,110212,430488,540700,MKT
06079807303050000,2021,161090,475710,636800,MKT
06079807303050000,2020,112934,453166,566100,MKT
06079807303050000,2019,112934,453166,566100,MKT
06079807303060000,2021,161090,429910,591000,MKT
06079807303060000,2020,112934,453566,566500,MKT
06079807303060000,2019,112934,453566,566500,MKT
06079807303070000,2021,161289,343211,504500,MKT
06079807303070000,2020,113091,355009,468100,MKT
06079807303070000,2019,113091,355009,468100,MKT
06079807303080000,2021,161289,570011,731300,MKT
06079807303080000,2020,113091,558509,671600,MKT
06079807303080000,2019,113091,558509,671600,MKT
06079807303090000,2021,161289,361711,523000,MKT
06079807303090000,2020,113091,312809,425900,MKT
06079807303090000,2019,113091,312809,425900,MKT
06079807303100000,2021,161289,598111,759400,MKT
06079807303100000,2020,113091,620509,733600,MKT
06079807303100000,2019,113091,620509,733600,MKT
06079807303110000,2021,167413,569987,737400,MKT
06079807303110000,2020,117923,502377,620300,MKT
06079807303110000,2019,117923,502377,620300,MKT
06079807303130000,2021,167413,450187,617600,MKT
06079807303130000,2020,117923,438077,556000,MKT
06079807303130000,2019,117923,438077,556000,MKT
06079807303150000,2021,171021,433779,604800,MKT
06079807303150000,2020,120779,356321,477100,MKT
06079807303150000,2019,120779,356321,477100,MKT
06079807303170000,2021,161685,457115,618800,MKT
06079807303170000,2020,113403,436297,549700,MKT
06079807303170000,2019,113403,436297,549700,MKT
06079807303190000,2021,198193,629707,827900,MKT
06079807303190000,2020,142521,562323,704844,MRA
06079807303190000,2019,142521,562323,704844,MRA
06079807303210000,2021,202045,490355,692400,MKT
06079807303210000,2020,145635,489265,634900,MKT
06079807303210000,2019,145635,489265,634900,MKT
06079807303230000,2021,202045,480355,682400,MKT
06079807303230000,2020,145635,445265,590900,MKT
06079807303230000,2019,145635,445265,590900,MKT
06079807303250000,2021,194182,573918,768100,MKT
06079807303250000,2020,139288,544712,684000,MKT
06079807303250000,2019,139288,544712,684000,MKT
06079807303270000,2021,204533,450467,655000,MKT
06079807303270000,2020,147650,447550,595200,MKT
06079807303270000,2019,147650,447550,595200,MKT
06079807303290000,2021,195538,538862,734400,MKT
06079807303290000,2020,140380,562320,702700,MKT
06079807303290000,2019,140380,562320,702700,MKT
06079807304010000,2021,208154,398646,606800,MKT
06079807304010000,2020,150587,386313,536900,MKT
06079807304010000,2019,150587,386313,536900,MKT
06079807304030000,2021,194182,571118,765300,MKT
06079807304030000,2020,139288,534512,673800,MKT
06079807304030000,2019,139288,534512,673800,MKT
06079807304050000,2021,188558,460042,648600,MKT
06079807304050000,2020,134768,414632,549400,MKT
06079807304050000,2019,134768,414632,549400,MKT
06079807304070000,2021,209333,605567,814900,MKT
06079807304070000,2020,151545,555555,707100,MKT
06079807304070000,2019,151545,555555,707100,MKT
06079807304090000,2021,205755,678945,884700,MKT
06079807304090000,2020,148640,660730,809370,COST
06079807304090000,2019,148640,660730,809370,COST
06079807304110000,2021,205755,743545,949300,MKT
06079807304110000,2020,148640,641360,790000,OVR
06079807304110000,2019,148640,641360,790000,OVR
06079807305017000,2021,518490,0,518490,COST
06079807305017000,2020,420267,0,420267,COST
06079807305017000,2019,420267,0,420267,COST
06079807306010000,2021,190727,421073,611800,MKT
06079807306010000,2020,110212,389288,499500,MKT
06079807306010000,2019,110212,389288,499500,MKT
06079807306030000,2021,190727,528173,718900,MKT
06079807306030000,2020,110212,501088,611300,MKT
06079807306030000,2019,110212,501088,611300,MKT
06079807306050000,2021,190727,476773,667500,MKT
06079807306050000,2020,110212,458488,568700,MKT
06079807306050000,2019,110212,458488,568700,MKT
06079807306070000,2021,190727,485373,676100,MKT
06079807306070000,2020,110212,471588,581800,MKT
06079807306070000,2019,110212,471588,581800,MKT
06079807306090000,2021,198004,460096,658100,MKT
06079807306090000,2020,114943,446557,561500,MKT
06079807306090000,2019,114943,446557,561500,MKT
06079807306110000,2021,204776,493024,697800,MKT
06079807306110000,2020,119365,454535,573900,MKT
06079807306110000,2019,119365,454535,573900,MKT
06079807306130000,2021,200313,562487,762800,MKT
06079807306130000,2020,116449,556051,672500,MKT
06079807306130000,2019,116449,556051,672500,MKT
06079807306150000,2021,190727,467473,658200,MKT
06079807306150000,2020,110212,444688,554900,MKT
06079807306150000,2019,110212,444688,554900,MKT
06079807306170000,2021,193215,448685,641900,MKT
06079807306170000,2020,111827,458173,570000,MKT
06079807306170000,2019,111827,458173,570000,MKT
06079807306190000,2021,193215,534385,727600,MKT
06079807306190000,2020,111827,514973,626800,MKT
06079807306190000,2019,111827,514973,626800,MKT
06079807306210000,2021,193215,701170,894385,COST
06079807306210000,2020,111827,631110,742937,COST
06079807306210000,2019,111827,631110,742937,COST
06079807306230000,2021,195639,551861,747500,MKT
06079807306230000,2020,113403,519997,633400,MKT
06079807306230000,2019,113403,518497,631900,MKT
06079807306250000,2021,195639,370561,566200,MKT
06079807306250000,2020,113403,364297,477700,MKT
06079807306250000,2019,113403,364297,477700,MKT
06079807306270000,2021,200313,462887,663200,MKT
06079807306270000,2020,116449,434451,550900,MKT
06079807306270000,2019,116449,434451,550900,MKT
06079807306290000,2021,198004,531396,729400,MKT
06079807306290000,2020,114943,500357,615300,MKT
06079807306290000,2019,114943,500357,615300,MKT
06079807306310000,2021,193215,531385,724600,MKT
06079807306310000,2020,111827,504373,616200,MKT
06079807306310000,2019,111827,504373,616200,MKT
06079807306330000,2021,188172,347428,535600,MKT
06079807306330000,2020,108556,334444,443000,MKT
06079807306330000,2019,108556,334444,443000,MKT
06079807306350000,2021,190727,489873,680600,MKT
06079807306350000,2020,110212,436588,546800,MKT
06079807306350000,2019,110212,436588,546800,MKT
06079807306370000,2021,190727,315873,506600,MKT
06079807306370000,2020,110212,325588,435800,MKT
06079807306370000,2019,110212,325588,435800,MKT
06079807307010000,2021,190727,547973,738700,MKT
06079807307010000,2020,110212,515288,625500,MKT
06079807307010000,2019,110212,515288,625500,MKT
06079807307030000,2021,190727,449773,640500,MKT
06079807307030000,2020,110212,440888,551100,MKT
06079807307030000,2019,110212,440888,551100,MKT
06079807307050000,2021,190727,324773,515500,MKT
06079807307050000,2020,110212,329988,440200,MKT
06079807307050000,2019,110212,329988,440200,MKT
06079807307070000,2021,198004,374196,572200,MKT
06079807307070000,2020,114943,330157,445100,MKT
06079807307070000,2019,114943,330157,445100,MKT
06079807307090000,2021,204776,516924,721700,MKT
06079807307090000,2020,119365,517935,637300,MKT
06079807307090000,2019,119365,517935,637300,MKT
06079807307110000,2021,200313,470287,670600,MKT
06079807307110000,2020,116449,473351,589800,MKT
06079807307110000,2019,116449,473351,589800,MKT
06079807307130000,2021,190727,410473,601200,MKT
06079807307130000,2020,110212,397088,507300,MKT
06079807307130000,2019,110212,397088,507300,MKT
06079807307150000,2021,200313,526487,726800,MKT
06079807307150000,2020,116449,513051,629500,MKT
06079807307150000,2019,116449,513051,629500,MKT
06079807307170000,2021,193215,347385,540600,MKT
06079807307170000,2020,111827,334573,446400,MKT
06079807307170000,2019,111827,334573,446400,MKT
06079807307190000,2021,198004,450196,648200,MKT
06079807307190000,2020,114943,453857,568800,MKT
06079807307190000,2019,114943,453857,568800,MKT
06079807307210000,2021,195639,302261,497900,MKT
06079807307210000,2020,113403,263597,377000,MKT
06079807307210000,2019,113403,263597,377000,MKT
06079807307230000,2021,193215,402185,595400,MKT
06079807307230000,2020,111827,371173,483000,MKT
06079807307230000,2019,111827,371173,483000,MKT
06079807307250000,2021,193215,531085,724300,MKT
06079807307250000,2020,111827,504073,615900,MKT
06079807307250000,2019,111827,504073,615900,MKT
06079807307270000,2021,195639,431461,627100,MKT
06079807307270000,2020,113403,413497,526900,MKT
06079807307270000,2019,113403,413497,526900,MKT
06079807307290000,2021,195639,437961,633600,MKT
06079807307290000,2020,113403,431497,544900,MKT
06079807307290000,2019,113403,431497,544900,MKT
06079807307310000,2021,193215,410385,603600,MKT
06079807307310000,2020,111827,409073,520900,MKT
06079807307310000,2019,111827,409073,520900,MKT
06079807307330000,2021,193215,482485,675700,MKT
06079807307330000,2020,111827,472673,584500,MKT
06079807307330000,2019,111827,472673,584500,MKT
06079807307350000,2021,190727,418573,609300,MKT
06079807307350000,2020,110212,387788,498000,MKT
06079807307350000,2019,110212,387788,498000,MKT
06079807307370000,2021,191730,464270,656000,MKT
06079807307370000,2020,110863,432437,543300,MKT
06079807307370000,2019,110863,432437,543300,MKT
06079807307390000,2021,218644,459756,678400,MKT
06079807307390000,2020,128477,460023,588500,MKT
06079807307390000,2019,128477,460023,588500,MKT
06079807308010000,2021,194192,557608,751800,MKT
06079807308010000,2020,112462,536138,648600,MKT
06079807308010000,2019,112462,536138,648600,MKT
06079807308030000,2021,191730,433470,625200,MKT
06079807308030000,2020,110863,413437,524300,MKT
06079807308030000,2019,110863,413437,524300,MKT
06079807308050000,2021,191730,465270,657000,MKT
06079807308050000,2020,110863,473037,583900,MKT
06079807308050000,2019,110863,473037,583900,MKT
06079807308070000,2021,196117,525883,722000,MKT
06079807308070000,2020,113714,501286,615000,MKT
06079807308070000,2019,113714,501286,615000,MKT
06079807308090000,2021,199626,497774,697400,MKT
06079807308090000,2020,116001,506899,622900,MKT
06079807308090000,2019,116001,506899,622900,MKT
06079807308110000,2021,193949,467451,661400,MKT
06079807308110000,2020,112304,459596,571900,MKT
06079807308110000,2019,112304,459596,571900,MKT
06079807308130000,2021,191730,410870,602600,MKT
06079807308130000,2020,110863,402837,513700,MKT
06079807308130000,2019,110863,402837,513700,MKT
06079807308150000,2021,198004,411796,609800,MKT
06079807308150000,2020,114943,404257,519200,MKT
06079807308150000,2019,114943,404257,519200,MKT
06079807308170000,2021,196117,516083,712200,MKT
06079807308170000,2020,113714,503386,617100,MKT
06079807308170000,2019,113714,503386,617100,MKT
06079807308190000,2021,196355,485145,681500,MKT
06079807308190000,2020,113869,435231,549100,MKT
06079807308190000,2019,113869,435231,549100,MKT
06079807308210000,2021,197065,485435,682500,MKT
06079807308210000,2020,114331,435569,549900,MKT
06079807308210000,2019,114331,435569,549900,MKT
06079807308230000,2021,200769,546431,747200,MKT
06079807308230000,2020,116746,504154,620900,MKT
06079807308230000,2019,116746,504154,620900,MKT
06079807308250000,2021,198934,563466,762400,MKT
06079807308250000,2020,115550,541150,656700,MKT
06079807308250000,2019,115550,541150,656700,MKT
06079807308270000,2021,193460,519340,712800,MKT
06079807308270000,2020,111986,502714,614700,MKT
06079807308270000,2019,111986,502714,614700,MKT
06079807308290000,2021,200541,448859,649400,MKT
06079807308290000,2020,116598,393302,509900,MKT
06079807308290000,2019,116598,393302,509900,MKT
06079807308310000,2021,200313,474087,674400,MKT
06079807308310000,2020,116449,474251,590700,MKT
06079807308310000,2019,116449,462251,578700,MKT
06079807308330000,2021,200541,518859,719400,MKT
06079807308330000,2020,116598,492502,609100,MKT
06079807308330000,2019,116598,492502,609100,MKT
06079807308350000,2021,206507,498593,705100,MKT
06079807308350000,2020,120499,459301,579800,MKT
06079807308350000,2019,120499,472801,593300,MKT
06079807308370000,2021,207787,457013,664800,MKT
06079807308370000,2020,121337,456463,577800,MKT
06079807308370000,2019,121337,456463,577800,MKT
06079807308390000,2021,207998,0,207998,COST
06079807308390000,2020,121476,0,121476,COST
06079807308390000,2019,121476,0,121476,COST
06079807308416500,2021,187302,0,187302,COST
06079807308416500,2020,125014,0,125014,COST
06079807308416500,2019,125014,0,125014,COST
06079807309010000,2021,194192,482308,676500,MKT
06079807309010000,2020,112462,491938,604400,MKT
06079807309010000,2019,112462,0,112462,COST
06079807309030000,2021,194192,491308,685500,MKT
06079807309030000,2020,112462,467938,580400,MKT
06079807309030000,2019,112462,467938,580400,MKT
06079807309050000,2021,188689,526011,714700,MKT
06079807309050000,2020,108890,503210,612100,MKT
06079807309050000,2019,108890,503210,612100,MKT
06079807309070000,2021,202792,467508,670300,MKT
06079807309070000,2020,118068,480532,598600,MKT
06079807309070000,2019,118068,494832,612900,MKT
06079807309090000,2021,204119,615781,819900,MKT
06079807309090000,2020,118936,558964,677900,MKT
06079807309090000,2019,118936,558964,677900,MKT
06079807309110000,2021,210298,449202,659500,MKT
06079807309110000,2020,122985,449015,572000,MKT
06079807309110000,2019,122985,449015,572000,MKT
06079807309130000,2021,212751,400349,613100,MKT
06079807309130000,2020,124596,365204,489800,MKT
06079807309130000,2019,124596,365204,489800,MKT
06079807309150000,2021,210917,476583,687500,MKT
06079807309150000,2020,123391,476909,600300,MKT
06079807309150000,2019,123391,476909,600300,MKT
06079807309170000,2021,208420,466180,674600,MKT
06079807309170000,2020,121753,460147,581900,MKT
06079807309170000,2019,121753,460147,581900,MKT
06079807309190000,2021,203899,402501,606400,MKT
06079807309190000,2020,118792,368708,487500,OVR
06079807309190000,2019,118792,368708,487500,OVR
06079807309210000,2021,187392,560808,748200,MKT
06079807309210000,2020,108050,533250,641300,MKT
06079807309210000,2019,108050,533250,641300,MKT
06079807309230000,2021,194192,555608,749800,MKT
06079807309230000,2020,112462,573338,685800,OVR
06079807309230000,2019,112462,573338,685800,MKT
06079807309250000,2021,194192,441308,635500,MKT
06079807309250000,2020,112462,451238,563700,MKT
06079807309250000,2019,112462,451238,563700,MKT
06079807310010000,2021,202792,502208,705000,MKT
06079807310010000,2020,118068,467132,585200,MKT
06079807310010000,2019,118068,467132,585200,MKT
06079807310030000,2021,202570,388730,591300,MKT
06079807310030000,2020,117923,359977,477900,MKT
06079807310030000,2019,117923,359977,477900,MKT
06079807310050000,2021,202570,603130,805700,MKT
06079807310050000,2020,117923,569377,687300,MKT
06079807310050000,2019,117923,569377,687300,MKT
06079807310070000,2021,202570,0,202570,COST
06079807310070000,2020,117923,0,117923,COST
06079807310070000,2019,117923,0,117923,COST
06079807310090000,2021,202570,533730,736300,MKT
06079807310090000,2020,117923,536477,654400,MKT
06079807310090000,2019,117923,536477,654400,MKT
06079807310110000,2021,202570,598030,800600,MKT
06079807310110000,2020,117923,568977,686900,MKT
06079807310110000,2019,117923,568977,686900,MKT
06079807310130000,2021,202570,494030,696600,MKT
06079807310130000,2020,117923,489877,607800,MKT
06079807310130000,2019,117923,489877,607800,MKT
06079807310150000,2021,202570,524630,727200,MKT
06079807310150000,2020,117923,514177,632100,MKT
06079807310150000,2019,117923,514177,632100,MKT
06079807310170000,2021,202570,446830,649400,MKT
06079807310170000,2020,117923,452677,570600,MKT
06079807310170000,2019,117923,452677,570600,MKT
06079807310190000,2021,202570,554330,756900,MKT
06079807310190000,2020,117923,507277,625200,MKT
06079807310190000,2019,117923,507277,625200,MKT
06079807310210000,2021,202570,689260,891830,COST
06079807310210000,2020,117923,616500,734423,COST
06079807310210000,2019,117923,616500,734423,COST
06079807310230000,2021,202570,392630,595200,MKT
06079807310230000,2020,117923,378177,496100,MKT
06079807310230000,2019,117923,378177,496100,MKT
06079807310250000,2021,202570,464230,666800,MKT
06079807310250000,2020,117923,473577,591500,MKT
06079807310250000,2019,117923,473577,591500,MKT
06079807310270000,2021,202570,466430,669000,MKT
06079807310270000,2020,117923,463777,581700,MKT
06079807310270000,2019,117923,463777,581700,MKT
06079807310290000,2021,202570,471030,673600,MKT
06079807310290000,2020,117923,464377,582300,MKT
06079807310290000,2019,117923,464377,582300,MKT
06079807310310000,2021,202570,531430,734000,MKT
06079807310310000,2020,117923,524877,642800,MKT
06079807310310000,2019,117923,524877,642800,MKT
06079807310330000,2021,197770,0,197770,COST
06079807310330000,2020,114791,0,114791,COST
06079807310330000,2019,114791,0,114791,COST
06079807310350000,2021,191979,401221,593200,MKT
06079807310350000,2020,111024,392076,503100,MKT
06079807310350000,2019,111024,392076,503100,MKT
06079807310370000,2021,192228,439772,632000,MKT
06079807310370000,2020,111186,435314,546500,MKT
06079807310370000,2019,111186,435314,546500,MKT
06079807310390000,2021,202122,565278,767400,MKT
06079807310390000,2020,117630,227700,345330,COST
06079807310390000,2019,117630,0,117630,COST
06079807310410000,2021,223136,488264,711400,MKT
06079807310410000,2020,131444,476356,607800,MKT
06079807310410000,2019,131444,476356,607800,MKT
06079807310430000,2021,296155,518645,814800,MKT
06079807310430000,2020,180618,513682,694300,MKT
06079807310430000,2019,180618,513682,694300,MKT
06079807310450000,2021,300933,519867,820800,MKT
06079807310450000,2020,183892,532610,716502,COST
06079807310450000,2019,183892,532610,716502,COST
06079807310470000,2021,260461,655460,915921,COST
06079807310470000,2020,156368,636180,792548,OVR
06079807310470000,2019,156368,636180,792548,COST
06079807310490000,2021,243403,740797,984200,MKT
06079807310490000,2020,144919,736640,881559,COST
06079807310490000,2019,144919,736640,881559,COST
06079807310510000,2021,239178,618222,857400,MKT
06079807310510000,2020,142098,0,142098,COST
06079807310510000,2019,142098,0,142098,COST
06079807310536500,2021,127333,0,127333,COST
06079807310536500,2020,81061,0,81061,COST
06079807310536500,2019,81061,0,81061,COST
06079807310550000,2021,242477,756223,998700,MKT
06079807310550000,2020,144300,730630,874930,OVR
06079807310550000,2019,144300,730630,874930,COST
06079807310570000,2021,243095,590605,833700,MKT
06079807310570000,2020,144713,556487,701200,MKT
06079807310570000,2019,144713,556487,701200,MKT
06079807310590000,2021,225315,624585,849900,MKT
06079807310590000,2020,132886,583714,716600,OVR
06079807310590000,2019,132886,583714,716600,MKT
06079807310610000,2021,211327,760273,971600,MKT
06079807310610000,2020,123661,592239,715900,MKT
06079807310610000,2019,123661,592239,715900,MKT
06079807310630000,2021,211532,803568,1015100,MKT
06079807310630000,2020,123795,683805,807600,MKT
06079807310630000,2019,123795,669105,792900,MKT
06079807311010000,2021,217297,518003,735300,MKT
06079807311010000,2020,127589,232030,359619,COST
06079807311010000,2019,127589,0,127589,COST
06079807311030000,2021,207149,543651,750800,MKT
06079807311030000,2020,120919,139020,259939,COST
06079807311030000,2019,120919,0,120919,COST
06079807311050000,2021,190979,648221,839200,MKT
06079807311050000,2020,110375,343080,453455,COST
06079807311050000,2019,110375,0,110375,COST
06079807311070000,2021,190979,534121,725100,MKT
06079807311070000,2020,110375,493125,603500,MKT
06079807311070000,2019,110375,493125,603500,MKT
06079807311090000,2021,190979,577721,768700,MKT
06079807311090000,2020,110375,539625,650000,OVR
06079807311090000,2019,110375,539625,650000,OVR
06079807311110000,2021,190979,467521,658500,MKT
06079807311110000,2020,110375,472325,582700,MKT
06079807311110000,2019,110375,472325,582700,MKT
06079807311130000,2021,190979,350821,541800,MKT
06079807311130000,2020,110375,314825,425200,MKT
06079807311130000,2019,110375,334925,445300,MKT
06079807311150000,2021,190979,408021,599000,MKT
06079807311150000,2020,110375,381825,492200,MKT
06079807311150000,2019,110375,381825,492200,MKT
06079807311170000,2021,190979,589821,780800,MKT
06079807311170000,2020,110375,544225,654600,MKT
06079807311170000,2019,110375,528225,638600,MKT
06079807311190000,2021,190979,517221,708200,MKT
06079807311190000,2020,110375,580030,690405,COST
06079807311190000,2019,110375,580030,690405,COST
06079807311210000,2021,190979,497321,688300,MKT
06079807311210000,2020,110375,198090,308465,COST
06079807311210000,2019,110375,0,110375,COST
06079807311230000,2021,190979,536821,727800,MKT
06079807311230000,2020,110375,493425,603800,MKT
06079807311230000,2019,110375,493425,603800,MKT
06079807311250000,2021,190979,513221,704200,MKT
06079807311250000,2020,110375,500025,610400,MKT
06079807311250000,2019,110375,500025,610400,MKT
06079807311270000,2021,190979,602621,793600,MKT
06079807311270000,2020,110375,531525,641900,MKT
06079807311270000,2019,110375,531525,641900,MKT
06079807311290000,2021,190979,481821,672800,MKT
06079807311290000,2020,110375,495825,606200,MKT
06079807311290000,2019,110375,495825,606200,MKT
06079807311310000,2021,190979,602421,793400,MKT
06079807311310000,2020,110375,655225,765600,MKT
06079807311310000,2019,110375,550325,660700,MKT
06079807311330000,2021,228680,712870,941550,COST
06079807311330000,2020,135116,580272,715388,OVR
06079807311330000,2019,135116,580272,715388,OVR
06079807312010000,2021,231609,574091,805700,MKT
06079807312010000,2020,137059,527641,664700,MKT
06079807312010000,2019,137059,527641,664700,MKT
06079807312030000,2021,241387,659113,900500,MKT
06079807312030000,2020,143572,594828,738400,MKT
06079807312030000,2019,143572,594828,738400,MKT
06079807312050000,2021,241387,489413,730800,MKT
06079807312050000,2020,143572,479028,622600,MKT
06079807312050000,2019,143572,0,143572,COST
06079807312070000,2021,241387,436013,677400,MKT
06079807312070000,2020,143572,396328,539900,MKT
06079807312070000,2019,143572,396328,539900,MKT
06079807312090000,2021,240288,0,240288,COST
06079807312090000,2020,142838,0,142838,COST
06079807312090000,2019,142838,0,142838,COST
06079807312110000,2021,235125,891475,1126600,MKT
06079807312110000,2020,139398,748802,888200,MKT
06079807312110000,2019,139398,748802,888200,MKT
06079807312130000,2021,217876,474624,692500,MKT
06079807312130000,2020,127971,440729,568700,MKT
06079807312130000,2019,127971,440729,568700,MKT
06079807312150000,2021,217876,574124,792000,MKT
06079807312150000,2020,127971,539929,667900,MKT
06079807312150000,2019,127971,539929,667900,MKT
06079807312170000,2021,217876,497324,715200,MKT
06079807312170000,2020,127971,444929,572900,MKT
06079807312170000,2019,127971,444929,572900,MKT
06079807312190000,2021,232456,422044,654500,MKT
06079807312190000,2020,137622,414778,552400,MKT
06079807312190000,2019,137622,414778,552400,MKT
06079807312210000,2021,224774,549826,774600,MKT
06079807312210000,2020,132528,498072,630600,MKT
06079807312210000,2019,132528,498072,630600,MKT
06079807320010000,2021,144066,0,144066,COST
06079807320010000,2020,184976,0,184976,COST
06079807320010000,2019,184976,0,184976,COST
06079807401100000,2021,83052,0,83052,COST
06079807401100000,2020,106714,0,106714,COST
06079807401100000,2019,106714,0,106714,COST
06079807415010000,2021,394818,1127282,1522100,INCOME
06079807415010000,2020,416292,874508,1290800,INCOME
06079807415010000,2019,416292,874508,1290800,INCOME
06079807415030000,2021,152327,285373,437700,MKT
06079807415030000,2020,122971,254829,377800,OVR
06079807415030000,2019,122971,254829,377800,MKT
06079807415040000,2021,151895,302105,454000,MKT
06079807415040000,2020,122580,275820,398400,MKT
06079807415040000,2019,122580,262320,384900,MKT
06079807415050000,2021,151678,255222,406900,MKT
06079807415050000,2020,122383,224317,346700,OVR
06079807415050000,2019,122383,224317,346700,MKT
06079807415060000,2021,151460,394140,545600,MKT
06079807415060000,2020,122186,408814,531000,OVR
06079807415060000,2019,122186,408814,531000,MKT
06079807415070000,2021,151241,319130,470371,COST
06079807415070000,2020,121988,286480,408468,COST
06079807415070000,2019,121988,286480,408468,COST
06079808101010000,2021,62180,582600,644780,COST
06079808101010000,2020,62032,525440,587472,COST
06079808101010000,2019,62032,525440,587472,COST
06079808101020000,2021,516826,151000,667826,COST
06079808101020000,2020,484626,137630,622256,COST
06079808101020000,2019,484626,137630,622256,COST
06079808101040000,2021,98421,542910,641331,COST
06079808101040000,2020,121616,507460,629076,COST
06079808101040000,2019,121616,508830,630446,COST
06079808201010000,2021,47872,0,47872,COST
06079808201010000,2020,44297,0,44297,COST
06079808201010000,2019,44297,0,44297,COST
06079808201200000,2021,35425,0,35425,COST
06079808201200000,2020,33623,0,33623,COST
06079808201200000,2019,33623,0,33623,COST
06079808202010000,2021,205570,221630,427200,MKT
06079808202010000,2020,172165,230535,402700,MKT
06079808202010000,2019,172165,230535,402700,MKT
06079808203030000,2021,17549,397410,414959,COST
06079808203030000,2020,17896,357490,375386,COST
06079808203030000,2019,17896,357490,375386,COST
06079808301010000,2021,196952,409050,606002,COST
06079808301010000,2020,164079,374380,538459,COST
06079808301010000,2019,164079,374380,538459,COST
06079808301100000,2021,2214,6800,9014,COST
06079808301100000,2020,2060,7420,9480,COST
06079808301100000,2019,2060,7420,9480,COST
06079808302010000,2021,652679,871921,1524600,INCOME
06079808302010000,2020,351460,964440,1315900,INCOME
06079808302010000,2019,351460,964440,1315900,INCOME
06079808302030000,2021,196502,218930,415432,COST
06079808302030000,2020,163660,200370,364030,COST
06079808302030000,2019,163660,200370,364030,COST
06079808302040000,2021,134465,0,134465,COST
06079808302040000,2020,106906,0,106906,COST
06079808302040000,2019,106906,0,106906,COST
06079808302050000,2021,100340,0,100340,COST
06079808302050000,2020,76997,0,76997,COST
06079808302050000,2019,76997,0,76997,COST
06079808302070000,2021,284998,430302,715300,MKT
06079808302070000,2020,248438,425040,673478,COST
06079808302070000,2019,248438,425040,673478,COST
06079808302100000,2021,652483,907720,1560203,COST
06079808302100000,2020,351390,1134210,1485600,INCOME
06079808302100000,2019,351390,1134210,1485600,INCOME
06079808302150000,2021,349532,1384968,1734500,INCOME
06079808302150000,2020,232762,1361438,1594200,INCOME
06079808302150000,2019,232762,1361438,1594200,INCOME
06079808302170000,2021,310772,0,310772,COST
06079808302170000,2020,215391,0,215391,COST
06079808302170000,2019,215391,0,215391,COST
06079808302200000,2021,325854,0,325854,COST
06079808302200000,2020,222233,0,222233,COST
06079808302200000,2019,222233,0,222233,COST
06079808302250000,2021,567716,5069284,5637000,INCOME
06079808302250000,2020,320559,4422641,4743200,INCOME
06079808302250000,2019,320559,4422641,4743200,INCOME
06079808302300000,2021,2288,0,2288,COST
06079808302300000,2020,2129,0,2129,COST
06079808302300000,2019,2129,0,2129,COST
06079808401010000,2021,4291,0,4291,COST
06079808401010000,2020,3994,0,3994,COST
06079808401010000,2019,3994,0,3994,COST
06079809101030000,2021,393862,245280,639142,COST
06079809101030000,2020,328119,229190,557309,COST
06079809101030000,2019,199262,229190,428452,COST
06079809101040000,2021,281628,185872,467500,INCOME
06079809101040000,2020,245142,163858,409000,INCOME
06079809101040000,2019,245142,163858,409000,INCOME
06079809101060000,2021,702,0,702,COST
06079809101060000,2020,886,0,886,COST
06079809101060000,2019,886,0,886,COST
06079809101080000,2021,195900,214100,410000,MKT
06079809101080000,2020,126125,222275,348400,MKT
06079809101080000,2019,126125,222275,348400,MKT
06079809101090000,2021,155802,201498,357300,MKT
06079809101090000,2020,126125,166575,292700,MKT
06079809101090000,2019,126125,166575,292700,MKT
06079809101100000,2021,195900,208300,404200,MKT
06079809101100000,2020,163100,179500,342600,MKT
06079809101100000,2019,163100,179500,342600,MKT
06079809101110000,2021,195900,222000,417900,MKT
06079809101110000,2020,163100,171900,335000,MKT
06079809101110000,2019,163100,171900,335000,MKT
06079809101130000,2021,4390,0,4390,COST
06079809101130000,2020,4085,0,4085,COST
06079809101130000,2019,4085,0,4085,COST
06079809101140000,2021,214370,189360,403730,COST
06079809101140000,2020,211483,189080,400563,COST
06079809101140000,2019,211483,189080,400563,COST
06079809102016500,2021,50640,0,50640,COST
06079809102016500,2020,63744,0,63744,COST
06079809102016500,2019,63744,0,63744,COST
06079809102106500,2021,79156,0,79156,COST
06079809102106500,2020,152433,0,152433,COST
06079809102106500,2019,152433,0,152433,COST
06079809103010000,2021,100917,480483,581400,MKT
06079809103010000,2020,77847,425253,503100,MKT
06079809103010000,2019,77847,425253,503100,MKT
06079809103030000,2021,98391,364009,462400,MKT
06079809103030000,2020,74090,337610,411700,MKT
06079809103030000,2019,74090,337610,411700,MKT
06079809103050000,2021,100917,370083,471000,MKT
06079809103050000,2020,77847,354753,432600,MKT
06079809103050000,2019,77847,354753,432600,MKT
06079809103070000,2021,97585,352915,450500,MKT
06079809103070000,2020,72910,341090,414000,MKT
06079809103070000,2019,72910,341090,414000,MKT
06079809103090000,2021,102168,317032,419200,MKT
06079809103090000,2020,79743,303257,383000,MKT
06079809103090000,2019,79743,303257,383000,MKT
06079809104010000,2021,104094,354806,458900,MKT
06079809104010000,2020,82703,353297,436000,MKT
06079809104010000,2019,82703,353297,436000,MKT
06079809104030000,2021,101948,378952,480900,MKT
06079809104030000,2020,79407,365593,445000,MKT
06079809104030000,2019,79407,365593,445000,MKT
06079809104050000,2021,101948,381152,483100,MKT
06079809104050000,2020,79407,362593,442000,MKT
06079809104050000,2019,79407,362593,442000,MKT
06079809104070000,2021,104357,335043,439400,MKT
06079809104070000,2020,83112,310788,393900,MKT
06079809104070000,2019,83112,310788,393900,MKT
06079809105010000,2021,101144,468856,570000,MKT
06079809105010000,2020,78190,419810,498000,MKT
06079809105010000,2019,78190,419810,498000,MKT
06079809105030000,2021,97493,382107,479600,MKT
06079809105030000,2020,72776,369224,442000,MKT
06079809105030000,2019,72776,369224,442000,MKT
06079809105050000,2021,97493,379007,476500,MKT
06079809105050000,2020,72776,363124,435900,MKT
06079809105050000,2019,72776,363124,435900,MKT
06079809105070000,2021,97493,0,97493,COST
06079809105070000,2020,72776,0,72776,COST
06079809105070000,2019,72776,0,72776,COST
06079809105090000,2021,101356,397344,498700,MKT
06079809105090000,2020,78509,384591,463100,MKT
06079809105090000,2019,78509,384591,463100,MKT
06079809105110000,2021,100118,350182,450300,MKT
06079809105110000,2020,76650,336050,412700,MKT
06079809105110000,2019,76650,336050,412700,MKT
06079809105130000,2021,97493,312107,409600,MKT
06079809105130000,2020,72776,296324,369100,MKT
06079809105130000,2019,72776,296324,369100,MKT
06079809105150000,2021,97493,339607,437100,MKT
06079809105150000,2020,72776,323124,395900,MKT
06079809105150000,2019,72776,323124,395900,MKT
06079809105170000,2021,97493,278407,375900,MKT
06079809105170000,2020,72776,268524,341300,MKT
06079809105170000,2019,72776,268524,341300,MKT
06079809105190000,2021,100256,448344,548600,MKT
06079809105190000,2020,76855,439345,516200,MKT
06079809105190000,2019,76855,439345,516200,MKT
06079809106010000,2021,100861,343139,444000,MKT
06079809106010000,2020,77763,331237,409000,MKT
06079809106010000,2019,77763,331237,409000,MKT
06079809106030000,2021,98391,395009,493400,MKT
06079809106030000,2020,74090,375810,449900,MKT
06079809106030000,2019,74090,375810,449900,MKT
06079809106050000,2021,98391,338209,436600,MKT
06079809106050000,2020,74090,318310,392400,MKT
06079809106050000,2019,74090,318310,392400,MKT
06079809106070000,2021,98391,308709,407100,MKT
06079809106070000,2020,74090,282710,356800,MKT
06079809106070000,2019,74090,282710,356800,MKT
06079809106090000,2021,98391,338209,436600,MKT
06079809106090000,2020,74090,322010,396100,MKT
06079809106090000,2019,74090,322010,396100,MKT
06079809106110000,2021,104141,333600,437741,COST
06079809106110000,2020,82775,0,82775,COST
06079809106110000,2019,82775,0,82775,COST
06079809107010000,2021,139408,0,139408,COST
06079809107030000,2021,139408,0,139408,COST
06079809107050000,2021,139010,0,139010,COST
06079809107070000,2021,172061,0,172061,COST
06079809107090000,2021,142931,0,142931,COST
06079809107110000,2021,143851,0,143851,COST
06079809107130000,2021,143843,0,143843,COST
06079809108010000,2021,140847,0,140847,COST
06079809108030000,2021,92232,0,92232,COST
06079809108050000,2021,92011,0,92011,COST
06079809108070000,2021,91789,0,91789,COST
06079809108090000,2021,91558,0,91558,COST
06079809108110000,2021,98361,0,98361,COST
06079809108130000,2021,96754,0,96754,COST
06079809108150000,2021,96075,0,96075,COST
06079809108170000,2021,96069,0,96069,COST
06079809108190000,2021,96624,0,96624,COST
06079809108216500,2021,37617,0,37617,COST
06079809112010000,2021,323276,0,323276,COST
06079809112010000,2020,479201,0,479201,COST
06079809112010000,2019,479201,0,479201,COST
06079809112100000,2021,1947032,4098940,6045972,COST
06079809112100000,2020,1232766,4068340,5301106,COST
06079809112100000,2019,1232766,4068340,5301106,COST
06079809112150000,2021,2818211,9043410,11861621,COST
06079809112150000,2020,754751,8794270,9549021,COST
06079809112150000,2019,754751,8794270,9549021,COST
06079809112206500,2021,167435,0,167435,COST
06079809112206500,2020,417386,0,417386,COST
06079809112206500,2019,417386,0,417386,COST
06079809148016500,2021,87673,0,87673,COST
06079809148016500,2020,699406,0,699406,COST
06079809148016500,2019,699406,0,699406,COST
06079809201100000,2021,14079,0,14079,COST
06079809201100000,2020,13066,0,13066,COST
06079809201100000,2019,13066,0,13066,COST
06079809201200000,2021,15853,0,15853,COST
06079809201200000,2020,14714,0,14714,COST
06079809201200000,2019,14714,0,14714,COST
06079809202010000,2021,179693,0,179693,COST
06079809202010000,2020,148031,0,148031,COST
06079809202010000,2019,148031,0,148031,COST
06079809203015001,2021,93420,213080,306500,MKT
06079809203015001,2020,66960,228540,295500,MKT
06079809203015001,2019,66960,228540,295500,MKT
06079809203035002,2021,90162,184638,274800,MKT
06079809203035002,2020,62477,206423,268900,MKT
06079809203035002,2019,62477,206423,268900,MKT
06079809203055001,2021,91831,265369,357200,MKT
06079809203055001,2020,64754,277846,342600,MKT
06079809203055001,2019,64754,277846,342600,MKT
06079809203075002,2021,91831,265069,356900,MKT
06079809203075002,2020,64754,277746,342500,MKT
06079809203075002,2019,64754,277746,342500,MKT
06079809203095001,2021,91831,255769,347600,MKT
06079809203095001,2020,64754,264546,329300,MKT
06079809203095001,2019,64754,264546,329300,MKT
06079809203115002,2021,91831,256069,347900,MKT
06079809203115002,2020,64754,264946,329700,MKT
06079809203115002,2019,64754,264946,329700,MKT
06079809203135001,2021,91831,221569,313400,MKT
06079809203135001,2020,64754,233446,298200,MKT
06079809203135001,2019,64754,233446,298200,MKT
06079809203155002,2021,98341,221159,319500,MKT
06079809203155002,2020,74017,226883,300900,MKT
06079809203155002,2019,74017,226883,300900,MKT
06079809203176500,2021,65743,0,65743,COST
06079809203176500,2020,106094,0,106094,COST
06079809203176500,2019,106094,0,106094,COST
06079809204015001,2021,99437,247963,347400,MKT
06079809204015001,2020,75635,267665,343300,MKT
06079809204015001,2019,75635,267665,343300,MKT
06079809204035002,2021,90740,256460,347200,MKT
06079809204035002,2020,63261,268539,331800,MKT
06079809204035002,2019,63261,268539,331800,MKT
06079809204050000,2021,91229,329571,420800,MKT
06079809204050000,2020,63928,315272,379200,MKT
06079809204050000,2019,63928,315272,379200,MKT
06079809204070000,2021,91155,330945,422100,MKT
06079809204070000,2020,63827,316273,380100,MKT
06079809204070000,2019,63827,316273,380100,MKT
06079809204090000,2021,90471,316229,406700,MKT
06079809204090000,2020,62896,292004,354900,MKT
06079809204090000,2019,62896,292004,354900,MKT
06079809204110000,2021,84788,318012,402800,MKT
06079809204110000,2020,55415,302485,357900,MKT
06079809204110000,2019,55415,302485,357900,MKT
06079809204130000,2021,84788,314712,399500,MKT
06079809204130000,2020,55415,301685,357100,MKT
06079809204130000,2019,55415,301685,357100,MKT
06079809204150000,2021,87930,302570,390500,MKT
06079809204150000,2020,59494,282206,341700,MKT
06079809204150000,2019,59494,282206,341700,MKT
06079809205015001,2021,89547,288453,378000,MKT
06079809205015001,2020,61648,276352,338000,MKT
06079809205015001,2019,61648,276352,338000,MKT
06079809205035002,2021,85669,306231,391900,MKT
06079809205035002,2020,56545,275755,332300,MKT
06079809205035002,2019,56545,276355,332900,MKT
06079809205055001,2021,85072,219528,304600,MKT
06079809205055001,2020,55778,231222,287000,MKT
06079809205055001,2019,55778,231222,287000,MKT
06079809205075002,2021,83779,183621,267400,MKT
06079809205075002,2020,54136,204964,259100,MKT
06079809205075002,2019,54136,204964,259100,MKT
06079809205095001,2021,88422,257278,345700,MKT
06079809205095001,2020,60146,268954,329100,MKT
06079809205095001,2019,60146,268954,329100,MKT
06079809205115002,2021,88012,248088,336100,MKT
06079809205115002,2020,59602,263998,323600,MKT
06079809205115002,2019,59602,263998,323600,MKT
06079809205135001,2021,84788,287212,372000,MKT
06079809205135001,2020,55415,275485,330900,MKT
06079809205135001,2019,55415,275485,330900,MKT
06079809205155002,2021,84788,287212,372000,MKT
06079809205155002,2020,55415,275485,330900,MKT
06079809205155002,2019,55415,275485,330900,MKT
06079809205175001,2021,84788,302812,387600,MKT
06079809205175001,2020,55415,274585,330000,MKT
06079809205175001,2019,55415,274585,330000,MKT
06079809205195002,2021,89971,273029,363000,MKT
06079809205195002,2020,62219,294181,356400,MKT
06079809205195002,2019,62219,294181,356400,MKT
06079809206015001,2021,140243,343057,483300,MKT
06079809206015001,2020,85652,371148,456800,MKT
06079809206015001,2019,85652,371148,456800,MKT
06079809206035002,2021,135919,348581,484500,MKT
06079809206035002,2020,80573,345127,425700,MKT
06079809206035002,2019,80573,345127,425700,MKT
06079809206055001,2021,135919,290281,426200,MKT
06079809206055001,2020,80573,308427,389000,MKT
06079809206055001,2019,80573,308427,389000,MKT
06079809206075002,2021,137703,344997,482700,MKT
06079809206075002,2020,82649,371651,454300,MKT
06079809206075002,2019,82649,371651,454300,MKT
06079809206095001,2021,139087,334413,473500,MKT
06079809206095001,2020,84278,346422,430700,MKT
06079809206095001,2019,84278,346422,430700,MKT
06079809206115002,2021,139104,343496,482600,MKT
06079809206115002,2020,84299,368601,452900,MKT
06079809206115002,2019,84299,368601,452900,MKT
06079809206135001,2021,139095,324805,463900,MKT
06079809206135001,2020,84289,345011,429300,MKT
06079809206135001,2019,84289,345011,429300,MKT
06079809206155002,2021,139104,324796,463900,MKT
06079809206155002,2020,84299,345001,429300,MKT
06079809206155002,2019,84299,345001,429300,MKT
06079809206175001,2021,136690,343710,480400,MKT
06079809206175001,2020,81467,388333,469800,MKT
06079809206175001,2019,81467,388333,469800,MKT
06079809206195002,2021,140243,322657,462900,MKT
06079809206195002,2020,85652,365748,451400,MKT
06079809206195002,2019,85652,365748,451400,MKT
06079809207010000,2021,89333,0,89333,COST
06079809207010000,2020,61361,0,61361,COST
06079809207010000,2019,61361,0,61361,COST
06079809207030000,2021,87347,288053,375400,MKT
06079809207030000,2020,58726,270374,329100,MKT
06079809207030000,2019,58726,270374,329100,MKT
06079809207050000,2021,87444,287356,374800,MKT
06079809207050000,2020,58853,269447,328300,MKT
06079809207050000,2019,58853,269447,328300,MKT
06079809207070000,2021,87527,279673,367200,MKT
06079809207070000,2020,58962,269438,328400,MKT
06079809207070000,2019,58962,269438,328400,MKT
06079809207096500,2021,70116,0,70116,COST
06079809207096500,2020,120304,0,120304,COST
06079809207096500,2019,120304,0,120304,COST
06079809208015002,2021,89682,154518,244200,MKT
06079809208015002,2020,61830,168770,230600,MKT
06079809208015002,2019,61830,168770,230600,MKT
06079809208035001,2021,80861,162739,243600,MKT
06079809208035001,2020,50516,172684,223200,MKT
06079809208035001,2019,50516,172684,223200,MKT
06079809208055002,2021,79903,158697,238600,MKT
06079809208055002,2020,49355,172445,221800,MKT
06079809208055002,2019,49355,172445,221800,MKT
06079809208075001,2021,79903,132897,212800,MKT
06079809208075001,2020,49355,155545,204900,MKT
06079809208075001,2019,49355,155545,204900,MKT
06079809208095002,2021,79903,158697,238600,MKT
06079809208095002,2020,49355,172545,221900,MKT
06079809208095002,2019,49355,172545,221900,MKT
06079809208115001,2021,79903,132997,212900,MKT
06079809208115001,2020,49355,155545,204900,MKT
06079809208115001,2019,49355,155545,204900,MKT
06079809208135002,2021,79912,164388,244300,MKT
06079809208135002,2020,49365,174435,223800,MKT
06079809208135002,2019,49365,174435,223800,MKT
06079809208155001,2021,81530,128370,209900,MKT
06079809208155001,2020,51335,150165,201500,MKT
06079809208155001,2019,51335,150165,201500,MKT
06079809209010000,2021,93724,311476,405200,MKT
06079809209010000,2020,67385,263815,331200,MKT
06079809209010000,2019,67385,269615,337000,MKT
06079809209030000,2021,89682,357318,447000,MKT
06079809209030000,2020,61830,347770,409600,MKT
06079809209030000,2019,61830,347770,409600,MKT
06079809209050000,2021,96059,352741,448800,MKT
06079809209050000,2020,70700,344000,414700,MKT
06079809209050000,2019,70700,344000,414700,MKT
06079809209075002,2021,91963,274237,366200,MKT
06079809209075002,2020,64937,0,64937,COST
06079809209075002,2019,64937,0,64937,COST
06079809209095001,2021,90976,278124,369100,MKT
06079809209095001,2020,63583,0,63583,COST
06079809209095001,2019,63583,0,63583,COST
06079809209110000,2021,88629,0,88629,COST
06079809209110000,2020,60421,0,60421,COST
06079809209110000,2019,60421,0,60421,COST
06079809209130000,2021,87034,0,87034,COST
06079809209130000,2020,58316,0,58316,COST
06079809209130000,2019,58316,0,58316,COST
06079809209155001,2021,86097,282703,368800,MKT
06079809209155001,2020,57097,287803,344900,MKT
06079809209155001,2019,57097,287803,344900,MKT
06079809209175002,2021,90883,293117,384000,MKT
06079809209175002,2020,63456,328044,391500,MKT
06079809209175002,2019,63456,328044,391500,MKT
06079809210010000,2021,98446,324554,423000,MKT
06079809210010000,2020,74171,302429,376600,MKT
06079809210010000,2019,74171,302429,376600,MKT
06079809210030000,2021,93097,348703,441800,MKT
06079809210030000,2020,66508,334892,401400,MKT
06079809210030000,2019,66508,0,66508,COST
06079809210050000,2021,90988,327112,418100,MKT
06079809210050000,2020,63600,310700,374300,MKT
06079809210050000,2019,63600,310700,374300,MKT
06079809210070000,2021,91831,359969,451800,MKT
06079809210070000,2020,64754,339346,404100,MKT
06079809210070000,2019,64754,339346,404100,MKT
06079809210090000,2021,91831,338569,430400,MKT
06079809210090000,2020,64754,318746,383500,OVR
06079809210090000,2019,64754,318746,383500,MKT
06079809210110000,2021,91831,357769,449600,MKT
06079809210110000,2020,64754,334646,399400,MKT
06079809210110000,2019,64754,334646,399400,MKT
06079809210130000,2021,91831,329069,420900,MKT
06079809210130000,2020,64754,315346,380100,MKT
06079809210130000,2019,64754,315346,380100,MKT
06079809211010000,2021,101948,397452,499400,MKT
06079809211010000,2020,79407,382193,461600,MKT
06079809211010000,2019,79407,382193,461600,MKT
06079809211030000,2021,101948,475552,577500,MKT
06079809211030000,2020,79407,420693,500100,MKT
06079809211030000,2019,79407,420693,500100,MKT
06079809211050000,2021,101948,462752,564700,MKT
06079809211050000,2020,79407,412393,491800,MKT
06079809211050000,2019,79407,412393,491800,MKT
06079809211070000,2021,101993,390707,492700,MKT
06079809211070000,2020,79476,369424,448900,MKT
06079809211070000,2019,79476,175440,254916,COST
06079809211090000,2021,103673,440027,543700,MKT
06079809211090000,2020,82052,412348,494400,MKT
06079809211090000,2019,82052,412348,494400,MKT
06079809211110000,2021,93974,252726,346700,MKT
06079809211110000,2020,67736,0,67736,COST
06079809211110000,2019,67736,0,67736,COST
06079809211130000,2021,93917,319783,413700,MKT
06079809211130000,2020,67656,304244,371900,MKT
06079809211130000,2019,67656,304244,371900,MKT
06079809211150000,2021,97334,334666,432000,MKT
06079809211150000,2020,72545,203450,275995,COST
06079809211150000,2019,72545,0,72545,COST
06079809212010000,2021,143951,0,143951,COST
06079809212010000,2020,90127,0,90127,COST
06079809212010000,2019,90127,0,90127,COST
06079809212030000,2021,141171,362729,503900,MKT
06079809212030000,2020,86762,340138,426900,MKT
06079809212030000,2019,86762,340138,426900,MKT
06079809212050000,2021,141204,425596,566800,MKT
06079809212050000,2020,86801,378999,465800,MKT
06079809212050000,2019,86801,0,86801,COST
06079809212070000,2021,141244,0,141244,COST
06079809212070000,2020,86849,0,86849,COST
06079809212070000,2019,86849,0,86849,COST
06079809212090000,2021,141261,397539,538800,MKT
06079809212090000,2020,86869,352131,439000,MKT
06079809212090000,2019,86869,357431,444300,MKT
06079809212110000,2021,137423,0,137423,COST
06079809212110000,2020,82322,0,82322,COST
06079809212110000,2019,82322,0,82322,COST
06079809212130000,2021,139357,391143,530500,MKT
06079809212130000,2020,84599,0,84599,COST
06079809212130000,2019,84599,0,84599,COST
06079809212150000,2021,140293,356107,496400,MKT
06079809212150000,2020,85711,349589,435300,MKT
06079809212150000,2019,85711,349589,435300,MKT
06079809212170000,2021,140243,396657,536900,MKT
06079809212170000,2020,85652,351148,436800,MKT
06079809212170000,2019,85652,0,85652,COST
06079809212190000,2021,98056,430520,528576,COST
06079809212190000,2020,73598,0,73598,COST
06079809212190000,2019,73598,0,73598,COST
06079809212216500,2021,86291,0,86291,COST
06079809212216500,2020,168599,0,168599,COST
06079809212216500,2019,168599,0,168599,COST
06079809212230000,2021,145411,0,145411,COST
06079809212230000,2020,91920,0,91920,COST
06079809212230000,2019,91920,0,91920,COST
06079809212250000,2021,147398,398802,546200,MKT
06079809212250000,2020,94388,361712,456100,MKT
06079809212250000,2019,94388,0,94388,COST
06079809212270000,2021,147398,418902,566300,MKT
06079809212270000,2020,94388,374412,468800,MKT
06079809212270000,2019,94388,374412,468800,MKT
06079809212290000,2021,141882,405518,547400,MKT
06079809212290000,2020,87617,367483,455100,MKT
06079809212290000,2019,87617,0,87617,COST
06079809212310000,2021,143143,419657,562800,MKT
06079809212310000,2020,89142,406458,495600,MKT
06079809212310000,2019,89142,0,89142,COST
06079809212330000,2021,143143,467657,610800,MKT
06079809212330000,2020,89142,409758,498900,MKT
06079809212330000,2019,89142,0,89142,COST
06079809212350000,2021,143143,418057,561200,MKT
06079809212350000,2020,89142,376258,465400,MKT
06079809212350000,2019,89142,0,89142,COST
06079809212370000,2021,143143,0,143143,COST
06079809212370000,2020,89142,0,89142,COST
06079809212370000,2019,89142,0,89142,COST
06079809213010000,2021,101603,373597,475200,MKT
06079809213010000,2020,78883,365917,444800,MKT
06079809213010000,2019,78883,365917,444800,MKT
06079809213030000,2021,100388,340412,440800,MKT
06079809213030000,2020,77053,322847,399900,MKT
06079809213030000,2019,77053,316347,393400,MKT
06079809213050000,2021,98916,333584,432500,MKT
06079809213050000,2020,74863,225220,300083,COST
06079809213050000,2019,74863,0,74863,COST
06079809213070000,2021,87636,323864,411500,MKT
06079809213070000,2020,59107,274293,333400,MKT
06079809213070000,2019,59107,274293,333400,MKT
06079809213090000,2021,87657,317543,405200,MKT
06079809213090000,2020,59134,263066,322200,MKT
06079809213090000,2019,59134,263066,322200,MKT
06079809213110000,2021,87657,320843,408500,MKT
06079809213110000,2020,59134,269366,328500,MKT
06079809213110000,2019,59134,266966,326100,MKT
06079809213130000,2021,87643,323857,411500,MKT
06079809213130000,2020,59116,272184,331300,MKT
06079809213130000,2019,59116,264984,324100,MKT
06079809213150000,2021,94490,303910,398400,MKT
06079809213150000,2020,68465,264735,333200,MKT
06079809213150000,2019,68465,148740,217205,COST
06079809213170000,2021,99856,335544,435400,MKT
06079809213170000,2020,76258,311142,387400,MKT
06079809213170000,2019,76258,0,76258,COST
06079809213190000,2021,93015,339985,433000,MKT
06079809213190000,2020,66395,314505,380900,MKT
06079809213190000,2019,66395,0,66395,COST
06079809213210000,2021,93015,321985,415000,MKT
06079809213210000,2020,66395,269905,336300,MKT
06079809213210000,2019,66395,0,66395,COST
06079809213230000,2021,98491,314709,413200,MKT
06079809213230000,2020,74237,293963,368200,MKT
06079809213230000,2019,74237,0,74237,COST
06079809213250000,2021,100698,326302,427000,MKT
06079809213250000,2020,77518,309682,387200,MKT
06079809213250000,2019,77518,0,77518,COST
06079809213270000,2021,99437,331563,431000,MKT
06079809213270000,2020,75635,302665,378300,MKT
06079809213270000,2019,75635,131730,207365,COST
06079809214010000,2021,100161,503039,603200,MKT
06079809214010000,2020,76713,492440,569153,COST
06079809214010000,2019,76713,0,76713,COST
06079809214030000,2021,94440,328060,422500,MKT
06079809214030000,2020,68394,311706,380100,MKT
06079809214030000,2019,68394,311706,380100,MKT
06079809214050000,2021,91855,351145,443000,MKT
06079809214050000,2020,64787,344313,409100,MKT
06079809214050000,2019,64787,0,64787,COST
06079809214070000,2021,97661,382939,480600,MKT
06079809214070000,2020,73021,357279,430300,MKT
06079809214070000,2019,73021,0,73021,COST
06079809214090000,2021,97636,452564,550200,MKT
06079809214090000,2020,72984,0,72984,COST
06079809214090000,2019,72984,0,72984,COST
06079809214110000,2021,97636,369764,467400,MKT
06079809214110000,2020,72984,346116,419100,MKT
06079809214110000,2019,72984,137450,210434,COST
06079809214130000,2021,90446,342854,433300,MKT
06079809214130000,2020,62861,277639,340500,MKT
06079809214130000,2019,62861,155350,218211,COST
06079809214150000,2021,90446,0,90446,COST
06079809214170000,2021,90446,345754,436200,MKT
06079809214190000,2021,90446,340700,431146,COST
06079809214210000,2021,90446,368854,459300,MKT
06079809214230000,2021,90446,332454,422900,MKT
06079809214250000,2021,93883,0,93883,COST
06079809215010000,2021,96128,355072,451200,MKT
06079809215010000,2020,70800,274100,344900,COST
06079809215030000,2021,86964,323536,410500,MKT
06079809215030000,2020,58225,209560,267785,COST
06079809215055001,2021,86964,192336,279300,MKT
06079809215055001,2020,58225,206175,264400,MKT
06079809215075002,2021,86964,192336,279300,MKT
06079809215075002,2020,58225,209200,267425,COST
06079809215090000,2021,86964,309736,396700,MKT
06079809215090000,2020,58225,259375,317600,MKT
06079809215110000,2021,97247,340553,437800,MKT
06079809215110000,2020,72418,265460,337878,COST
06079809215136500,2021,51387,0,51387,COST
06079809215136500,2020,61300,0,61300,COST
06079809215150000,2021,96869,0,96869,COST
06079809215170000,2021,86964,0,86964,COST
06079809215190000,2021,86964,0,86964,COST
06079809215210000,2021,86964,0,86964,COST
06079809215230000,2021,86964,0,86964,COST
06079809215250000,2021,95684,0,95684,COST
06079809216010000,2021,101580,0,101580,COST
06079809216010000,2020,65464,0,65464,COST
06079809216030000,2021,89624,283376,373000,MKT
06079809216030000,2020,61752,0,61752,COST
06079809216050000,2021,89624,0,89624,COST
06079809216050000,2020,61752,0,61752,COST
06079809216070000,2021,89624,283476,373100,MKT
06079809216070000,2020,61752,0,61752,COST
06079809216090000,2021,89624,268776,358400,MKT
06079809216090000,2020,61752,249148,310900,MKT
06079809216110000,2021,94928,225072,320000,MKT
06079809216110000,2020,69085,214415,283500,MKT
06079809217010000,2021,133711,202430,336141,COST
06079809217010000,2020,78037,0,78037,COST
06079809217030000,2021,133178,434722,567900,MKT
06079809217030000,2020,77432,0,77432,COST
06079809217050000,2021,133178,350522,483700,MKT
06079809217050000,2020,77432,0,77432,COST
06079809217070000,2021,135292,0,135292,COST
06079809217070000,2020,79849,0,79849,COST
06079809218010000,2021,95614,343286,438900,MKT
06079809218010000,2020,70063,321637,391700,MKT
06079809218030000,2021,88999,258101,347100,MKT
06079809218030000,2020,60914,244586,305500,MKT
06079809218050000,2021,88999,362701,451700,MKT
06079809218050000,2020,60914,349186,410100,MKT
06079809218070000,2021,91927,331173,423100,MKT
06079809218070000,2020,64887,314290,379177,COST
06079809218090000,2021,92852,274548,367400,MKT
06079809218090000,2020,66167,0,66167,COST
06079809218110000,2021,88749,330451,419200,MKT
06079809218110000,2020,60580,0,60580,COST
06079809218135002,2021,88755,206645,295400,MKT
06079809218135002,2020,60589,0,60589,COST
06079809218155001,2021,92280,195920,288200,MKT
06079809218155001,2020,65374,0,65374,COST
06079809219010000,2021,136637,0,136637,COST
06079809219010000,2020,81405,0,81405,COST
06079809219030000,2021,92011,0,92011,COST
06079809219030000,2020,65003,0,65003,COST
06079809219050000,2021,92011,0,92011,COST
06079809219050000,2020,65003,0,65003,COST
06079809219070000,2021,92011,0,92011,COST
06079809219070000,2020,65003,0,65003,COST
06079809219090000,2021,92011,338489,430500,MKT
06079809219090000,2020,65003,193370,258373,COST
06079809219110000,2021,95403,385197,480600,MKT
06079809219110000,2020,69761,0,69761,COST
06079809219130000,2021,101264,512336,613600,MKT
06079809219130000,2020,78371,163940,242311,COST
06079809219150000,2021,98016,0,98016,COST
06079809219150000,2020,73539,0,73539,COST
06079809219170000,2021,98016,0,98016,COST
06079809219170000,2020,73539,0,73539,COST
06079809219190000,2021,98016,346984,445000,MKT
06079809219190000,2020,73539,0,73539,COST
06079809219210000,2021,145553,503747,649300,MKT
06079809219210000,2020,92096,435004,527100,MKT
06079809220010000,2021,149160,0,149160,COST
06079809220010000,2020,96603,0,96603,COST
06079809220030000,2021,146919,0,146919,COST
06079809220030000,2020,93790,0,93790,COST
06079809220050000,2021,146919,0,146919,COST
06079809220050000,2020,93790,0,93790,COST
06079809220070000,2021,151352,0,151352,COST
06079809220070000,2020,99393,0,99393,COST
06079809221010000,2021,101014,358986,460000,MKT
06079809221010000,2020,77994,0,77994,COST
06079809221030000,2021,93877,364923,458800,MKT
06079809221030000,2020,67601,0,67601,COST
06079809221050000,2021,93877,362723,456600,MKT
06079809221050000,2020,67601,349399,417000,MKT
06079809221070000,2021,93877,384223,478100,MKT
06079809221070000,2020,67601,0,67601,COST
06079809221090000,2021,98111,0,98111,COST
06079809221090000,2020,73679,0,73679,COST
06079809221110000,2021,92723,0,92723,COST
06079809221110000,2020,65988,0,65988,COST
06079809221130000,2021,88335,0,88335,COST
06079809221130000,2020,60030,0,60030,COST
06079809221150000,2021,88335,352865,441200,MKT
06079809221150000,2020,60030,213230,273260,COST
06079809221170000,2021,88335,358465,446800,MKT
06079809221170000,2020,60030,346870,406900,MKT
06079809221190000,2021,93265,0,93265,COST
06079809221190000,2020,66742,0,66742,COST
06079809260016500,2021,37566,0,37566,COST
06079809260016500,2020,289797,0,289797,COST
06079809260016500,2019,702695,0,702695,COST
06079809310010000,2021,38782,214800,253582,COST
06079809310010000,2020,49364,191750,241114,COST
06079809310010000,2019,49364,191750,241114,COST
06079809310020000,2021,156520,0,156520,COST
06079809310020000,2020,126777,0,126777,COST
06079809310020000,2019,126777,0,126777,COST
06079809310040000,2021,142,0,142,COST
06079809310040000,2020,177,0,177,COST
06079809310040000,2019,177,0,177,COST
06079809401200000,2021,455819,0,455819,COST
06079809401200000,2020,937073,0,937073,COST
06079809401200000,2019,937073,0,937073,COST
06079809402010000,2021,1045778,1635722,2681500,INCOME
06079809402010000,2020,944174,985926,1930100,INCOME
06079809402010000,2019,944174,985926,1930100,INCOME
06079809402050000,2021,1589553,6745747,8335300,INCOME
06079809402050000,2020,1129658,5690542,6820200,INCOME
06079809402050000,2019,1129658,5690542,6820200,INCOME
06079809402100000,2021,1607684,511350,2119034,COST
06079809402100000,2020,1135160,521830,1656990,COST
06079809402100000,2019,1135160,521830,1656990,COST
06079809403016500,2021,84318,0,84318,COST
06079809403016500,2020,109403,0,109403,COST
06079809403016500,2019,109403,0,109403,COST
06079809403050000,2021,1642596,6384704,8027300,INCOME
06079809403050000,2020,1145655,5154145,6299800,INCOME
06079809403050000,2019,1145655,5154145,6299800,INCOME
06079809403100000,2021,731536,0,731536,COST
06079809403100000,2020,712933,0,712933,COST
06079809403100000,2019,712933,0,712933,COST
06079809404010000,2021,166375,1254825,1421200,INCOME
06079809404010000,2020,131050,0,131050,COST
06079809404010000,2019,131050,0,131050,COST
06079809405010000,2021,303955,2346245,2650200,INCOME
06079809405010000,2020,167359,1572741,1740100,INCOME
06079809405010000,2019,167359,1572741,1740100,INCOME
06079809405056500,2021,53423,0,53423,COST
06079809405056500,2020,44893,0,44893,COST
06079809405056500,2019,44893,0,44893,COST
06079809405100000,2021,409908,3123692,3533600,INCOME
06079809405100000,2020,216926,2103174,2320100,INCOME
06079809405100000,2019,216926,2103174,2320100,INCOME
06079809406010000,2021,421742,3995258,4417000,INCOME
06079809406010000,2020,222348,2677852,2900200,INCOME
06079809406010000,2019,222348,2677852,2900200,INCOME
06079809407010000,2021,127886,297814,425700,MKT
06079809407010000,2020,78416,303384,381800,MKT
06079809407010000,2019,78416,303384,381800,MKT
06079809407030000,2021,124326,237374,361700,MKT
06079809407030000,2020,74212,241188,315400,MKT
06079809407030000,2019,74212,241188,315400,MKT
06079809407050000,2021,124326,268074,392400,MKT
06079809407050000,2020,74212,266488,340700,MKT
06079809407050000,2019,74212,266488,340700,MKT
06079809407070000,2021,122482,306218,428700,MKT
06079809407070000,2020,72078,295222,367300,MKT
06079809407070000,2019,72078,295222,367300,MKT
06079809407090000,2021,122286,252014,374300,MKT
06079809407090000,2020,71854,247746,319600,MKT
06079809407090000,2019,71854,247746,319600,MKT
06079809407110000,2021,124249,285651,409900,MKT
06079809407110000,2020,74122,286478,360600,MKT
06079809407110000,2019,74122,286478,360600,MKT
06079809407130000,2021,124326,303274,427600,MKT
06079809407130000,2020,74212,283488,357700,MKT
06079809407130000,2019,74212,283488,357700,MKT
06079809407150000,2021,133262,259538,392800,MKT
06079809407150000,2020,73126,259074,332200,MKT
06079809407150000,2019,73126,259074,332200,MKT
06079809407170000,2021,134272,208528,342800,MKT
06079809407170000,2020,74212,228488,302700,MKT
06079809407170000,2019,74212,228488,302700,MKT
06079809407190000,2021,118443,263157,381600,MKT
06079809407190000,2020,67512,253788,321300,MKT
06079809407190000,2019,67512,253788,321300,MKT
06079809407210000,2021,124326,299474,423800,MKT
06079809407210000,2020,74212,281788,356000,MKT
06079809407210000,2019,74212,281788,356000,MKT
06079809407230000,2021,127001,293999,421000,MKT
06079809407230000,2020,77360,291740,369100,MKT
06079809407230000,2019,77360,291740,369100,MKT
06079809407250000,2021,118443,242257,360700,MKT
06079809407250000,2020,67512,241688,309200,MKT
06079809407250000,2019,67512,241688,309200,MKT
06079809407270000,2021,124326,285774,410100,MKT
06079809407270000,2020,74212,304888,379100,MKT
06079809407270000,2019,74212,304888,379100,MKT
06079809407290000,2021,118443,252957,371400,MKT
06079809407290000,2020,67512,255988,323500,MKT
06079809407290000,2019,67512,255988,323500,MKT
06079809407310000,2021,127538,275562,403100,MKT
06079809407310000,2020,78000,258700,336700,MKT
06079809407310000,2019,78000,258700,336700,MKT
06079809408016500,2021,107008,0,107008,COST
06079809408016500,2020,174196,0,174196,COST
06079809408016500,2019,174196,0,174196,COST
06079809408026500,2021,63093,0,63093,COST
06079809408026500,2020,62117,0,62117,COST
06079809408026500,2019,62117,0,62117,COST
06079809409010000,2021,111671,235529,347200,MKT
06079809409010000,2020,60184,234116,294300,MKT
06079809409010000,2019,60184,234116,294300,MKT
06079809409030000,2021,106071,234129,340200,MKT
06079809409030000,2020,54433,232367,286800,MKT
06079809409030000,2019,54433,232367,286800,MKT
06079809409050000,2021,105788,235712,341500,MKT
06079809409050000,2020,54150,233950,288100,MKT
06079809409050000,2019,54150,233950,288100,MKT
06079809409070000,2021,105503,226197,331700,MKT
06079809409070000,2020,53865,232235,286100,MKT
06079809409070000,2019,53865,232235,286100,MKT
06079809409090000,2021,105762,238638,344400,MKT
06079809409090000,2020,54124,233576,287700,MKT
06079809409090000,2019,54124,233576,287700,MKT
06079809409110000,2021,112840,236760,349600,MKT
06079809409110000,2020,61419,236581,298000,MKT
06079809409110000,2019,61419,236581,298000,MKT
06079809409130000,2021,104260,225340,329600,MKT
06079809409130000,2020,52634,236466,289100,MKT
06079809409130000,2019,52634,236466,289100,MKT
06079809409150000,2021,103955,222745,326700,MKT
06079809409150000,2020,52333,233167,285500,MKT
06079809409150000,2019,52333,233167,285500,MKT
06079809409170000,2021,112209,238491,350700,MKT
06079809409170000,2020,60750,236250,297000,MKT
06079809409170000,2019,60750,236250,297000,MKT
06079809409190000,2021,111989,243011,355000,MKT
06079809409190000,2020,60518,246782,307300,MKT
06079809409190000,2019,60518,246782,307300,MKT
06079809409210000,2021,103400,229100,332500,MKT
06079809409210000,2020,51789,243811,295600,MKT
06079809409210000,2019,51789,243811,295600,MKT
06079809409230000,2021,103400,242700,346100,MKT
06079809409230000,2020,51789,260711,312500,MKT
06079809409230000,2019,51789,260711,312500,MKT
06079809409250000,2021,111545,241955,353500,MKT
06079809409250000,2020,60051,245549,305600,MKT
06079809409250000,2019,60051,245549,305600,MKT
06079809409276500,2021,36321,0,36321,COST
06079809409276500,2020,21140,0,21140,COST
06079809409276500,2019,21140,0,21140,COST
06079809409290000,2021,103946,238454,342400,MKT
06079809409290000,2020,52324,261076,313400,MKT
06079809409290000,2019,52324,261076,313400,MKT
06079809409310000,2021,103400,229500,332900,MKT
06079809409310000,2020,51789,243911,295700,MKT
06079809409310000,2019,51789,243911,295700,MKT
06079809409330000,2021,103400,230500,333900,MKT
06079809409330000,2020,51789,245411,297200,MKT
06079809409330000,2019,51789,245411,297200,MKT
06079809409350000,2021,103400,243400,346800,MKT
06079809409350000,2020,51789,261411,313200,MKT
06079809409350000,2019,51789,261411,313200,MKT
06079809409370000,2021,108536,238064,346600,MKT
06079809409370000,2020,56929,237371,294300,MKT
06079809409370000,2019,56929,237371,294300,MKT
06079809410010000,2021,121682,287218,408900,MKT
06079809410010000,2020,71163,288937,360100,MKT
06079809410010000,2019,71163,288937,360100,MKT
06079809410030000,2021,118474,241126,359600,MKT
06079809410030000,2020,67547,235753,303300,MKT
06079809410030000,2019,67547,235753,303300,MKT
06079809410050000,2021,118474,265226,383700,MKT
06079809410050000,2020,67547,255753,323300,MKT
06079809410050000,2019,67547,255753,323300,MKT
06079809410070000,2021,118474,248326,366800,MKT
06079809410070000,2020,67547,251253,318800,MKT
06079809410070000,2019,67547,251253,318800,MKT
06079809410090000,2021,118474,302726,421200,MKT
06079809410090000,2020,67547,302153,369700,MKT
06079809410090000,2019,67547,302153,369700,MKT
06079809410110000,2021,118474,249226,367700,MKT
06079809410110000,2020,67547,244853,312400,MKT
06079809410110000,2019,67547,244853,312400,MKT
06079809410130000,2021,118474,286526,405000,MKT
06079809410130000,2020,67547,292853,360400,MKT
06079809410130000,2019,67547,292853,360400,MKT
06079809410150000,2021,118474,307326,425800,MKT
06079809410150000,2020,67547,296453,364000,MKT
06079809410150000,2019,67547,296453,364000,MKT
06079809410170000,2021,127952,250848,378800,MKT
06079809410170000,2020,67547,251553,319100,MKT
06079809410170000,2019,67547,251553,319100,MKT
06079809410190000,2021,127952,270148,398100,MKT
06079809410190000,2020,67547,263253,330800,MKT
06079809410190000,2019,67547,263253,330800,MKT
06079809410210000,2021,118474,285026,403500,MKT
06079809410210000,2020,67547,260953,328500,MKT
06079809410210000,2019,67547,260953,328500,MKT
06079809410230000,2021,118443,256457,374900,MKT
06079809410230000,2020,67512,257388,324900,MKT
06079809410230000,2019,67512,257388,324900,MKT
06079809410250000,2021,118506,268694,387200,MKT
06079809410250000,2020,67582,258018,325600,MKT
06079809410250000,2019,67582,258018,325600,MKT
06079809410270000,2021,118474,310626,429100,MKT
06079809410270000,2020,67547,315653,383200,MKT
06079809410270000,2019,67547,315653,383200,MKT
06079809410290000,2021,118443,249457,367900,MKT
06079809410290000,2020,67512,249888,317400,MKT
06079809410290000,2019,67512,249888,317400,MKT
06079809410310000,2021,118506,287294,405800,MKT
06079809410310000,2020,67582,270318,337900,MKT
06079809410310000,2019,67582,270318,337900,MKT
06079809410330000,2021,118474,277826,396300,MKT
06079809410330000,2020,67547,283553,351100,MKT
06079809410330000,2019,67547,283553,351100,MKT
06079809410350000,2021,118443,247257,365700,MKT
06079809410350000,2020,67512,249588,317100,MKT
06079809410350000,2019,67512,249588,317100,MKT
06079809410370000,2021,118506,296094,414600,MKT
06079809410370000,2020,67582,297818,365400,MKT
06079809410370000,2019,67582,297818,365400,MKT
06079809410390000,2021,121594,274106,395700,MKT
06079809410390000,2020,71063,271737,342800,MKT
06079809410390000,2019,71063,271737,342800,MKT
06079809411010000,2021,127213,262587,389800,MKT
06079809411010000,2020,77613,242187,319800,MKT
06079809411010000,2019,77613,242187,319800,MKT
06079809411030000,2021,118443,248857,367300,MKT
06079809411030000,2020,67512,250288,317800,MKT
06079809411030000,2019,67512,250288,317800,MKT
06079809411050000,2021,121483,288417,409900,MKT
06079809411050000,2020,70935,271865,342800,MKT
06079809411050000,2019,70935,271865,342800,MKT
06079809411070000,2021,121483,274517,396000,MKT
06079809411070000,2020,70935,272265,343200,MKT
06079809411070000,2019,70935,272265,343200,MKT
06079809411096500,2021,49521,0,49521,COST
06079809411096500,2020,38717,0,38717,COST
06079809411096500,2019,38717,0,38717,COST
06079809411110000,2021,121483,327717,449200,MKT
06079809411110000,2020,70935,319265,390200,MKT
06079809411110000,2019,70935,319265,390200,MKT
06079809411130000,2021,121483,300317,421800,MKT
06079809411130000,2020,70935,286265,357200,MKT
06079809411130000,2019,70935,286265,357200,MKT
06079809411150000,2021,121483,277317,398800,MKT
06079809411150000,2020,70935,276065,347000,MKT
06079809411150000,2019,70935,276065,347000,MKT
06079809411170000,2021,121483,289717,411200,MKT
06079809411170000,2020,70935,255565,326500,MKT
06079809411170000,2019,70935,255565,326500,MKT
06079809411190000,2021,118443,246557,365000,MKT
06079809411190000,2020,67512,247388,314900,MKT
06079809411190000,2019,67512,247388,314900,MKT
06079809411210000,2021,124326,313374,437700,MKT
06079809411210000,2020,74212,333688,407900,MKT
06079809411210000,2019,74212,333688,407900,MKT
06079809411230000,2021,134272,275628,409900,MKT
06079809411230000,2020,74212,267088,341300,MKT
06079809411230000,2019,74212,267088,341300,MKT
06079809411250000,2021,131202,282998,414200,MKT
06079809411250000,2020,70935,270365,341300,MKT
06079809411250000,2019,70935,270365,341300,MKT
06079809411270000,2021,127918,242682,370600,MKT
06079809411270000,2020,67512,246288,313800,MKT
06079809411270000,2019,67512,246288,313800,MKT
06079809411290000,2021,131202,321998,453200,MKT
06079809411290000,2020,70935,317465,388400,MKT
06079809411290000,2019,70935,317465,388400,MKT
06079809411310000,2021,131202,268798,400000,MKT
06079809411310000,2020,70935,268765,339700,MKT
06079809411310000,2019,70935,268765,339700,MKT
06079809411330000,2021,131202,261998,393200,MKT
06079809411330000,2020,70935,256365,327300,MKT
06079809411330000,2019,70935,256365,327300,MKT
06079809411350000,2021,131202,344398,475600,MKT
06079809411350000,2020,70935,332765,403700,MKT
06079809411350000,2019,70935,320365,391300,MKT
06079809411370000,2021,131202,284398,415600,MKT
06079809411370000,2020,70935,263265,334200,MKT
06079809411370000,2019,70935,263265,334200,MKT
06079809411390000,2021,127918,247082,375000,MKT
06079809411390000,2020,67512,250788,318300,MKT
06079809411390000,2019,67512,250788,318300,MKT
06079809411410000,2021,137290,286510,423800,MKT
06079809411410000,2020,77502,271798,349300,MKT
06079809411410000,2019,77502,271798,349300,MKT
06079809412010000,2021,108855,241145,350000,MKT
06079809412010000,2020,57257,243843,301100,MKT
06079809412010000,2019,57257,243843,301100,MKT
06079809412030000,2021,103701,232499,336200,MKT
06079809412030000,2020,52084,248116,300200,MKT
06079809412030000,2019,52084,245316,297400,MKT
06079809412050000,2021,103701,269099,372800,MKT
06079809412050000,2020,52084,260916,313000,MKT
06079809412050000,2019,52084,260916,313000,MKT
06079809412070000,2021,103701,244599,348300,MKT
06079809412070000,2020,52084,246416,298500,MKT
06079809412070000,2019,52084,246416,298500,MKT
06079809412090000,2021,104251,224149,328400,MKT
06079809412090000,2020,52625,241475,294100,MKT
06079809412090000,2019,52625,241475,294100,MKT
06079809412110000,2021,111871,242129,354000,MKT
06079809412110000,2020,60394,254706,315100,MKT
06079809412110000,2019,60394,254706,315100,MKT
06079809412130000,2021,103701,227499,331200,MKT
06079809412130000,2020,52084,243816,295900,MKT
06079809412130000,2019,52084,243816,295900,MKT
06079809412150000,2021,103701,266599,370300,MKT
06079809412150000,2020,52084,264016,316100,MKT
06079809412150000,2019,52084,264016,316100,MKT
06079809412170000,2021,112318,237282,349600,MKT
06079809412170000,2020,60866,243434,304300,MKT
06079809412170000,2019,60866,243434,304300,MKT
06079809413017000,2021,257857,0,257857,COST
06079809413017000,2020,308216,0,308216,COST
06079809413017000,2019,308216,0,308216,COST
06079809415010000,2021,127006,267894,394900,MKT
06079809415010000,2020,77366,255134,332500,MKT
06079809415010000,2019,77366,255134,332500,MKT
06079809415030000,2021,123778,284322,408100,MKT
06079809415030000,2020,73574,269226,342800,MKT
06079809415030000,2019,73574,269226,342800,MKT
06079809415050000,2021,123778,327922,451700,MKT
06079809415050000,2020,73574,319826,393400,MKT
06079809415050000,2019,73574,319826,393400,MKT
06079809415070000,2021,123778,278722,402500,MKT
06079809415070000,2020,73574,273926,347500,MKT
06079809415070000,2019,73574,273926,347500,MKT
06079809415096500,2021,40302,0,40302,COST
06079809415096500,2020,25898,0,25898,COST
06079809415096500,2019,25898,0,25898,COST
06079809415110000,2021,124000,267900,391900,MKT
06079809415110000,2020,73833,258067,331900,MKT
06079809415110000,2019,73833,258067,331900,MKT
06079809415130000,2021,117744,280256,398000,MKT
06079809415130000,2020,66737,276963,343700,MKT
06079809415130000,2019,66737,0,66737,COST
06079809415150000,2021,128362,285838,414200,MKT
06079809415150000,2020,78987,266913,345900,MKT
06079809415150000,2019,78987,0,78987,COST
06079809415170000,2021,135460,130620,266080,COST
06079809415170000,2020,75499,0,75499,COST
06079809415170000,2019,75499,0,75499,COST
06079809415196500,2021,46934,0,46934,COST
06079809415196500,2020,34867,0,34867,COST
06079809415196500,2019,34867,0,34867,COST
06079809416010000,2021,132416,280884,413300,MKT
06079809416010000,2020,72223,269577,341800,MKT
06079809416010000,2019,72223,269577,341800,MKT
06079809416030000,2021,132416,279784,412200,MKT
06079809416030000,2020,72223,279777,352000,MKT
06079809416030000,2019,72223,279777,352000,MKT
06079809416050000,2021,132416,292784,425200,MKT
06079809416050000,2020,72223,307977,380200,MKT
06079809416050000,2019,72223,307977,380200,MKT
06079809416070000,2021,132416,266284,398700,MKT
06079809416070000,2020,72223,266477,338700,MKT
06079809416070000,2019,72223,266477,338700,MKT
06079809416090000,2021,132416,279484,411900,MKT
06079809416090000,2020,72223,263677,335900,MKT
06079809416090000,2019,72223,263677,335900,MKT
06079809416110000,2021,133031,275869,408900,MKT
06079809416110000,2020,72879,276321,349200,MKT
06079809416110000,2019,72879,276321,349200,MKT
06079809416130000,2021,126014,267086,393100,MKT
06079809416130000,2020,76191,255009,331200,MKT
06079809416130000,2019,76191,255009,331200,MKT
06079809416150000,2021,122608,270792,393400,MKT
06079809416150000,2020,72223,270577,342800,MKT
06079809416150000,2019,72223,270577,342800,MKT
06079809416170000,2021,122608,268392,391000,MKT
06079809416170000,2020,72223,261877,334100,MKT
06079809416170000,2019,72223,261877,334100,MKT
06079809416190000,2021,122608,290692,413300,MKT
06079809416190000,2020,72223,260177,332400,MKT
06079809416190000,2019,72223,260177,332400,MKT
06079809416210000,2021,122608,268192,390800,MKT
06079809416210000,2020,72223,261777,334000,MKT
06079809416210000,2019,72223,261777,334000,MKT
06079809416230000,2021,122608,270792,393400,MKT
06079809416230000,2020,72223,270577,342800,MKT
06079809416230000,2019,72223,270577,342800,MKT
06079809417010000,2021,130922,154090,285012,COST
06079809417010000,2020,70640,0,70640,COST
06079809417010000,2019,70640,0,70640,COST
06079809417030000,2021,126609,291291,417900,MKT
06079809417030000,2020,76896,270204,347100,MKT
06079809417030000,2019,76896,0,76896,COST
06079809417050000,2021,117795,275905,393700,MKT
06079809417050000,2020,66794,272606,339400,MKT
06079809417050000,2019,66794,0,66794,COST
06079809417070000,2021,122933,269867,392800,MKT
06079809417070000,2020,72598,268202,340800,MKT
06079809417070000,2019,72598,268202,340800,MKT
06079809417090000,2021,122933,272367,395300,MKT
06079809417090000,2020,72598,270002,342600,MKT
06079809417090000,2019,72598,270002,342600,MKT
06079809417110000,2021,122933,280267,403200,MKT
06079809417110000,2020,72598,276702,349300,MKT
06079809417110000,2019,72598,276702,349300,MKT
06079809417130000,2021,122933,310567,433500,MKT
06079809417130000,2020,72598,314002,386600,MKT
06079809417130000,2019,72598,314002,386600,MKT
06079809417150000,2021,128038,274062,402100,MKT
06079809417150000,2020,78599,273001,351600,MKT
06079809417150000,2019,78599,273001,351600,MKT
06079809417170000,2021,128008,267492,395500,MKT
06079809417170000,2020,78562,266138,344700,MKT
06079809417170000,2019,78562,0,78562,COST
06079809417190000,2021,122910,262490,385400,MKT
06079809417190000,2020,72571,257429,330000,MKT
06079809417190000,2019,72571,257429,330000,MKT
06079809417210000,2021,122910,288490,411400,MKT
06079809417210000,2020,72571,281829,354400,MKT
06079809417210000,2019,72571,281829,354400,MKT
06079809417230000,2021,122910,298090,421000,MKT
06079809417230000,2020,72571,306029,378600,MKT
06079809417230000,2019,72571,306029,378600,MKT
06079809417250000,2021,118962,276738,395700,MKT
06079809417250000,2020,68091,288709,356800,MKT
06079809417250000,2019,68091,288709,356800,MKT
06079809417270000,2021,118962,285538,404500,MKT
06079809417270000,2020,68091,262609,330700,MKT
06079809417270000,2019,68091,0,68091,COST
06079809417290000,2021,118944,290856,409800,MKT
06079809417290000,2020,68070,296430,364500,MKT
06079809417290000,2019,68070,0,68070,COST
06079809417310000,2021,134923,274277,409200,MKT
06079809417310000,2020,74915,266985,341900,MKT
06079809417310000,2019,74915,266985,341900,MKT
06079809418010000,2021,127337,273563,400900,MKT
06079809418010000,2020,77761,275339,353100,MKT
06079809418010000,2019,77761,275339,353100,MKT
06079809418030000,2021,122608,290392,413000,MKT
06079809418030000,2020,72223,310677,382900,MKT
06079809418030000,2019,72223,310677,382900,MKT
06079809418050000,2021,122608,273792,396400,MKT
06079809418050000,2020,72223,276277,348500,MKT
06079809418050000,2019,72223,276277,348500,MKT
06079809418070000,2021,122608,291492,414100,MKT
06079809418070000,2020,72223,282277,354500,MKT
06079809418070000,2019,72223,277277,349500,MKT
06079809418090000,2021,122608,269292,391900,MKT
06079809418090000,2020,72223,233477,305700,MKT
06079809418090000,2019,72223,233477,305700,MKT
06079809418110000,2021,122608,308592,431200,MKT
06079809418110000,2020,72223,325277,397500,MKT
06079809418110000,2019,72223,325277,397500,MKT
06079809418130000,2021,122608,272992,395600,MKT
06079809418130000,2020,72223,274477,346700,MKT
06079809418130000,2019,72223,274477,346700,MKT
06079809418150000,2021,122608,286192,408800,MKT
06079809418150000,2020,72223,308277,380500,MKT
06079809418150000,2019,72223,308277,380500,MKT
06079809418170000,2021,122608,276392,399000,MKT
06079809418170000,2020,72223,275777,348000,MKT
06079809418170000,2019,72223,275777,348000,MKT
06079809418190000,2021,122608,270292,392900,MKT
06079809418190000,2020,72223,265877,338100,MKT
06079809418190000,2019,72223,265877,338100,MKT
06079809418210000,2021,122608,280492,403100,MKT
06079809418210000,2020,72223,278077,350300,MKT
06079809418210000,2019,72223,278077,350300,MKT
06079809418230000,2021,127409,277891,405300,MKT
06079809418230000,2020,77847,276453,354300,MKT
06079809418230000,2019,77847,276453,354300,MKT
06079809419010000,2021,127006,257894,384900,MKT
06079809419010000,2020,77366,0,77366,COST
06079809419010000,2019,77366,0,77366,COST
06079809419030000,2021,123778,255222,379000,MKT
06079809419030000,2020,73574,0,73574,COST
06079809419030000,2019,73574,0,73574,COST
06079809419050000,2021,123778,287422,411200,MKT
06079809419050000,2020,73574,0,73574,COST
06079809419050000,2019,73574,0,73574,COST
06079809419070000,2021,123778,260222,384000,MKT
06079809419070000,2020,73574,257726,331300,MKT
06079809419070000,2019,73574,0,73574,COST
06079809419090000,2021,123778,256522,380300,MKT
06079809419090000,2020,73574,144540,218114,COST
06079809419090000,2019,73574,0,73574,COST
06079809419110000,2021,123081,294519,417600,MKT
06079809419110000,2020,72768,0,72768,COST
06079809419110000,2019,72768,0,72768,COST
06079809419130000,2021,127006,288994,416000,MKT
06079809419130000,2020,77366,0,77366,COST
06079809419130000,2019,77366,0,77366,COST
06079809420020000,2021,3427673,868627,4296300,INCOME
06079809420020000,2020,1230466,1579934,2810400,INCOME
06079809420020000,2019,1230466,1579934,2810400,INCOME
06079809420026500,2021,309228,0,309228,COST
06079809420026500,2020,281502,0,281502,COST
06079809420026500,2019,281502,0,281502,COST
06079809420040000,2021,1164361,857339,2021700,INCOME
06079809420040000,2020,988633,517410,1506043,COST
06079809420040000,2019,988633,517410,1506043,COST
06079809421010000,2021,122608,271292,393900,MKT
06079809421010000,2020,72223,254877,327100,MKT
06079809421010000,2019,72223,254877,327100,MKT
06079809421030000,2021,122608,280192,402800,MKT
06079809421030000,2020,72223,276677,348900,MKT
06079809421030000,2019,72223,276677,348900,MKT
06079809421050000,2021,122608,322592,445200,MKT
06079809421050000,2020,72223,315477,387700,MKT
06079809421050000,2019,72223,315477,387700,MKT
06079809421070000,2021,122608,283092,405700,MKT
06079809421070000,2020,72223,276577,348800,MKT
06079809421070000,2019,72223,276577,348800,MKT
06079809421090000,2021,122608,279792,402400,MKT
06079809421090000,2020,72223,277877,350100,MKT
06079809421090000,2019,72223,277877,350100,MKT
06079809421110000,2021,127213,264287,391500,MKT
06079809421110000,2020,77613,256687,334300,MKT
06079809421110000,2019,77613,256687,334300,MKT
06079809421130000,2021,127136,276564,403700,MKT
06079809421130000,2020,77521,146350,223871,COST
06079809421130000,2019,77521,0,77521,COST
06079809421150000,2021,122608,257792,380400,MKT
06079809421150000,2020,72223,248577,320800,MKT
06079809421150000,2019,72223,0,72223,COST
06079809421170000,2021,122608,256692,379300,MKT
06079809421170000,2020,72223,255677,327900,MKT
06079809421170000,2019,72223,0,72223,COST
06079809421190000,2021,122608,272392,395000,MKT
06079809421190000,2020,72223,301660,373883,COST
06079809421190000,2019,72223,0,72223,COST
06079809421210000,2021,122608,254292,376900,MKT
06079809421210000,2020,72223,251077,323300,MKT
06079809421210000,2019,72223,0,72223,COST
06079809421230000,2021,122608,344792,467400,MKT
06079809421230000,2020,72223,313877,386100,MKT
06079809421230000,2019,72223,0,72223,COST
06079809421256500,2021,75092,0,75092,COST
06079809421256500,2020,87256,0,87256,COST
06079809421256500,2019,87256,0,87256,COST
06079809422010000,2021,127006,292194,419200,MKT
06079809422010000,2020,77366,0,77366,COST
06079809422010000,2019,77366,0,77366,COST
06079809422030000,2021,126980,284420,411400,MKT
06079809422030000,2020,77335,283665,361000,MKT
06079809422030000,2019,77335,283665,361000,MKT
06079809422050000,2021,123307,285793,409100,MKT
06079809422050000,2020,73029,286371,359400,MKT
06079809422050000,2019,73029,286371,359400,MKT
06079809422070000,2021,122659,261641,384300,MKT
06079809422070000,2020,72282,261718,334000,MKT
06079809422070000,2019,72282,261718,334000,MKT
06079809422090000,2021,124033,306867,430900,MKT
06079809422090000,2020,73871,329729,403600,MKT
06079809422090000,2019,73871,329729,403600,MKT
06079809422110000,2021,124033,262767,386800,MKT
06079809422110000,2020,73871,257829,331700,MKT
06079809422110000,2019,73871,257829,331700,MKT
06079809422130000,2021,124033,279567,403600,MKT
06079809422130000,2020,73871,273329,347200,MKT
06079809422130000,2019,73871,273329,347200,MKT
06079809422150000,2021,126980,288320,415300,MKT
06079809422150000,2020,77335,285965,363300,MKT
06079809422150000,2019,77335,285965,363300,MKT
06079809422170000,2021,127006,347494,474500,MKT
06079809422170000,2020,77366,328234,405600,MKT
06079809422170000,2019,77366,0,77366,COST
06079809422190000,2021,124056,259944,384000,MKT
06079809422190000,2020,73897,253203,327100,MKT
06079809422190000,2019,73897,0,73897,COST
06079809422210000,2021,124056,288844,412900,MKT
06079809422210000,2020,73897,295403,369300,MKT
06079809422210000,2019,73897,0,73897,COST
06079809422230000,2021,124056,256744,380800,MKT
06079809422230000,2020,73897,123840,197737,COST
06079809422230000,2019,73897,0,73897,COST
06079809422250000,2021,122682,256518,379200,MKT
06079809422250000,2020,72309,122120,194429,COST
06079809422250000,2019,72309,0,72309,COST
06079809422270000,2021,123329,256771,380100,MKT
06079809422270000,2020,73055,123840,196895,COST
06079809422270000,2019,73055,0,73055,COST
06079809422296500,2021,37301,0,37301,COST
06079809422296500,2020,22268,0,22268,COST
06079809422296500,2019,22268,0,22268,COST
06079809423010000,2021,125286,267514,392800,MKT
06079809423010000,2020,75334,270366,345700,MKT
06079809423010000,2019,75271,0,75271,COST
06079809423030000,2021,121828,337172,459000,MKT
06079809423030000,2020,71329,310571,381900,MKT
06079809423030000,2019,71329,310571,381900,MKT
06079809423050000,2021,121828,260572,382400,MKT
06079809423050000,2020,71329,260871,332200,MKT
06079809423050000,2019,71329,260871,332200,MKT
06079809423070000,2021,121828,272372,394200,MKT
06079809423070000,2020,71329,279271,350600,MKT
06079809423070000,2019,71329,279271,350600,MKT
06079809423090000,2021,122933,281067,404000,MKT
06079809423090000,2020,72598,267402,340000,MKT
06079809423090000,2019,72598,267402,340000,MKT
06079809423110000,2021,122933,282367,405300,MKT
06079809423110000,2020,72598,289702,362300,MKT
06079809423110000,2019,72598,289702,362300,MKT
06079809423130000,2021,122933,275067,398000,MKT
06079809423130000,2020,72598,275102,347700,MKT
06079809423130000,2019,72598,275102,347700,MKT
06079809423150000,2021,128038,271162,399200,MKT
06079809423150000,2020,78599,262401,341000,MKT
06079809423150000,2019,78599,262401,341000,MKT
06079809423170000,2021,483,0,483,COST
06079809424010000,2021,127011,270689,397700,MKT
06079809424010000,2020,77372,264828,342200,MKT
06079809424010000,2019,77372,264828,342200,MKT
06079809424030000,2021,123329,292471,415800,MKT
06079809424030000,2020,73055,300845,373900,MKT
06079809424030000,2019,73055,300845,373900,MKT
06079809424050000,2021,122682,262918,385600,MKT
06079809424050000,2020,72309,260891,333200,MKT
06079809424050000,2019,72309,260891,333200,MKT
06079809424070000,2021,124056,277744,401800,MKT
06079809424070000,2020,73897,271103,345000,MKT
06079809424070000,2019,73897,271103,345000,MKT
06079809424090000,2021,124056,264344,388400,MKT
06079809424090000,2020,73897,262103,336000,MKT
06079809424090000,2019,73897,262103,336000,MKT
06079809424110000,2021,124056,270144,394200,MKT
06079809424110000,2020,73897,270503,344400,MKT
06079809424110000,2019,73897,270503,344400,MKT
06079809424130000,2021,127011,269389,396400,MKT
06079809424130000,2020,77372,259028,336400,MKT
06079809424130000,2019,77372,259028,336400,MKT
06079809424156500,2021,44844,0,44844,COST
06079809424156500,2020,31901,0,31901,COST
06079809424156500,2019,31901,0,31901,COST
06079809425010000,2021,122234,284066,406300,MKT
06079809425010000,2020,71794,266606,338400,MKT
06079809425010000,2019,71794,264306,336100,MKT
06079809425030000,2021,122234,268366,390600,MKT
06079809425030000,2020,71794,269506,341300,MKT
06079809425030000,2019,71794,267106,338900,MKT
06079809425050000,2021,122234,304966,427200,MKT
06079809425050000,2020,71794,293406,365200,MKT
06079809425050000,2019,71794,0,71794,COST
06079809425070000,2021,122234,277566,399800,MKT
06079809425070000,2020,71794,142270,214064,COST
06079809425070000,2019,71794,0,71794,COST
06079809425090000,2021,122234,288766,411000,MKT
06079809425090000,2020,71794,120050,191844,COST
06079809425090000,2019,71794,0,71794,COST
06079809425110000,2021,126625,294275,420900,MKT
06079809425110000,2020,76914,0,76914,COST
06079809425110000,2019,76914,0,76914,COST
06079809425130000,2021,126552,0,126552,COST
06079809425130000,2020,76827,0,76827,COST
06079809425130000,2019,76827,0,76827,COST
06079809425150000,2021,122234,0,122234,COST
06079809425150000,2020,71794,0,71794,COST
06079809425150000,2019,71794,0,71794,COST
06079809425170000,2021,122234,0,122234,COST
06079809425170000,2020,71794,0,71794,COST
06079809425170000,2019,71794,0,71794,COST
06079809425190000,2021,122234,0,122234,COST
06079809425190000,2020,71794,0,71794,COST
06079809425190000,2019,71794,0,71794,COST
06079809425210000,2021,122234,0,122234,COST
06079809425210000,2020,71794,0,71794,COST
06079809425210000,2019,71794,0,71794,COST
06079809425230000,2021,122234,0,122234,COST
06079809425230000,2020,71794,0,71794,COST
06079809425230000,2019,71794,0,71794,COST
06079809426010000,2021,77,0,77,COST
06079809426046500,2021,41209,0,41209,COST
06079809426070000,2021,193473,0,193473,COST
06079809426100000,2021,193473,0,193473,COST
