id,year,land,building,total,method
06079811301480000,2021,1827394,394306,2221700,INCOME
06079811301480000,2020,1101988,867712,1969700,INCOME
06079811301480000,2019,1101988,867712,1969700,INCOME
06079811301490000,2021,8017859,0,8017859,COST
06079811301490000,2020,2076319,0,2076319,COST
06079811301490000,2019,2076319,0,2076319,COST
06079811301500000,2021,922993,269807,1192800,INCOME
06079811301500000,2020,822441,180459,1002900,INCOME
06079811301500000,2019,822441,180459,1002900,INCOME
06079811301540000,2021,1633954,5482346,7116300,INCOME
06079811301540000,2020,1050415,4916485,5966900,INCOME
06079811301540000,2019,1050415,4916485,5966900,INCOME
06079811301560000,2021,1415906,1712794,3128700,INCOME
06079811301560000,2020,987901,1906499,2894400,INCOME
06079811301560000,2019,987901,1906499,2894400,INCOME
06079811301666500,2021,131150,0,131150,COST
06079811301666500,2020,259112,0,259112,COST
06079811301666500,2019,259112,0,259112,COST
06079811330010000,2021,325317,16500,341817,COST
06079811330010000,2020,485124,17670,502794,COST
06079811330010000,2019,485124,17670,502794,COST
06079811330030000,2021,172304,364096,536400,MKT
06079811330030000,2020,140320,330080,470400,MKT
06079811330030000,2019,140320,330080,470400,MKT
06079811330040000,2021,134472,156428,290900,MKT
06079811330040000,2020,86492,166908,253400,MKT
06079811330040000,2019,86492,166908,253400,MKT
06079811330307000,2021,280982,0,280982,COST
06079811330307000,2020,302599,0,302599,COST
06079811330307000,2019,302599,0,302599,COST
06079811334420000,2021,231675,125530,357205,COST
06079811334420000,2020,207636,128850,336486,COST
06079811334420000,2019,207636,128850,336486,COST
06079811334460000,2021,292295,0,292295,COST
06079811334460000,2020,393658,0,393658,COST
06079811334460000,2019,393658,0,393658,COST
06079811338340000,2021,310768,0,310768,COST
06079811338340000,2020,368363,0,368363,COST
06079811338340000,2019,368363,0,368363,COST
06079811338400000,2021,488970,1990390,2479360,COST
06079811338400000,2020,252787,1733880,1986667,COST
06079811338400000,2019,252787,1733880,1986667,COST
06079811340010000,2021,213364,214636,428000,MKT
06079811340010000,2020,212960,161940,374900,MKT
06079811340010000,2019,212960,161940,374900,MKT
06079811340020000,2021,195900,355900,551800,INCOME
06079811340020000,2020,163100,320700,483800,INCOME
06079811340020000,2019,163100,320700,483800,INCOME
06079811340030000,2021,210051,0,210051,COST
06079811340030000,2020,206554,0,206554,COST
06079811340030000,2019,206554,0,206554,COST
06079811340040000,2021,210165,166035,376200,INCOME
06079811340040000,2020,206773,131527,338300,INCOME
06079811340040000,2019,206773,131527,338300,INCOME
06079811340050000,2021,153503,264397,417900,MKT
06079811340050000,2020,124038,218362,342400,MKT
06079811340050000,2019,124038,218362,342400,MKT
06079811340060000,2021,173941,0,173941,COST
06079811340060000,2020,142933,0,142933,COST
06079811340060000,2019,142933,0,142933,COST
06079811340070000,2021,152650,244550,397200,MKT
06079811340070000,2020,123264,198036,321300,MKT
06079811340070000,2019,123264,198036,321300,MKT
06079811340080000,2021,158831,135669,294500,INCOME
06079811340080000,2020,128881,130619,259500,INCOME
06079811340080000,2019,128881,130619,259500,INCOME
06079811340090000,2021,195900,204400,400300,MKT
06079811340090000,2020,163100,169400,332500,MKT
06079811340090000,2019,163100,169400,332500,MKT
06079811340100000,2021,235880,216210,452090,COST
06079811340100000,2020,215056,172844,387900,MKT
06079811340100000,2019,215056,172844,387900,MKT
06079811353010000,2021,154881,306019,460900,INCOME
06079811353010000,2020,113960,308340,422300,INCOME
06079811353010000,2019,113960,308340,422300,INCOME
06079811353030000,2021,145419,226881,372300,MKT
06079811353030000,2020,100767,221633,322400,MKT
06079811353030000,2019,100767,221633,322400,MKT
06079811353050000,2021,139251,249449,388700,MKT
06079811353050000,2020,92593,234707,327300,MKT
06079811353050000,2019,92593,234707,327300,MKT
06079811353070000,2021,135138,274162,409300,MKT
06079811353070000,2020,87329,298871,386200,MKT
06079811353070000,2019,87329,298871,386200,MKT
06079811353090000,2021,144423,316477,460900,INCOME
06079811353090000,2020,99424,322876,422300,INCOME
06079811353090000,2019,99424,322876,422300,INCOME
06079811353110000,2021,129296,247304,376600,MKT
06079811353110000,2020,80113,242887,323000,MKT
06079811353110000,2019,80113,242887,323000,MKT
06079811353130000,2021,132183,234617,366800,MKT
06079811353130000,2020,83641,244659,328300,MKT
06079811353130000,2019,83641,244659,328300,MKT
06079811353150000,2021,134067,242333,376400,MKT
06079811353150000,2020,85984,251816,337800,MKT
06079811353150000,2019,85984,251816,337800,MKT
06079811353170000,2021,146544,308456,455000,MKT
06079811353170000,2020,102293,310007,412300,MKT
06079811353170000,2019,102293,310007,412300,MKT
06079811353190000,2021,136655,228345,365000,MKT
06079811353190000,2020,89253,237347,326600,MKT
06079811353190000,2019,89253,237347,326600,MKT
06079811353210000,2021,145096,282804,427900,MKT
06079811353210000,2020,100331,291369,391700,MKT
06079811353210000,2019,100331,291369,391700,MKT
06079811353230000,2021,145247,310353,455600,MKT
06079811353230000,2020,100534,314866,415400,MKT
06079811353230000,2019,100534,314866,415400,MKT
06079811353250000,2021,141782,268118,409900,MKT
06079811353250000,2020,95905,253695,349600,MKT
06079811353250000,2019,95905,253695,349600,MKT
06079811353270000,2021,153624,312176,465800,MKT
06079811353270000,2020,112161,297839,410000,MKT
06079811353270000,2019,112161,297839,410000,MKT
06079811353290000,2021,137530,228470,366000,MKT
06079811353290000,2020,90372,244428,334800,MKT
06079811353290000,2019,90372,244428,334800,MKT
06079811353310000,2021,141261,289439,430700,MKT
06079811353310000,2020,95220,284680,379900,MKT
06079811353310000,2019,95220,284680,379900,MKT
06079811353330000,2021,138883,270117,409000,MKT
06079811353330000,2020,92116,255284,347400,MKT
06079811353330000,2019,92116,255284,347400,MKT
06079811353350000,2021,134201,245999,380200,MKT
06079811353350000,2020,86151,246549,332700,MKT
06079811353350000,2019,86151,246549,332700,MKT
06079811353370000,2021,128664,270536,399200,MKT
06079811353370000,2020,79350,258950,338300,MKT
06079811353370000,2019,79350,258950,338300,MKT
06079811353390000,2021,127548,235752,363300,MKT
06079811353390000,2020,78012,201988,280000,OVR
06079811353390000,2019,78012,201988,280000,OVR
06079811353410000,2021,136151,257149,393300,MKT
06079811353410000,2020,88612,259388,348000,MKT
06079811353410000,2019,88612,262388,351000,MKT
06079811353436500,2021,40190,0,40190,COST
06079811353436500,2020,25758,0,25758,COST
06079811353436500,2019,25758,0,25758,COST
06079811353450000,2021,138729,264371,403100,MKT
06079811353450000,2020,91916,276784,368700,MKT
06079811353450000,2019,91916,276784,368700,MKT
06079811353470000,2021,135019,253381,388400,MKT
06079811353470000,2020,87180,258120,345300,MKT
06079811353470000,2019,87180,258120,345300,MKT
06079811353490000,2021,134326,261874,396200,MKT
06079811353490000,2020,86308,261192,347500,MKT
06079811353490000,2019,86308,261192,347500,MKT
06079811353510000,2021,133986,237314,371300,MKT
06079811353510000,2020,85883,242917,328800,MKT
06079811353510000,2019,85883,242917,328800,MKT
06079811353530000,2021,134468,300032,434500,MKT
06079811353530000,2020,86486,292814,379300,MKT
06079811353530000,2019,86486,292814,379300,MKT
06079811353550000,2021,142251,308049,450300,MKT
06079811353550000,2020,96526,293474,390000,MKT
06079811353550000,2019,96526,293474,390000,MKT
06079811353570000,2021,143136,242464,385600,MKT
06079811353570000,2020,97702,225598,323300,MKT
06079811353570000,2019,97702,225598,323300,MKT
06079811353597000,2021,289772,0,289772,COST
06079811353597000,2020,387054,0,387054,COST
06079811353597000,2019,387054,0,387054,COST
06079811354016500,2021,79833,0,79833,COST
06079811354016500,2020,98332,0,98332,COST
06079811354016500,2019,98332,0,98332,COST
06079811354030000,2021,134557,215443,350000,MKT
06079811354030000,2020,86598,217602,304200,MKT
06079811354030000,2019,86598,217602,304200,MKT
06079811354050000,2021,132618,277582,410200,MKT
06079811354050000,2020,84179,270521,354700,MKT
06079811354050000,2019,84179,270521,354700,MKT
06079811354070000,2021,132766,227034,359800,MKT
06079811354070000,2020,84362,232638,317000,MKT
06079811354070000,2019,84362,232638,317000,MKT
06079811354090000,2021,134392,234708,369100,MKT
06079811354090000,2020,86391,243209,329600,MKT
06079811354090000,2019,86391,243209,329600,MKT
06079811354110000,2021,135889,232111,368000,MKT
06079811354110000,2020,88279,234121,322400,MKT
06079811354110000,2019,88279,234121,322400,MKT
06079811354130000,2021,131253,265247,396500,MKT
06079811354130000,2020,82496,256204,338700,MKT
06079811354130000,2019,82496,256204,338700,MKT
06079811354150000,2021,128864,240436,369300,MKT
06079811354150000,2020,79591,242009,321600,MKT
06079811354150000,2019,79591,242009,321600,MKT
06079811354170000,2021,129822,240978,370800,MKT
06079811354170000,2020,80750,244650,325400,MKT
06079811354170000,2019,80750,244650,325400,MKT
06079811354190000,2021,128448,229252,357700,MKT
06079811354190000,2020,79090,235210,314300,MKT
06079811354190000,2019,79090,235210,314300,MKT
06079811354210000,2021,130227,269773,400000,MKT
06079811354210000,2020,81242,275658,356900,MKT
06079811354210000,2019,81242,275658,356900,MKT
06079811354230000,2021,131790,239710,371500,MKT
06079811354230000,2020,83157,244843,328000,MKT
06079811354230000,2019,83157,244843,328000,MKT
06079811354250000,2021,136727,254073,390800,MKT
06079811354250000,2020,89345,248055,337400,MKT
06079811354250000,2019,89345,248055,337400,MKT
06079811354270000,2021,137580,228920,366500,MKT
06079811354270000,2020,90436,235064,325500,MKT
06079811354270000,2019,90436,235064,325500,MKT
06079811357030000,2021,148942,306158,455100,MKT
06079811357030000,2020,105587,313413,419000,MKT
06079811357030000,2019,105587,313413,419000,MKT
06079811357050000,2021,142644,245056,387700,MKT
06079811357050000,2020,97048,257652,354700,MKT
06079811357050000,2019,97048,257652,354700,MKT
06079811357070000,2021,138984,259916,398900,MKT
06079811357070000,2020,92247,267753,360000,MKT
06079811357070000,2019,92247,267753,360000,MKT
06079811357090000,2021,139332,235268,374600,MKT
06079811357090000,2020,92697,251403,344100,MKT
06079811357090000,2019,92697,251403,344100,MKT
06079811357110000,2021,139336,245864,385200,MKT
06079811357110000,2020,92702,244698,337400,MKT
06079811357110000,2019,92702,244698,337400,MKT
06079811357130000,2021,139348,270252,409600,MKT
06079811357130000,2020,92718,266282,359000,MKT
06079811357130000,2019,92718,266282,359000,MKT
06079811357150000,2021,139364,235336,374700,MKT
06079811357150000,2020,92739,240561,333300,MKT
06079811357150000,2019,92739,240561,333300,MKT
06079811357170000,2021,144558,224742,369300,MKT
06079811357170000,2020,99605,218995,318600,MKT
06079811357170000,2019,99605,218995,318600,MKT
06079811359010000,2021,134441,219859,354300,MKT
06079811359010000,2020,86453,224047,310500,MKT
06079811359010000,2019,86453,222047,308500,MKT
06079811359030000,2021,134062,229038,363100,MKT
06079811359030000,2020,85978,237222,323200,MKT
06079811359030000,2019,85978,237222,323200,MKT
06079811359050000,2021,135181,229019,364200,MKT
06079811359050000,2020,87384,232616,320000,MKT
06079811359050000,2019,87384,232616,320000,MKT
06079811359070000,2021,140327,234473,374800,MKT
06079811359070000,2020,93995,233205,327200,MKT
06079811359070000,2019,93995,233205,327200,MKT
06079811359090000,2021,138262,236838,375100,MKT
06079811359090000,2020,91314,236886,328200,MKT
06079811359090000,2019,91314,236886,328200,MKT
06079811359110000,2021,150153,207047,357200,MKT
06079811359110000,2020,107269,211631,318900,MKT
06079811359110000,2019,107269,211631,318900,MKT
06079811359130000,2021,141466,255234,396700,MKT
06079811359130000,2020,95489,260711,356200,MKT
06079811359130000,2019,95489,260711,356200,MKT
06079811359150000,2021,145358,223842,369200,MKT
06079811359150000,2020,100684,220716,321400,MKT
06079811359150000,2019,100684,220716,321400,MKT
06079811359170000,2021,137065,237935,375000,MKT
06079811359170000,2020,89776,227124,316900,MKT
06079811359170000,2019,89776,227124,316900,MKT
06079811359190000,2021,150199,312101,462300,MKT
06079811359190000,2020,107332,294868,402200,MKT
06079811359190000,2019,107332,294868,402200,MKT
06079811359210000,2021,150726,229774,380500,MKT
06079811359210000,2020,108069,233131,341200,MKT
06079811359210000,2019,108069,233131,341200,MKT
06079811359230000,2021,139624,234176,373800,MKT
06079811359230000,2020,93078,233422,326500,MKT
06079811359230000,2019,93078,233422,326500,MKT
06079811359250000,2021,137783,225917,363700,MKT
06079811359250000,2020,90697,234803,325500,MKT
06079811359250000,2019,90697,234803,325500,MKT
06079811359270000,2021,137646,216354,354000,MKT
06079811359270000,2020,90521,217879,308400,MKT
06079811359270000,2019,90521,217879,308400,MKT
06079811359290000,2021,139041,226159,365200,MKT
06079811359290000,2020,92320,228980,321300,MKT
06079811359290000,2019,92320,228980,321300,MKT
06079811359310000,2021,135269,256231,391500,MKT
06079811359310000,2020,87495,264605,352100,MKT
06079811359310000,2019,87495,264605,352100,MKT
06079811359330000,2021,142175,224725,366900,MKT
06079811359330000,2020,96425,230775,327200,MKT
06079811359330000,2019,96425,230775,327200,MKT
06079811359350000,2021,149002,228998,378000,MKT
06079811359350000,2020,105670,229330,335000,MKT
06079811359350000,2019,105670,229330,335000,MKT
06079811359370000,2021,150130,209670,359800,MKT
06079811359370000,2020,107237,212263,319500,MKT
06079811359370000,2019,107237,212263,319500,MKT
06079811368390000,2021,2340012,714988,3055000,INCOME
06079811368390000,2020,1805462,1061738,2867200,INCOME
06079811368390000,2019,1805462,1061738,2867200,INCOME
06079811401020000,2021,888586,604414,1493000,INCOME
06079811401020000,2020,809165,576635,1385800,INCOME
06079811401020000,2019,809165,576635,1385800,INCOME
06079811401040000,2021,412808,501892,914700,INCOME
06079811401040000,2020,557958,439342,997300,INCOME
06079811401040000,2019,557958,439342,997300,INCOME
06079811401057000,2021,360634,8120,368754,COST
06079811401057000,2020,526579,8170,534749,COST
06079811401057000,2019,526579,8170,534749,COST
06079811402020000,2021,2435109,83091,2518200,INCOME
06079811402020000,2020,1356130,573070,1929200,INCOME
06079811402020000,2019,1356130,573070,1929200,INCOME
06079811402030000,2021,166416,254884,421300,MKT
06079811402030000,2020,120747,242153,362900,MKT
06079811402030000,2019,120747,242153,362900,MKT
06079811402040000,2021,937064,4389936,5327000,INCOME
06079811402040000,2020,792709,2481391,3274100,INCOME
06079811402040000,2019,792709,2481391,3274100,INCOME
06079811402050000,2021,1122728,4393772,5516500,INCOME
06079811402050000,2020,973332,2496768,3470100,INCOME
06079811402050000,2019,973332,2496768,3470100,INCOME
06079811402060000,2021,1024080,2255620,3279700,INCOME
06079811402060000,2020,859884,1780616,2640500,INCOME
06079811402060000,2019,859884,1780616,2640500,INCOME
06079811402070000,2021,230876,229760,460636,COST
06079811402070000,2020,166743,224870,391613,COST
06079811402070000,2019,166743,224870,391613,COST
06079811402070900,2021,224272,0,224272,COST
06079811402070900,2020,162040,0,162040,COST
06079811402070900,2019,162040,0,162040,COST
06079811402070901,2021,224433,0,224433,COST
06079811402070901,2020,162155,0,162155,COST
06079811402070901,2019,162155,0,162155,COST
06079811402070902,2021,204742,0,204742,COST
06079811402070902,2020,148120,0,148120,COST
06079811402070902,2019,148120,0,148120,COST
06079811402080000,2021,720125,622875,1343000,INCOME
06079811402080000,2020,739485,326315,1065800,INCOME
06079811402080000,2019,739485,326315,1065800,INCOME
06079811402090000,2021,309149,253951,563100,INCOME
06079811402090000,2020,492953,93047,586000,INCOME
06079811402090000,2019,492953,93047,586000,INCOME
06079811402100000,2021,1513838,2293562,3807400,INCOME
06079811402100000,2020,1016613,1836630,2853243,COST
06079811402100000,2019,1016613,1836630,2853243,COST
06079811402110000,2021,609068,1119132,1728200,INCOME
06079811402110000,2020,659117,1017983,1677100,INCOME
06079811402110000,2019,659117,1017983,1677100,INCOME
06079811402120000,2021,476705,435995,912700,INCOME
06079811402120000,2020,593439,276061,869500,INCOME
06079811402120000,2019,593439,276061,869500,INCOME
06079811402130000,2021,1336145,1185155,2521300,INCOME
06079811402130000,2020,963666,1508650,2472316,COST
06079811402130000,2019,963666,1508650,2472316,COST
06079811402147000,2021,860104,31550,891654,COST
06079811402147000,2020,797951,30540,828491,COST
06079811402147000,2019,797951,30540,828491,COST
06079811403017000,2021,337610,6480,344090,COST
06079811403017000,2020,511906,6760,518666,COST
06079811403017000,2019,511906,6760,518666,COST
06079811403020000,2021,337597,491700,829297,COST
06079811403020000,2020,511897,322303,834200,INCOME
06079811403020000,2019,511897,322303,834200,INCOME
06079811403030000,2021,337610,48280,385890,COST
06079811403030000,2020,325758,48750,374508,COST
06079811403030000,2019,325758,48750,374508,COST
06079811403050000,2021,791010,937790,1728800,INCOME
06079811403050000,2020,769833,761967,1531800,INCOME
06079811403050000,2019,769833,761967,1531800,INCOME
06079811404010000,2021,425820,0,425820,COST
06079811404010000,2020,565425,0,565425,COST
06079811404010000,2019,565425,0,565425,COST
06079811404030000,2021,316134,0,316134,COST
06079811404030000,2020,497694,0,497694,COST
06079811404030000,2019,497694,0,497694,COST
06079811404050000,2021,624183,3540917,4165100,INCOME
06079811404050000,2020,666075,2729225,3395300,INCOME
06079811404050000,2019,666075,2729225,3395300,INCOME
06079811406010000,2021,3155887,1957613,5113500,INCOME
06079811406010000,2020,1515439,2652861,4168300,INCOME
06079811406010000,2019,1515439,2652861,4168300,INCOME
06079811408027000,2021,272528,4860,277388,COST
06079811408027000,2020,196364,0,196364,COST
06079811408027000,2019,196364,0,196364,COST
06079811408060000,2021,644211,2847389,3491600,INCOME
06079811408060000,2020,675148,1710652,2385800,INCOME
06079811408060000,2019,675148,1710652,2385800,INCOME
06079811408100000,2021,659266,4429334,5088600,INCOME
06079811408100000,2020,681862,2652838,3334700,INCOME
06079811408100000,2019,681862,2652838,3334700,INCOME
06079811408140000,2021,606801,99220,706021,COST
06079811408140000,2020,658065,89930,747995,COST
06079811408140000,2019,658065,89930,747995,COST
06079811408180000,2021,634715,3022985,3657700,INCOME
06079811408180000,2020,670866,1839234,2510100,INCOME
06079811408180000,2019,670866,1839234,2510100,INCOME
06079811408220000,2021,635916,1393684,2029600,INCOME
06079811408220000,2020,671410,965590,1637000,INCOME
06079811408220000,2019,671410,965590,1637000,INCOME
06079811408260000,2021,492851,1230149,1723000,INCOME
06079811408260000,2020,601967,1072833,1674800,INCOME
06079811408260000,2019,601967,1072833,1674800,INCOME
06079811408270000,2021,574299,0,574299,COST
06079811408270000,2020,549602,0,549602,COST
06079811408270000,2019,549602,0,549602,COST
06079811408300000,2021,871619,1993581,2865200,INCOME
06079811408300000,2020,657151,2274549,2931700,INCOME
06079811408300000,2019,657151,2160740,2817891,COST
06079811408400000,2021,160862,309138,470000,MKT
06079811408400000,2020,109940,262360,372300,MKT
06079811408400000,2019,109940,262360,372300,MKT
06079811408600000,2021,407280,1678320,2085600,INCOME
06079811408600000,2020,554744,1280856,1835600,INCOME
06079811408600000,2019,554744,1280856,1835600,INCOME
06079811418010000,2021,362669,657831,1020500,INCOME
06079811418010000,2020,527849,448851,976700,INCOME
06079811418010000,2019,527849,448851,976700,INCOME
06079811418037000,2021,609996,18230,628226,COST
06079811418037000,2020,659547,17640,677187,COST
06079811418037000,2019,659547,17640,677187,COST
06079811418040000,2021,469300,497400,966700,INCOME
06079811418040000,2020,589472,300128,889600,INCOME
06079811418040000,2019,589472,300128,889600,INCOME
06079811418050000,2021,455114,117086,572200,INCOME
06079811418050000,2020,433809,41191,475000,OVR
06079811418050000,2019,433809,41191,475000,OVR
06079811418060000,2021,339937,0,339937,COST
06079811418060000,2020,513414,0,513414,COST
06079811418060000,2019,513414,0,513414,COST
06079811418070000,2021,415740,316260,732000,INCOME
06079811418070000,2020,559652,207600,767252,COST
06079811418070000,2019,559652,207600,767252,COST
06079811418080000,2021,410650,378350,789000,INCOME
06079811418080000,2020,556706,129630,686336,COST
06079811418080000,2019,556706,129630,686336,COST
06079811418090000,2021,339937,220963,560900,INCOME
06079811418090000,2020,513414,70386,583800,INCOME
06079811418090000,2019,513414,70386,583800,INCOME
06079811418090900,2021,339937,299063,639000,INCOME
06079811418090900,2020,513414,60286,573700,INCOME
06079811418090900,2019,513414,60286,573700,INCOME
06079811418107000,2021,717308,0,717308,COST
06079811418107000,2020,509816,0,509816,COST
06079811418107000,2019,509816,0,509816,COST
06079811421010000,2021,1169443,7377357,8546800,INCOME
06079811421010000,2020,990480,5112520,6103000,INCOME
06079811421010000,2019,990480,5112520,6103000,INCOME
06079811421020000,2021,425820,464500,890320,COST
06079811421020000,2020,565425,467875,1033300,INCOME
06079811421020000,2019,565425,467875,1033300,INCOME
06079811421030000,2021,557444,0,557444,COST
06079811421030000,2020,634578,0,634578,COST
06079811421030000,2019,634578,0,634578,COST
06079811422010000,2021,133039,14040,147079,COST
06079811422010000,2020,65645,13790,79435,COST
06079811422010000,2019,65645,13790,79435,COST
06079811422020000,2021,92146,0,92146,COST
06079811422020000,2020,46925,0,46925,COST
06079811422020000,2019,46925,0,46925,COST
06079811422030000,2021,115673,0,115673,COST
06079811422030000,2020,57766,0,57766,COST
06079811422030000,2019,57766,0,57766,COST
06079811422050000,2021,115673,10060,125733,COST
06079811422050000,2020,57766,10100,67866,COST
06079811422050000,2019,57766,10100,67866,COST
06079811422070000,2021,115673,0,115673,COST
06079811422070000,2020,57766,0,57766,COST
06079811422070000,2019,57766,0,57766,COST
06079811422090000,2021,111109,225391,336500,MKT
06079811422090000,2020,57766,153850,211616,COST
06079811422090000,2019,57766,153850,211616,COST
06079811422110000,2021,115673,0,115673,COST
06079811422110000,2020,57766,0,57766,COST
06079811422110000,2019,57766,0,57766,COST
06079811422130000,2021,111109,142191,253300,MKT
06079811422130000,2020,57766,125360,183126,COST
06079811422130000,2019,57766,125360,183126,COST
06079811422150000,2021,115673,7960,123633,COST
06079811422150000,2020,57766,7900,65666,COST
06079811422150000,2019,57766,7900,65666,COST
06079811422170000,2021,115673,1700,117373,COST
06079811422170000,2020,57766,1880,59646,COST
06079811422170000,2019,57766,1880,59646,COST
06079811422190000,2021,111109,104691,215800,MKT
06079811422190000,2020,57766,35060,92826,COST
06079811422190000,2019,57766,250,58016,COST
06079811422210000,2021,115673,130,115803,COST
06079811422210000,2020,57766,130,57896,COST
06079811422210000,2019,57766,130,57896,COST
06079811422230000,2021,119143,8340,127483,COST
06079811422230000,2020,59349,8180,67529,COST
06079811422230000,2019,59349,8180,67529,COST
06079811422250000,2021,114339,0,114339,COST
06079811422250000,2020,57157,0,57157,COST
06079811422250000,2019,57157,0,57157,COST
06079811422270000,2021,120718,0,120718,COST
06079811422270000,2020,60065,0,60065,COST
06079811422270000,2019,60065,0,60065,COST
06079811422290000,2021,121405,0,121405,COST
06079811422290000,2020,60377,0,60377,COST
06079811422290000,2019,60377,0,60377,COST
06079811422310000,2021,111574,540,112114,COST
06079811422310000,2020,55892,560,56452,COST
06079811422310000,2019,55892,560,56452,COST
06079811422320000,2021,115673,0,115673,COST
06079811422320000,2020,57766,0,57766,COST
06079811422320000,2019,57766,0,57766,COST
06079811422340000,2021,115673,870,116543,COST
06079811422340000,2020,57766,890,58656,COST
06079811422340000,2019,57766,890,58656,COST
06079811422360000,2021,115673,3970,119643,COST
06079811422360000,2020,57766,3960,61726,COST
06079811422360000,2019,57766,3960,61726,COST
06079811422380000,2021,115673,1590,117263,COST
06079811422380000,2020,57766,1530,59296,COST
06079811422380000,2019,57766,1530,59296,COST
06079811422400000,2021,111109,106191,217300,MKT
06079811422400000,2020,57766,52270,110036,COST
06079811422400000,2019,57766,52270,110036,COST
06079811422430000,2021,132327,6880,139207,COST
06079811422430000,2020,65324,7000,72324,COST
06079811422430000,2019,65324,7000,72324,COST
06079811422450000,2021,132327,9400,141727,COST
06079811422450000,2020,65324,9660,74984,COST
06079811422450000,2019,65324,9660,74984,COST
06079811422480000,2021,111109,146291,257400,MKT
06079811422480000,2020,57766,40740,98506,COST
06079811422480000,2019,57766,40740,98506,COST
06079811422500000,2021,111109,177091,288200,MKT
06079811422500000,2020,57766,127030,184796,COST
06079811422500000,2019,57766,127030,184796,COST
06079811422520000,2021,115673,1290,116963,COST
06079811422520000,2020,57766,1250,59016,COST
06079811422520000,2019,57766,1250,59016,COST
06079811422526700,2021,59377,0,59377,COST
06079811422526700,2020,28251,0,28251,COST
06079811422526700,2019,28251,0,28251,COST
06079811422530000,2021,115673,8950,124623,COST
06079811422530000,2020,57766,9080,66846,COST
06079811422530000,2019,57766,9080,66846,COST
06079811422550000,2021,115673,14380,130053,COST
06079811422550000,2020,57766,14400,72166,COST
06079811422550000,2019,57766,14400,72166,COST
06079811425077000,2021,164088,0,164088,COST
06079811425077000,2020,119081,0,119081,COST
06079811425077000,2019,119081,0,119081,COST
06079811425080000,2021,186604,261896,448500,INCOME
06079811425080000,2020,108755,316245,425000,INCOME
06079811425080000,2019,108755,316245,425000,INCOME
06079811425100000,2021,175863,358637,534500,INCOME
06079811425100000,2020,103693,394007,497700,INCOME
06079811425100000,2019,103693,394007,497700,INCOME
06079811425120000,2021,174764,484536,659300,INCOME
06079811425120000,2020,103172,394528,497700,INCOME
06079811425120000,2019,103172,394528,497700,INCOME
06079811425140000,2021,163513,239487,403000,INCOME
06079811425140000,2020,97797,299403,397200,INCOME
06079811425140000,2019,97797,299403,397200,INCOME
06079811425160000,2021,168074,332026,500100,INCOME
06079811425160000,2020,99984,356016,456000,INCOME
06079811425160000,2019,99984,356016,456000,INCOME
06079811426017000,2021,211396,620,212016,COST
06079811426017000,2020,152865,630,153495,COST
06079811426017000,2019,152865,630,153495,COST
06079811426020000,2021,158581,375919,534500,INCOME
06079811426020000,2020,95419,402281,497700,INCOME
06079811426020000,2019,95419,402281,497700,INCOME
06079811426030000,2021,159811,305789,465600,INCOME
06079811426030000,2020,96013,318387,414400,INCOME
06079811426030000,2019,96013,318387,414400,INCOME
06079811426040000,2021,159821,374679,534500,INCOME
06079811426040000,2020,96018,401682,497700,INCOME
06079811426040000,2019,96018,401682,497700,INCOME
06079811426050000,2021,167046,367454,534500,INCOME
06079811426050000,2020,99492,398208,497700,INCOME
06079811426050000,2019,99492,398208,497700,INCOME
06079811426060000,2021,167093,238307,405400,INCOME
06079811426060000,2020,99515,256685,356200,INCOME
06079811426060000,2019,99515,256685,356200,INCOME
06079811426070000,2021,192321,348279,540600,INCOME
06079811426070000,2020,111425,363475,474900,INCOME
06079811426070000,2019,111425,363475,474900,INCOME
06079811426080000,2021,189477,351123,540600,INCOME
06079811426080000,2020,110099,364801,474900,INCOME
06079811426080000,2019,110099,364801,474900,INCOME
06079811426090000,2021,195715,344885,540600,INCOME
06079811426090000,2020,113004,361896,474900,INCOME
06079811426090000,2019,113004,361896,474900,INCOME
06079811426100000,2021,194907,345693,540600,INCOME
06079811426100000,2020,112628,362272,474900,INCOME
06079811426100000,2019,112628,362272,474900,INCOME
06079811426110000,2021,202480,338120,540600,INCOME
06079811426110000,2020,116133,358767,474900,INCOME
06079811426110000,2019,116133,358767,474900,INCOME
06079811426127000,2021,145557,0,145557,COST
06079811426127000,2020,105812,0,105812,COST
06079811426127000,2019,105812,0,105812,COST
06079811426130000,2021,180345,408655,589000,INCOME
06079811426130000,2020,105812,413288,519100,INCOME
06079811426130000,2019,105812,413288,519100,INCOME
06079811426150000,2021,180345,360255,540600,INCOME
06079811426150000,2020,105812,369088,474900,INCOME
06079811426150000,2019,105812,369088,474900,INCOME
06079811426207000,2021,1209007,51690,1260697,COST
06079811426207000,2020,756031,50380,806411,COST
06079811426207000,2019,756031,50380,806411,COST
06079811429010000,2021,1152284,463980,1616264,COST
06079811429010000,2020,904449,435360,1339809,COST
06079811429010000,2019,904449,435360,1339809,COST
06079811430720000,2021,184203,271610,455813,COST
06079811430720000,2020,188497,272050,460547,COST
06079811430720000,2019,188497,272050,460547,COST
06079811430730000,2021,497925,1166675,1664600,INCOME
06079811430730000,2020,356049,840451,1196500,INCOME
06079811430730000,2019,356049,840451,1196500,INCOME
06079811430740000,2021,487967,1575733,2063700,INCOME
06079811430740000,2020,348583,1119717,1468300,INCOME
06079811430740000,2019,348583,1119717,1468300,INCOME
06079811440020000,2021,449390,112590,561980,COST
06079811440020000,2020,604232,111650,715882,COST
06079811440020000,2019,604232,111650,715882,COST
06079811440087000,2021,534581,14810,549391,COST
06079811440087000,2020,650878,14340,665218,COST
06079811440087000,2019,650878,14340,665218,COST
06079811440100000,2021,537621,399479,937100,INCOME
06079811440100000,2020,652461,92439,744900,INCOME
06079811440100000,2019,652461,92439,744900,INCOME
06079811440137000,2021,1587634,50620,1638254,COST
06079811440137000,2020,1037554,48990,1086544,COST
06079811440137000,2019,1037554,48990,1086544,COST
06079811440160000,2021,931310,1646290,2577600,INCOME
06079811440160000,2020,825608,1157792,1983400,INCOME
06079811440160000,2019,825608,1157792,1983400,INCOME
06079811442010000,2021,451221,740779,1192000,INCOME
06079811442010000,2020,579635,545965,1125600,INCOME
06079811442010000,2019,579635,545965,1125600,INCOME
06079811442020000,2021,4424296,11178104,15602400,INCOME
06079811442020000,2020,1609460,11703340,13312800,INCOME
06079811442020000,2019,1609460,11703340,13312800,INCOME
06079811442030000,2021,880753,1600747,2481500,INCOME
06079811442030000,2020,806101,1166499,1972600,INCOME
06079811442030000,2019,806101,1166499,1972600,INCOME
06079811442050000,2021,947699,0,947699,COST
06079811442050000,2020,831801,0,831801,COST
06079811442050000,2019,831801,0,831801,COST
06079811442067000,2021,544781,11980,556761,COST
06079811442067000,2020,628362,11590,639952,COST
06079811442067000,2019,628362,11590,639952,COST
06079811443020000,2021,148973,492027,641000,INCOME
06079811443020000,2020,108260,481240,589500,INCOME
06079811443020000,2019,108260,481240,589500,INCOME
06079811443030000,2021,145468,495532,641000,INCOME
06079811443030000,2020,105749,483751,589500,INCOME
06079811443030000,2019,105749,483751,589500,INCOME
06079811443050000,2021,145468,495532,641000,INCOME
06079811443050000,2020,105749,483751,589500,INCOME
06079811443050000,2019,105749,483751,589500,INCOME
06079811443067000,2021,145468,0,145468,COST
06079811443067000,2020,105749,0,105749,COST
06079811443067000,2019,105749,0,105749,COST
06079811443070000,2021,129664,319636,449300,MKT
06079811443070000,2020,94414,271186,365600,MKT
06079811443070000,2019,94414,271186,365600,MKT
06079811443080000,2021,129664,225736,355400,INCOME
06079811443080000,2020,94414,232986,327400,INCOME
06079811443080000,2019,94414,232986,327400,INCOME
06079811443100000,2021,237835,227765,465600,INCOME
06079811443100000,2020,132174,282226,414400,INCOME
06079811443100000,2019,132174,282226,414400,INCOME
06079811443120000,2021,168074,297526,465600,INCOME
06079811443120000,2020,99984,314416,414400,INCOME
06079811443120000,2019,99984,314416,414400,INCOME
06079811443150000,2021,137428,368372,505800,MKT
06079811443150000,2020,99984,322016,422000,MKT
06079811443150000,2019,99984,322016,422000,MKT
06079811443170000,2021,126418,239582,366000,MKT
06079811443170000,2020,92083,226317,318400,MKT
06079811443170000,2019,92083,230117,322200,MKT
06079811443190000,2021,303297,185503,488800,INCOME
06079811443190000,2020,400000,49800,449800,INCOME
06079811443190000,2019,400000,49800,449800,INCOME
06079811444010000,2021,439110,1089650,1528760,COST
06079811444010000,2020,572918,1041320,1614238,COST
06079811444010000,2019,572918,1041320,1614238,COST
06079811444060000,2021,166998,495250,662248,COST
06079811444060000,2020,99470,412360,511830,COST
06079811444060000,2019,99470,412360,511830,COST
06079811444080000,2021,158953,239230,398183,COST
06079811444080000,2020,95598,229710,325308,COST
06079811444080000,2019,95598,229710,325308,COST
06079811444100000,2021,159538,534762,694300,INCOME
06079811444100000,2020,95881,376519,472400,INCOME
06079811444100000,2019,95881,376519,472400,INCOME
06079811444120000,2021,159538,254962,414500,INCOME
06079811444120000,2020,95881,266419,362300,INCOME
06079811444120000,2019,95881,266419,362300,INCOME
06079811444130000,2021,171877,293723,465600,INCOME
06079811444130000,2020,101799,312601,414400,INCOME
06079811444130000,2019,101799,312601,414400,INCOME
06079811444160000,2021,177819,287781,465600,INCOME
06079811444160000,2020,104619,309781,414400,INCOME
06079811444160000,2019,104619,309781,414400,INCOME
06079811444180000,2021,191045,479655,670700,INCOME
06079811444180000,2020,110831,484069,594900,INCOME
06079811444180000,2019,110831,484069,594900,INCOME
06079811444200000,2021,133896,201404,335300,INCOME
06079811444200000,2020,97451,199949,297400,INCOME
06079811444200000,2019,97451,199949,297400,INCOME
06079811444220000,2021,133896,213904,347800,INCOME
06079811444220000,2020,97451,207949,305400,INCOME
06079811444220000,2019,97451,207949,305400,INCOME
06079811444240000,2021,133896,176404,310300,INCOME
06079811444240000,2020,97451,187749,285200,INCOME
06079811444240000,2019,97451,187749,285200,INCOME
06079811444260000,2021,133896,201404,335300,INCOME
06079811444260000,2020,97451,199949,297400,INCOME
06079811444260000,2019,97451,199949,297400,INCOME
06079811444280000,2021,133896,201404,335300,INCOME
06079811444280000,2020,97451,199949,297400,INCOME
06079811444280000,2019,97451,199949,297400,INCOME
06079811444300000,2021,161771,11520,173291,COST
06079811444300000,2020,461037,11150,472187,COST
06079811444300000,2019,461037,11150,472187,COST
06079811444320000,2021,162348,283152,445500,MKT
06079811444320000,2020,117836,265464,383300,MKT
06079811444320000,2019,117836,265464,383300,MKT
06079811449010000,2021,231510,0,231510,COST
06079811449010000,2020,454786,0,454786,COST
06079811449010000,2019,454786,0,454786,COST
06079811460010000,2021,118592,276408,395000,MKT
06079811460010000,2020,81401,252399,333800,MKT
06079811460010000,2019,81401,252399,333800,MKT
06079811460020000,2021,155010,331730,486740,COST
06079811460020000,2020,452682,196618,649300,OVR
06079811460020000,2019,452682,196618,649300,INCOME
06079811460030000,2021,111682,245318,357000,MKT
06079811460030000,2020,76722,227578,304300,MKT
06079811460030000,2019,76722,227578,304300,MKT
06079811460040000,2021,111682,0,111682,COST
06079811460040000,2020,76722,0,76722,COST
06079811460040000,2019,76722,0,76722,COST
06079811460050000,2021,116268,356432,472700,MKT
06079811460050000,2020,79828,301872,381700,MKT
06079811460050000,2019,79828,301872,381700,MKT
06079811460060000,2021,266099,203801,469900,INCOME
06079811460060000,2020,400000,89000,489000,INCOME
06079811460060000,2019,400000,89000,489000,INCOME
06079811460070000,2021,129464,270736,400200,INCOME
06079811460070000,2020,94270,279030,373300,INCOME
06079811460070000,2019,94270,279030,373300,INCOME
06079811460087000,2021,129464,0,129464,COST
06079811460087000,2020,94270,0,94270,COST
06079811460087000,2019,94270,0,94270,COST
06079811460090000,2021,129464,322536,452000,INCOME
06079811460090000,2020,94270,212230,306500,INCOME
06079811460090000,2019,94270,212230,306500,INCOME
06079811460100000,2021,133896,221504,355400,INCOME
06079811460100000,2020,97451,229949,327400,INCOME
06079811460100000,2019,97451,229949,327400,INCOME
06079811470010000,2021,906637,867563,1774200,INCOME
06079811470010000,2020,787345,764955,1552300,INCOME
06079811470010000,2019,787345,764955,1552300,INCOME
06079811470117000,2021,1576959,34280,1611239,COST
06079811470117000,2020,1034560,33190,1067750,COST
06079811470117000,2019,1034560,33190,1067750,COST
06079811472017000,2021,1368983,25160,1394143,COST
06079811472017000,2020,973741,24430,998171,COST
06079811472017000,2019,973741,24430,998171,COST
06079811474017000,2021,838849,12290,851139,COST
06079811474017000,2020,789443,11890,801333,COST
06079811474017000,2019,789443,11890,801333,COST
06079811474047000,2021,709474,11050,720524,COST
06079811474047000,2020,734780,10700,745480,COST
06079811474047000,2019,734780,10700,745480,COST
06079811474070000,2021,709474,672526,1382000,INCOME
06079811474070000,2020,734780,586320,1321100,INCOME
06079811474070000,2019,734780,586320,1321100,INCOME
06079812101015001,2021,106292,88508,194800,MKT
06079812101015001,2020,49320,146280,195600,MKT
06079812101015001,2019,49320,146280,195600,MKT
06079812101016500,2021,112787,70430,183217,COST
06079812101016500,2020,66565,68170,134735,COST
06079812101016500,2019,66565,68170,134735,COST
06079812101025002,2021,121862,87538,209400,MKT
06079812101025002,2020,57976,146324,204300,MKT
06079812101025002,2019,57976,146324,204300,MKT
06079812101035003,2021,117615,91985,209600,MKT
06079812101035003,2020,57570,146230,203800,MKT
06079812101035003,2019,57570,146230,203800,MKT
06079812101045004,2021,109023,88477,197500,MKT
06079812101045004,2020,50821,146579,197400,MKT
06079812101045004,2019,50821,146579,197400,MKT
06079812101055005,2021,108649,93051,201700,MKT
06079812101055005,2020,50615,150385,201000,MKT
06079812101055005,2019,50615,150385,201000,MKT
06079812101065006,2021,107372,87128,194500,MKT
06079812101065006,2020,49913,145387,195300,MKT
06079812101065006,2019,49913,145387,195300,MKT
06079812101075007,2021,107007,94093,201100,MKT
06079812101075007,2020,49713,157087,206800,MKT
06079812101075007,2019,49713,158587,208300,MKT
06079812101085008,2021,106641,87459,194100,MKT
06079812101085008,2020,49512,146388,195900,MKT
06079812101085008,2019,49512,146388,195900,MKT
06079812101095009,2021,107190,87610,194800,MKT
06079812101095009,2020,49813,146687,196500,MKT
06079812101095009,2019,49813,146687,196500,MKT
06079812101105010,2021,101180,88420,189600,MKT
06079812101105010,2020,46531,148069,194600,MKT
06079812101105010,2019,46531,148069,194600,MKT
06079812101115011,2021,100601,87499,188100,MKT
06079812101115011,2020,46217,146383,192600,MKT
06079812101115011,2019,46217,146383,192600,MKT
06079812101125012,2021,105866,87534,193400,MKT
06079812101125012,2020,49087,146313,195400,MKT
06079812101125012,2019,49087,146313,195400,MKT
06079812101135013,2021,105494,87506,193000,MKT
06079812101135013,2020,48883,146317,195200,MKT
06079812101135013,2019,48883,146317,195200,MKT
06079812101145014,2021,109940,87460,197400,MKT
06079812101145014,2020,51327,146373,197700,MKT
06079812101145014,2019,51327,146373,197700,MKT
06079812101155032,2021,107372,87528,194900,MKT
06079812101155032,2020,49913,146287,196200,MKT
06079812101155032,2019,49913,146287,196200,MKT
06079812101165031,2021,107716,87484,195200,MKT
06079812101165031,2020,50102,146298,196400,MKT
06079812101165031,2019,50102,146298,196400,MKT
06079812101175030,2021,107716,87984,195700,MKT
06079812101175030,2020,50102,147298,197400,MKT
06079812101175030,2019,50102,147298,197400,MKT
06079812101185029,2021,101061,87439,188500,MKT
06079812101185029,2020,46467,146333,192800,MKT
06079812101185029,2019,46467,146333,192800,MKT
06079812101195028,2021,101061,88239,189300,MKT
06079812101195028,2020,46467,147933,194400,MKT
06079812101195028,2019,46467,147933,194400,MKT
06079812101205027,2021,107044,87656,194700,MKT
06079812101205027,2020,49733,146767,196500,MKT
06079812101205027,2019,49733,146767,196500,MKT
06079812101215026,2021,107372,91028,198400,MKT
06079812101215026,2020,49913,149787,199700,MKT
06079812101215026,2019,49913,149787,199700,MKT
06079812101225025,2021,115892,91308,207200,MKT
06079812101225025,2020,54630,146270,200900,MKT
06079812101225025,2019,54630,146270,200900,MKT
06079812101235015,2021,110237,91763,202000,MKT
06079812101235015,2020,51491,150209,201700,MKT
06079812101235015,2019,51491,150209,201700,MKT
06079812101245016,2021,102305,85995,188300,MKT
06079812101245016,2020,47142,146358,193500,MKT
06079812101245016,2019,47142,146358,193500,MKT
06079812101255024,2021,117539,87761,205300,MKT
06079812101255024,2020,55550,146550,202100,MKT
06079812101255024,2019,55550,146550,202100,MKT
06079812101265021,2021,117539,95561,213100,MKT
06079812101265021,2020,55550,158350,213900,MKT
06079812101265021,2019,55550,158350,213900,MKT
06079812101275022,2021,117539,90661,208200,MKT
06079812101275022,2020,55550,148350,203900,MKT
06079812101275022,2019,55550,148350,203900,MKT
06079812101285023,2021,117539,87761,205300,MKT
06079812101285023,2020,55550,146550,202100,MKT
06079812101285023,2019,55550,146550,202100,MKT
06079812101295020,2021,117539,91161,208700,MKT
06079812101295020,2020,55550,155350,210900,MKT
06079812101295020,2019,55550,146550,202100,MKT
06079812101305017,2021,117539,90361,207900,MKT
06079812101305017,2020,55550,149650,205200,MKT
06079812101305017,2019,55550,149650,205200,MKT
06079812101315018,2021,117539,91461,209000,MKT
06079812101315018,2020,55550,149050,204600,MKT
06079812101315018,2019,55550,149050,204600,MKT
06079812101325019,2021,117539,87761,205300,MKT
06079812101325019,2020,55550,148150,203700,MKT
06079812101325019,2019,55550,148150,203700,MKT
06079812101340000,2021,532514,4545786,5078300,INCOME
06079812101340000,2020,252681,3410419,3663100,INCOME
06079812101340000,2019,252681,3410419,3663100,INCOME
06079812108010000,2021,418119,710881,1129000,INCOME
06079812108010000,2020,585849,482251,1068100,INCOME
06079812108010000,2019,585849,482251,1068100,INCOME
06079812108070000,2021,336644,331756,668400,INCOME
06079812108070000,2020,511278,98822,610100,INCOME
06079812108070000,2019,511278,98822,610100,INCOME
06079812108130000,2021,777555,415000,1192555,COST
06079812108130000,2020,764195,404690,1168885,COST
06079812108130000,2019,764195,404690,1168885,COST
06079812109010000,2021,1196100,4127000,5323100,INCOME
06079812109010000,2020,919025,3366675,4285700,INCOME
06079812109010000,2019,919025,3366675,4285700,INCOME
06079812109100000,2021,616149,1817151,2433300,INCOME
06079812109100000,2020,691702,1242598,1934300,INCOME
06079812109100000,2019,691702,1242598,1934300,INCOME
06079812110017000,2021,952800,28990,981790,COST
06079812110017000,2020,833716,28270,861986,COST
06079812110017000,2019,833716,28270,861986,COST
06079812110120000,2021,258719,345681,604400,INCOME
06079812110120000,2020,456745,64655,521400,INCOME
06079812110120000,2019,456745,64655,521400,INCOME
06079812110150000,2021,284768,947930,1232698,COST
06079812110150000,2020,475907,587093,1063000,INCOME
06079812110150000,2019,475907,587093,1063000,INCOME
06079812110170000,2021,216690,323910,540600,INCOME
06079812110170000,2020,442078,62300,504378,COST
06079812110170000,2019,442078,62300,504378,COST
06079812110220000,2021,374909,541860,916769,COST
06079812110220000,2020,522742,181058,703800,INCOME
06079812110220000,2019,522742,181058,703800,INCOME
06079812111010000,2021,391608,432292,823900,INCOME
06079812111010000,2020,629909,237891,867800,INCOME
06079812111010000,2019,629909,237891,867800,INCOME
06079812111100000,2021,438407,103960,542367,COST
06079812111100000,2020,541371,102020,643391,COST
06079812111100000,2019,541371,102020,643391,COST
06079812111160000,2021,438407,17120,455527,COST
06079812111160000,2020,541371,16570,557941,COST
06079812111160000,2019,541371,16570,557941,COST
06079812111220000,2021,448816,1991684,2440500,INCOME
06079812111220000,2020,667798,1183402,1851200,INCOME
06079812111220000,2019,667798,1042002,1709800,INCOME
06079812112100000,2021,289674,306560,596234,COST
06079812112100000,2020,553586,301970,855556,COST
06079812112100000,2019,553586,301970,855556,COST
06079812112120000,2021,268454,320846,589300,INCOME
06079812112120000,2020,535835,28465,564300,INCOME
06079812112120000,2019,535835,28465,564300,INCOME
06079812112150000,2021,260202,458298,718500,INCOME
06079812112150000,2020,528716,181120,709836,COST
06079812112150000,2019,528716,181120,709836,COST
06079812112250000,2021,393927,366700,760627,COST
06079812112250000,2020,631505,504095,1135600,INCOME
06079812112250000,2019,631505,504095,1135600,INCOME
06079812112390000,2021,246041,0,246041,COST
06079812112390000,2020,422695,0,422695,COST
06079812112390000,2019,422695,0,422695,COST
06079812112450000,2021,260202,0,260202,COST
06079812112450000,2020,432950,0,432950,COST
06079812112450000,2019,432950,0,432950,COST
06079812112470000,2021,331639,0,331639,COST
06079812112470000,2020,480364,0,480364,COST
06079812112470000,2019,480364,0,480364,COST
06079812112500000,2021,326892,0,326892,COST
06079812112500000,2020,477406,0,477406,COST
06079812112500000,2019,477406,0,477406,COST
06079812112520000,2021,952606,0,952606,COST
06079812112520000,2020,921848,0,921848,COST
06079812112520000,2019,921848,0,921848,COST
06079812112550000,2021,179114,0,179114,COST
06079812112550000,2020,368947,0,368947,COST
06079812112550000,2019,368947,0,368947,COST
06079812112600000,2021,260202,313998,574200,INCOME
06079812112600000,2020,432950,186370,619320,COST
06079812112600000,2019,432950,186370,619320,COST
06079812113090000,2021,3166853,0,3166853,COST
06079812113090000,2020,792947,0,792947,COST
06079812113090000,2019,792947,0,792947,COST
06079812113110000,2021,847929,149230,997159,COST
06079812113110000,2020,528716,58984,587700,INCOME
06079812113110000,2019,528716,58984,587700,INCOME
06079812113130000,2021,847929,180930,1028859,COST
06079812113130000,2020,322517,158620,481137,COST
06079812113130000,2019,528716,172940,701656,COST
06079812113150000,2021,847929,221871,1069800,INCOME
06079812113150000,2020,528716,567384,1096100,INCOME
06079812113150000,2019,528716,567384,1096100,INCOME
06079812113170000,2021,847929,74690,922619,COST
06079812113170000,2020,528716,73280,601996,COST
06079812113170000,2019,528716,73280,601996,COST
06079812113200000,2021,1283707,2493,1286200,INCOME
06079812113200000,2020,631505,64595,696100,INCOME
06079812113200000,2019,631505,288395,919900,INCOME
06079812113230000,2021,159646,478754,638400,INCOME
06079812113230000,2020,458433,162667,621100,INCOME
06079812113230000,2019,458433,162667,621100,INCOME
06079812113250000,2021,135167,544633,679800,INCOME
06079812113250000,2020,426883,198500,625383,COST
06079812113250000,2019,426883,198500,625383,COST
06079812113250900,2021,36768,0,36768,COST
06079812113250900,2020,122805,0,122805,COST
06079812113250900,2019,122805,0,122805,COST
06079812113290000,2021,392072,158528,550600,MKT
06079812113290000,2020,275105,122795,397900,MKT
06079812113290000,2019,275105,122795,397900,MKT
06079812113310000,2021,392072,247528,639600,MKT
06079812113310000,2020,275105,193295,468400,MKT
06079812113310000,2019,275105,193295,468400,MKT
06079812113330000,2021,139693,357107,496800,INCOME
06079812113330000,2020,432950,97940,530890,COST
06079812113330000,2019,432950,97940,530890,COST
06079812113350000,2021,864771,0,864771,COST
06079812113350000,2020,436613,0,436613,COST
06079812113350000,2019,436613,0,436613,COST
06079812113370000,2021,870315,0,870315,COST
06079812113370000,2020,437810,0,437810,COST
06079812113370000,2019,437810,0,437810,COST
06079812113400000,2021,677287,0,677287,COST
06079812113400000,2020,561691,0,561691,COST
06079812113400000,2019,561691,0,561691,COST
06079812115010000,2021,174466,236434,410900,INCOME
06079812115010000,2020,368271,25929,394200,INCOME
06079812115010000,2019,81811,211289,293100,MKT
06079812115040000,2021,112091,245209,357300,MKT
06079812115040000,2020,81811,224889,306700,MKT
06079812115040000,2019,81811,224889,306700,MKT
06079812115060000,2021,112091,247709,359800,MKT
06079812115060000,2020,81811,213689,295500,MKT
06079812115060000,2019,81811,213689,295500,MKT
06079812115080000,2021,112091,232509,344600,MKT
06079812115080000,2020,81811,201089,282900,MKT
06079812115080000,2019,81811,201089,282900,MKT
06079812115100000,2021,112091,251509,363600,MKT
06079812115100000,2020,81811,224089,305900,MKT
06079812115100000,2019,81811,224089,305900,MKT
06079812115120000,2021,112091,260409,372500,MKT
06079812115120000,2020,81811,230489,312300,MKT
06079812115120000,2019,81811,230489,312300,MKT
06079812115150000,2021,132005,197795,329800,MKT
06079812115150000,2020,98845,165555,264400,MKT
06079812115150000,2019,98845,165555,264400,MKT
06079812115180000,2021,132005,338695,470700,MKT
06079812115180000,2020,98845,292755,391600,OVR
06079812115180000,2019,98845,292755,391600,MKT
06079812115217000,2021,336644,3740,340384,COST
06079812115217000,2020,511278,3620,514898,COST
06079812115217000,2019,511278,3620,514898,COST
06079812116010000,2021,128383,77290,205673,COST
06079812116010000,2020,95715,77780,173495,COST
06079812116010000,2019,95715,77780,173495,COST
06079812116040000,2021,117334,201666,319000,MKT
06079812116040000,2020,86252,173248,259500,MKT
06079812116040000,2019,86252,173248,259500,MKT
06079812116060000,2021,128383,200517,328900,MKT
06079812116060000,2020,95715,179585,275300,MKT
06079812116060000,2019,95715,179585,275300,MKT
06079812116080000,2021,128383,245117,373500,MKT
06079812116080000,2020,95715,209585,305300,MKT
06079812116080000,2019,95715,209585,305300,MKT
06079812116100000,2021,108385,207215,315600,MKT
06079812116100000,2020,78690,177510,256200,MKT
06079812116100000,2019,78690,177510,256200,MKT
06079812116120000,2021,108385,243415,351800,MKT
06079812116120000,2020,78690,210310,289000,MKT
06079812116120000,2019,78690,210310,289000,MKT
06079812116160000,2021,110261,234939,345200,MKT
06079812116160000,2020,80267,205333,285600,MKT
06079812116160000,2019,80267,205333,285600,MKT
06079812116200000,2021,109703,219997,329700,MKT
06079812116200000,2020,79798,189702,269500,MKT
06079812116200000,2019,79798,189702,269500,MKT
06079812116230000,2021,120644,295056,415700,MKT
06079812116230000,2020,89073,251027,340100,OVR
06079812116230000,2019,89073,251027,340100,MKT
06079812116260000,2021,126589,258211,384800,MKT
06079812116260000,2020,94170,243530,337700,OVR
06079812116260000,2019,94170,243530,337700,MKT
06079812116280000,2021,128383,225217,353600,MKT
06079812116280000,2020,95715,191585,287300,MKT
06079812116280000,2019,95715,191585,287300,MKT
06079812116330000,2021,369169,894670,1263839,COST
06079812116330000,2020,531882,837090,1368972,COST
06079812116330000,2019,531882,837090,1368972,COST
06079812117010000,2021,186705,0,186705,COST
06079812117010000,2020,397178,0,397178,COST
06079812117010000,2019,397178,0,397178,COST
06079812117030000,2021,172369,407231,579600,INCOME
06079812117030000,2020,383815,89385,473200,INCOME
06079812117030000,2019,383815,89385,473200,INCOME
06079812117050000,2021,97073,0,97073,COST
06079812117050000,2020,69270,0,69270,COST
06079812117050000,2019,69270,0,69270,COST
06079812117060000,2021,128383,0,128383,COST
06079812117060000,2020,95715,0,95715,COST
06079812117060000,2019,95715,0,95715,COST
06079812117090000,2021,151190,190410,341600,MKT
06079812117090000,2020,115645,155955,271600,MKT
06079812117090000,2019,115645,155955,271600,MKT
06079812117120000,2021,132005,221395,353400,MKT
06079812117120000,2020,98845,192855,291700,MKT
06079812117120000,2019,98845,192855,291700,MKT
06079812117130000,2021,91222,170078,261300,MKT
06079812117130000,2020,64464,77390,141854,COST
06079812117130000,2019,64464,77390,141854,COST
06079812117170000,2021,120644,260156,380800,MKT
06079812117170000,2020,89073,228227,317300,MKT
06079812117170000,2019,89073,228227,317300,MKT
06079812117200000,2021,122568,261432,384000,MKT
06079812117200000,2020,90718,249882,340600,OVR
06079812117200000,2019,90718,249882,340600,MKT
06079812117230000,2021,128972,270228,399200,MKT
06079812117230000,2020,96223,220477,316700,OVR
06079812117230000,2019,96223,220477,316700,MKT
06079812117260000,2021,148721,306579,455300,MKT
06079812117260000,2020,113463,258437,371900,OVR
06079812117260000,2019,113463,258437,371900,MKT
06079812117300000,2021,303297,490103,793400,INCOME
06079812117300000,2020,488933,131767,620700,INCOME
06079812117300000,2019,488933,131767,620700,INCOME
06079812118010000,2021,227204,290296,517500,INCOME
06079812118010000,2020,408516,84484,493000,INCOME
06079812118010000,2019,408516,84484,493000,INCOME
06079812118060000,2021,343971,346629,690600,INCOME
06079812118060000,2020,487936,112064,600000,OVR
06079812118060000,2019,487936,112064,600000,OVR
06079812118120000,2021,438407,988893,1427300,INCOME
06079812118120000,2020,541371,682629,1224000,INCOME
06079812118120000,2019,541371,682629,1224000,INCOME
06079812118180000,2021,438407,605250,1043657,COST
06079812118180000,2020,151564,541880,693444,COST
06079812118180000,2019,151564,541880,693444,COST
06079812118200000,2021,122647,214853,337500,MKT
06079812118200000,2020,90786,201914,292700,MKT
06079812118200000,2019,90786,201914,292700,MKT
06079812118250000,2021,343971,166530,510501,COST
06079812118250000,2020,487936,121970,609906,COST
06079812118250000,2019,487936,121970,609906,COST
06079812119020000,2021,393927,316573,710500,INCOME
06079812119020000,2020,517121,157479,674600,INCOME
06079812119020000,2019,517121,157479,674600,INCOME
06079812119060000,2021,331639,554861,886500,INCOME
06079812119060000,2020,480364,293436,773800,INCOME
06079812119060000,2019,480364,293436,773800,INCOME
06079812119080000,2021,312212,213788,526000,MKT
06079812119080000,2020,267784,178016,445800,MKT
06079812119080000,2019,267784,178016,445800,MKT
06079812119110000,2021,347184,167716,514900,MKT
06079812119110000,2020,282422,153378,435800,MKT
06079812119110000,2019,282422,153378,435800,MKT
06079812119130000,2021,329472,141928,471400,MKT
06079812119130000,2020,275105,134495,409600,MKT
06079812119130000,2019,275105,134495,409600,MKT
06079812119150000,2021,234307,183490,417797,COST
06079812119150000,2020,413939,124940,538879,COST
06079812119150000,2019,413939,124940,538879,COST
06079812119180000,2021,455939,493461,949400,INCOME
06079812119180000,2020,550541,169559,720100,INCOME
06079812119180000,2019,550541,169559,720100,INCOME
06079812119210000,2021,326892,597008,923900,INCOME
06079812119210000,2020,477406,333794,811200,INCOME
06079812119210000,2019,477406,333794,811200,INCOME
06079812119230000,2021,260202,104898,365100,INCOME
06079812119230000,2020,432950,98990,531940,COST
06079812119230000,2019,432950,98990,531940,COST
06079812119270000,2021,329472,160828,490300,MKT
06079812119270000,2020,275105,133995,409100,MKT
06079812119270000,2019,275105,133995,409100,MKT
06079812119280000,2021,329472,184628,514100,MKT
06079812119280000,2020,275105,160595,435700,MKT
06079812119280000,2019,275105,160595,435700,MKT
06079812119290000,2021,281467,410233,691700,INCOME
06079812119290000,2020,254223,405277,659500,INCOME
06079812119290000,2019,254223,417890,672113,COST
06079812119300000,2021,281467,189633,471100,MKT
06079812119300000,2020,254223,176577,430800,MKT
06079812119300000,2019,254223,176577,430800,MKT
06079812119310000,2021,329472,170128,499600,MKT
06079812119310000,2020,275105,146995,422100,MKT
06079812119310000,2019,275105,131695,406800,MKT
06079812119340000,2021,329472,131828,461300,MKT
06079812119340000,2020,275105,124995,400100,MKT
06079812119340000,2019,275105,124995,400100,MKT
06079812119350000,2021,329472,348510,677982,COST
06079812119350000,2020,275105,185800,460905,COST
06079812119350000,2019,275105,185800,460905,COST
06079812119370000,2021,329472,0,329472,COST
06079812119370000,2020,275105,0,275105,COST
06079812119370000,2019,275105,0,275105,COST
06079812120030000,2021,413066,633030,1046096,COST
06079812120030000,2020,480364,443236,923600,INCOME
06079812120030000,2019,480364,443236,923600,INCOME
06079812120050000,2021,436171,101529,537700,INCOME
06079812120050000,2020,491695,19305,511000,INCOME
06079812120050000,2019,491695,153805,645500,INCOME
06079812120080000,2021,389057,130380,519437,COST
06079812120080000,2020,468198,75110,543308,COST
06079812120080000,2019,468198,75110,543308,COST
06079812120100000,2021,392072,445100,837172,COST
06079812120100000,2020,275105,438582,713687,OVR
06079812120100000,2019,275105,438582,713687,OVR
06079812120110000,2021,324089,109111,433200,INCOME
06079812120110000,2020,400000,55400,455400,INCOME
06079812120110000,2019,400000,55400,455400,INCOME
06079812120120000,2021,324089,169811,493900,INCOME
06079812120120000,2020,432950,85450,518400,INCOME
06079812120120000,2019,432950,85450,518400,INCOME
06079812120140000,2021,324089,275811,599900,INCOME
06079812120140000,2020,432950,109950,542900,INCOME
06079812120140000,2019,432950,109950,542900,INCOME
06079812120160000,2021,324089,303911,628000,INCOME
06079812120160000,2020,432950,143050,576000,INCOME
06079812120160000,2019,432950,143050,576000,INCOME
06079812120180000,2021,139693,576810,716503,COST
06079812120180000,2020,432950,225850,658800,INCOME
06079812120180000,2019,432950,225850,658800,INCOME
06079812120200000,2021,281467,154833,436300,MKT
06079812120200000,2020,254223,110777,365000,MKT
06079812120200000,2019,254223,110777,365000,MKT
06079812120210000,2021,281467,212133,493600,MKT
06079812120210000,2020,254223,183477,437700,MKT
06079812120210000,2019,254223,183477,437700,MKT
06079812120230000,2021,329472,309430,638902,COST
06079812120230000,2020,275105,260595,535700,OVR
06079812120230000,2019,275105,260595,535700,MKT
06079812120250000,2021,329472,122728,452200,MKT
06079812120250000,2020,275105,114295,389400,MKT
06079812120250000,2019,275105,114295,389400,MKT
06079812120280000,2021,411350,158550,569900,MKT
06079812120280000,2020,307481,148619,456100,MKT
06079812120280000,2019,307481,148619,456100,MKT
06079812120300000,2021,329472,189028,518500,MKT
06079812120300000,2020,275105,153795,428900,MKT
06079812120300000,2019,275105,153795,428900,MKT
06079812120310000,2021,281467,329333,610800,MKT
06079812120310000,2020,254223,288777,543000,MKT
06079812120310000,2019,254223,288777,543000,MKT
06079812120320000,2021,329472,176828,506300,MKT
06079812120320000,2020,275105,117895,393000,MKT
06079812120320000,2019,275105,117895,393000,MKT
06079812120330000,2021,281467,118033,399500,MKT
06079812120330000,2020,254223,100377,354600,MKT
06079812120330000,2019,254223,100377,354600,MKT
06079812120340000,2021,291589,360490,652079,COST
06079812120340000,2020,258765,317740,576505,COST
06079812120340000,2019,258765,317740,576505,COST
06079812120350000,2021,364051,150449,514500,MKT
06079812120350000,2020,289218,134782,424000,MKT
06079812120350000,2019,289218,134782,424000,MKT
06079812122010000,2021,148244,244756,393000,MKT
06079812122010000,2020,113042,204158,317200,MKT
06079812122010000,2019,113042,204158,317200,MKT
06079812122080000,2021,112091,262709,374800,MKT
06079812122080000,2020,81811,234289,316100,OVR
06079812122080000,2019,81811,234289,316100,MKT
06079812122100000,2021,112091,534900,646991,COST
06079812122100000,2020,81811,545570,627381,COST
06079812122100000,2019,81811,545570,627381,COST
06079812122110000,2021,194574,201830,396404,COST
06079812122110000,2020,404264,194610,598874,COST
06079812122110000,2019,404264,194610,598874,COST
06079812122150000,2021,213372,408128,621500,INCOME
06079812122150000,2020,420555,186845,607400,INCOME
06079812122150000,2019,420555,186845,607400,INCOME
06079812122180000,2021,213372,253430,466802,COST
06079812122180000,2020,420555,41145,461700,INCOME
06079812122180000,2019,420555,41145,461700,INCOME
06079812123010000,2021,106459,215441,321900,MKT
06079812123010000,2020,77075,196025,273100,OVR
06079812123010000,2019,77075,196025,273100,MKT
06079812123040000,2021,113879,206021,319900,MKT
06079812123040000,2020,83321,179479,262800,MKT
06079812123040000,2019,83321,179479,262800,MKT
06079812123080000,2021,197622,990478,1188100,INCOME
06079812123080000,2020,132254,858646,990900,INCOME
06079812123080000,2019,132254,858646,990900,INCOME
06079812123100000,2021,128383,260117,388500,MKT
06079812123100000,2020,95715,224185,319900,MKT
06079812123100000,2019,95715,224185,319900,MKT
06079812123120000,2021,128383,256617,385000,MKT
06079812123120000,2020,95715,221385,317100,MKT
06079812123120000,2019,95715,221385,317100,MKT
06079812123140000,2021,128383,254317,382700,MKT
06079812123140000,2020,95715,227870,323585,OVR
06079812123140000,2019,95715,227585,323300,MKT
06079812123160000,2021,128383,231217,359600,MKT
06079812123160000,2020,95715,201685,297400,MKT
06079812123160000,2019,95715,201685,297400,MKT
06079812123200000,2021,106459,201141,307600,MKT
06079812123200000,2020,77075,175525,252600,MKT
06079812123200000,2019,77075,175525,252600,MKT
06079812124010000,2021,99920,187380,287300,MKT
06079812124010000,2020,71625,149775,221400,MKT
06079812124010000,2019,71625,149775,221400,MKT
06079812124040000,2021,147041,241159,388200,MKT
06079812124040000,2020,111982,220818,332800,OVR
06079812124040000,2019,111982,220818,332800,MKT
06079812124090000,2021,128383,170817,299200,MKT
06079812124090000,2020,95715,151385,247100,MKT
06079812124090000,2019,95715,151385,247100,MKT
06079812124110000,2021,128383,367817,496200,MKT
06079812124110000,2020,95715,265285,361000,MKT
06079812124110000,2019,95715,265285,361000,MKT
06079812124130000,2021,128383,266017,394400,MKT
06079812124130000,2020,95715,236085,331800,OVR
06079812124130000,2019,95715,236085,331800,MKT
06079812124170000,2021,136037,291763,427800,INCOME
06079812124170000,2020,98845,285455,384300,INCOME
06079812124170000,2019,98845,285455,384300,INCOME
06079812124210000,2021,124602,231898,356500,MKT
06079812124210000,2020,92462,216438,308900,OVR
06079812124210000,2019,92462,216438,308900,MKT
06079812124257000,2021,166554,0,166554,COST
06079812124257000,2020,98476,0,98476,COST
06079812124257000,2019,98476,238850,337326,COST
06079812125010000,2021,339838,246162,586000,INCOME
06079812125010000,2020,485416,27284,512700,INCOME
06079812125010000,2019,485416,27284,512700,INCOME
06079812125090000,2021,348071,244429,592500,INCOME
06079812125090000,2020,490419,102081,592500,INCOME
06079812125090000,2019,490419,102081,592500,INCOME
06079812125140000,2021,376688,181830,558518,COST
06079812125140000,2020,507302,171660,678962,COST
06079812125140000,2019,507302,171660,678962,COST
06079812125170000,2021,91222,198778,290000,MKT
06079812125170000,2020,64464,191736,256200,OVR
06079812125170000,2019,64464,191736,256200,MKT
06079812125200000,2021,93922,184178,278100,MKT
06079812125200000,2020,66676,185524,252200,MKT
06079812125200000,2019,66676,185524,252200,MKT
06079812125220000,2021,105477,195923,301400,MKT
06079812125220000,2020,76252,189148,265400,MKT
06079812125220000,2019,76252,189148,265400,MKT
06079812126010000,2021,286048,142252,428300,MKT
06079812126010000,2020,256289,129411,385700,MKT
06079812126010000,2019,256289,129411,385700,MKT
06079812126060000,2021,220806,214494,435300,MKT
06079812126060000,2020,225098,173502,398600,MKT
06079812126060000,2019,225098,173502,398600,MKT
06079812126100000,2021,447567,271430,718997,COST
06079812126100000,2020,320766,242000,562766,COST
06079812126100000,2019,320766,242000,562766,COST
06079812126120000,2021,338390,130710,469100,MKT
06079812126120000,2020,278813,125587,404400,MKT
06079812126120000,2019,278813,125587,404400,MKT
06079812126150000,2021,338390,158810,497200,MKT
06079812126150000,2020,278813,131387,410200,MKT
06079812126150000,2019,278813,131387,410200,MKT
06079812126180000,2021,271035,222365,493400,MKT
06079812126180000,2020,249456,189744,439200,MKT
06079812126180000,2019,249456,189744,439200,MKT
06079812126200000,2021,214930,266370,481300,INCOME
06079812126200000,2020,398912,63088,462000,INCOME
06079812126200000,2019,398912,63088,462000,INCOME
06079812126220000,2021,396104,267210,663314,COST
06079812126220000,2020,301714,234300,536014,COST
06079812126220000,2019,301714,234300,536014,COST
06079812126250000,2021,321338,298162,619500,MKT
06079812126250000,2020,271679,217421,489100,MKT
06079812126250000,2019,271679,217421,489100,MKT
06079812126300000,2021,239971,346729,586700,INCOME
06079812126300000,2020,418196,190804,609000,INCOME
06079812126300000,2019,418196,190804,609000,INCOME
06079812126350000,2021,267909,93340,361249,COST
06079812126350000,2020,438398,88420,526818,COST
06079812126350000,2019,438398,88420,526818,COST
06079812126400000,2021,275470,418330,693800,INCOME
06079812126400000,2020,443656,75544,519200,INCOME
06079812126400000,2019,443656,75544,519200,INCOME
06079812126420000,2021,226699,189101,415800,MKT
06079812126420000,2020,228090,170710,398800,MKT
06079812126420000,2019,228090,170710,398800,MKT
06079812126450000,2021,226768,97400,324168,COST
06079812126450000,2020,408180,93940,502120,COST
06079812126450000,2019,408180,93940,502120,COST
06079812126500000,2021,210612,333288,543900,INCOME
06079812126500000,2020,300000,55800,355800,INCOME
06079812126500000,2019,300000,55800,355800,INCOME
06079812127010000,2021,240904,117196,358100,MKT
06079812127010000,2020,235145,115355,350500,MKT
06079812127010000,2019,235145,115355,350500,MKT
06079812127040000,2021,319690,84110,403800,MKT
06079812127040000,2020,270980,70420,341400,MKT
06079812127040000,2019,270980,70420,341400,MKT
06079812127060000,2021,297244,142756,440000,MKT
06079812127060000,2020,261269,150931,412200,MKT
06079812127060000,2019,261269,150931,412200,MKT
06079812127080000,2021,271089,99511,370600,MKT
06079812127080000,2020,249481,61819,311300,MKT
06079812127080000,2019,249481,61819,311300,MKT
06079812127095002,2021,235713,128570,364283,COST
06079812127095002,2020,78579,160821,239400,MKT
06079812127095002,2019,78579,160821,239400,MKT
06079812127100000,2021,296492,140808,437300,MKT
06079812127100000,2020,260937,148663,409600,MKT
06079812127100000,2019,260937,148663,409600,MKT
06079812127115001,2021,235713,128570,364283,COST
06079812127115001,2020,78579,160821,239400,MKT
06079812127115001,2019,78579,160821,239400,MKT
06079812127120000,2021,358852,559920,918772,COST
06079812127120000,2020,287140,507070,794210,OVR
06079812127120000,2019,287140,507070,794210,COST
06079812127140000,2021,274049,532180,806229,COST
06079812127140000,2020,250842,140158,391000,MKT
06079812127140000,2019,250842,140158,391000,MKT
06079812127160000,2021,274049,147051,421100,MKT
06079812127160000,2020,250842,135558,386400,MKT
06079812127160000,2019,250842,135558,386400,MKT
06079812127180000,2021,309654,402246,711900,MKT
06079812127180000,2020,266681,356019,622700,OVR
06079812127180000,2019,266681,356019,622700,MKT
06079812127200000,2021,280417,184683,465100,MKT
06079812127200000,2020,253747,144053,397800,MKT
06079812127200000,2019,253747,144053,397800,MKT
06079812127220000,2021,281467,140333,421800,MKT
06079812127220000,2020,254223,130677,384900,MKT
06079812127220000,2019,254223,130677,384900,MKT
06079812127240000,2021,271035,135765,406800,MKT
06079812127240000,2020,249456,105144,354600,MKT
06079812127240000,2019,249456,86044,335500,MKT
06079812127260000,2021,302811,166089,468900,MKT
06079812127260000,2020,263711,158789,422500,MKT
06079812127260000,2019,263711,158789,422500,MKT
06079812127280000,2021,267993,185507,453500,MKT
06079812127280000,2020,248048,169252,417300,MKT
06079812127280000,2019,248048,169252,417300,MKT
06079812127300000,2021,267993,187907,455900,MKT
06079812127300000,2020,248048,157552,405600,MKT
06079812127300000,2019,248048,157552,405600,MKT
06079812127320000,2021,242538,275170,517708,COST
06079812127320000,2020,235944,195256,431200,MKT
06079812127320000,2019,235944,195256,431200,MKT
06079812127340000,2021,291589,123811,415400,MKT
06079812127340000,2020,258765,124735,383500,MKT
06079812127340000,2019,258765,124735,383500,MKT
06079812127360000,2021,222753,167547,390300,MKT
06079812127360000,2020,226091,149809,375900,MKT
06079812127360000,2019,226091,149809,375900,MKT
06079812129010000,2021,143436,272164,415600,MKT
06079812129010000,2020,108812,223988,332800,OVR
06079812129010000,2019,108812,230788,339600,MKT
06079812129030000,2021,130343,307957,438300,MKT
06079812129030000,2020,97407,243893,341300,MKT
06079812129030000,2019,97407,243893,341300,MKT
06079812129050000,2021,131099,325701,456800,MKT
06079812129050000,2020,98061,258139,356200,MKT
06079812129050000,2019,98061,276139,374200,MKT
06079812129070000,2021,138145,400855,539000,MKT
06079812129070000,2020,104183,327717,431900,OVR
06079812129070000,2019,104183,327717,431900,MKT
06079812129090000,2021,345671,57329,403000,INCOME
06079812129090000,2020,106113,245187,351300,INCOME
06079812129090000,2019,106113,245187,351300,INCOME
06079812129110000,2021,140355,315545,455900,MKT
06079812129110000,2020,106113,297987,404100,OVR
06079812129110000,2019,106113,297987,404100,MKT
06079812129130000,2021,140407,335693,476100,MKT
06079812129130000,2020,106159,294641,400800,OVR
06079812129130000,2019,106159,294641,400800,MKT
06079812129150000,2021,407577,99823,507400,INCOME
06079812129150000,2020,120658,322542,443200,INCOME
06079812129150000,2019,120658,322542,443200,INCOME
06079812130010000,2021,450203,72797,523000,INCOME
06079812130010000,2020,130388,367312,497700,INCOME
06079812130010000,2019,130388,367312,497700,INCOME
06079812130070000,2021,352635,72765,425400,INCOME
06079812130070000,2020,107776,272324,380100,INCOME
06079812130070000,2019,107776,272324,380100,INCOME
06079812130090000,2021,149066,221334,370400,MKT
06079812130090000,2020,113767,192633,306400,MKT
06079812130090000,2019,113767,192633,306400,MKT
06079812130110000,2021,153049,204751,357800,MKT
06079812130110000,2020,117291,166209,283500,MKT
06079812130110000,2019,117291,166209,283500,MKT
06079812130130000,2021,138145,363955,502100,MKT
06079812130130000,2020,104183,312017,416200,MKT
06079812130130000,2019,104183,306117,410300,MKT
06079812130150000,2021,143787,347013,490800,MKT
06079812130150000,2020,109120,275180,384300,OVR
06079812130150000,2019,109120,275180,384300,MKT
06079812130170000,2021,149066,243134,392200,MKT
06079812130170000,2020,113767,204833,318600,MKT
06079812130170000,2019,113767,204833,318600,MKT
06079812130180000,2021,167437,284563,452000,INCOME
06079812130180000,2020,130137,290963,421100,INCOME
06079812130180000,2019,130137,290963,421100,INCOME
06079812131010000,2021,185549,314551,500100,INCOME
06079812131010000,2020,125911,330089,456000,INCOME
06079812131010000,2019,125911,330089,456000,INCOME
06079812131037000,2021,218290,0,218290,COST
06079812131037000,2020,160301,0,160301,COST
06079812131037000,2019,160301,0,160301,COST
06079812131070000,2021,138178,238022,376200,INCOME
06079812131070000,2020,104212,253188,357400,INCOME
06079812131070000,2019,104212,253188,357400,INCOME
06079812131100000,2021,462433,313660,776093,COST
06079812131100000,2020,585762,292910,878672,COST
06079812131100000,2019,585762,292910,878672,COST
06079812131120000,2021,153771,272929,426700,MKT
06079812131120000,2020,117931,231169,349100,MKT
06079812131120000,2019,117931,231169,349100,MKT
06079812131140000,2021,159555,354245,513800,MKT
06079812131140000,2020,123077,293823,416900,MKT
06079812131140000,2019,123077,297923,421000,MKT
06079812131160000,2021,186867,313233,500100,INCOME
06079812131160000,2020,126608,329392,456000,INCOME
06079812131160000,2019,126608,329392,456000,INCOME
06079812132010000,2021,355240,350010,705250,COST
06079812132010000,2020,494721,339410,834131,COST
06079812132010000,2019,494721,339410,834131,COST
06079812132020000,2021,550887,812213,1363100,INCOME
06079812132020000,2020,597013,810887,1407900,INCOME
06079812132020000,2019,597013,810887,1407900,INCOME
06079812132040000,2021,652696,44430,697126,COST
06079812132040000,2020,641998,43740,685738,COST
06079812132040000,2019,641998,43740,685738,COST
06079812132080000,2021,331250,8790,340040,COST
06079812132080000,2020,480123,8510,488633,COST
06079812132080000,2019,480123,8510,488633,COST
06079812133010000,2021,655434,1415410,2070844,COST
06079812133010000,2020,643150,1374100,2017250,COST
06079812133010000,2019,643150,1631140,2274290,COST
06079812133040000,2021,425788,156012,581800,INCOME
06079812133040000,2020,312844,243556,556400,INCOME
06079812133040000,2019,312844,243556,556400,INCOME
06079812133080000,2021,327232,488400,815632,COST
06079812133080000,2020,477619,620981,1098600,INCOME
06079812133080000,2019,477619,620981,1098600,INCOME
06079812133150000,2021,1049295,1700005,2749300,INCOME
06079812133150000,2020,786792,1530070,2316862,COST
06079812133150000,2019,786792,1530070,2316862,COST
06079812134010000,2021,345263,299937,645200,MKT
06079812134010000,2020,281637,257263,538900,MKT
06079812134010000,2019,281637,257263,538900,MKT
06079812134030000,2021,386607,191093,577700,MKT
06079812134030000,2020,298066,165734,463800,MKT
06079812134030000,2019,298066,165734,463800,MKT
06079812134050000,2021,386607,218493,605100,MKT
06079812134050000,2020,298066,182434,480500,MKT
06079812134050000,2019,298066,182434,480500,MKT
06079812134060000,2021,292300,147600,439900,MKT
06079812134060000,2020,259082,141518,400600,MKT
06079812134060000,2019,259082,141518,400600,MKT
06079812134070000,2021,326239,157161,483400,MKT
06079812134070000,2020,273748,136152,409900,MKT
06079812134070000,2019,273748,136152,409900,MKT
06079812134100000,2021,489617,101883,591500,INCOME
06079812134100000,2020,332416,179184,511600,INCOME
06079812134100000,2019,332416,179184,511600,INCOME
06079812134120000,2021,369357,217743,587100,MKT
06079812134120000,2020,291324,193476,484800,MKT
06079812134120000,2019,291324,193476,484800,MKT
06079812134140000,2021,357478,140522,498000,MKT
06079812134140000,2020,286589,120911,407500,MKT
06079812134140000,2019,286589,120911,407500,MKT
06079812134160000,2021,350956,190244,541200,MKT
06079812134160000,2020,283956,177444,461400,MKT
06079812134160000,2019,283956,177444,461400,MKT
06079812134200000,2021,518589,590400,1108989,COST
06079812134200000,2020,615238,562900,1178138,COST
06079812134200000,2019,615238,562900,1178138,COST
06079812134220000,2021,309654,216846,526500,MKT
06079812134220000,2020,266681,199919,466600,OVR
06079812134220000,2019,266681,199919,466600,MKT
06079812134260000,2021,348789,163311,512100,MKT
06079812134260000,2020,283075,134225,417300,MKT
06079812134260000,2019,283075,134225,417300,MKT
06079812134280000,2021,321573,183627,505200,MKT
06079812134280000,2020,271778,163722,435500,MKT
06079812134280000,2019,271778,163722,435500,MKT
06079812134300000,2021,375106,216994,592100,INCOME
06079812134300000,2020,294183,227817,522000,INCOME
06079812134300000,2019,294183,227817,522000,INCOME
06079812134310000,2021,310863,187337,498200,MKT
06079812134310000,2020,267203,197197,464400,MKT
06079812134310000,2019,267203,197197,464400,MKT
06079812134320000,2021,296090,115310,411400,MKT
06079812134320000,2020,260760,86940,347700,MKT
06079812134320000,2019,260760,86940,347700,MKT
06079812136010000,2021,146573,249727,396300,INCOME
06079812136010000,2020,104766,252634,357400,INCOME
06079812136010000,2019,104766,252634,357400,INCOME
06079812136030000,2021,138628,231672,370300,MKT
06079812136030000,2020,104604,206396,311000,MKT
06079812136030000,2019,104604,206396,311000,MKT
06079812136050000,2021,137659,307341,445000,MKT
06079812136050000,2020,103759,254641,358400,MKT
06079812136050000,2019,103759,254641,358400,MKT
06079812136070000,2021,137171,215529,352700,MKT
06079812136070000,2020,103334,188666,292000,MKT
06079812136070000,2019,103334,188666,292000,MKT
06079812136090000,2021,136187,274513,410700,MKT
06079812136090000,2020,102476,234624,337100,MKT
06079812136090000,2019,102476,234624,337100,MKT
06079812136110000,2021,135192,216708,351900,MKT
06079812136110000,2020,101611,184789,286400,MKT
06079812136110000,2019,101611,184789,286400,MKT
06079812136130000,2021,134690,329410,464100,MKT
06079812136130000,2020,101175,226850,328025,COST
06079812136130000,2019,101175,247325,348500,MKT
06079812136150000,2021,133169,205531,338700,MKT
06079812136150000,2020,99854,170946,270800,MKT
06079812136150000,2019,99854,170946,270800,MKT
06079812136170000,2021,132656,263544,396200,MKT
06079812136170000,2020,99409,227291,326700,MKT
06079812136170000,2019,99409,227291,326700,MKT
06079812136190000,2021,131621,254379,386000,MKT
06079812136190000,2020,98513,214887,313400,MKT
06079812136190000,2019,98513,214887,313400,MKT
06079812136210000,2021,130574,310026,440600,MKT
06079812136210000,2020,97607,250193,347800,MKT
06079812136210000,2019,97607,250193,347800,MKT
06079812136230000,2021,142357,293243,435600,MKT
06079812136230000,2020,107866,254134,362000,MKT
06079812136230000,2019,107866,254134,362000,MKT
06079812136250000,2021,141873,323127,465000,MKT
06079812136250000,2020,107442,301758,409200,OVR
06079812136250000,2019,107442,301758,409200,MKT
06079812136270000,2021,139587,214913,354500,MKT
06079812136270000,2020,105442,189058,294500,MKT
06079812136270000,2019,105442,189058,294500,MKT
06079812136290000,2021,139587,261413,401000,MKT
06079812136290000,2020,105442,243458,348900,MKT
06079812136290000,2019,105442,243458,348900,MKT
06079812136310000,2021,139587,258313,397900,MKT
06079812136310000,2020,105442,225958,331400,MKT
06079812136310000,2019,105442,225958,331400,MKT
06079812136330000,2021,139587,248213,387800,MKT
06079812136330000,2020,105442,220158,325600,MKT
06079812136330000,2019,105442,220158,325600,MKT
06079812136350000,2021,139587,236713,376300,MKT
06079812136350000,2020,105442,218858,324300,MKT
06079812136350000,2019,105442,218858,324300,MKT
06079812136370000,2021,139587,341113,480700,MKT
06079812136370000,2020,105442,285558,391000,MKT
06079812136370000,2019,105442,285558,391000,MKT
06079812136390000,2021,139587,272013,411600,MKT
06079812136390000,2020,105442,221558,327000,MKT
06079812136390000,2019,105442,221558,327000,MKT
06079812136410000,2021,139587,327313,466900,MKT
06079812136410000,2020,105442,276158,381600,MKT
06079812136410000,2019,105442,276158,381600,MKT
06079812136430000,2021,139587,328913,468500,MKT
06079812136430000,2020,105442,270658,376100,MKT
06079812136430000,2019,105442,270658,376100,MKT
06079812136450000,2021,139587,308813,448400,MKT
06079812136450000,2020,105442,292458,397900,OVR
06079812136450000,2019,105442,292458,397900,MKT
06079812136470000,2021,150197,269303,419500,INCOME
06079812136470000,2020,106780,266520,373300,INCOME
06079812136470000,2019,106780,266520,373300,INCOME
06079812137010000,2021,153494,332606,486100,INCOME
06079812137010000,2020,108603,261697,370300,INCOME
06079812137010000,2019,108603,261697,370300,INCOME
06079812137030000,2021,141509,248091,389600,MKT
06079812137030000,2020,107123,217477,324600,MKT
06079812137030000,2019,107123,217477,324600,MKT
06079812137050000,2021,141509,249891,391400,MKT
06079812137050000,2020,107123,222877,330000,MKT
06079812137050000,2019,107123,222877,330000,MKT
06079812137070000,2021,141509,272391,413900,MKT
06079812137070000,2020,107123,243177,350300,OVR
06079812137070000,2019,107123,243177,350300,MKT
06079812137090000,2021,141509,254491,396000,MKT
06079812137090000,2020,107123,219477,326600,MKT
06079812137090000,2019,107123,219477,326600,MKT
06079812137110000,2021,141509,319691,461200,MKT
06079812137110000,2020,107123,278877,386000,MKT
06079812137110000,2019,107123,278877,386000,MKT
06079812137130000,2021,141509,345691,487200,MKT
06079812137130000,2020,107123,304977,412100,OVR
06079812137130000,2019,107123,304977,412100,MKT
06079812137150000,2021,141509,354191,495700,MKT
06079812137150000,2020,107123,271377,378500,MKT
06079812137150000,2019,107123,271377,378500,MKT
06079812137170000,2021,141509,314391,455900,MKT
06079812137170000,2020,107123,249977,357100,MKT
06079812137170000,2019,107123,239877,347000,MKT
06079812137190000,2021,141509,250291,391800,MKT
06079812137190000,2020,107123,218677,325800,MKT
06079812137190000,2019,107123,218677,325800,MKT
06079812137210000,2021,141509,264491,406000,MKT
06079812137210000,2020,107123,224777,331900,MKT
06079812137210000,2019,107123,222577,329700,MKT
06079812137230000,2021,141509,263391,404900,MKT
06079812137230000,2020,107123,225077,332200,MKT
06079812137230000,2019,107123,225077,332200,MKT
06079812137250000,2021,141509,280791,422300,MKT
06079812137250000,2020,107123,243077,350200,MKT
06079812137250000,2019,107123,243077,350200,MKT
06079812137270000,2021,134179,309821,444000,MKT
06079812137270000,2020,100731,245569,346300,MKT
06079812137270000,2019,100731,245569,346300,MKT
06079812137290000,2021,131077,262923,394000,MKT
06079812137290000,2020,98042,219558,317600,MKT
06079812137290000,2019,98042,219558,317600,MKT
06079812137310000,2021,131077,262923,394000,MKT
06079812137310000,2020,98042,235158,333200,MKT
06079812137310000,2019,98042,235158,333200,MKT
06079812137330000,2021,131077,233823,364900,MKT
06079812137330000,2020,98042,207958,306000,OVR
06079812137330000,2019,98042,207958,306000,MKT
06079812137350000,2021,143593,334607,478200,MKT
06079812137350000,2020,108950,278450,387400,MKT
06079812137350000,2019,108950,278450,387400,MKT
06079812137370000,2021,143593,329107,472700,MKT
06079812137370000,2020,108950,265250,374200,MKT
06079812137370000,2019,108950,265250,374200,MKT
06079812137390000,2021,154054,315846,469900,MKT
06079812137390000,2020,118182,249518,367700,OVR
06079812137390000,2019,118182,249518,367700,MKT
06079812137410000,2021,131077,278923,410000,MKT
06079812137410000,2020,98042,229058,327100,MKT
06079812137410000,2019,98042,229058,327100,MKT
06079812137430000,2021,131077,228023,359100,MKT
06079812137430000,2020,98042,198358,296400,MKT
06079812137430000,2019,98042,198358,296400,MKT
06079812137450000,2021,131077,272623,403700,MKT
06079812137450000,2020,98042,236058,334100,OVR
06079812137450000,2019,98042,236058,334100,MKT
06079812137470000,2021,131077,270923,402000,MKT
06079812137470000,2020,98042,219258,317300,MKT
06079812137470000,2019,98042,219258,317300,MKT
06079812137490000,2021,131077,320123,451200,MKT
06079812137490000,2020,98042,266258,364300,MKT
06079812137490000,2019,98042,266258,364300,MKT
06079812138010000,2021,147041,341759,488800,MKT
06079812138010000,2020,111982,297718,409700,OVR
06079812138010000,2019,111982,297718,409700,MKT
06079812138030000,2021,155516,179784,335300,INCOME
06079812138030000,2020,109717,187683,297400,INCOME
06079812138030000,2019,109717,187683,297400,INCOME
06079812138050000,2021,144467,242133,386600,MKT
06079812138050000,2020,109717,212083,321800,MKT
06079812138050000,2019,109717,212083,321800,MKT
06079812138070000,2021,144467,269833,414300,MKT
06079812138070000,2020,109717,229783,339500,MKT
06079812138070000,2019,109717,229783,339500,MKT
06079812138090000,2021,144467,283733,428200,MKT
06079812138090000,2020,109717,246683,356400,MKT
06079812138090000,2019,109717,246683,356400,MKT
06079812138110000,2021,144467,275233,419700,MKT
06079812138110000,2020,109717,224383,334100,MKT
06079812138110000,2019,109717,224383,334100,MKT
06079812138130000,2021,144467,236133,380600,MKT
06079812138130000,2020,109717,216983,326700,MKT
06079812138130000,2019,109717,216983,326700,MKT
06079812138150000,2021,144467,239933,384400,MKT
06079812138150000,2020,109717,213683,323400,MKT
06079812138150000,2019,109717,213683,323400,MKT
06079812138170000,2021,144467,286333,430800,MKT
06079812138170000,2020,109717,247183,356900,OVR
06079812138170000,2019,109717,247183,356900,MKT
06079812138190000,2021,144467,246533,391000,MKT
06079812138190000,2020,109717,210583,320300,MKT
06079812138190000,2019,109717,210583,320300,MKT
06079812138210000,2021,144467,239133,383600,MKT
06079812138210000,2020,109717,205383,315100,MKT
06079812138210000,2019,109717,205383,315100,MKT
06079812138230000,2021,144467,252033,396500,MKT
06079812138230000,2020,109717,214483,324200,MKT
06079812138230000,2019,109717,214483,324200,MKT
06079812138250000,2021,140018,278182,418200,MKT
06079812138250000,2020,105818,248282,354100,OVR
06079812138250000,2019,105818,248282,354100,MKT
06079812138270000,2021,627486,1000614,1628100,INCOME
06079812138270000,2020,667582,805718,1473300,INCOME
06079812138270000,2019,667582,805718,1473300,INCOME
06079812138277000,2021,1125357,50890,1176247,COST
06079812138277000,2020,974308,49670,1023978,COST
06079812138277000,2019,974308,49670,1023978,COST
06079812138310000,2021,975191,1390809,2366000,INCOME
06079812138310000,2020,762490,1165610,1928100,INCOME
06079812138310000,2019,762490,1165610,1928100,INCOME
06079812138390000,2021,795000,1114600,1909600,INCOME
06079812138390000,2020,698597,1032403,1731000,INCOME
06079812138390000,2019,699640,1031360,1731000,INCOME
06079812138430000,2021,443632,422568,866200,INCOME
06079812138430000,2020,544125,172175,716300,INCOME
06079812138430000,2019,544125,172175,716300,INCOME
06079812138440000,2021,682859,255241,938100,INCOME
06079812138440000,2020,654543,140657,795200,INCOME
06079812138440000,2019,654543,140657,795200,INCOME
06079812138450000,2021,307241,444059,751300,INCOME
06079812138450000,2020,464894,97306,562200,INCOME
06079812138450000,2019,464894,97306,562200,INCOME
06079812138460000,2021,369830,165070,534900,COST
06079812138460000,2020,503325,166610,669935,COST
06079812138460000,2019,503325,166610,669935,COST
06079812138470000,2021,256410,0,256410,COST
06079812138470000,2020,430236,0,430236,COST
06079812138470000,2019,430236,0,430236,COST
06079812140010000,2021,329949,304851,634800,INCOME
06079812140010000,2020,479313,95887,575200,INCOME
06079812140010000,2019,479313,95887,575200,INCOME
06079812140050000,2021,415769,334790,750559,COST
06079812140050000,2020,529214,292690,821904,COST
06079812140050000,2019,529214,292690,821904,COST
06079812140060000,2021,210475,220325,430800,INCOME
06079812140060000,2020,395348,70252,465600,INCOME
06079812140060000,2019,395348,70252,465600,INCOME
06079812140070000,2021,210475,330325,540800,INCOME
06079812140070000,2020,395348,138590,533938,COST
06079812140070000,2019,395348,138590,533938,COST
06079812140080000,2021,234733,363267,598000,INCOME
06079812140080000,2020,414261,95290,509551,COST
06079812140080000,2019,414261,95290,509551,COST
06079812140090000,2021,184170,309630,493800,INCOME
06079812140090000,2020,373372,73600,446972,COST
06079812140090000,2019,373372,73600,446972,COST
06079812140120000,2021,381316,311484,692800,INCOME
06079812140120000,2020,509962,115750,625712,COST
06079812140120000,2019,509962,115750,625712,COST
06079812140150000,2021,116211,0,116211,COST
06079812140150000,2020,90420,0,90420,COST
06079812140150000,2019,90420,0,90420,COST
06079812140160000,2021,305382,179818,485200,MKT
06079812140160000,2020,233882,222818,456700,OVR
06079812140160000,2019,233882,222818,456700,MKT
06079812140170000,2021,305382,176218,481600,MKT
06079812140170000,2020,233882,184118,418000,MKT
06079812140170000,2019,233882,184118,418000,MKT
06079812140180000,2021,348478,240422,588900,MKT
06079812140180000,2020,249883,225917,475800,MKT
06079812140180000,2019,249883,225917,475800,MKT
06079812140190000,2021,348478,161822,510300,MKT
06079812140190000,2020,249883,170117,420000,MKT
06079812140190000,2019,249883,170117,420000,MKT
06079812141010000,2021,320492,212008,532500,MKT
06079812141010000,2020,239613,223487,463100,MKT
06079812141010000,2019,239613,223487,463100,MKT
06079812141020000,2021,347734,191566,539300,MKT
06079812141020000,2020,249615,210785,460400,MKT
06079812141020000,2019,249615,210785,460400,MKT
06079812141030000,2021,354773,146127,500900,MKT
06079812141030000,2020,252135,151665,403800,MKT
06079812141030000,2019,252135,151665,403800,MKT
06079812141040000,2021,351440,135960,487400,MKT
06079812141040000,2020,250945,148255,399200,MKT
06079812141040000,2019,250945,148255,399200,MKT
06079812141060000,2021,431976,134624,566600,MKT
06079812141060000,2020,278290,164310,442600,MKT
06079812141060000,2019,278290,164310,442600,MKT
06079812141080000,2021,209213,0,209213,COST
06079812141080000,2020,394331,0,394331,COST
06079812141080000,2019,394331,0,394331,COST
06079812141100000,2021,598890,0,598890,COST
06079812141100000,2020,618767,0,618767,COST
06079812141100000,2019,618767,0,618767,COST
06079812141300000,2021,985931,0,985931,COST
06079812141300000,2020,766075,0,766075,COST
06079812141300000,2019,766075,0,766075,COST
06079812141320000,2021,423612,12488,436100,INCOME
06079812141320000,2020,275576,123924,399500,INCOME
06079812141320000,2019,275576,123924,399500,INCOME
06079812141340000,2021,340222,150178,490400,MKT
06079812141340000,2020,246897,168603,415500,MKT
06079812141340000,2019,246897,168603,415500,MKT
06079812141360000,2021,340222,177378,517600,MKT
06079812141360000,2020,246897,201503,448400,MKT
06079812141360000,2019,246897,201503,448400,MKT
06079812141380000,2021,340222,156578,496800,MKT
06079812141380000,2020,246897,167003,413900,MKT
06079812141380000,2019,246897,167003,413900,MKT
06079812141400000,2021,308409,166191,474600,MKT
06079812141400000,2020,235041,170259,405300,MKT
06079812141400000,2019,235041,170259,405300,MKT
06079812142010000,2021,307943,218357,526300,MKT
06079812142010000,2020,234863,278437,513300,OVR
06079812142010000,2019,234863,278437,513300,MKT
06079812142020000,2021,302469,225031,527500,MKT
06079812142020000,2020,232761,200239,433000,MKT
06079812142020000,2019,232761,200239,433000,MKT
06079812142040000,2021,330763,125037,455800,MKT
06079812142040000,2020,243432,122468,365900,MKT
06079812142040000,2019,243432,122468,365900,MKT
06079812142050000,2021,310867,142033,452900,MKT
06079812142050000,2020,235978,164922,400900,OVR
06079812142050000,2019,235978,164922,400900,MKT
06079812142070000,2021,388121,233879,622000,MKT
06079812142070000,2020,263750,196750,460500,MKT
06079812142070000,2019,263750,196750,460500,MKT
06079812142090000,2021,388121,135879,524000,MKT
06079812142090000,2020,263750,150750,414500,MKT
06079812142090000,2019,263750,150750,414500,MKT
06079812142110000,2021,388121,160279,548400,MKT
06079812142110000,2020,263750,173050,436800,MKT
06079812142110000,2019,263750,173050,436800,MKT
06079812142130000,2021,388121,125879,514000,MKT
06079812142130000,2020,263750,135550,399300,MKT
06079812142130000,2019,263750,135550,399300,MKT
06079812142150000,2021,388121,136879,525000,MKT
06079812142150000,2020,263750,155550,419300,MKT
06079812142150000,2019,263750,155550,419300,MKT
06079812142170000,2021,343494,127806,471300,MKT
06079812142170000,2020,248085,104715,352800,MKT
06079812142170000,2019,248085,104715,352800,MKT
06079812142190000,2021,358879,281921,640800,MKT
06079812142190000,2020,253594,260406,514000,MKT
06079812142190000,2019,253594,260406,514000,MKT
06079812142200000,2021,310867,103633,414500,MKT
06079812142200000,2020,235978,107322,343300,MKT
06079812142200000,2019,235978,107322,343300,MKT
06079812142210000,2021,310867,131433,442300,MKT
06079812142210000,2020,235978,131422,367400,MKT
06079812142210000,2019,235978,131422,367400,MKT
06079812142230000,2021,343494,165106,508600,MKT
06079812142230000,2020,248085,164115,412200,MKT
06079812142230000,2019,248085,164115,412200,MKT
06079812142250000,2021,358879,152321,511200,MKT
06079812142250000,2020,253594,171006,424600,MKT
06079812142250000,2019,253594,171006,424600,MKT
06079812142270000,2021,385280,220820,606100,MKT
06079812142270000,2020,262780,199920,462700,MKT
06079812142270000,2019,262780,199920,462700,MKT
06079812143010000,2021,302608,130992,433600,MKT
06079812143010000,2020,232815,132785,365600,MKT
06079812143010000,2019,232815,132785,365600,MKT
06079812143030000,2021,440209,117691,557900,MKT
06079812143030000,2020,280936,163464,444400,MKT
06079812143030000,2019,280936,160864,441800,MKT
06079812143040000,2021,301214,133886,435100,MKT
06079812143040000,2020,232276,118324,350600,MKT
06079812143040000,2019,232276,118324,350600,MKT
06079812143060000,2021,341836,436380,778216,COST
06079812143060000,2020,247484,379190,626674,COST
06079812143060000,2019,247484,379190,626674,COST
06079812143080000,2021,337280,104920,442200,MKT
06079812143080000,2020,245825,110875,356700,MKT
06079812143080000,2019,245825,110875,356700,MKT
06079812143100000,2021,298408,132492,430900,MKT
06079812143100000,2020,231189,132011,363200,MKT
06079812143100000,2019,231189,132011,363200,MKT
06079812143120000,2021,314390,156110,470500,MKT
06079812143120000,2020,237315,110885,348200,MKT
06079812143120000,2019,237315,110885,348200,MKT
06079812143140000,2021,370804,192796,563600,MKT
06079812143140000,2020,257784,198216,456000,MKT
06079812143140000,2019,257784,198216,456000,MKT
06079812143167000,2021,388215,830,389045,COST
06079812143167000,2020,139944,810,140754,COST
06079812143167000,2019,139944,810,140754,COST
06079812143180000,2021,386607,218093,604700,MKT
06079812143180000,2020,298066,177834,475900,OVR
06079812143180000,2019,298066,177834,475900,MKT
06079812143190000,2021,315660,193440,509100,MKT
06079812143190000,2020,269262,166238,435500,MKT
06079812143190000,2019,269262,166238,435500,MKT
06079812143200000,2021,308684,265416,574100,MKT
06079812143200000,2020,266262,179338,445600,MKT
06079812143200000,2019,266262,179338,445600,MKT
06079812143210000,2021,286926,76974,363900,MKT
06079812143210000,2020,256683,58717,315400,MKT
06079812143210000,2019,256683,58717,315400,MKT
06079812143220000,2021,348789,198511,547300,MKT
06079812143220000,2020,283075,150525,433600,MKT
06079812143220000,2019,283075,150525,433600,MKT
06079812143230000,2021,481171,6429,487600,INCOME
06079812143230000,2020,332620,131780,464400,INCOME
06079812143230000,2019,332620,131780,464400,INCOME
06079812143250000,2021,308684,111716,420400,MKT
06079812143250000,2020,266262,93638,359900,MKT
06079812143250000,2019,266262,93638,359900,MKT
06079812143260000,2021,465139,43661,508800,MKT
06079812143260000,2020,327018,85282,412300,MKT
06079812143260000,2019,327018,85282,412300,MKT
06079812143290000,2021,394402,171798,566200,MKT
06079812143290000,2020,301064,155436,456500,MKT
06079812143290000,2019,301064,155436,456500,MKT
06079812143310000,2021,394402,178398,572800,MKT
06079812143310000,2020,301064,160636,461700,MKT
06079812143310000,2019,301064,160636,461700,MKT
06079812143330000,2021,269056,280844,549900,MKT
06079812143330000,2020,248541,251359,499900,MKT
06079812143330000,2019,248541,251359,499900,MKT
06079812143350000,2021,312669,121031,433700,MKT
06079812143350000,2020,267980,103020,371000,MKT
06079812143350000,2019,267980,103020,371000,MKT
06079812143370000,2021,360478,182522,543000,MKT
06079812143370000,2020,287792,149908,437700,MKT
06079812143370000,2019,287792,149908,437700,MKT
06079812143390000,2021,362994,128706,491700,MKT
06079812143390000,2020,255047,110953,366000,MKT
06079812143390000,2019,255047,110953,366000,MKT
06079812143410000,2021,337433,146767,484200,MKT
06079812143410000,2020,245880,160220,406100,OVR
06079812143410000,2019,245880,160220,406100,MKT
06079812143430000,2021,331228,174772,506000,MKT
06079812143430000,2020,243604,199896,443500,MKT
06079812143430000,2019,243604,199896,443500,MKT
06079812143450000,2021,341987,136713,478700,MKT
06079812143450000,2020,247538,139562,387100,MKT
06079812143450000,2019,247538,139562,387100,MKT
06079812143470000,2021,303998,179102,483100,MKT
06079812143470000,2020,233350,213850,447200,MKT
06079812143470000,2019,233350,213850,447200,MKT
06079812148100000,2021,970645,4345150,5315795,COST
06079812148100000,2020,760965,2131100,2892065,COST
06079812148100000,2019,760965,2131100,2892065,COST
06079812149010000,2021,373737,205663,579400,MKT
06079812149010000,2020,258803,222897,481700,MKT
06079812149010000,2019,258803,222897,481700,MKT
06079812149040000,2021,373737,166363,540100,MKT
06079812149040000,2020,258803,183797,442600,MKT
06079812149040000,2019,258803,183797,442600,MKT
06079812149060000,2021,343494,133306,476800,MKT
06079812149060000,2020,248085,105715,353800,MKT
06079812149060000,2019,248085,105715,353800,MKT
06079812149080000,2021,451824,21876,473700,INCOME
06079812149080000,2020,284628,92372,377000,INCOME
06079812149080000,2019,284628,92372,377000,INCOME
06079812149100000,2021,385280,111120,496400,MKT
06079812149100000,2020,262780,125220,388000,MKT
06079812149100000,2019,262780,125220,388000,MKT
06079812149120000,2021,373737,150663,524400,MKT
06079812149120000,2020,258803,191697,450500,MKT
06079812149120000,2019,258803,191697,450500,MKT
06079812149140000,2021,343494,175806,519300,MKT
06079812149140000,2020,248085,167515,415600,MKT
06079812149140000,2019,248085,167515,415600,MKT
06079812149160000,2021,310867,186133,497000,MKT
06079812149160000,2020,235978,215322,451300,MKT
06079812149160000,2019,235978,215322,451300,MKT
06079812149180000,2021,310867,140533,451400,MKT
06079812149180000,2020,235978,148222,384200,MKT
06079812149180000,2019,235978,148222,384200,MKT
06079812165070000,2021,993184,1070080,2063264,COST
06079812165070000,2020,848674,1028726,1877400,INCOME
06079812165070000,2019,848674,1028726,1877400,INCOME
06079812166130000,2021,204825,148275,353100,MKT
06079812166130000,2020,216779,83021,299800,OVR
06079812166130000,2019,216779,83021,299800,MKT
06079812166160000,2021,197913,138187,336100,MKT
06079812166160000,2020,213080,66220,279300,MKT
06079812166160000,2019,213080,66220,279300,MKT
06079812166180000,2021,184938,175462,360400,MKT
06079812166180000,2020,205959,91441,297400,MKT
06079812166180000,2019,205959,91441,297400,MKT
06079812166200000,2021,198962,136338,335300,INCOME
06079812166200000,2020,213646,83754,297400,INCOME
06079812166200000,2019,213646,83754,297400,INCOME
06079812166230000,2021,329932,63960,393892,COST
06079812166230000,2020,275297,51030,326327,COST
06079812166230000,2019,275297,51030,326327,COST
06079812166390000,2021,1114575,2356525,3471100,INCOME
06079812166390000,2020,891649,1977951,2869600,INCOME
06079812166390000,2019,891649,1977951,2869600,INCOME
06079812166410000,2021,613674,4803490,5417164,COST
06079812166410000,2020,690510,4586780,5277290,COST
06079812166410000,2019,690510,2971590,3662100,COST
06079812168010000,2021,311225,156175,467400,MKT
06079812168010000,2020,267359,147741,415100,MKT
06079812168010000,2019,267359,147741,415100,MKT
06079812168050000,2021,156086,145650,301736,COST
06079812168050000,2020,347825,126880,474705,COST
06079812168050000,2019,347825,126880,474705,COST
06079812168080000,2021,270115,131370,401485,COST
06079812168080000,2020,249031,204569,453600,MKT
06079812168080000,2019,249031,204569,453600,MKT
06079812168110000,2021,348283,0,348283,COST
06079812168110000,2020,490547,0,490547,COST
06079812168110000,2019,490547,0,490547,COST
06079812168140000,2021,343642,258658,602300,INCOME
06079812168140000,2020,487736,129564,617300,INCOME
06079812168140000,2019,487736,129564,617300,INCOME
06079812168200000,2021,500544,1456256,1956800,INCOME
06079812168200000,2020,573000,627500,1200500,INCOME
06079812168200000,2019,573000,627500,1200500,INCOME
06079812168220000,2021,259406,415594,675000,INCOME
06079812168220000,2020,528023,250910,778933,COST
06079812168220000,2019,528023,250910,778933,COST
06079812168240000,2021,259406,985194,1244600,INCOME
06079812168240000,2020,528023,362377,890400,INCOME
06079812168240000,2019,528023,362377,890400,INCOME
06079812168260000,2021,259406,525294,784700,INCOME
06079812168260000,2020,528023,192677,720700,INCOME
06079812168260000,2019,528023,192677,720700,INCOME
06079812168280000,2021,635200,2926600,3561800,INCOME
06079812168280000,2020,774931,2733969,3508900,INCOME
06079812168280000,2019,774931,2733969,3508900,INCOME
06079812168290000,2021,343642,606558,950200,INCOME
06079812168290000,2020,595620,151280,746900,INCOME
06079812168290000,2019,595620,151280,746900,INCOME
06079812168320000,2021,349701,0,349701,COST
06079812168320000,2020,600097,0,600097,COST
06079812168320000,2019,600097,0,600097,COST
06079812170017000,2021,2085044,2429480,4514524,COST
06079812170017000,2020,801870,0,801870,COST
06079812170017000,2019,801870,0,801870,COST
06079812170060000,2021,208530,0,208530,COST
06079812170060000,2020,472325,0,472325,COST
06079812170060000,2019,472325,0,472325,COST
06079812170070000,2021,5914576,0,5914576,COST
06079812170070000,2020,1036244,0,1036244,COST
06079812170070000,2019,1036244,0,1036244,COST
06079812170330000,2021,210574,0,210574,COST
06079812170330000,2020,474303,0,474303,COST
06079812170330000,2019,474303,0,474303,COST
06079812210010000,2021,1053651,1086730,2140381,COST
06079812210010000,2020,870434,1088660,1959094,COST
06079812210010000,2019,870434,1088660,1959094,COST
06079812210020000,2021,3071065,11768535,14839600,INCOME
06079812210020000,2020,1376443,7733820,9110263,COST
06079812210020000,2019,1376443,7733820,9110263,COST
06079812210090000,2021,899254,1435246,2334500,INCOME
06079812210090000,2020,813312,937988,1751300,INCOME
06079812210090000,2019,813312,937988,1751300,INCOME
06079812210100000,2021,506114,1036960,1543074,COST
06079812210100000,2020,635797,987690,1623487,COST
06079812210100000,2019,635797,987690,1623487,COST
06079812210130000,2021,1069276,0,1069276,COST
06079812210130000,2020,875941,0,875941,COST
06079812210130000,2019,875941,0,875941,COST
06079812210170000,2021,1344049,0,1344049,COST
06079812210170000,2020,966103,0,966103,COST
06079812210170000,2019,966103,0,966103,COST
06079812211010000,2021,280236,379764,660000,INCOME
06079812211010000,2020,472648,136260,608908,COST
06079812211010000,2019,472648,136260,608908,COST
06079812211050000,2021,318663,426237,744900,INCOME
06079812211050000,2020,499395,70205,569600,INCOME
06079812211050000,2019,499395,70205,569600,INCOME
06079812211100000,2021,523007,0,523007,COST
06079812211100000,2020,617478,0,617478,COST
06079812211100000,2019,617478,0,617478,COST
06079812211150000,2021,655779,843621,1499400,INCOME
06079812211150000,2020,680315,703985,1384300,INCOME
06079812211150000,2019,680315,703985,1384300,INCOME
06079812212010000,2021,2296047,4326280,6622327,COST
06079812212010000,2020,1215207,3725860,4941067,COST
06079812212010000,2019,1215207,3725860,4941067,COST
06079812213010000,2021,379103,0,379103,COST
06079812213010000,2020,561773,0,561773,COST
06079812213010000,2019,561773,0,561773,COST
06079812213010900,2021,3707489,9263411,12970900,INCOME
06079812213010900,2020,1272533,9066767,10339300,INCOME
06079812213010900,2019,1272533,9066767,10339300,INCOME
06079812213020000,2021,509866,583600,1093466,COST
06079812213020000,2020,637812,627988,1265800,INCOME
06079812213020000,2019,637812,627988,1265800,INCOME
06079812213077000,2021,1116876,22250,1139126,COST
06079812213077000,2020,892437,21530,913967,COST
06079812213077000,2019,892437,21530,913967,COST
06079812213080000,2021,558693,617407,1176100,INCOME
06079812213080000,2020,663295,584790,1248085,COST
06079812213080000,2019,663295,584790,1248085,COST
06079812213100000,2021,1047556,783740,1831296,COST
06079812213100000,2020,740508,669420,1409928,COST
06079812213100000,2019,740508,0,740508,COST
06079812214010000,2021,593319,1013881,1607200,INCOME
06079812214010000,2020,680603,850597,1531200,INCOME
06079812214010000,2019,680603,850597,1531200,INCOME
06079812214030000,2021,411718,636550,1048268,COST
06079812214030000,2020,557326,595580,1152906,COST
06079812214030000,2019,557326,595580,1152906,COST
06079812214050000,2021,151190,278310,429500,MKT
06079812214050000,2020,115645,220255,335900,MKT
06079812214050000,2019,115645,220255,335900,MKT
06079812214060000,2021,151190,316510,467700,MKT
06079812214060000,2020,115645,249155,364800,OVR
06079812214060000,2019,115645,249155,364800,MKT
06079812214070000,2021,151190,270310,421500,MKT
06079812214070000,2020,115645,233955,349600,MKT
06079812214070000,2019,115645,233955,349600,MKT
06079812214080000,2021,151190,217510,368700,MKT
06079812214080000,2020,115645,188655,304300,MKT
06079812214080000,2019,115645,188655,304300,MKT
06079812214090000,2021,151190,225710,376900,MKT
06079812214090000,2020,115645,191955,307600,MKT
06079812214090000,2019,115645,191955,307600,MKT
06079812214100000,2021,151190,252410,403600,MKT
06079812214100000,2020,115645,219155,334800,MKT
06079812214100000,2019,115645,207355,323000,MKT
06079812214110000,2021,151190,293450,444640,COST
06079812214110000,2020,115645,298480,414125,COST
06079812214110000,2019,115645,297280,412925,COST
06079812214120000,2021,167497,230703,398200,MKT
06079812214120000,2020,130191,190709,320900,MKT
06079812214120000,2019,130191,190709,320900,MKT
06079812228010000,2021,146981,304619,451600,MKT
06079812228010000,2020,111928,266695,378623,OVR
06079812228010000,2019,111928,266695,378623,OVR
06079812228020000,2021,140795,254705,395500,MKT
06079812228020000,2020,106498,238402,344900,MKT
06079812228020000,2019,106498,238402,344900,MKT
06079812228030000,2021,140795,286905,427700,MKT
06079812228030000,2020,106498,241502,348000,MKT
06079812228030000,2019,106498,241502,348000,MKT
06079812228040000,2021,140795,230805,371600,MKT
06079812228040000,2020,106498,206702,313200,MKT
06079812228040000,2019,106498,206702,313200,MKT
06079812228050000,2021,140795,311705,452500,MKT
06079812228050000,2020,106498,249602,356100,MKT
06079812228050000,2019,106498,249602,356100,MKT
06079812228060000,2021,140795,336105,476900,MKT
06079812228060000,2020,106498,290802,397300,OVR
06079812228060000,2019,106498,290802,397300,MKT
06079812228070000,2021,140795,313405,454200,MKT
06079812228070000,2020,106498,246702,353200,MKT
06079812228070000,2019,106498,246702,353200,MKT
06079812228080000,2021,133413,315787,449200,MKT
06079812228080000,2020,100066,263934,364000,MKT
06079812228080000,2019,100066,263934,364000,MKT
06079812228090000,2021,133413,277587,411000,MKT
06079812228090000,2020,100066,230334,330400,MKT
06079812228090000,2019,100066,230334,330400,MKT
06079812228100000,2021,133413,306587,440000,MKT
06079812228100000,2020,100066,273634,373700,MKT
06079812228100000,2019,100066,273634,373700,MKT
06079812228110000,2021,133413,291787,425200,MKT
06079812228110000,2020,100066,231034,331100,MKT
06079812228110000,2019,100066,231034,331100,MKT
06079812228120000,2021,133413,217787,351200,MKT
06079812228120000,2020,100066,194834,294900,MKT
06079812228120000,2019,100066,194834,294900,MKT
06079812228130000,2021,131863,230637,362500,MKT
06079812228130000,2020,98722,211578,310300,MKT
06079812228130000,2019,98722,211578,310300,MKT
06079812228140000,2021,128678,297222,425900,MKT
06079812228140000,2020,95969,260831,356800,OVR
06079812228140000,2019,95969,260831,356800,MKT
06079812228150000,2021,128678,235022,363700,MKT
06079812228150000,2020,95969,217631,313600,MKT
06079812228150000,2019,95969,217631,313600,MKT
06079812228160000,2021,128678,263522,392200,MKT
06079812228160000,2020,95969,231531,327500,MKT
06079812228160000,2019,95969,231531,327500,MKT
06079812228170000,2021,131863,291737,423600,MKT
06079812228170000,2020,98722,257178,355900,MKT
06079812228170000,2019,98722,257178,355900,MKT
06079812228180000,2021,128899,266101,395000,MKT
06079812228180000,2020,96160,239240,335400,MKT
06079812228180000,2019,96160,239240,335400,MKT
06079812228190000,2021,128899,249501,378400,MKT
06079812228190000,2020,96160,236240,332400,OVR
06079812228190000,2019,96160,236240,332400,MKT
06079812228200000,2021,129412,301888,431300,MKT
06079812228200000,2020,96603,269497,366100,OVR
06079812228200000,2019,96603,269497,366100,MKT
06079812228210000,2021,129412,293688,423100,MKT
06079812228210000,2020,96603,266097,362700,MKT
06079812228210000,2019,96603,266097,362700,MKT
06079812228220000,2021,129922,205378,335300,INCOME
06079812228220000,2020,97044,200356,297400,INCOME
06079812228220000,2019,97044,200356,297400,INCOME
06079812228230000,2021,129922,242578,372500,MKT
06079812228230000,2020,97044,224256,321300,MKT
06079812228230000,2019,97044,224256,321300,MKT
06079812228240000,2021,130429,236271,366700,MKT
06079812228240000,2020,97482,220018,317500,MKT
06079812228240000,2019,97482,217418,314900,MKT
06079812228250000,2021,130429,204871,335300,INCOME
06079812228250000,2020,97482,199918,297400,INCOME
06079812228250000,2019,97482,199918,297400,INCOME
06079812228260000,2021,130934,204366,335300,INCOME
06079812228260000,2020,97918,199482,297400,INCOME
06079812228260000,2019,97918,199482,297400,INCOME
06079812228270000,2021,130934,204366,335300,INCOME
06079812228270000,2020,97918,199482,297400,INCOME
06079812228270000,2019,97918,199482,297400,INCOME
06079812228280000,2021,131435,203865,335300,INCOME
06079812228280000,2020,98352,199048,297400,INCOME
06079812228280000,2019,98352,199048,297400,INCOME
06079812228290000,2021,131934,162566,294500,INCOME
06079812228290000,2020,98784,160716,259500,INCOME
06079812228290000,2019,98784,160716,259500,INCOME
06079812228300000,2021,135657,194043,329700,INCOME
06079812228300000,2020,102015,209885,311900,INCOME
06079812228300000,2019,102015,209885,311900,INCOME
06079812228310000,2021,139757,200843,340600,INCOME
06079812228310000,2020,105590,213210,318800,INCOME
06079812228310000,2019,105590,213210,318800,INCOME
06079812228320000,2021,139757,208443,348200,MKT
06079812228320000,2020,105590,170910,276500,MKT
06079812228320000,2019,105590,170910,276500,MKT
06079812228330000,2021,140278,264522,404800,INCOME
06079812228330000,2020,106045,262455,368500,INCOME
06079812228330000,2019,106045,262455,368500,INCOME
06079812228340000,2021,148304,159396,307700,INCOME
06079812228340000,2020,113095,184305,297400,INCOME
06079812228340000,2019,113095,184305,297400,INCOME
06079812229010000,2021,144280,273920,418200,MKT
06079812229010000,2020,109553,255407,364960,OVR
06079812229010000,2019,109553,255407,364960,OVR
06079812229020000,2021,140083,244717,384800,MKT
06079812229020000,2020,105875,228325,334200,MKT
06079812229020000,2019,105875,228325,334200,MKT
06079812229030000,2021,140083,244617,384700,MKT
06079812229030000,2020,105875,219425,325300,MKT
06079812229030000,2019,105875,219425,325300,MKT
06079812229040000,2021,137913,263187,401100,MKT
06079812229040000,2020,103980,245720,349700,MKT
06079812229040000,2019,103980,245720,349700,MKT
06079812229050000,2021,137913,244487,382400,MKT
06079812229050000,2020,103980,230120,334100,MKT
06079812229050000,2019,103980,227220,331200,MKT
06079812229060000,2021,137913,264087,402000,MKT
06079812229060000,2020,103980,244720,348700,MKT
06079812229060000,2019,103980,244720,348700,MKT
06079812229070000,2021,132712,295388,428100,MKT
06079812229070000,2020,99458,265442,364900,MKT
06079812229070000,2019,99458,265442,364900,MKT
06079812229080000,2021,137913,259187,397100,MKT
06079812229080000,2020,103980,247520,351500,MKT
06079812229080000,2019,103980,247520,351500,MKT
06079812229090000,2021,137913,260087,398000,MKT
06079812229090000,2020,103980,248120,352100,MKT
06079812229090000,2019,103980,248120,352100,MKT
06079812229100000,2021,137913,293687,431600,MKT
06079812229100000,2020,103980,259920,363900,MKT
06079812229100000,2019,103980,262120,366100,MKT
06079812229110000,2021,137178,235622,372800,MKT
06079812229110000,2020,103339,219861,323200,MKT
06079812229110000,2019,103339,219861,323200,MKT
06079812229120000,2021,141502,259498,401000,MKT
06079812229120000,2020,107117,221383,328500,MKT
06079812229120000,2019,107117,221383,328500,MKT
06079812229130000,2021,140795,369105,509900,MKT
06079812229130000,2020,106498,333702,440200,OVR
06079812229130000,2019,106498,333702,440200,MKT
06079812229140000,2021,140795,346805,487600,MKT
06079812229140000,2020,106498,282902,389400,MKT
06079812229140000,2019,106498,282902,389400,MKT
06079812229150000,2021,140795,326905,467700,MKT
06079812229150000,2020,106498,271102,377600,MKT
06079812229150000,2019,106498,271102,377600,MKT
06079812229160000,2021,134179,244121,378300,MKT
06079812229160000,2020,100731,208569,309300,MKT
06079812229160000,2019,100731,208569,309300,MKT
06079812229170000,2021,130285,250815,381100,MKT
06079812229170000,2020,97357,210443,307800,MKT
06079812229170000,2019,97357,210443,307800,MKT
06079812229180000,2021,128678,268822,397500,MKT
06079812229180000,2020,95969,230531,326500,MKT
06079812229180000,2019,95969,230531,326500,MKT
06079812229190000,2021,128678,259122,387800,MKT
06079812229190000,2020,95969,231431,327400,MKT
06079812229190000,2019,95969,231431,327400,MKT
06079812229200000,2021,128678,242622,371300,MKT
06079812229200000,2020,95969,204431,300400,MKT
06079812229200000,2019,95969,204431,300400,MKT
06079812229210000,2021,131863,232437,364300,MKT
06079812229210000,2020,98722,198078,296800,MKT
06079812229210000,2019,98722,198078,296800,MKT
06079812229220000,2021,133413,263887,397300,MKT
06079812229220000,2020,100066,226634,326700,MKT
06079812229220000,2019,100066,226634,326700,MKT
06079812229230000,2021,129485,229115,358600,MKT
06079812229230000,2020,96666,212234,308900,MKT
06079812229230000,2019,96666,212234,308900,MKT
06079812229240000,2021,137178,264322,401500,MKT
06079812229240000,2020,103339,226561,329900,MKT
06079812229240000,2019,103339,226561,329900,MKT
06079812229250000,2021,133413,229087,362500,MKT
06079812229250000,2020,100066,201234,301300,MKT
06079812229250000,2019,100066,201234,301300,MKT
06079812229260000,2021,133413,19410,152823,COST
06079812229260000,2020,100066,18590,118656,COST
06079812229260000,2019,100066,18590,118656,COST
06079812229270000,2021,140795,273005,413800,MKT
06079812229270000,2020,106498,239202,345700,MKT
06079812229270000,2019,106498,239202,345700,MKT
06079812229280000,2021,140795,166905,307700,INCOME
06079812229280000,2020,106498,190902,297400,INCOME
06079812229280000,2019,106498,190902,297400,INCOME
06079812229290000,2021,140795,231305,372100,INCOME
06079812229290000,2020,106498,262002,368500,INCOME
06079812229290000,2019,106498,262002,368500,INCOME
06079812229300000,2021,140795,271705,412500,MKT
06079812229300000,2020,106498,227102,333600,MKT
06079812229300000,2019,106498,227102,333600,MKT
06079812229310000,2021,140795,264105,404900,MKT
06079812229310000,2020,106498,222602,329100,OVR
06079812229310000,2019,106498,222602,329100,MKT
06079812229320000,2021,140795,279205,420000,MKT
06079812229320000,2020,106498,225102,331600,MKT
06079812229320000,2019,106498,225102,331600,MKT
06079812229330000,2021,146313,229787,376100,INCOME
06079812229330000,2020,111340,256460,367800,INCOME
06079812229330000,2019,111340,256460,367800,INCOME
06079812230010000,2021,175497,331903,507400,INCOME
06079812230010000,2020,120560,293840,414400,INCOME
06079812230010000,2019,120560,293840,414400,INCOME
06079812230025001,2021,98709,151591,250300,MKT
06079812230025001,2020,84074,147426,231500,MKT
06079812230025001,2019,84074,147426,231500,MKT
06079812230025002,2021,91259,149741,241000,MKT
06079812230025002,2020,76779,147221,224000,MKT
06079812230025002,2019,76779,147221,224000,MKT
06079812230025003,2021,91296,135804,227100,MKT
06079812230025003,2020,76814,136086,212900,MKT
06079812230025003,2019,76814,136086,212900,MKT
06079812230025004,2021,98654,141246,239900,MKT
06079812230025004,2020,84020,141180,225200,MKT
06079812230025004,2019,84020,141180,225200,MKT
06079812230040000,2021,200330,0,200330,COST
06079812230040000,2020,121923,0,121923,COST
06079812230040000,2019,121923,0,121923,COST
06079812230050000,2021,176136,412864,589000,INCOME
06079812230050000,2020,120902,353998,474900,INCOME
06079812230050000,2019,120902,353998,474900,INCOME
06079812230070000,2021,215973,373027,589000,INCOME
06079812230070000,2020,141736,333164,474900,INCOME
06079812230070000,2019,141736,333164,474900,INCOME
06079812230090000,2021,212614,376386,589000,INCOME
06079812230090000,2020,140014,334886,474900,INCOME
06079812230090000,2019,140014,334886,474900,INCOME
06079812230120000,2021,209218,400482,609700,INCOME
06079812230120000,2020,138267,350833,489100,INCOME
06079812230120000,2019,138267,350833,489100,INCOME
06079812230130000,2021,175497,331903,507400,INCOME
06079812230130000,2020,120560,293840,414400,INCOME
06079812230130000,2019,120560,293840,414400,INCOME
06079812230140000,2021,176774,330626,507400,INCOME
06079812230140000,2020,121244,293156,414400,INCOME
06079812230140000,2019,121244,293156,414400,INCOME
06079812230150000,2021,174213,310887,485100,INCOME
06079812230150000,2020,119872,347728,467600,INCOME
06079812230150000,2019,119872,347728,467600,INCOME
06079812230160000,2021,155177,174523,329700,INCOME
06079812230160000,2020,119179,192721,311900,INCOME
06079812230160000,2019,119179,192721,311900,INCOME
06079812230170000,2021,155177,153223,308400,INCOME
06079812230170000,2020,119179,169721,288900,INCOME
06079812230170000,2019,119179,169721,288900,INCOME
06079812230180000,2021,183071,324329,507400,INCOME
06079812230180000,2020,124598,289802,414400,INCOME
06079812230180000,2019,124598,289802,414400,INCOME
06079812230190000,2021,140018,188382,328400,INCOME
06079812230190000,2020,105818,207482,313300,INCOME
06079812230190000,2019,105818,207482,313300,INCOME
06079812230200000,2021,263180,157520,420700,INCOME
06079812230200000,2020,112725,230075,342800,INCOME
06079812230200000,2019,112725,230075,342800,INCOME
06079812230210000,2021,155177,331123,486300,MKT
06079812230210000,2020,119179,286921,406100,MKT
06079812230210000,2019,119179,286921,406100,MKT
06079812230220000,2021,155177,370323,525500,MKT
06079812230220000,2020,119179,324221,443400,MKT
06079812230220000,2019,119179,324221,443400,MKT
06079812230230000,2021,155177,333123,488300,MKT
06079812230230000,2020,119179,300621,419800,MKT
06079812230230000,2019,119179,300621,419800,MKT
06079812230240000,2021,155177,311223,466400,MKT
06079812230240000,2020,119179,272821,392000,MKT
06079812230240000,2019,119179,272721,391900,MKT
06079812230250000,2021,152803,295997,448800,MKT
06079812230250000,2020,117073,277127,394200,MKT
06079812230250000,2019,117073,277127,394200,MKT
06079812230260000,2021,152000,237400,389400,MKT
06079812230260000,2020,116361,212339,328700,MKT
06079812230260000,2019,116361,212339,328700,MKT
06079812230270000,2021,152000,580400,732400,MKT
06079812230270000,2020,116361,605620,721981,COST
06079812230270000,2019,116361,605620,721981,COST
06079812230280000,2021,152000,254100,406100,MKT
06079812230280000,2020,116361,232639,349000,MKT
06079812230280000,2019,116361,232639,349000,MKT
06079812230290000,2021,152000,256300,408300,MKT
06079812230290000,2020,116361,239439,355800,MKT
06079812230290000,2019,116361,239439,355800,MKT
06079812230300000,2021,152000,282700,434700,MKT
06079812230300000,2020,116361,261139,377500,OVR
06079812230300000,2019,116361,261139,377500,MKT
06079812230310000,2021,152000,262100,414100,MKT
06079812230310000,2020,116361,248139,364500,MKT
06079812230310000,2019,116361,248139,364500,MKT
06079812230320000,2021,152000,296800,448800,MKT
06079812230320000,2020,116361,284439,400800,MKT
06079812230320000,2019,116361,284439,400800,MKT
06079812230330000,2021,153601,262799,416400,MKT
06079812230330000,2020,117780,241520,359300,MKT
06079812230330000,2019,117780,241520,359300,MKT
06079812230340000,2021,153601,290699,444300,MKT
06079812230340000,2020,117780,267320,385100,MKT
06079812230340000,2019,117780,267320,385100,MKT
06079812230350000,2021,157498,352002,509500,MKT
06079812230350000,2020,121244,317456,438700,OVR
06079812230350000,2019,121244,317456,438700,MKT
06079812231010000,2021,573858,435360,1009218,COST
06079812231010000,2020,642516,408320,1050836,COST
06079812231010000,2019,642516,408320,1050836,COST
06079812231100000,2021,350551,161090,511641,COST
06079812231100000,2020,520221,154790,675011,COST
06079812231100000,2019,520221,154790,675011,COST
06079812231110000,2021,152517,264183,416700,MKT
06079812231110000,2020,116819,239681,356500,MKT
06079812231110000,2019,116819,239681,356500,MKT
06079812231120000,2021,152517,257983,410500,MKT
06079812231120000,2020,116819,236881,353700,MKT
06079812231120000,2019,116819,236881,353700,MKT
06079812231130000,2021,152517,310283,462800,MKT
06079812231130000,2020,116819,287781,404600,MKT
06079812231130000,2019,116819,287781,404600,MKT
06079812231140000,2021,152517,282083,434600,MKT
06079812231140000,2020,116819,262581,379400,MKT
06079812231140000,2019,116819,262581,379400,MKT
06079812231150000,2021,152517,286983,439500,MKT
06079812231150000,2020,116819,246881,363700,MKT
06079812231150000,2019,116819,246881,363700,MKT
06079812231160000,2021,152517,296783,449300,MKT
06079812231160000,2020,116819,249781,366600,MKT
06079812231160000,2019,116819,245381,362200,MKT
06079812231170000,2021,152517,249983,402500,MKT
06079812231170000,2020,116819,225081,341900,MKT
06079812231170000,2019,116819,225081,341900,MKT
06079812231180000,2021,152517,237283,389800,MKT
06079812231180000,2020,116819,202081,318900,MKT
06079812231180000,2019,116819,202081,318900,MKT
06079812231190000,2021,152517,312083,464600,MKT
06079812231190000,2020,116819,273681,390500,MKT
06079812231190000,2019,116819,273681,390500,MKT
06079812231200000,2021,152517,266683,419200,MKT
06079812231200000,2020,116819,240481,357300,MKT
06079812231200000,2019,116819,240481,357300,MKT
06079812231210000,2021,152517,244183,396700,MKT
06079812231210000,2020,116819,222381,339200,MKT
06079812231210000,2019,116819,222381,339200,MKT
06079812231220000,2021,156592,294508,451100,MKT
06079812231220000,2020,120437,273463,393900,MKT
06079812231220000,2019,120437,273463,393900,MKT
06079812231230000,2021,153345,176355,329700,INCOME
06079812231230000,2020,117553,194347,311900,INCOME
06079812231230000,2019,117553,194347,311900,INCOME
06079812231240000,2021,152517,273683,426200,MKT
06079812231240000,2020,116819,260281,377100,OVR
06079812231240000,2019,116819,260281,377100,MKT
06079812231250000,2021,152517,226083,378600,MKT
06079812231250000,2020,116819,199081,315900,MKT
06079812231250000,2019,116819,199081,315900,MKT
06079812231260000,2021,152517,177783,330300,MKT
06079812231260000,2020,116819,164481,281300,MKT
06079812231260000,2019,116819,164481,281300,MKT
06079812231270000,2021,152517,246983,399500,MKT
06079812231270000,2020,116819,218181,335000,MKT
06079812231270000,2019,116819,218181,335000,MKT
06079812231280000,2021,152517,224483,377000,MKT
06079812231280000,2020,116819,185581,302400,MKT
06079812231280000,2019,116819,185581,302400,MKT
06079812231290000,2021,152517,198983,351500,INCOME
06079812231290000,2020,116819,208881,325700,INCOME
06079812231290000,2019,116819,208881,325700,INCOME
06079812231300000,2021,152517,262583,415100,MKT
06079812231300000,2020,116819,240581,357400,MKT
06079812231300000,2019,116819,226381,343200,MKT
06079812231310000,2021,152517,257583,410100,MKT
06079812231310000,2020,116819,227581,344400,MKT
06079812231310000,2019,116819,227581,344400,MKT
06079812231320000,2021,152517,315683,468200,MKT
06079812231320000,2020,116819,254081,370900,MKT
06079812231320000,2019,116819,254081,370900,MKT
06079812231330000,2021,152517,294883,447400,MKT
06079812231330000,2020,116819,264481,381300,MKT
06079812231330000,2019,116819,264481,381300,MKT
06079812231340000,2021,152517,308983,461500,MKT
06079812231340000,2020,116819,284681,401500,OVR
06079812231340000,2019,116819,284681,401500,MKT
06079812231350000,2021,175451,211149,386600,INCOME
06079812231350000,2020,120536,230564,351100,INCOME
06079812231350000,2019,120536,230564,351100,INCOME
06079812231360000,2021,156703,378997,535700,INCOME
06079812231360000,2020,120536,379264,499800,INCOME
06079812231360000,2019,120536,379264,499800,INCOME
06079812231370000,2021,161073,358327,519400,MKT
06079812231370000,2020,124433,331567,456000,MKT
06079812231370000,2019,124433,331567,456000,MKT
06079812231380000,2021,175451,413549,589000,INCOME
06079812231380000,2020,120536,354364,474900,INCOME
06079812231380000,2019,120536,354364,474900,INCOME
06079812235010000,2021,196964,192736,389700,MKT
06079812235010000,2020,157032,158568,315600,MKT
06079812235010000,2019,157032,158568,315600,MKT
06079812235060000,2021,32855,0,32855,COST
06079812235060000,2020,23892,0,23892,COST
06079812235060000,2019,23892,0,23892,COST
06079812235080000,2021,170764,368236,539000,MKT
06079812235080000,2020,133132,341968,475100,OVR
06079812235080000,2019,133132,341968,475100,MKT
06079812235090000,2021,144342,185358,329700,INCOME
06079812235090000,2020,109608,202292,311900,INCOME
06079812235090000,2019,109608,202292,311900,INCOME
06079812235100000,2021,143843,281757,425600,MKT
06079812235100000,2020,109170,231830,341000,MKT
06079812235100000,2019,109170,231830,341000,MKT
06079812235110000,2021,143342,261958,405300,MKT
06079812235110000,2020,108730,239370,348100,MKT
06079812235110000,2019,108730,239370,348100,MKT
06079812235120000,2021,143342,277958,421300,MKT
06079812235120000,2020,108730,251370,360100,MKT
06079812235120000,2019,108730,251370,360100,MKT
06079812236010000,2021,2186162,0,2186162,COST
06079812236010000,2020,1087720,0,1087720,COST
06079812236010000,2019,587367,0,587367,COST
06079812236020000,2021,787426,0,787426,COST
06079812236020000,2020,702332,0,702332,COST
06079812236020000,2019,264929,0,264929,COST
06079812236030000,2021,938266,0,938266,COST
06079812236030000,2020,757092,0,757092,COST
06079812236030000,2019,303723,0,303723,COST
06079812236040000,2021,967355,0,967355,COST
06079812236040000,2020,767060,0,767060,COST
06079812236040000,2019,311040,101180,412220,COST
06079812236050000,2021,1650052,0,1650052,COST
06079812236050000,2020,964219,0,964219,COST
06079812236050000,2019,471673,125050,596723,COST
06079812236150000,2021,1308462,0,1308462,COST
06079812236150000,2020,913839,0,913839,COST
06079812236150000,2019,427780,0,427780,COST
06079812236170000,2021,1737626,0,1737626,COST
06079812236170000,2020,851422,0,851422,COST
06079812236170000,2019,376095,0,376095,COST
06079812236190000,2021,1320181,0,1320181,COST
06079812236190000,2020,756787,0,756787,COST
06079812236190000,2019,303500,0,303500,COST
06079812236210000,2021,1732307,0,1732307,COST
06079812236210000,2020,1281148,0,1281148,COST
06079812236210000,2019,1281148,0,1281148,COST
06079812236250000,2021,7629485,0,7629485,COST
06079812236250000,2020,1911153,0,1911153,COST
06079812236250000,2019,1911153,0,1911153,COST
06079812301010900,2021,183719,405281,589000,INCOME
06079812301010900,2020,107401,367499,474900,INCOME
06079812301010900,2019,107401,367499,474900,INCOME
06079812301020900,2021,238729,301871,540600,INCOME
06079812301020900,2020,132574,386526,519100,INCOME
06079812301020900,2019,132574,386526,519100,INCOME
06079812301030000,2021,469300,929400,1398700,INCOME
06079812301030000,2020,589472,787028,1376500,INCOME
06079812301030000,2019,589472,787028,1376500,INCOME
06079812301030900,2021,113455,287445,400900,INCOME
06079812301030900,2020,82767,288133,370900,INCOME
06079812301030900,2019,82767,288133,370900,INCOME
06079812301040900,2021,147773,359627,507400,INCOME
06079812301040900,2020,107401,306999,414400,INCOME
06079812301040900,2019,107401,306999,414400,INCOME
06079812301060900,2021,382665,89635,472300,MKT
06079812301060900,2020,274401,156810,431211,COST
06079812301060900,2019,274401,156810,431211,COST
06079812301070000,2021,964470,210840,1175310,COST
06079812301070000,2020,911999,238600,1150599,COST
06079812301070000,2019,911999,238600,1150599,COST
06079812301080000,2021,964470,1749030,2713500,INCOME
06079812301080000,2020,274401,2181199,2455600,INCOME
06079812301080000,2019,274401,2181199,2455600,INCOME
06079812301100000,2021,117871,187910,305781,COST
06079812301100000,2020,85942,183720,269662,COST
06079812301100000,2019,85942,183720,269662,COST
06079812301110000,2021,145344,364756,510100,MKT
06079812301110000,2020,105660,347440,453100,MKT
06079812301110000,2019,105660,347440,453100,MKT
06079812301120000,2021,179324,219176,398500,MKT
06079812301120000,2020,129976,212224,342200,MKT
06079812301120000,2019,129976,212224,342200,MKT
06079812301130000,2021,159335,244665,404000,MKT
06079812301130000,2020,115680,232120,347800,MKT
06079812301130000,2019,115680,232120,347800,MKT
06079812301140000,2021,375320,165280,540600,INCOME
06079812301140000,2020,128487,390613,519100,INCOME
06079812301140000,2019,128487,390613,519100,INCOME
06079812301150000,2021,209004,252496,461500,MKT
06079812301150000,2020,151160,258940,410100,MKT
06079812301150000,2019,151160,258940,410100,MKT
06079812301160000,2021,123192,9600,132792,COST
06079812301160000,2020,167009,10320,177329,COST
06079812301160000,2019,167009,10320,177329,COST
06079812301227000,2021,765738,40740,806478,COST
06079812301227000,2020,727025,39630,766655,COST
06079812301227000,2019,727025,39630,766655,COST
06079812301230000,2021,627097,401503,1028600,INCOME
06079812301230000,2020,667405,366195,1033600,INCOME
06079812301230000,2019,500000,40000,540000,INCOME
06079812301270000,2021,568737,237163,805900,INCOME
06079812301270000,2020,640053,90247,730300,INCOME
06079812301270000,2019,640053,90247,730300,INCOME
06079812301280000,2021,637063,850637,1487700,INCOME
06079812301280000,2020,671928,708972,1380900,INCOME
06079812301280000,2019,671928,708972,1380900,INCOME
06079812301300000,2021,420800,94020,514820,COST
06079812301300000,2020,562560,90460,653020,COST
06079812301300000,2019,562560,90460,653020,COST
06079812301320000,2021,600687,1210113,1810800,INCOME
06079812301320000,2020,655216,905340,1560556,COST
06079812301320000,2019,655216,905340,1560556,COST
06079812301330000,2021,732923,2519577,3252500,INCOME
06079812301330000,2020,713511,1442889,2156400,INCOME
06079812301330000,2019,713511,1442889,2156400,INCOME
06079812301340000,2021,444915,612385,1057300,INCOME
06079812301340000,2020,576150,381950,958100,INCOME
06079812301340000,2019,576150,381950,958100,INCOME
06079812301350000,2021,300726,314774,615500,INCOME
06079812301350000,2020,487154,107746,594900,INCOME
06079812301350000,2019,487154,107746,594900,INCOME
06079812301360000,2021,659594,1453706,2113300,INCOME
06079812301360000,2020,583190,1437010,2020200,INCOME
06079812301360000,2019,583190,1437010,2020200,INCOME
06079812301427000,2021,157784,0,157784,COST
06079812301427000,2020,114570,0,114570,COST
06079812301427000,2019,114570,0,114570,COST
06079812301430000,2021,199096,471604,670700,INCOME
06079812301430000,2020,114570,425530,540100,INCOME
06079812301430000,2019,114570,425530,540100,INCOME
06079812301440000,2021,206934,500866,707800,INCOME
06079812301440000,2020,118183,442417,560600,INCOME
06079812301440000,2019,118183,442417,560600,INCOME
06079812301450000,2021,206934,500866,707800,INCOME
06079812301450000,2020,118183,442417,560600,INCOME
06079812301450000,2019,118183,442417,560600,INCOME
06079812301470000,2021,313228,1145672,1458900,INCOME
06079812301470000,2020,164925,1096175,1261100,INCOME
06079812301470000,2019,164925,1096175,1261100,INCOME
06079812301480000,2021,206934,333666,540600,INCOME
06079812301480000,2020,118183,400917,519100,INCOME
06079812301480000,2019,118183,400917,519100,INCOME
06079812301497000,2021,162832,0,162832,COST
06079812301497000,2020,118183,0,118183,COST
06079812301497000,2019,118183,0,118183,COST
06079812301500000,2021,294101,205999,500100,INCOME
06079812301500000,2020,105613,350387,456000,INCOME
06079812301500000,2019,105613,350387,456000,INCOME
06079812301510000,2021,192447,286053,478500,MKT
06079812301510000,2020,139348,258952,398300,MKT
06079812301510000,2019,139348,258952,398300,MKT
06079812302015001,2021,62826,176874,239700,MKT
06079812302015001,2020,46217,140780,186997,COST
06079812302015001,2019,46217,140780,186997,COST
06079812302015002,2021,62107,173393,235500,MKT
06079812302015002,2020,45696,143350,189046,COST
06079812302015002,2019,45696,143350,189046,COST
06079812302015003,2021,59854,173346,233200,MKT
06079812302015003,2020,44061,143240,187301,COST
06079812302015003,2019,44061,143240,187301,COST
06079812302015004,2021,51032,177368,228400,MKT
06079812302015004,2020,35448,146930,182378,COST
06079812302015004,2019,35448,146930,182378,COST
06079812302015005,2021,50565,171235,221800,MKT
06079812302015005,2020,35128,140980,176108,COST
06079812302015005,2019,35128,140980,176108,COST
06079812302015006,2021,50038,171262,221300,MKT
06079812302015006,2020,34767,140980,175747,COST
06079812302015006,2019,34767,140980,175747,COST
06079812302015007,2021,58659,175741,234400,MKT
06079812302015007,2020,40666,220334,261000,MKT
06079812302015007,2019,40666,231434,272100,MKT
06079812302016500,2021,39711,0,39711,COST
06079812302016500,2020,28907,0,28907,COST
06079812302016500,2019,28907,0,28907,COST
06079812302030900,2021,180363,400637,581000,INCOME
06079812302030900,2020,105821,381179,487000,INCOME
06079812302030900,2019,105821,381179,487000,INCOME
06079812302040900,2021,180220,327180,507400,INCOME
06079812302040900,2020,105753,308647,414400,INCOME
06079812302040900,2019,105753,308647,414400,INCOME
06079812302050900,2021,181689,325711,507400,INCOME
06079812302050900,2020,106446,307954,414400,INCOME
06079812302050900,2019,106446,307954,414400,INCOME
06079812302060900,2021,284699,730101,1014800,INCOME
06079812302060900,2020,152737,676063,828800,INCOME
06079812302060900,2019,152737,676063,828800,INCOME
06079812302090000,2021,369523,321977,691500,INCOME
06079812302090000,2020,532100,134700,666800,INCOME
06079812302090000,2019,532100,134700,666800,INCOME
06079812302100000,2021,955360,6140940,7096300,INCOME
06079812302100000,2020,908298,3796602,4704900,INCOME
06079812302100000,2019,908298,3796602,4704900,INCOME
06079812302110000,2021,229839,531261,761100,INCOME
06079812302110000,2020,128590,493010,621600,INCOME
06079812302110000,2019,128590,493010,621600,INCOME
06079812302127000,2021,248803,0,248803,COST
06079812302127000,2020,179501,0,179501,COST
06079812302127000,2019,179501,0,179501,COST
06079812302170000,2021,283866,730934,1014800,INCOME
06079812302170000,2020,152377,676423,828800,INCOME
06079812302170000,2019,152377,676423,828800,INCOME
06079812302187000,2021,166554,0,166554,COST
06079812302187000,2020,120846,0,120846,COST
06079812302187000,2019,120846,0,120846,COST
06079812302197000,2021,221208,0,221208,COST
06079812302197000,2020,159858,0,159858,COST
06079812302197000,2019,159858,0,159858,COST
06079812302210000,2021,180516,295984,476500,INCOME
06079812302210000,2020,105893,319107,425000,INCOME
06079812302210000,2019,105893,319107,425000,INCOME
06079812302220000,2021,180516,336284,516800,INCOME
06079812302220000,2020,105893,313807,419700,INCOME
06079812302220000,2019,105893,313807,419700,INCOME
06079812302240000,2021,650725,1767170,2417895,COST
06079812302240000,2020,770763,1621037,2391800,INCOME
06079812302240000,2019,770763,1621037,2391800,INCOME
06079812302250000,2021,289118,478882,768000,INCOME
06079812302250000,2020,479007,294470,773477,COST
06079812302250000,2019,479007,294470,773477,COST
06079812302260000,2021,225314,545186,770500,INCOME
06079812302260000,2020,430481,342319,772800,INCOME
06079812302260000,2019,430481,342319,772800,INCOME
06079812302286500,2021,188106,0,188106,COST
06079812302286500,2020,227512,0,227512,COST
06079812302286500,2019,227512,0,227512,COST
06079812303010000,2021,201231,179269,380500,INCOME
06079812303010000,2020,115557,195243,310800,INCOME
06079812303010000,2019,115557,195243,310800,INCOME
06079812303020000,2021,165424,215076,380500,INCOME
06079812303020000,2020,98715,212085,310800,INCOME
06079812303020000,2019,98715,212085,310800,INCOME
06079812303030000,2021,138625,283775,422400,INCOME
06079812303030000,2020,85639,250961,336600,INCOME
06079812303030000,2019,85639,250961,336600,INCOME
06079812303040000,2021,189051,443649,632700,INCOME
06079812303040000,2020,109900,389500,499400,INCOME
06079812303040000,2019,109900,389500,499400,INCOME
06079812304010000,2021,172562,315038,487600,MKT
06079812304010000,2020,125142,299458,424600,MKT
06079812304010000,2019,125142,299458,424600,MKT
06079812304020000,2021,117893,280207,398100,MKT
06079812304020000,2020,85958,291042,377000,OVR
06079812304020000,2019,85958,291042,377000,MKT
06079812304047000,2021,190247,0,190247,COST
06079812304047000,2020,137777,0,137777,COST
06079812304047000,2019,137777,0,137777,COST
06079812305010000,2021,118423,326677,445100,MKT
06079812305010000,2020,86339,314461,400800,MKT
06079812305010000,2019,86339,314461,400800,MKT
06079812305030000,2021,119322,312078,431400,MKT
06079812305030000,2020,86985,270115,357100,MKT
06079812305030000,2019,86985,270115,357100,MKT
06079812305050000,2021,118423,315677,434100,MKT
06079812305050000,2020,86339,302461,388800,MKT
06079812305050000,2019,86339,302461,388800,MKT
06079812305070000,2021,118423,233277,351700,MKT
06079812305070000,2020,86339,234161,320500,MKT
06079812305070000,2019,86339,234161,320500,MKT
06079812305090000,2021,118423,249477,367900,MKT
06079812305090000,2020,86339,229461,315800,MKT
06079812305090000,2019,86339,229461,315800,MKT
06079812305110000,2021,118423,376077,494500,MKT
06079812305110000,2020,86339,348561,434900,MKT
06079812305110000,2019,86339,348561,434900,MKT
06079812305130000,2021,118848,357752,476600,MKT
06079812305130000,2020,86644,300856,387500,MKT
06079812305130000,2019,86644,300856,387500,MKT
06079812305150000,2021,117479,316821,434300,MKT
06079812305150000,2020,85661,268639,354300,MKT
06079812305150000,2019,85661,268639,354300,MKT
06079812305170000,2021,117479,353221,470700,MKT
06079812305170000,2020,85661,291839,377500,MKT
06079812305170000,2019,85661,291839,377500,MKT
06079812305190000,2021,117005,353195,470200,MKT
06079812305190000,2020,85319,307681,393000,MKT
06079812305190000,2019,85319,307681,393000,MKT
06079812305210000,2021,117005,354995,472000,MKT
06079812305210000,2020,85319,294281,379600,MKT
06079812305210000,2019,85319,294281,379600,MKT
06079812305230000,2021,118371,325529,443900,MKT
06079812305230000,2020,86302,313698,400000,MKT
06079812305230000,2019,86302,313698,400000,MKT
06079812306010900,2021,122574,330326,452900,MKT
06079812306010900,2020,89322,276278,365600,MKT
06079812306010900,2019,89322,276278,365600,MKT
06079812306030900,2021,120748,299452,420200,MKT
06079812306030900,2020,88010,229590,317600,MKT
06079812306030900,2019,88010,229590,317600,MKT
06079812306050000,2021,120748,307952,428700,MKT
06079812306050000,2020,88010,284890,372900,MKT
06079812306050000,2019,88010,284890,372900,MKT
06079812306070000,2021,120748,309352,430100,MKT
06079812306070000,2020,88010,239090,327100,MKT
06079812306070000,2019,88010,239090,327100,MKT
06079812306090000,2021,120748,291752,412500,MKT
06079812306090000,2020,88010,282290,370300,MKT
06079812306090000,2019,88010,282290,370300,MKT
06079812306110000,2021,122574,298326,420900,MKT
06079812306110000,2020,89322,284278,373600,MKT
06079812306110000,2019,89322,284278,373600,MKT
06079812306130000,2021,120733,257167,377900,MKT
06079812306130000,2020,87999,236601,324600,MKT
06079812306130000,2019,87999,236601,324600,MKT
06079812306150000,2021,119823,304777,424600,MKT
06079812306150000,2020,87345,295255,382600,MKT
06079812306150000,2019,87345,295255,382600,MKT
06079812306170000,2021,119823,269777,389600,MKT
06079812306170000,2020,87345,248055,335400,MKT
06079812306170000,2019,87345,248055,335400,MKT
06079812306190000,2021,122942,296058,419000,MKT
06079812306190000,2020,89586,241114,330700,MKT
06079812306190000,2019,89586,241114,330700,MKT
06079812306210000,2021,115659,303741,419400,MKT
06079812306210000,2020,84352,235048,319400,MKT
06079812306210000,2019,84352,235048,319400,MKT
06079812306230000,2021,120733,316467,437200,MKT
06079812306230000,2020,87999,303701,391700,MKT
06079812306230000,2019,87999,303701,391700,MKT
06079812307010900,2021,137089,334811,471900,MKT
06079812307010900,2020,99741,273259,373000,MKT
06079812307010900,2019,99741,273259,373000,MKT
06079812307040000,2021,121379,341021,462400,MKT
06079812307040000,2020,88463,321337,409800,MKT
06079812307040000,2019,88463,321337,409800,MKT
06079812307060000,2021,111048,274052,385100,MKT
06079812307060000,2020,81036,296964,378000,MKT
06079812307060000,2019,81036,296964,378000,MKT
06079812307080000,2021,145504,340096,485600,MKT
06079812307080000,2020,105774,322226,428000,MKT
06079812307080000,2019,105774,322226,428000,MKT
06079812307100000,2021,134636,336464,471100,MKT
06079812307100000,2020,97981,351019,449000,MKT
06079812307100000,2019,97981,351019,449000,MKT
06079812307120000,2021,130463,332637,463100,MKT
06079812307120000,2020,94986,331114,426100,MKT
06079812307120000,2019,94986,331114,426100,MKT
06079812307130000,2021,93734,244566,338300,MKT
06079812307130000,2020,68565,254335,322900,MKT
06079812307130000,2019,68565,254335,322900,MKT
06079812307150000,2021,92316,268284,360600,MKT
06079812307150000,2020,67542,217358,284900,MKT
06079812307150000,2019,67542,217358,284900,MKT
06079812307180000,2021,148973,323327,472300,MKT
06079812307180000,2020,108260,241740,350000,MKT
06079812307180000,2019,108260,241740,350000,MKT
06079812307200000,2021,118906,373994,492900,MKT
06079812307200000,2020,86686,349614,436300,OVR
06079812307200000,2019,86686,349614,436300,MKT
06079812307220000,2021,121636,323864,445500,MKT
06079812307220000,2020,88648,309052,397700,MKT
06079812307220000,2019,88648,309052,397700,MKT
06079812308030000,2021,117005,327195,444200,MKT
06079812308030000,2020,85319,315081,400400,MKT
06079812308030000,2019,85319,315081,400400,MKT
06079812308050000,2021,175863,331537,507400,INCOME
06079812308050000,2020,103693,310707,414400,INCOME
06079812308050000,2019,103693,310707,414400,INCOME
06079812308080000,2021,108786,302514,411300,MKT
06079812308080000,2020,79408,251992,331400,MKT
06079812308080000,2019,79408,251992,331400,MKT
06079812308100000,2021,108279,332321,440600,MKT
06079812308100000,2020,79043,231957,311000,MKT
06079812308100000,2019,79043,231957,311000,MKT
06079812308130000,2021,96733,280567,377300,MKT
06079812308130000,2020,70727,253673,324400,MKT
06079812308130000,2019,70727,248173,318900,MKT
06079812308140000,2021,96733,343667,440400,MKT
06079812308140000,2020,70727,322873,393600,MKT
06079812308140000,2019,70727,322873,393600,MKT
06079812308160000,2021,104300,399100,503400,MKT
06079812308160000,2020,76179,352421,428600,OVR
06079812308160000,2019,76179,352421,428600,MKT
06079812308200000,2021,86018,261082,347100,MKT
06079812308200000,2020,62998,227302,290300,MKT
06079812308200000,2019,62998,227302,290300,MKT
06079812311010000,2021,354068,0,354068,COST
06079812311010000,2020,522450,0,522450,COST
06079812311010000,2019,522450,0,522450,COST
06079812311030000,2021,1158638,2525862,3684500,INCOME
06079812311030000,2020,742373,2810827,3553200,INCOME
06079812311030000,2019,742373,2810827,3553200,INCOME
06079812311057000,2021,1361448,48340,1409788,COST
06079812311057000,2020,795485,46800,842285,COST
06079812311057000,2019,795485,46800,842285,COST
06079812311070000,2021,659704,497996,1157700,INCOME
06079812311070000,2020,583232,534668,1117900,INCOME
06079812311070000,2019,583232,534668,1117900,INCOME
06079812311170000,2021,1994619,832781,2827400,INCOME
06079812311170000,2020,1064633,1513830,2578463,COST
06079812311170000,2019,1064633,1513830,2578463,COST
06079812313010000,2021,3318012,937420,4255432,COST
06079812313010000,2020,1548312,893070,2441382,COST
06079812313010000,2019,740925,893070,1633995,COST
06079812314010000,2021,160928,347472,508400,MKT
06079812314010000,2020,116821,294379,411200,MKT
06079812314010000,2019,116821,294379,411200,MKT
06079812314030000,2021,139854,384846,524700,MKT
06079812314030000,2020,101724,336676,438400,MKT
06079812314030000,2019,101724,336676,438400,MKT
06079812314050000,2021,139854,362746,502600,MKT
06079812314050000,2020,101724,327176,428900,MKT
06079812314050000,2019,101724,327176,428900,MKT
06079812314070000,2021,114296,312304,426600,MKT
06079812314070000,2020,83372,257428,340800,MKT
06079812314070000,2019,83372,257428,340800,MKT
06079812314090000,2021,114296,347004,461300,MKT
06079812314090000,2020,83372,282728,366100,MKT
06079812314090000,2019,83372,282728,366100,MKT
06079812314110000,2021,114296,284500,398796,COST
06079812314110000,2020,83372,273028,356400,OVR
06079812314110000,2019,83372,273028,356400,INCOME
06079812314130000,2021,113838,325462,439300,MKT
06079812314130000,2020,83042,287058,370100,MKT
06079812314130000,2019,83042,287058,370100,MKT
06079812314150000,2021,113838,392562,506400,MKT
06079812314150000,2020,83042,312258,395300,MKT
06079812314150000,2019,83042,312258,395300,MKT
06079812315010000,2021,117005,330995,448000,MKT
06079812315010000,2020,85319,305281,390600,MKT
06079812315010000,2019,85319,305281,390600,MKT
06079812315030000,2021,117005,299595,416600,MKT
06079812315030000,2020,85319,245781,331100,MKT
06079812315030000,2019,85319,261681,347000,MKT
06079812315050000,2021,117005,309795,426800,MKT
06079812315050000,2020,85319,247381,332700,MKT
06079812315050000,2019,85319,247381,332700,MKT
06079812315070000,2021,117005,278895,395900,MKT
06079812315070000,2020,85319,251281,336600,MKT
06079812315070000,2019,85319,251281,336600,MKT
06079812315090000,2021,117005,302495,419500,MKT
06079812315090000,2020,85319,276581,361900,MKT
06079812315090000,2019,85319,276581,361900,MKT
06079812315100000,2021,116558,260042,376600,MKT
06079812315100000,2020,84998,211602,296600,MKT
06079812315100000,2019,84998,211602,296600,MKT
06079812315110000,2021,116558,276242,392800,MKT
06079812315110000,2020,84998,245702,330700,MKT
06079812315110000,2019,84998,165010,250008,COST
06079812315130000,2021,116109,315491,431600,MKT
06079812315130000,2020,84676,308824,393500,MKT
06079812315130000,2019,84676,308824,393500,MKT
06079812315150000,2021,116109,213191,329300,MKT
06079812315150000,2020,84676,106370,191046,OVR
06079812315150000,2019,84676,106370,191046,COST
06079812315170000,2021,116109,325091,441200,MKT
06079812315170000,2020,84676,316424,401100,MKT
06079812315170000,2019,84676,316424,401100,MKT
06079812316030000,2021,130463,316437,446900,MKT
06079812316030000,2020,94986,295514,390500,MKT
06079812316030000,2019,94986,295514,390500,MKT
06079812316060000,2021,130463,329437,459900,MKT
06079812316060000,2020,94986,276914,371900,MKT
06079812316060000,2019,94986,276914,371900,MKT
06079812316090000,2021,130463,357537,488000,MKT
06079812316090000,2020,94986,310514,405500,MKT
06079812316090000,2019,94986,310514,405500,MKT
06079812316100000,2021,106637,279963,386600,MKT
06079812316100000,2020,77862,239638,317500,MKT
06079812316100000,2019,77862,239638,317500,MKT
06079812316110000,2021,106637,391663,498300,MKT
06079812316110000,2020,77862,323438,401300,MKT
06079812316110000,2019,77862,333338,411200,MKT
06079812316120000,2021,130463,368437,498900,MKT
06079812316120000,2020,94986,336514,431500,MKT
06079812316120000,2019,94986,336514,431500,MKT
06079812316180000,2021,106637,301763,408400,MKT
06079812316180000,2020,77862,276138,354000,MKT
06079812316180000,2019,77862,276138,354000,MKT
06079812316190000,2021,129964,303536,433500,MKT
06079812316190000,2020,94629,258471,353100,MKT
06079812316190000,2019,94629,258471,353100,MKT
06079812316230000,2021,129464,438336,567800,MKT
06079812316230000,2020,94270,393530,487800,OVR
06079812316230000,2019,94270,393530,487800,MKT
06079812317010000,2021,95821,306579,402400,MKT
06079812317010000,2020,70070,270930,341000,MKT
06079812317010000,2019,70070,270930,341000,MKT
06079812317020000,2021,92316,233284,325600,MKT
06079812317020000,2020,67542,227558,295100,MKT
06079812317020000,2019,67542,227558,295100,MKT
06079812317030000,2021,108263,333337,441600,MKT
06079812317030000,2020,79032,280568,359600,MKT
06079812317030000,2019,79032,280568,359600,MKT
06079812317060000,2021,108263,304737,413000,MKT
06079812317060000,2020,79032,282968,362000,MKT
06079812317060000,2019,79032,282968,362000,MKT
06079812317080000,2021,108263,311837,420100,MKT
06079812317080000,2020,79032,289968,369000,MKT
06079812317080000,2019,79032,289968,369000,MKT
06079812317100000,2021,159889,265811,425700,INCOME
06079812317100000,2020,96051,257849,353900,INCOME
06079812317100000,2019,96051,257849,353900,INCOME
06079812317130000,2021,115206,284794,400000,MKT
06079812317130000,2020,84026,267574,351600,MKT
06079812317130000,2019,84026,267574,351600,MKT
06079812317150000,2021,113316,296084,409400,MKT
06079812317150000,2020,82667,246833,329500,MKT
06079812317150000,2019,82667,246833,329500,MKT
06079812317160000,2021,117064,300536,417600,MKT
06079812317160000,2020,85362,279638,365000,MKT
06079812317160000,2019,85362,279638,365000,MKT
06079812317170000,2021,111916,202340,314256,COST
06079812317170000,2020,81660,197470,279130,COST
06079812317170000,2019,81660,197470,279130,COST
06079812317180000,2021,117516,341984,459500,MKT
06079812317180000,2020,85687,318513,404200,OVR
06079812317180000,2019,85687,318513,404200,MKT
06079812318017000,2021,796838,19660,816498,COST
06079812318017000,2020,739530,19050,758580,COST
06079812318017000,2019,739530,19050,758580,COST
06079812319047000,2021,406649,0,406649,COST
06079812319047000,2020,291349,0,291349,COST
06079812319047000,2019,291349,0,291349,COST
06079812319090000,2021,183337,405663,589000,INCOME
06079812319090000,2020,107221,367679,474900,INCOME
06079812319090000,2019,107221,367679,474900,INCOME
06079812319100000,2021,183337,405663,589000,INCOME
06079812319100000,2020,107221,367679,474900,INCOME
06079812319100000,2019,107221,367679,474900,INCOME
06079812319117000,2021,148076,0,148076,COST
06079812319117000,2020,107617,0,107617,COST
06079812319117000,2019,107617,0,107617,COST
06079812319127000,2021,148076,0,148076,COST
06079812319127000,2020,107617,0,107617,COST
06079812319127000,2019,107617,0,107617,COST
06079812319137000,2021,151828,0,151828,COST
06079812319137000,2020,110305,0,110305,COST
06079812319137000,2019,110305,0,110305,COST
06079812321010000,2021,187183,445517,632700,INCOME
06079812321010000,2020,109026,390374,499400,INCOME
06079812321010000,2019,109026,390374,499400,INCOME
06079812321020000,2021,187699,483001,670700,INCOME
06079812321020000,2020,109267,409833,519100,INCOME
06079812321020000,2019,109267,409833,519100,INCOME
06079812321030000,2021,183026,405974,589000,INCOME
06079812321030000,2020,107075,367825,474900,INCOME
06079812321030000,2019,107075,367825,474900,INCOME
06079812321040000,2021,183248,405752,589000,INCOME
06079812321040000,2020,107180,367720,474900,INCOME
06079812321040000,2019,107180,367720,474900,INCOME
06079812321050000,2021,183355,354345,537700,INCOME
06079812321050000,2020,107230,464170,571400,INCOME
06079812321050000,2019,107230,464170,571400,INCOME
06079812321060000,2021,195188,376912,572100,INCOME
06079812321060000,2020,112759,335241,448000,INCOME
06079812321060000,2019,112759,335241,448000,INCOME
06079812321070000,2021,188145,362155,550300,INCOME
06079812321070000,2020,109476,326224,435700,INCOME
06079812321070000,2019,109476,326224,435700,INCOME
06079812322010000,2021,1229261,0,1229261,COST
06079812322010000,2020,1011874,0,1011874,COST
06079812322010000,2019,333492,0,333492,COST
06079812322100000,2021,165530,271770,437300,MKT
06079812322100000,2020,120113,249387,369500,MKT
06079812322100000,2019,120113,249387,369500,MKT
06079812322250000,2021,115598,0,115598,COST
06079812322250000,2020,84308,0,84308,COST
06079812322250000,2019,84308,0,84308,COST
06079812323010000,2021,114752,295248,410000,MKT
06079812323010000,2020,83700,270000,353700,MKT
06079812323010000,2019,83700,270000,353700,MKT
06079812323030000,2021,114752,349348,464100,MKT
06079812323030000,2020,83700,266100,349800,MKT
06079812323030000,2019,83700,266100,349800,MKT
06079812323050000,2021,114752,275548,390300,MKT
06079812323050000,2020,83700,253800,337500,MKT
06079812323050000,2019,83700,253800,337500,MKT
06079812323070000,2021,114752,285148,399900,MKT
06079812323070000,2020,83700,250800,334500,MKT
06079812323070000,2019,83700,249500,333200,MKT
06079812323090000,2021,114752,277348,392100,MKT
06079812323090000,2020,83700,255100,338800,MKT
06079812323090000,2019,83700,255100,338800,MKT
06079812323100900,2021,114752,295148,409900,MKT
06079812323100900,2020,83700,257600,341300,MKT
06079812323100900,2019,83700,257600,341300,MKT
06079812323100901,2021,114752,656448,771200,MKT
06079812323100901,2020,83700,641800,725500,COST
06079812323100901,2019,83700,641800,725500,COST
06079812323110000,2021,114752,307848,422600,MKT
06079812323110000,2020,83700,273000,356700,MKT
06079812323110000,2019,83700,273000,356700,MKT
06079812323130000,2021,114752,345948,460700,MKT
06079812323130000,2020,83700,305000,388700,MKT
06079812323130000,2019,83700,305000,388700,MKT
06079812324010000,2021,117005,304795,421800,MKT
06079812324010000,2020,85319,276281,361600,MKT
06079812324010000,2019,85319,276281,361600,MKT
06079812324030000,2021,112141,357859,470000,MKT
06079812324030000,2020,81822,335678,417500,MKT
06079812324030000,2019,81822,335678,417500,MKT
06079812324050000,2021,121664,266636,388300,MKT
06079812324050000,2020,88668,231132,319800,MKT
06079812324050000,2019,88668,231132,319800,MKT
06079812324070000,2021,117005,267495,384500,MKT
06079812324070000,2020,85319,260181,345500,MKT
06079812324070000,2019,85319,260181,345500,MKT
06079812324090000,2021,117005,325595,442600,MKT
06079812324090000,2020,85319,335881,421200,MKT
06079812324090000,2019,85319,335881,421200,MKT
06079812324110000,2021,117005,314995,432000,MKT
06079812324110000,2020,85319,255581,340900,MKT
06079812324110000,2019,85319,255581,340900,MKT
06079812324130000,2021,117005,309095,426100,MKT
06079812324130000,2020,85319,291781,377100,MKT
06079812324130000,2019,85319,291781,377100,MKT
06079812324150000,2021,107046,336554,443600,MKT
06079812324150000,2020,78156,252544,330700,MKT
06079812324150000,2019,78156,252544,330700,MKT
06079812324190000,2021,163461,344139,507600,MKT
06079812324190000,2020,118633,329367,448000,MKT
06079812324190000,2019,118633,329367,448000,MKT
06079812325010000,2021,130463,279137,409600,MKT
06079812325010000,2020,94986,263614,358600,MKT
06079812325010000,2019,94986,263614,358600,MKT
06079812325040000,2021,130463,313237,443700,MKT
06079812325040000,2020,94986,288514,383500,MKT
06079812325040000,2019,94986,288514,383500,MKT
06079812325060000,2021,107046,317454,424500,MKT
06079812325060000,2020,78156,296444,374600,OVR
06079812325060000,2019,78156,296444,374600,MKT
06079812325080000,2021,107046,299054,406100,MKT
06079812325080000,2020,78156,275144,353300,OVR
06079812325080000,2019,78156,275144,353300,MKT
06079812325100000,2021,107046,361954,469000,MKT
06079812325100000,2020,78156,244444,322600,MKT
06079812325100000,2019,78156,244444,322600,MKT
06079812325110000,2021,130463,330537,461000,MKT
06079812325110000,2020,94986,287914,382900,MKT
06079812325110000,2019,94986,287914,382900,MKT
06079812325130000,2021,107046,326554,433600,MKT
06079812325130000,2020,78156,305944,384100,MKT
06079812325130000,2019,78156,305944,384100,MKT
06079812325150000,2021,107046,300454,407500,MKT
06079812325150000,2020,78156,258244,336400,MKT
06079812325150000,2019,78156,258244,336400,MKT
06079812325170000,2021,119823,289277,409100,MKT
06079812325170000,2020,87345,238655,326000,MKT
06079812325170000,2019,87345,238655,326000,MKT
06079812325200000,2021,119823,331777,451600,MKT
06079812325200000,2020,87345,301455,388800,MKT
06079812325200000,2019,87345,301455,388800,MKT
06079812326010000,2021,142648,560352,703000,INCOME
06079812326010000,2020,103727,491173,594900,INCOME
06079812326010000,2019,103727,491173,594900,INCOME
06079812326040000,2021,120243,421657,541900,MKT
06079812326040000,2020,87647,352553,440200,MKT
06079812326040000,2019,87647,352553,440200,MKT
06079812326080000,2021,131946,380854,512800,MKT
06079812326080000,2020,96051,325749,421800,MKT
06079812326080000,2019,96051,325749,421800,MKT
06079812326100000,2021,131946,413154,545100,MKT
06079812326100000,2020,96051,359049,455100,MKT
06079812326100000,2019,96051,359049,455100,MKT
06079812326120000,2021,115659,350041,465700,MKT
06079812326120000,2020,84352,330448,414800,MKT
06079812326120000,2019,84352,330448,414800,MKT
06079812326140000,2021,115659,330641,446300,MKT
06079812326140000,2020,84352,321748,406100,MKT
06079812326140000,2019,84352,321748,406100,MKT
06079812326160000,2021,115659,250141,365800,MKT
06079812326160000,2020,84352,248348,332700,MKT
06079812326160000,2019,84352,248348,332700,MKT
06079812326180000,2021,115206,226094,341300,MKT
06079812326180000,2020,84026,220274,304300,MKT
06079812326180000,2019,84026,220274,304300,MKT
06079812326190000,2021,115206,271294,386500,MKT
06079812326190000,2020,84026,233374,317400,MKT
06079812326190000,2019,84026,233374,317400,MKT
06079812329017000,2021,603620,0,603620,COST
06079812329017000,2020,430062,0,430062,COST
06079812329017000,2019,430062,0,430062,COST
06079812330010000,2021,282346,158254,440600,INCOME
06079812330010000,2020,151721,194279,346000,INCOME
06079812330010000,2019,108598,237402,346000,INCOME
06079812330030000,2021,188737,400263,589000,INCOME
06079812330030000,2020,109753,365147,474900,INCOME
06079812330030000,2019,109753,365147,474900,INCOME
06079812330040000,2021,188476,318924,507400,INCOME
06079812330040000,2020,109631,304769,414400,INCOME
06079812330040000,2019,109631,304769,414400,INCOME
06079812330050000,2021,188206,537694,725900,INCOME
06079812330050000,2020,109504,0,109504,COST
06079812330050000,2019,109504,0,109504,COST
06079812330067000,2021,150544,0,150544,COST
06079812330067000,2020,109386,0,109386,COST
06079812330067000,2019,109386,0,109386,COST
06079812330077000,2021,150379,0,150379,COST
06079812330077000,2020,109267,0,109267,COST
06079812330077000,2019,109267,0,109267,COST
06079812330087000,2021,154712,0,154712,COST
06079812330087000,2020,112370,0,112370,COST
06079812330087000,2019,112370,0,112370,COST
06079812331010000,2021,180247,429453,609700,INCOME
06079812331010000,2020,105766,383334,489100,INCOME
06079812331010000,2019,105766,383334,489100,INCOME
06079812331027000,2021,145693,3150,148843,COST
06079812331027000,2020,105910,3710,109620,COST
06079812331027000,2019,105910,3710,109620,COST
06079812331030000,2021,181653,335147,516800,INCOME
06079812331030000,2020,106429,313271,419700,INCOME
06079812331030000,2019,106429,313271,419700,INCOME
06079812331040000,2021,181644,325756,507400,INCOME
06079812331040000,2020,106425,307975,414400,INCOME
06079812331040000,2019,106425,307975,414400,INCOME
06079812331057000,2021,146722,0,146722,COST
06079812331057000,2020,106648,0,106648,COST
06079812331057000,2019,106648,0,106648,COST
06079812331067000,2021,146288,0,146288,COST
06079812331067000,2020,106336,0,106336,COST
06079812331067000,2019,106336,0,106336,COST
06079812331075001,2021,60940,192260,253200,MKT
06079812331075001,2020,44849,231851,276700,MKT
06079812331075001,2019,44849,231851,276700,MKT
06079812331076500,2021,29479,0,29479,COST
06079812331076500,2020,21549,0,21549,COST
06079812331076500,2019,21549,0,21549,COST
06079812331085002,2021,56702,144398,201100,MKT
06079812331085002,2020,41773,186927,228700,MKT
06079812331085002,2019,41773,186927,228700,MKT
06079812331095003,2021,56718,159882,216600,MKT
06079812331095003,2020,41784,186916,228700,MKT
06079812331095003,2019,41784,186916,228700,MKT
06079812331105004,2021,60955,161045,222000,MKT
06079812331105004,2020,44860,193340,238200,MKT
06079812331105004,2019,44860,193340,238200,MKT
06079812331117000,2021,208149,0,208149,COST
06079812331117000,2020,150550,0,150550,COST
06079812331117000,2019,150550,0,150550,COST
06079812331125000,2021,49597,0,49597,COST
06079812331125000,2020,35990,0,35990,COST
06079812331125000,2019,35990,0,35990,COST
06079812331125001,2021,59873,168327,228200,MKT
06079812331125001,2020,44073,211127,255200,MKT
06079812331125001,2019,44073,211127,255200,MKT
06079812331125002,2021,59873,177927,237800,MKT
06079812331125002,2020,44073,222027,266100,MKT
06079812331125002,2019,44073,222027,266100,MKT
06079812331125003,2021,59873,183427,243300,MKT
06079812331125003,2020,44073,228727,272800,MKT
06079812331125003,2019,44073,228727,272800,MKT
06079812331125004,2021,58909,186491,245400,MKT
06079812331125004,2020,43372,230228,273600,MKT
06079812331125004,2019,43372,230228,273600,MKT
06079812331135005,2021,59873,174727,234600,MKT
06079812331135005,2020,44073,218227,262300,MKT
06079812331135005,2019,44073,218227,262300,MKT
06079812331135006,2021,60372,168028,228400,MKT
06079812331135006,2020,44435,211665,256100,MKT
06079812331135006,2019,44435,211665,256100,MKT
06079812331135007,2021,60468,169232,229700,MKT
06079812331135007,2020,44505,212595,257100,MKT
06079812331135007,2019,44505,212595,257100,MKT
06079812331135008,2021,66370,163730,230100,MKT
06079812331135008,2020,48789,207111,255900,MKT
06079812331135008,2019,48789,207111,255900,MKT
06079812331145009,2021,59873,168027,227900,MKT
06079812331145009,2020,44073,211627,255700,MKT
06079812331145009,2019,44073,211627,255700,MKT
06079812331145010,2021,59873,169027,228900,MKT
06079812331145010,2020,44073,212227,256300,MKT
06079812331145010,2019,44073,212227,256300,MKT
06079812331145011,2021,59873,168327,228200,MKT
06079812331145011,2020,44073,211627,255700,MKT
06079812331145011,2019,44073,211627,255700,MKT
06079812331145012,2021,61765,165835,227600,MKT
06079812331145012,2020,45447,209553,255000,MKT
06079812331145012,2019,45447,209553,255000,MKT
06079812331150000,2021,187795,444905,632700,INCOME
06079812331150000,2020,109312,390088,499400,INCOME
06079812331150000,2019,109312,390088,499400,INCOME
06079812331160000,2021,189546,387354,576900,INCOME
06079812331160000,2020,110131,436669,546800,INCOME
06079812331160000,2019,110131,436669,546800,INCOME
06079812331180000,2021,145474,0,145474,COST
06079812331180000,2020,105753,0,105753,COST
06079812331180000,2019,105753,0,105753,COST
06079812332010000,2021,114752,298048,412800,MKT
06079812332010000,2020,83700,236300,320000,MKT
06079812332010000,2019,83700,236300,320000,MKT
06079812332030000,2021,114752,213448,328200,MKT
06079812332030000,2020,83700,242500,326200,MKT
06079812332030000,2019,83700,242500,326200,MKT
06079812332050000,2021,114752,318648,433400,MKT
06079812332050000,2020,83700,228900,312600,MKT
06079812332050000,2019,83700,228900,312600,MKT
06079812332070000,2021,114752,277430,392182,COST
06079812332070000,2020,83700,273260,356960,COST
06079812332070000,2019,83700,236150,319850,COST
06079812332090000,2021,114752,327048,441800,MKT
06079812332090000,2020,83700,308600,392300,MKT
06079812332090000,2019,83700,308600,392300,MKT
06079812332100000,2021,190301,462699,653000,INCOME
06079812332100000,2020,110483,418217,528700,INCOME
06079812332100000,2019,110483,418217,528700,INCOME
06079812332130000,2021,127619,352081,479700,MKT
06079812332130000,2020,92945,281455,374400,MKT
06079812332130000,2019,92945,281455,374400,MKT
06079812332150000,2021,115040,259560,374600,MKT
06079812332150000,2020,83907,223993,307900,MKT
06079812332150000,2019,83907,173180,257087,COST
06079812332170000,2021,114752,291348,406100,MKT
06079812332170000,2020,83700,257000,340700,MKT
06079812332170000,2019,83700,257000,340700,MKT
06079812333010000,2021,117005,402195,519200,MKT
06079812333010000,2020,85319,291181,376500,MKT
06079812333010000,2019,85319,330481,415800,MKT
06079812333030000,2021,117005,365595,482600,MKT
06079812333030000,2020,85319,315381,400700,MKT
06079812333030000,2019,85319,315381,400700,MKT
06079812333050000,2021,117005,257895,374900,MKT
06079812333050000,2020,85319,248581,333900,MKT
06079812333050000,2019,85319,248581,333900,MKT
06079812333070000,2021,117005,315295,432300,MKT
06079812333070000,2020,85319,265681,351000,MKT
06079812333070000,2019,85319,265681,351000,MKT
06079812333090000,2021,117005,292795,409800,MKT
06079812333090000,2020,85319,239481,324800,MKT
06079812333090000,2019,85319,239481,324800,MKT
06079812333110000,2021,117450,353350,470800,MKT
06079812333110000,2020,85639,297261,382900,MKT
06079812333110000,2019,85639,297261,382900,MKT
06079812333130000,2021,117450,334950,452400,MKT
06079812333130000,2020,85639,314461,400100,MKT
06079812333130000,2019,85639,314461,400100,MKT
06079812333150000,2021,117450,340550,458000,MKT
06079812333150000,2020,85639,301161,386800,MKT
06079812333150000,2019,85639,301161,386800,MKT
06079812333170000,2021,117450,344050,461500,MKT
06079812333170000,2020,85639,285661,371300,MKT
06079812333170000,2019,85639,288661,374300,MKT
06079812333190000,2021,117005,351295,468300,MKT
06079812333190000,2020,85319,326981,412300,MKT
06079812333190000,2019,85319,326981,412300,MKT
06079812334010000,2021,107046,310954,418000,MKT
06079812334010000,2020,78156,265644,343800,MKT
06079812334010000,2019,78156,265644,343800,MKT
06079812334030000,2021,150122,388678,538800,MKT
06079812334030000,2020,109083,326117,435200,MKT
06079812334030000,2019,109083,326117,435200,MKT
06079812334050000,2021,107046,336854,443900,MKT
06079812334050000,2020,78156,297844,376000,MKT
06079812334050000,2019,78156,297844,376000,MKT
06079812334060000,2021,107046,351554,458600,MKT
06079812334060000,2020,78156,327444,405600,MKT
06079812334060000,2019,78156,327444,405600,MKT
06079812334090000,2021,107046,320354,427400,MKT
06079812334090000,2020,78156,312044,390200,OVR
06079812334090000,2019,78156,312044,390200,MKT
06079812334110000,2021,107453,251147,358600,MKT
06079812334110000,2020,78449,223551,302000,MKT
06079812334110000,2019,78449,223551,302000,MKT
06079812334130000,2021,107453,297347,404800,MKT
06079812334130000,2020,78449,250551,329000,MKT
06079812334130000,2019,78449,264751,343200,MKT
06079812334160000,2021,107453,290947,398400,MKT
06079812334160000,2020,78449,253151,331600,OVR
06079812334160000,2019,78449,253151,331600,MKT
06079812334180000,2021,107046,294354,401400,MKT
06079812334180000,2020,78156,284844,363000,MKT
06079812334180000,2019,78156,284844,363000,MKT
06079812334200000,2021,107046,352754,459800,MKT
06079812334200000,2020,78156,337844,416000,MKT
06079812334200000,2019,78156,337844,416000,MKT
06079812334220000,2021,107046,286354,393400,MKT
06079812334220000,2020,78156,254244,332400,MKT
06079812334220000,2019,78156,254244,332400,MKT
06079812335020000,2021,108263,344137,452400,MKT
06079812335020000,2020,79032,310268,389300,MKT
06079812335020000,2019,79032,310268,389300,MKT
06079812335040000,2021,113416,266384,379800,MKT
06079812335040000,2020,82739,241761,324500,MKT
06079812335040000,2019,82739,241761,324500,MKT
06079812335050000,2021,102838,244762,347600,MKT
06079812335050000,2020,75126,235974,311100,MKT
06079812335050000,2019,75126,235974,311100,MKT
06079812335060000,2021,108263,403537,511800,MKT
06079812335060000,2020,79032,327068,406100,OVR
06079812335060000,2019,79032,327068,406100,MKT
06079812335080000,2021,108263,312537,420800,MKT
06079812335080000,2020,79032,299900,378932,COST
06079812335080000,2019,79032,119140,198172,COST
06079812335100000,2021,108263,321137,429400,MKT
06079812335100000,2020,79032,263168,342200,MKT
06079812335100000,2019,79032,263168,342200,MKT
06079812335120000,2021,129464,309936,439400,MKT
06079812335120000,2020,94270,253430,347700,MKT
06079812335120000,2019,94270,253430,347700,MKT
06079812335150000,2021,129464,339236,468700,MKT
06079812335150000,2020,94270,331830,426100,MKT
06079812335150000,2019,94270,331830,426100,MKT
06079812335160000,2021,105815,319685,425500,MKT
06079812335160000,2020,77269,276731,354000,MKT
06079812335160000,2019,77269,276731,354000,MKT
06079812335180000,2021,99417,366983,466400,MKT
06079812335180000,2020,72661,320339,393000,MKT
06079812335180000,2019,72661,320339,393000,MKT
06079812335200000,2021,111830,306870,418700,MKT
06079812335200000,2020,81598,236902,318500,MKT
06079812335200000,2019,81598,236902,318500,MKT
06079812338017000,2021,321972,0,321972,COST
06079812338017000,2020,231444,0,231444,COST
06079812338017000,2019,231444,0,231444,COST
06079812341010000,2021,140039,368661,508700,MKT
06079812341010000,2020,101857,305243,407100,MKT
06079812341010000,2019,101857,293543,395400,MKT
06079812341040000,2021,224433,420490,644923,COST
06079812341040000,2020,162155,406980,569135,COST
06079812341040000,2019,162155,406980,569135,COST
06079812341050000,2021,140039,376961,517000,MKT
06079812341050000,2020,101857,365143,467000,OVR
06079812341050000,2019,101857,365143,467000,MKT
06079812341067000,2021,163518,0,163518,COST
06079812341067000,2020,118674,0,118674,COST
06079812341067000,2019,118674,0,118674,COST
06079812341087000,2021,163518,0,163518,COST
06079812341087000,2020,118674,0,118674,COST
06079812341087000,2019,118674,0,118674,COST
06079812341090000,2021,134276,305924,440200,MKT
06079812341090000,2020,97723,275277,373000,MKT
06079812341090000,2019,97723,275277,373000,MKT
06079812341107000,2021,134276,0,134276,COST
06079812341107000,2020,97723,0,97723,COST
06079812341107000,2019,97723,0,97723,COST
06079812341110000,2021,134276,309424,443700,MKT
06079812341110000,2020,97723,275577,373300,MKT
06079812341110000,2019,97723,275577,373300,MKT
06079812341127000,2021,134276,0,134276,COST
06079812341127000,2020,97723,0,97723,COST
06079812341127000,2019,97723,0,97723,COST
06079812342010000,2021,250800,510300,761100,INCOME
06079812342010000,2020,137937,483663,621600,INCOME
06079812342010000,2019,137937,483663,621600,INCOME
06079812342040000,2021,260674,442326,703000,INCOME
06079812342040000,2020,142286,452614,594900,INCOME
06079812342040000,2019,142286,452614,594900,INCOME
06079812342050000,2021,126658,347242,473900,MKT
06079812342050000,2020,92255,332545,424800,MKT
06079812342050000,2019,92255,332545,424800,MKT
06079812342060000,2021,135817,340283,476100,MKT
06079812342060000,2020,98829,339471,438300,MKT
06079812342060000,2019,98829,364771,463600,MKT
06079812342070000,2021,135817,382583,518400,MKT
06079812342070000,2020,98829,350871,449700,MKT
06079812342070000,2019,98829,350871,449700,MKT
06079812342080000,2021,135817,353983,489800,MKT
06079812342080000,2020,98829,332971,431800,MKT
06079812342080000,2019,98829,375171,474000,MKT
06079812342090000,2021,136698,389002,525700,MKT
06079812342090000,2020,99461,371739,471200,OVR
06079812342090000,2019,99461,371739,471200,MKT
06079812342100000,2021,136698,354502,491200,MKT
06079812342100000,2020,99461,305339,404800,MKT
06079812342100000,2019,99461,305339,404800,MKT
06079812342110000,2021,136698,381602,518300,MKT
06079812342110000,2020,99461,341739,441200,MKT
06079812342110000,2019,99461,341739,441200,MKT
06079812342120000,2021,136698,347602,484300,MKT
06079812342120000,2020,99461,333139,432600,MKT
06079812342120000,2019,99461,333139,432600,MKT
06079812343040000,2021,106227,286973,393200,MKT
06079812343040000,2020,77566,241334,318900,MKT
06079812343040000,2019,77566,241334,318900,MKT
06079812343060000,2021,147144,356356,503500,MKT
06079812343060000,2020,106949,371651,478600,OVR
06079812343060000,2019,106949,371651,478600,MKT
06079812343080000,2021,106227,285173,391400,MKT
06079812343080000,2020,77566,267534,345100,MKT
06079812343080000,2019,77566,267534,345100,MKT
06079812343100000,2021,114258,312442,426700,MKT
06079812343100000,2020,83344,273156,356500,MKT
06079812343100000,2019,83344,276756,360100,MKT
06079812343120000,2021,156064,265936,422000,MKT
06079812343120000,2020,113338,231962,345300,MKT
06079812343120000,2019,113338,231962,345300,MKT
06079812343140000,2021,145000,369600,514600,MKT
06079812343140000,2020,105413,344087,449500,OVR
06079812343140000,2019,105413,344087,449500,MKT
06079812343300000,2021,169921,250679,420600,MKT
06079812343300000,2020,123253,225147,348400,MKT
06079812343300000,2019,123253,225147,348400,MKT
06079812343480000,2021,127306,257694,385000,MKT
06079812343480000,2020,92720,256880,349600,MKT
06079812343480000,2019,92720,256880,349600,MKT
06079812343500000,2021,127306,405794,533100,MKT
06079812343500000,2020,92720,348480,441200,OVR
06079812343500000,2019,92720,348480,441200,MKT
06079812343550000,2021,98183,18090,116273,COST
06079812343550000,2020,71772,17810,89582,COST
06079812343550000,2019,71772,17810,89582,COST
06079812343570000,2021,144881,338019,482900,MKT
06079812343570000,2020,105328,341572,446900,MKT
06079812343570000,2019,105328,341572,446900,MKT
06079812343600000,2021,197359,354041,551400,MKT
06079812343600000,2020,142854,309546,452400,MKT
06079812343600000,2019,142854,309546,452400,MKT
06079812344020000,2021,108263,295137,403400,MKT
06079812344020000,2020,79032,272668,351700,MKT
06079812344020000,2019,79032,272668,351700,MKT
06079812344040000,2021,108263,287437,395700,MKT
06079812344040000,2020,79032,243768,322800,MKT
06079812344040000,2019,79032,243768,322800,MKT
06079812344060000,2021,131946,342054,474000,MKT
06079812344060000,2020,96051,290449,386500,MKT
06079812344060000,2019,96051,290449,386500,MKT
06079812344090000,2021,159889,262511,422400,INCOME
06079812344090000,2020,96051,325649,421700,INCOME
06079812344090000,2019,96051,325649,421700,INCOME
06079812344150000,2021,108263,230537,338800,INCOME
06079812344150000,2020,79032,245368,324400,INCOME
06079812344150000,2019,79032,245368,324400,INCOME
06079812344200000,2021,109234,293966,403200,MKT
06079812344200000,2020,79731,283869,363600,MKT
06079812344200000,2019,79731,283869,363600,MKT
06079812344250000,2021,109466,287834,397300,MKT
06079812344250000,2020,79897,245103,325000,MKT
06079812344250000,2019,79897,245103,325000,MKT
06079812344270000,2021,109066,329334,438400,MKT
06079812344270000,2020,79610,289890,369500,MKT
06079812344270000,2019,79610,289390,369000,MKT
06079812344300000,2021,109066,228834,337900,MKT
06079812344300000,2020,79610,221490,301100,MKT
06079812344300000,2019,79610,221490,301100,MKT
06079812344400000,2021,191649,441051,632700,INCOME
06079812344400000,2020,111112,388288,499400,INCOME
06079812344400000,2019,111112,388288,499400,INCOME
06079812353010000,2021,145775,265625,411400,MKT
06079812353010000,2020,105969,228331,334300,MKT
06079812353010000,2019,105969,228331,334300,MKT
06079812353040000,2021,103559,358741,462300,MKT
06079812353040000,2020,75645,338355,414000,MKT
06079812353040000,2019,75645,338355,414000,MKT
06079812353060000,2021,106621,329479,436100,MKT
06079812353060000,2020,77850,317850,395700,MKT
06079812353060000,2019,77850,317850,395700,MKT
06079812359027000,2021,1053329,18290,1071619,COST
06079812359027000,2020,870320,17710,888030,COST
06079812359027000,2019,870320,17710,888030,COST
06079812359030000,2021,1140934,2567066,3708000,INCOME
06079812359030000,2020,900622,2512778,3413400,INCOME
06079812359030000,2019,900622,2512778,3413400,INCOME
06079812359050000,2021,514326,555074,1069400,INCOME
06079812359050000,2020,640196,218804,859000,INCOME
06079812359050000,2019,640196,218804,859000,INCOME
06079812359090000,2021,1154232,1092270,2246502,COST
06079812359090000,2020,905103,998697,1903800,INCOME
06079812359090000,2019,905103,998697,1903800,INCOME
06079812359100000,2021,97004,0,97004,COST
06079812359100000,2020,248331,0,248331,COST
06079812359100000,2019,248331,0,248331,COST
06079812359110000,2021,105846,123730,229576,COST
06079812359110000,2020,189135,105630,294765,COST
06079812359110000,2019,189135,105630,294765,COST
06079812359120000,2021,313212,154190,467402,COST
06079812359120000,2020,366155,133300,499455,COST
06079812359120000,2019,366155,133300,499455,COST
06079812359150000,2021,3027160,0,3027160,COST
06079812359150000,2020,1367978,0,1367978,COST
06079812359150000,2019,1367978,0,1367978,COST
06079812359160000,2021,2183177,1767923,3951100,INCOME
06079812359160000,2020,1014251,2155549,3169800,INCOME
06079812359160000,2019,1014251,2155549,3169800,INCOME
06079812360207000,2021,616271,0,616271,COST
06079812360207000,2020,438947,0,438947,COST
06079812360207000,2019,438947,0,438947,COST
06079812369030000,2021,328551,206549,535100,MKT
06079812369030000,2020,274719,141081,415800,MKT
06079812369030000,2019,274719,141081,415800,MKT
06079812369050000,2021,280680,231720,512400,MKT
06079812369050000,2020,253867,160133,414000,MKT
06079812369050000,2019,253867,160133,414000,MKT
06079812369070000,2021,280680,269020,549700,MKT
06079812369070000,2020,253867,262533,516400,MKT
06079812369070000,2019,253867,262533,516400,MKT
06079812369090000,2021,328551,292149,620700,MKT
06079812369090000,2020,274719,248881,523600,OVR
06079812369090000,2019,274719,248881,523600,MKT
06079812369110000,2021,328551,242349,570900,MKT
06079812369110000,2020,274719,170481,445200,MKT
06079812369110000,2019,274719,170481,445200,MKT
06079812369130000,2021,328551,154149,482700,MKT
06079812369130000,2020,274719,111381,386100,MKT
06079812369130000,2019,274719,111381,386100,MKT
06079812369150000,2021,297344,267556,564900,MKT
06079812369150000,2020,261313,258087,519400,MKT
06079812369150000,2019,261313,258087,519400,MKT
06079812369180000,2021,297344,386956,684300,MKT
06079812369180000,2020,261313,295887,557200,MKT
06079812369180000,2019,261313,295887,557200,MKT
06079812369200000,2021,297344,514910,812254,COST
06079812369200000,2020,261313,452430,713743,COST
06079812369200000,2019,261313,427960,689273,COST
06079812369220000,2021,297344,259256,556600,MKT
06079812369220000,2020,261313,226787,488100,MKT
06079812369220000,2019,261313,226787,488100,MKT
06079812369250000,2021,297344,343810,641154,COST
06079812369250000,2020,261313,306387,567700,OVR
06079812369250000,2019,261313,306387,567700,MKT
06079812369270000,2021,289848,286160,576008,COST
06079812369270000,2020,412643,251480,664123,COST
06079812369270000,2019,412643,251480,664123,COST
06079812369290000,2021,232598,360102,592700,INCOME
06079812369290000,2020,503917,71183,575100,INCOME
06079812369290000,2019,503917,71183,575100,INCOME
06079812369320000,2021,232877,357523,590400,INCOME
06079812369320000,2020,504175,47390,551565,COST
06079812369320000,2019,503917,47390,551307,COST
06079812369340000,2021,232598,440100,672698,COST
06079812369340000,2020,503917,54583,558500,INCOME
06079812369340000,2019,503917,54583,558500,INCOME
06079812369360000,2021,238121,532380,770501,COST
06079812369360000,2020,509008,81592,590600,INCOME
06079812369360000,2019,509008,77590,586598,COST
06079812369380000,2021,197377,327423,524800,INCOME
06079812369380000,2020,469690,123210,592900,INCOME
06079812369380000,2019,469690,92150,561840,COST
06079812369400000,2021,232598,417500,650098,COST
06079812369400000,2020,503917,114210,618127,COST
06079812369400000,2019,503917,114210,618127,COST
06079812369420000,2021,259406,240706,500112,MRA
06079812369420000,2020,528023,157380,685403,COST
06079812369420000,2019,528023,157380,685403,COST
06079812369450000,2021,284469,280531,565000,INCOME
06079812369450000,2020,549303,7097,556400,INCOME
06079812369450000,2019,549303,7097,556400,INCOME
06079812369480000,2021,372802,106260,479062,COST
06079812369480000,2020,616768,175220,791988,COST
06079812369480000,2019,616768,175220,791988,COST
06079812369510000,2021,330625,1355775,1686400,INCOME
06079812369510000,2020,585849,693251,1279100,INCOME
06079812369510000,2019,585849,693251,1279100,INCOME
06079812401010000,2021,292805,701895,994700,INCOME
06079812401010000,2020,481615,316185,797800,INCOME
06079812401010000,2019,481615,316185,797800,INCOME
06079812401050000,2021,305638,465762,771400,INCOME
06079812401050000,2020,108931,554469,663400,INCOME
06079812401050000,2019,108931,1015969,1124900,INCOME
06079812401070000,2021,338795,192105,530900,MKT
06079812401070000,2020,278980,128220,407200,MKT
06079812401070000,2019,278980,128220,407200,MKT
06079812401090000,2021,294326,233074,527400,MKT
06079812401090000,2020,259980,173620,433600,MKT
06079812401090000,2019,259980,173620,433600,MKT
06079812401120000,2021,294326,216174,510500,MKT
06079812401120000,2020,259980,153220,413200,MKT
06079812401120000,2019,259980,153220,413200,MKT
06079812401140000,2021,294326,397110,691436,COST
06079812401140000,2020,259980,325960,585940,COST
06079812401140000,2019,259980,325960,585940,COST
06079812401160000,2021,336767,168033,504800,MKT
06079812401160000,2020,278141,162059,440200,MKT
06079812401160000,2019,278141,162059,440200,MKT
06079812401190000,2021,336767,236233,573000,MKT
06079812401190000,2020,278141,149359,427500,OVR
06079812401190000,2019,278141,149359,427500,MKT
06079812401210000,2021,313713,825187,1138900,INCOME
06079812401210000,2020,271030,451970,723000,INCOME
06079812401210000,2019,271030,451970,723000,INCOME
06079812401280000,2021,453181,1132419,1585600,INCOME
06079812401280000,2020,580712,632088,1212800,INCOME
06079812401280000,2019,580712,632088,1212800,INCOME
06079812402010000,2021,340670,634430,975100,INCOME
06079812402010000,2020,513888,225812,739700,INCOME
06079812402010000,2019,513888,225812,739700,INCOME
06079812402060000,2021,306708,388992,695700,INCOME
06079812402060000,2020,422847,268653,691500,INCOME
06079812402060000,2019,422847,268653,691500,INCOME
06079812402090000,2021,451986,403614,855600,INCOME
06079812402090000,2020,320445,345455,665900,INCOME
06079812402090000,2019,320445,345455,665900,INCOME
06079812402120000,2021,327784,0,327784,COST
06079812402120000,2020,435058,0,435058,COST
06079812402120000,2019,435058,0,435058,COST
06079812402140000,2021,306708,1105392,1412100,INCOME
06079812402140000,2020,422847,477553,900400,INCOME
06079812402140000,2019,422847,477553,900400,INCOME
06079812402160000,2021,313269,208231,521500,MKT
06079812402160000,2020,268238,131462,399700,OVR
06079812402160000,2019,268238,131462,399700,MKT
06079812402180000,2021,355517,126683,482200,MKT
06079812402180000,2020,285799,143201,429000,MKT
06079812402180000,2019,285799,143201,429000,MKT
06079812402210000,2021,355517,251583,607100,MKT
06079812402210000,2020,285799,237801,523600,MKT
06079812402210000,2019,285799,237801,523600,MKT
06079812402240000,2021,390914,169786,560700,INCOME
06079812402240000,2020,469154,133200,602354,COST
06079812402240000,2019,469154,133200,602354,COST
06079812402280000,2021,342571,302550,645121,COST
06079812402280000,2020,515114,170686,685800,INCOME
06079812402280000,2019,515114,170686,685800,INCOME
06079812403010000,2021,293483,151760,445243,COST
06079812403010000,2020,482092,142808,624900,INCOME
06079812403010000,2019,482092,142808,624900,INCOME
06079812403040000,2021,98558,302142,400700,INCOME
06079812403040000,2020,302082,78330,380412,COST
06079812403040000,2019,302082,78330,380412,COST
06079812403060000,2021,298594,215906,514500,MKT
06079812403060000,2020,261863,152337,414200,MKT
06079812403060000,2019,261863,152337,414200,MKT
06079812403080000,2021,298594,236106,534700,MKT
06079812403080000,2020,261863,127037,388900,MKT
06079812403080000,2019,261863,127037,388900,MKT
06079812403110000,2021,372798,160802,533600,MKT
06079812403110000,2020,292681,156419,449100,MKT
06079812403110000,2019,292681,156419,449100,MKT
06079812403140000,2021,386607,165893,552500,MKT
06079812403140000,2020,298066,161534,459600,MKT
06079812403140000,2019,298066,161534,459600,MKT
06079812403160000,2021,285893,236607,522500,MKT
06079812403160000,2020,256219,153781,410000,MKT
06079812403160000,2019,256219,153781,410000,MKT
06079812403180000,2021,273137,169163,442300,MKT
06079812403180000,2020,250423,136877,387300,MKT
06079812403180000,2019,250423,136877,387300,MKT
06079812403200000,2021,298194,248106,546300,MKT
06079812403200000,2020,261688,140112,401800,MKT
06079812403200000,2019,261688,140112,401800,MKT
06079812403240000,2021,420170,95530,515700,INCOME
06079812403240000,2020,309895,189905,499800,INCOME
06079812403240000,2019,309895,189905,499800,INCOME
06079812403280000,2021,308267,765133,1073400,INCOME
06079812403280000,2020,492350,280250,772600,INCOME
06079812403280000,2019,492350,280250,772600,INCOME
06079812404010000,2021,310796,1346504,1657300,INCOME
06079812404010000,2020,494076,312324,806400,INCOME
06079812404010000,2019,494076,312324,806400,INCOME
06079812404060000,2021,291028,114872,405900,MKT
06079812404060000,2020,258516,60684,319200,MKT
06079812404060000,2019,258516,60684,319200,MKT
06079812404080000,2021,291028,176072,467100,MKT
06079812404080000,2020,258516,138084,396600,MKT
06079812404080000,2019,258516,138084,396600,MKT
06079812404100000,2021,281336,207564,488900,MKT
06079812404100000,2020,254164,145936,400100,MKT
06079812404100000,2019,254164,145936,400100,MKT
06079812404120000,2021,300461,204739,505200,MKT
06079812404120000,2020,262683,200017,462700,MKT
06079812404120000,2019,262683,200017,462700,MKT
06079812404140000,2021,291028,375572,666600,MKT
06079812404140000,2020,258516,265184,523700,MKT
06079812404140000,2019,258516,265184,523700,MKT
06079812404160000,2021,297093,0,297093,COST
06079812404160000,2020,261203,0,261203,COST
06079812404160000,2019,261203,0,261203,COST
06079812404180000,2021,297093,0,297093,COST
06079812404180000,2020,261203,0,261203,COST
06079812404180000,2019,261203,0,261203,COST
06079812404240000,2021,558516,1140770,1699286,COST
06079812404240000,2020,546632,1067730,1614362,COST
06079812404240000,2019,546632,1067730,1614362,COST
06079812404280000,2021,321455,257370,578825,COST
06079812404280000,2020,501265,243320,744585,COST
06079812404280000,2019,501265,243320,744585,COST
06079812405010000,2021,301848,476670,778518,COST
06079812405010000,2020,263290,393120,656410,COST
06079812405010000,2019,263290,393120,656410,COST
06079812405040000,2021,291028,265172,556200,MKT
06079812405040000,2020,258516,197084,455600,MKT
06079812405040000,2019,258516,197084,455600,MKT
06079812405060000,2021,300461,306739,607200,MKT
06079812405060000,2020,262683,238117,500800,MKT
06079812405060000,2019,262683,238117,500800,MKT
06079812405080000,2021,291028,268572,559600,MKT
06079812405080000,2020,258516,186884,445400,MKT
06079812405080000,2019,258516,186884,445400,MKT
06079812405100000,2021,291028,509172,800200,MKT
06079812405100000,2020,258516,390684,649200,MKT
06079812405100000,2019,258516,390684,649200,MKT
06079812405120000,2021,291028,478790,769818,COST
06079812405120000,2020,258516,413284,671800,MKT
06079812405120000,2019,258516,413284,671800,MKT
06079812405140000,2021,291028,483772,774800,MKT
06079812405140000,2020,258516,384484,643000,MKT
06079812405140000,2019,258516,384484,643000,MKT
06079812405160000,2021,291028,212072,503100,MKT
06079812405160000,2020,258516,175284,433800,MKT
06079812405160000,2019,258516,158384,416900,MKT
06079812405180000,2021,291028,488270,779298,COST
06079812405180000,2020,258516,394720,653236,COST
06079812405180000,2019,258516,204130,462646,COST
06079812405200000,2021,291028,193072,484100,MKT
06079812405200000,2020,258516,128084,386600,MKT
06079812405200000,2019,258516,128084,386600,MKT
06079812405220000,2021,287827,122873,410700,MKT
06079812405220000,2020,257087,89513,346600,MKT
06079812405220000,2019,257087,89513,346600,MKT
06079812405240000,2021,294200,385900,680100,MKT
06079812405240000,2020,259925,326575,586500,OVR
06079812405240000,2019,259925,326575,586500,MKT
06079812405260000,2021,291028,311372,602400,MKT
06079812405260000,2020,258516,223884,482400,OVR
06079812405260000,2019,258516,223884,482400,MKT
06079812405280000,2021,303551,139949,443500,MKT
06079812405280000,2020,264033,136467,400500,MKT
06079812405280000,2019,264033,136467,400500,MKT
06079812406010000,2021,309654,207846,517500,MKT
06079812406010000,2020,266681,132319,399000,MKT
06079812406010000,2019,266681,132319,399000,MKT
06079812406040000,2021,309654,308446,618100,MKT
06079812406040000,2020,266681,244119,510800,OVR
06079812406040000,2019,266681,244119,510800,MKT
06079812406060000,2021,309654,286846,596500,MKT
06079812406060000,2020,266681,220719,487400,MKT
06079812406060000,2019,266681,220719,487400,MKT
06079812406080000,2021,309654,233946,543600,MKT
06079812406080000,2020,266681,153419,420100,MKT
06079812406080000,2019,266681,153419,420100,MKT
06079812406100000,2021,309654,221246,530900,MKT
06079812406100000,2020,266681,148319,415000,MKT
06079812406100000,2019,266681,148319,415000,MKT
06079812406120000,2021,309654,257646,567300,MKT
06079812406120000,2020,266681,167019,433700,MKT
06079812406120000,2019,266681,167019,433700,MKT
06079812406140000,2021,309654,306660,616314,COST
06079812406140000,2020,266681,243910,510591,COST
06079812406140000,2019,266681,243910,510591,COST
06079812406160000,2021,309654,606870,916524,COST
06079812406160000,2020,266681,546020,812701,OVR
06079812406160000,2019,266681,546020,812701,COST
06079812406180000,2021,309654,323246,632900,MKT
06079812406180000,2020,266681,258319,525000,MKT
06079812406180000,2019,266681,258319,525000,MKT
06079812406200000,2021,313029,212671,525700,MKT
06079812406200000,2020,268135,151565,419700,MKT
06079812406200000,2019,268135,151565,419700,MKT
06079812406220000,2021,306249,208651,514900,MKT
06079812406220000,2020,265207,145493,410700,MKT
06079812406220000,2019,265207,145493,410700,MKT
06079812406240000,2021,309654,192746,502400,MKT
06079812406240000,2020,266681,142819,409500,MKT
06079812406240000,2019,266681,142819,409500,MKT
06079812406280000,2021,309654,479146,788800,MKT
06079812406280000,2020,266681,395219,661900,MKT
06079812406280000,2019,266681,395219,661900,MKT
06079812406300000,2021,288778,553360,842138,COST
06079812406300000,2020,257512,447560,705072,COST
06079812406300000,2019,257512,447560,705072,COST
06079812407010000,2021,401514,356150,757664,COST
06079812407010000,2020,285721,297680,583401,COST
06079812407010000,2019,285721,297680,583401,COST
06079812407040000,2021,363377,306423,669800,MKT
06079812407040000,2020,271778,240922,512700,MKT
06079812407040000,2019,271778,240922,512700,MKT
06079812407286500,2021,408740,0,408740,COST
06079812407286500,2020,168019,0,168019,COST
06079812407286500,2019,168019,0,168019,COST
06079812408010000,2021,545909,388130,934039,COST
06079812408010000,2020,429533,317420,746953,COST
06079812408010000,2019,429533,317420,746953,COST
06079812408060000,2021,505166,397430,902596,COST
06079812408060000,2020,413153,330647,743800,MKT
06079812408060000,2019,413153,330647,743800,MKT
06079812408080000,2021,664115,222380,886495,COST
06079812408080000,2020,473879,180930,654809,COST
06079812408080000,2019,473879,180930,654809,COST
06079812408110000,2021,565657,315670,881327,COST
06079812408110000,2020,437254,254130,691384,COST
06079812408110000,2019,437254,254130,691384,COST
06079812408140000,2021,568110,286140,854250,COST
06079812408140000,2020,438203,249020,687223,COST
06079812408140000,2019,438203,249020,687223,COST
06079812410010000,2021,271359,145141,416500,MKT
06079812410010000,2020,249605,93195,342800,MKT
06079812410010000,2019,249605,93195,342800,MKT
06079812410040000,2021,271359,154641,426000,MKT
06079812410040000,2020,249605,120695,370300,MKT
06079812410040000,2019,249605,120695,370300,MKT
06079812410060000,2021,271359,304041,575400,MKT
06079812410060000,2020,249605,233895,483500,OVR
06079812410060000,2019,249605,233895,483500,MKT
06079812410080000,2021,271359,214941,486300,MKT
06079812410080000,2020,249605,136095,385700,MKT
06079812410080000,2019,249605,136095,385700,MKT
06079812410100000,2021,271359,225241,496600,MKT
06079812410100000,2020,249605,157495,407100,OVR
06079812410100000,2019,249605,157495,407100,MKT
06079812410120000,2021,271359,199641,471000,MKT
06079812410120000,2020,249605,154895,404500,MKT
06079812410120000,2019,249605,154895,404500,MKT
06079812410130000,2021,251873,147327,399200,MKT
06079812410130000,2020,240453,116647,357100,MKT
06079812410130000,2019,240453,116647,357100,MKT
06079812410150000,2021,254020,177080,431100,MKT
06079812410150000,2020,241478,126222,367700,MKT
06079812410150000,2019,241478,126222,367700,MKT
06079812410170000,2021,298119,109681,407800,MKT
06079812410170000,2020,261655,92145,353800,MKT
06079812410170000,2019,261655,92145,353800,MKT
06079812410190000,2021,298594,185270,483864,COST
06079812410190000,2020,261863,151000,412863,COST
06079812410190000,2019,261863,124200,386063,COST
06079812410240000,2021,510414,142186,652600,INCOME
06079812410240000,2020,338819,305081,643900,INCOME
06079812410240000,2019,338819,305081,643900,INCOME
06079812411010000,2021,313269,90031,403300,MKT
06079812411010000,2020,268238,84962,353200,MKT
06079812411010000,2019,268238,84962,353200,MKT
06079812411057000,2021,446862,0,446862,COST
06079812411057000,2020,115055,0,115055,COST
06079812411057000,2019,115055,0,115055,COST
06079812411080000,2021,313269,275631,588900,MKT
06079812411080000,2020,268238,263162,531400,MKT
06079812411080000,2019,268238,263162,531400,MKT
06079812411120000,2021,457827,374480,832307,COST
06079812411120000,2020,324431,274069,598500,MKT
06079812411120000,2019,324431,274069,598500,MKT
06079812411140000,2021,313269,187031,500300,MKT
06079812411140000,2020,268238,141162,409400,MKT
06079812411140000,2019,268238,141162,409400,MKT
06079812411160000,2021,313269,196031,509300,MKT
06079812411160000,2020,268238,132162,400400,MKT
06079812411160000,2019,268238,132162,400400,MKT
06079812411180000,2021,313269,287331,600600,MKT
06079812411180000,2020,268238,229162,497400,OVR
06079812411180000,2019,268238,229162,497400,MKT
06079812411210000,2021,391120,342920,734040,COST
06079812411210000,2020,299805,266100,565905,COST
06079812411210000,2019,299805,266100,565905,COST
06079812411240000,2021,391120,176180,567300,MKT
06079812411240000,2020,299805,177395,477200,MKT
06079812411240000,2019,299805,177395,477200,MKT
06079812412010000,2021,1299767,2987090,4286857,COST
06079812412010000,2020,784942,2832820,3617762,COST
06079812412010000,2019,784942,2832820,3617762,COST
06079812413010000,2021,291028,412672,703700,MKT
06079812413010000,2020,258516,334284,592800,MKT
06079812413010000,2019,258516,334284,592800,MKT
06079812413050000,2021,363352,314748,678100,MKT
06079812413050000,2020,288939,247361,536300,MKT
06079812413050000,2019,288939,247361,536300,MKT
06079812413070000,2021,290799,277601,568400,MKT
06079812413070000,2020,258414,230986,489400,MKT
06079812413070000,2019,258414,230986,489400,MKT
06079812413100000,2021,321573,399427,721000,MKT
06079812413100000,2020,271778,319522,591300,MKT
06079812413100000,2019,271778,319522,591300,MKT
06079812413120000,2021,335976,278424,614400,MKT
06079812413120000,2020,277814,242186,520000,MKT
06079812413120000,2019,277814,242186,520000,MKT
06079812413140000,2021,298594,226706,525300,MKT
06079812413140000,2020,261863,178137,440000,MKT
06079812413140000,2019,261863,178137,440000,MKT
06079812413160000,2021,298594,261406,560000,MKT
06079812413160000,2020,261863,188437,450300,MKT
06079812413160000,2019,261863,188437,450300,MKT
06079812413180000,2021,298594,245606,544200,MKT
06079812413180000,2020,261863,166737,428600,OVR
06079812413180000,2019,261863,166737,428600,MKT
06079812413200000,2021,298719,274581,573300,MKT
06079812413200000,2020,261918,241082,503000,MKT
06079812413200000,2019,261918,241082,503000,MKT
06079812413220000,2021,298594,445600,744194,COST
06079812413220000,2020,261863,373260,635123,COST
06079812413220000,2019,261863,373260,635123,COST
06079812413240000,2021,298594,261006,559600,MKT
06079812413240000,2020,261863,210637,472500,MKT
06079812413240000,2019,261863,210637,472500,MKT
06079812414010000,2021,291028,389872,680900,MKT
06079812414010000,2020,258516,308684,567200,MKT
06079812414010000,2019,258516,308684,567200,MKT
06079812414040000,2021,291028,209772,500800,MKT
06079812414040000,2020,258516,154984,413500,MKT
06079812414040000,2019,258516,154984,413500,MKT
06079812414060000,2021,291028,259672,550700,MKT
06079812414060000,2020,258516,195784,454300,MKT
06079812414060000,2019,258516,195784,454300,MKT
06079812414080000,2021,291028,373372,664400,MKT
06079812414080000,2020,258516,279384,537900,MKT
06079812414080000,2019,258516,279384,537900,MKT
06079812414100000,2021,291028,376520,667548,COST
06079812414100000,2020,258516,337084,595600,MKT
06079812414100000,2019,258516,281284,539800,MKT
06079812414120000,2021,291028,227572,518600,MKT
06079812414120000,2020,258516,152284,410800,MKT
06079812414120000,2019,258516,152284,410800,MKT
06079812414140000,2021,282989,160211,443200,INCOME
06079812414140000,2020,258516,72084,330600,INCOME
06079812414140000,2019,258516,72084,330600,INCOME
06079812414160000,2021,291028,285172,576200,MKT
06079812414160000,2020,258516,201384,459900,MKT
06079812414160000,2019,258516,201384,459900,MKT
06079812414180000,2021,291028,376572,667600,MKT
06079812414180000,2020,258516,273884,532400,OVR
06079812414180000,2019,258516,273884,532400,MKT
06079812414200000,2021,291028,323672,614700,MKT
06079812414200000,2020,258516,249084,507600,MKT
06079812414200000,2019,258516,249084,507600,MKT
06079812414220000,2021,291028,268572,559600,MKT
06079812414220000,2020,258516,193984,452500,OVR
06079812414220000,2019,258516,193984,452500,MKT
06079812414240000,2021,291028,341972,633000,MKT
06079812414240000,2020,258516,262284,520800,MKT
06079812414240000,2019,258516,262284,520800,MKT
06079812415010000,2021,243130,228270,471400,MKT
06079812415010000,2020,236232,169168,405400,MKT
06079812415010000,2019,236232,169168,405400,MKT
06079812415020000,2021,176239,192861,369100,MKT
06079812415020000,2020,201045,110855,311900,MKT
06079812415020000,2019,201045,110855,311900,MKT
06079812415040000,2021,309654,560000,869654,COST
06079812415040000,2020,266681,423519,690200,MKT
06079812415040000,2019,266681,423519,690200,MKT
06079812415060000,2021,309654,202046,511700,MKT
06079812415060000,2020,266681,136219,402900,MKT
06079812415060000,2019,266681,136219,402900,MKT
06079812415080000,2021,309654,188346,498000,MKT
06079812415080000,2020,266681,126319,393000,MKT
06079812415080000,2019,266681,126319,393000,MKT
06079812415100000,2021,309654,291546,601200,MKT
06079812415100000,2020,266681,186719,453400,MKT
06079812415100000,2019,266681,186719,453400,MKT
06079812415110000,2021,235641,367300,602941,COST
06079812415110000,2020,232556,311144,543700,OVR
06079812415110000,2019,232556,311144,543700,MKT
06079812415120000,2021,185678,214622,400300,MKT
06079812415120000,2020,206372,134228,340600,MKT
06079812415120000,2019,206372,134228,340600,MKT
06079812415140000,2021,309654,230046,539700,MKT
06079812415140000,2020,266681,195519,462200,MKT
06079812415140000,2019,266681,195519,462200,MKT
06079812415160000,2021,309654,261646,571300,MKT
06079812415160000,2020,266681,231319,498000,MKT
06079812415160000,2019,266681,231319,498000,MKT
06079812415180000,2021,309654,142046,451700,MKT
06079812415180000,2020,266681,167519,434200,MKT
06079812415180000,2019,266681,167519,434200,MKT
06079812415200000,2021,309654,223746,533400,MKT
06079812415200000,2020,266681,210130,476811,COST
06079812415200000,2019,266681,210130,476811,COST
06079812415220000,2021,309654,327540,637194,COST
06079812415220000,2020,266681,271019,537700,MKT
06079812415220000,2019,266681,271019,537700,MKT
06079812415240000,2021,309654,383870,693524,COST
06079812415240000,2020,266681,305340,572021,COST
06079812415240000,2019,266681,305340,572021,COST
06079812416010000,2021,356639,226361,583000,INCOME
06079812416010000,2020,287449,166651,454100,INCOME
06079812416010000,2019,287449,166651,454100,INCOME
06079812416030000,2021,251873,227627,479500,MKT
06079812416030000,2020,240453,158647,399100,MKT
06079812416030000,2019,240453,158647,399100,MKT
06079812416060000,2021,302811,202089,504900,MKT
06079812416060000,2020,263711,133789,397500,MKT
06079812416060000,2019,263711,133789,397500,MKT
06079812416080000,2021,322978,239322,562300,MKT
06079812416080000,2020,272373,181227,453600,MKT
06079812416080000,2019,272373,181227,453600,MKT
06079812416100000,2021,302811,202989,505800,MKT
06079812416100000,2020,263711,142689,406400,MKT
06079812416100000,2019,263711,142689,406400,MKT
06079812416120000,2021,309654,274146,583800,MKT
06079812416120000,2020,266681,262219,528900,MKT
06079812416120000,2019,266681,262219,528900,MKT
06079812416140000,2021,309654,136946,446600,MKT
06079812416140000,2020,266681,143419,410100,MKT
06079812416140000,2019,266681,143419,410100,MKT
06079812416160000,2021,309654,344380,654034,COST
06079812416160000,2020,266681,276970,543651,COST
06079812416160000,2019,266681,276970,543651,COST
06079812416180000,2021,309509,281391,590900,MKT
06079812416180000,2020,266619,213781,480400,OVR
06079812416180000,2019,266619,213781,480400,MKT
06079812416200000,2021,309654,251946,561600,MKT
06079812416200000,2020,266681,179419,446100,MKT
06079812416200000,2019,266681,179419,446100,MKT
06079812416220000,2021,309654,325446,635100,MKT
06079812416220000,2020,266681,220919,487600,OVR
06079812416220000,2019,266681,220919,487600,MKT
06079812416240000,2021,309654,218046,527700,MKT
06079812416240000,2020,266681,148719,415400,MKT
06079812416240000,2019,266681,136519,403200,MKT
06079812416250000,2021,257565,358735,616300,MKT
06079812416250000,2020,243162,273938,517100,MKT
06079812416250000,2019,243162,273938,517100,MKT
06079812416270000,2021,257565,250435,508000,MKT
06079812416270000,2020,243162,158638,401800,MKT
06079812416270000,2019,243162,158638,401800,MKT
06079812416280000,2021,227949,278651,506600,MKT
06079812416280000,2020,228720,195780,424500,MKT
06079812416280000,2019,228720,195780,424500,MKT
06079812417010000,2021,570555,447750,1018305,COST
06079812417010000,2020,439147,368653,807800,MKT
06079812417010000,2019,439147,368653,807800,MKT
06079812417060000,2021,540964,238340,779304,COST
06079812417060000,2020,427579,192900,620479,COST
06079812417060000,2019,427579,192900,620479,COST
06079812417080000,2021,608244,520487,1128731,OVR
06079812417080000,2020,453457,489150,942607,COST
06079812417080000,2019,453457,489150,942607,COST
06079812417090000,2021,425813,588830,1014643,COST
06079812417090000,2020,379235,472000,851235,COST
06079812417090000,2019,379235,472000,851235,COST
06079812417120000,2021,238660,173640,412300,MKT
06079812417120000,2020,234045,147655,381700,MKT
06079812417120000,2019,234045,147655,381700,MKT
06079812419010000,2021,396578,364322,760900,MKT
06079812419010000,2020,301895,343905,645800,OVR
06079812419010000,2019,301895,343905,645800,MKT
06079812419070000,2021,338795,152505,491300,INCOME
06079812419070000,2020,278980,243720,522700,INCOME
06079812419070000,2019,278980,243720,522700,INCOME
06079812419100000,2021,338795,264705,603500,MKT
06079812419100000,2020,278980,209720,488700,MKT
06079812419100000,2019,278980,209720,488700,MKT
06079812419120000,2021,271359,317410,588769,COST
06079812419120000,2020,249605,156995,406600,MKT
06079812419120000,2019,249605,156995,406600,MKT
06079812419150000,2021,361758,289842,651600,MKT
06079812419150000,2020,288303,241597,529900,MKT
06079812419150000,2019,288303,241597,529900,MKT
06079812419170000,2021,289751,201049,490800,MKT
06079812419170000,2020,257947,137053,395000,MKT
06079812419170000,2019,257947,137053,395000,MKT
06079812419190000,2021,292300,127500,419800,MKT
06079812419190000,2020,259082,104018,363100,MKT
06079812419190000,2019,259082,104018,363100,MKT
06079812419220000,2021,365837,181963,547800,INCOME
06079812419220000,2020,290826,225574,516400,INCOME
06079812419220000,2019,290826,225574,516400,INCOME
06079812419240000,2021,294831,132069,426900,MKT
06079812419240000,2020,260204,121196,381400,MKT
06079812419240000,2019,260204,121196,381400,MKT
06079812420010000,2021,224812,169288,394100,MKT
06079812420010000,2020,227136,98064,325200,MKT
06079812420010000,2019,227136,98064,325200,MKT
06079812420020000,2021,283036,124964,408000,MKT
06079812420020000,2020,254932,90668,345600,MKT
06079812420020000,2019,254932,90668,345600,MKT
06079812420030000,2021,252905,199195,452100,MKT
06079812420030000,2020,240947,114053,355000,MKT
06079812420030000,2019,240947,114053,355000,MKT
06079812420060000,2021,309824,131076,440900,MKT
06079812420060000,2020,266755,104845,371600,OVR
06079812420060000,2019,266755,104845,371600,MKT
06079812420080000,2021,313269,271931,585200,MKT
06079812420080000,2020,268238,177762,446000,MKT
06079812420080000,2019,268238,177762,446000,MKT
06079812420100000,2021,313269,132931,446200,MKT
06079812420100000,2020,268238,80762,349000,MKT
06079812420100000,2019,268238,80762,349000,MKT
06079812420120000,2021,313269,289490,602759,COST
06079812420120000,2020,268238,223030,491268,COST
06079812420120000,2019,268238,223030,491268,COST
06079812420140000,2021,313269,359531,672800,MKT
06079812420140000,2020,268238,278062,546300,MKT
06079812420140000,2019,268238,278062,546300,MKT
06079812420170000,2021,391120,165580,556700,MKT
06079812420170000,2020,299805,132395,432200,MKT
06079812420170000,2019,299805,132395,432200,MKT
06079812420200000,2021,391120,161680,552800,MKT
06079812420200000,2020,299805,157595,457400,MKT
06079812420200000,2019,299805,157595,457400,MKT
06079812420210000,2021,330850,223550,554400,MKT
06079812420210000,2020,275681,150719,426400,OVR
06079812420210000,2019,275681,150719,426400,MKT
06079812420240000,2021,294831,206369,501200,MKT
06079812420240000,2020,260204,131096,391300,MKT
06079812420240000,2019,260204,131096,391300,MKT
06079812421010000,2021,372798,185402,558200,MKT
06079812421010000,2020,292681,222819,515500,MKT
06079812421010000,2019,292681,222819,515500,MKT
06079812421060000,2021,372798,255902,628700,MKT
06079812421060000,2020,292681,256919,549600,MKT
06079812421060000,2019,292681,256919,549600,MKT
06079812421100000,2021,394065,680360,1074425,COST
06079812421100000,2020,300935,560890,861825,COST
06079812421100000,2019,300935,560890,861825,COST
06079812421120000,2021,417066,239634,656700,MKT
06079812421120000,2020,428479,214940,643419,COST
06079812421120000,2019,428479,214940,643419,COST
06079812421180000,2021,610620,103080,713700,MKT
06079812421180000,2020,374815,145185,520000,MKT
06079812421180000,2019,374815,145185,520000,MKT
06079812421240000,2021,417818,163382,581200,MKT
06079812421240000,2020,309895,181705,491600,MKT
06079812421240000,2019,309895,181705,491600,MKT
06079812422010000,2021,291028,348972,640000,MKT
06079812422010000,2020,258516,276684,535200,MKT
06079812422010000,2019,258516,276684,535200,MKT
06079812422040000,2021,291028,220172,511200,MKT
06079812422040000,2020,258516,178784,437300,MKT
06079812422040000,2019,258516,178084,436600,MKT
06079812422060000,2021,291028,331272,622300,MKT
06079812422060000,2020,258516,223784,482300,OVR
06079812422060000,2019,258516,223784,482300,MKT
06079812422090000,2021,425399,320570,745969,COST
06079812422090000,2020,432749,258430,691179,COST
06079812422090000,2019,432749,258430,691179,COST
06079812422120000,2021,401559,244741,646300,MKT
06079812422120000,2020,420417,154583,575000,OVR
06079812422120000,2019,420417,230660,651077,COST
06079812422130000,2021,481546,270050,751596,COST
06079812422130000,2020,460496,252600,713096,COST
06079812422130000,2019,460496,252600,713096,COST
06079812422170000,2021,313269,334731,648000,MKT
06079812422170000,2020,268238,267062,535300,OVR
06079812422170000,2019,268238,267062,535300,MKT
06079812422200000,2021,370943,313857,684800,INCOME
06079812422200000,2020,292681,363119,655800,INCOME
06079812422200000,2019,292681,363119,655800,INCOME
06079812422230000,2021,372798,296102,668900,MKT
06079812422230000,2020,292681,263219,555900,MKT
06079812422230000,2019,292681,263219,555900,MKT
06079812423010000,2021,363352,332848,696200,MKT
06079812423010000,2020,288939,308461,597400,MKT
06079812423010000,2019,288939,308461,597400,MKT
06079812423060000,2021,363352,426748,790100,MKT
06079812423060000,2020,288939,344561,633500,MKT
06079812423060000,2019,288939,344561,633500,MKT
06079812423100000,2021,502801,485410,988211,COST
06079812423100000,2020,470574,383790,854364,COST
06079812423100000,2019,470574,383790,854364,COST
06079812423130000,2021,390976,441500,832476,COST
06079812423130000,2020,414826,356710,771536,COST
06079812423130000,2019,414826,356710,771536,COST
06079812423170000,2021,544814,633120,1177934,COST
06079812423170000,2020,489891,500250,990141,COST
06079812423170000,2019,489891,500250,990141,COST
06079812423190000,2021,291028,295172,586200,MKT
06079812423190000,2020,258516,218984,477500,MKT
06079812423190000,2019,258516,218984,477500,MKT
06079812423210000,2021,291028,205472,496500,MKT
06079812423210000,2020,258516,175084,433600,MKT
06079812423210000,2019,258516,175084,433600,MKT
06079812423230000,2021,291028,336972,628000,MKT
06079812423230000,2020,258516,257984,516500,MKT
06079812423230000,2019,258516,257984,516500,MKT
06079812424010000,2021,309654,219846,529500,MKT
06079812424010000,2020,266681,149919,416600,MKT
06079812424010000,2019,266681,149919,416600,MKT
06079812424040000,2021,309654,211846,521500,MKT
06079812424040000,2020,266681,138019,404700,MKT
06079812424040000,2019,266681,138019,404700,MKT
06079812424060000,2021,309654,150846,460500,MKT
06079812424060000,2020,266681,143319,410000,MKT
06079812424060000,2019,266681,143319,410000,MKT
06079812424080000,2021,309654,299646,609300,MKT
06079812424080000,2020,266681,196619,463300,MKT
06079812424080000,2019,266681,161819,428500,MKT
06079812424090000,2021,248987,285513,534500,MKT
06079812424090000,2020,239068,249732,488800,OVR
06079812424090000,2019,239068,249732,488800,MKT
06079812424100000,2021,248987,243113,492100,MKT
06079812424100000,2020,239068,244132,483200,MKT
06079812424100000,2019,239068,244132,483200,MKT
06079812424120000,2021,248987,257113,506100,MKT
06079812424120000,2020,239068,205632,444700,MKT
06079812424120000,2019,239068,205632,444700,MKT
06079812424130000,2021,368489,513310,881799,COST
06079812424130000,2020,402689,137090,539779,COST
06079812424130000,2019,402689,303411,706100,MKT
06079812424160000,2021,309654,158970,468624,COST
06079812424160000,2020,266681,0,266681,COST
06079812424160000,2019,266681,9050,275731,COST
06079812424190000,2021,351415,508410,859825,COST
06079812424190000,2020,284141,410620,694761,COST
06079812424190000,2019,284141,410620,694761,COST
06079812424220000,2021,386607,491063,877670,MRA
06079812424220000,2020,298066,519930,817996,COST
06079812424220000,2019,298066,519930,817996,COST
06079812424240000,2021,351415,347285,698700,MKT
06079812424240000,2020,284141,302259,586400,MKT
06079812424240000,2019,284141,302259,586400,MKT
06079812425010000,2021,243130,257570,500700,MKT
06079812425010000,2020,236232,148068,384300,MKT
06079812425010000,2019,236232,148068,384300,MKT
06079812425020000,2021,243130,221570,464700,MKT
06079812425020000,2020,236232,163668,399900,MKT
06079812425020000,2019,236232,163668,399900,MKT
06079812425030000,2021,257565,265235,522800,MKT
06079812425030000,2020,243162,148238,391400,MKT
06079812425030000,2019,243162,148238,391400,MKT
06079812425040000,2021,270277,155123,425400,MKT
06079812425040000,2020,249106,98294,347400,MKT
06079812425040000,2019,249106,98294,347400,MKT
06079812425060000,2021,258691,286520,545211,COST
06079812425060000,2020,243694,230220,473914,COST
06079812425060000,2019,243694,230220,473914,COST
06079812425100000,2021,342153,569747,911900,MKT
06079812425100000,2020,280363,385037,665400,MKT
06079812425100000,2019,280363,385037,665400,MKT
06079812425120000,2021,342153,313120,655273,COST
06079812425120000,2020,280363,348137,628500,MKT
06079812425120000,2019,280363,348137,628500,MKT
06079812425140000,2021,326239,489270,815509,COST
06079812425140000,2020,273748,325770,599518,COST
06079812425140000,2019,273748,260230,533978,COST
06079812425150000,2021,260372,137928,398300,MKT
06079812425150000,2020,244487,112113,356600,MKT
06079812425150000,2019,244487,112113,356600,MKT
06079812425170000,2021,268647,266853,535500,MKT
06079812425170000,2020,248352,229548,477900,MKT
06079812425170000,2019,248352,229548,477900,MKT
06079812425190000,2021,309654,199346,509000,MKT
06079812425190000,2020,266681,135500,402181,COST
06079812425190000,2019,266681,135500,402181,COST
06079812425220000,2021,329472,221728,551200,MKT
06079812425220000,2020,275105,152295,427400,MKT
06079812425220000,2019,275105,152295,427400,MKT
06079812425240000,2021,329472,192628,522100,MKT
06079812425240000,2020,275105,121795,396900,MKT
06079812425240000,2019,275105,121795,396900,MKT
06079812425260000,2021,351415,225785,577200,MKT
06079812425260000,2020,284141,179359,463500,MKT
06079812425260000,2019,284141,179359,463500,MKT
06079812425280000,2021,309654,251846,561500,MKT
06079812425280000,2020,266681,193619,460300,MKT
06079812425280000,2019,266681,193619,460300,MKT
06079812426010000,2021,468593,456865,925458,MRA
06079812426010000,2020,397878,400222,798100,MKT
06079812426010000,2019,397878,400222,798100,MKT
06079812426050000,2021,587429,592271,1179700,MKT
06079812426050000,2020,445610,518100,963710,COST
06079812426050000,2019,398690,518100,916790,COST
06079812426070000,2021,474307,452193,926500,MKT
06079812426070000,2020,400303,365410,765713,COST
06079812426070000,2019,400303,365410,765713,COST
06079812426090000,2021,479964,417236,897200,MKT
06079812426090000,2020,402689,348500,751189,COST
06079812426090000,2019,402689,348500,751189,COST
06079812426120000,2021,599240,402370,1001610,COST
06079812426120000,2020,298066,327550,625616,COST
06079812426120000,2019,298066,327550,625616,COST
06079812428010000,2021,338795,181405,520200,MKT
06079812428010000,2020,278980,113420,392400,MKT
06079812428010000,2019,278980,113420,392400,MKT
06079812428050000,2021,271359,205241,476600,MKT
06079812428050000,2020,249605,131495,381100,MKT
06079812428050000,2019,249605,131495,381100,MKT
06079812428070000,2021,271359,200141,471500,MKT
06079812428070000,2020,249605,123595,373200,MKT
06079812428070000,2019,249605,122595,372200,MKT
06079812428090000,2021,271359,152741,424100,MKT
06079812428090000,2020,249605,101695,351300,MKT
06079812428090000,2019,249605,101695,351300,MKT
06079812428120000,2021,338795,241380,580175,COST
06079812428120000,2020,278980,195590,474570,COST
06079812428120000,2019,278980,195590,474570,COST
06079812428130000,2021,304780,149820,454600,MKT
06079812428130000,2020,264569,146731,411300,MKT
06079812428130000,2019,264569,146731,411300,MKT
06079812428160000,2021,254732,148468,403200,MKT
06079812428160000,2020,241818,121282,363100,MKT
06079812428160000,2019,241818,121282,363100,MKT
06079812428200000,2021,414023,91919,505942,OVR
06079812428200000,2020,308481,46519,355000,OVR
06079812428200000,2019,308481,128619,437100,MKT
06079812428220000,2021,285893,113107,399000,MKT
06079812428220000,2020,256219,69981,326200,MKT
06079812428220000,2019,256219,69981,326200,MKT
06079812428240000,2021,287184,192416,479600,MKT
06079812428240000,2020,256799,118701,375500,MKT
06079812428240000,2019,256799,118701,375500,MKT
06079812429010000,2021,313269,141631,454900,MKT
06079812429010000,2020,268238,109062,377300,MKT
06079812429010000,2019,268238,109062,377300,MKT
06079812429040000,2021,313269,272031,585300,MKT
06079812429040000,2020,268238,187462,455700,MKT
06079812429040000,2019,268238,177890,446128,COST
06079812429060000,2021,313269,151331,464600,MKT
06079812429060000,2020,268238,173562,441800,MKT
06079812429060000,2019,268238,173562,441800,MKT
06079812429080000,2021,295713,172487,468200,MKT
06079812429080000,2020,260594,111106,371700,MKT
06079812429080000,2019,260594,111106,371700,MKT
06079812429090000,2021,318036,259164,577200,MKT
06079812429090000,2020,270276,200324,470600,MKT
06079812429090000,2019,270276,200324,470600,MKT
06079812429120000,2021,325426,247874,573300,MKT
06079812429120000,2020,273406,174694,448100,MKT
06079812429120000,2019,273406,174694,448100,MKT
06079812429130000,2021,314466,210134,524600,MKT
06079812429130000,2020,268751,148349,417100,OVR
06079812429130000,2019,268751,148349,417100,MKT
06079812429160000,2021,314466,255434,569900,MKT
06079812429160000,2020,268751,190849,459600,MKT
06079812429160000,2019,268751,190849,459600,MKT
06079812429200000,2021,457827,72073,529900,INCOME
06079812429200000,2020,324431,192069,516500,INCOME
06079812429200000,2019,324431,192069,516500,INCOME
06079812429210000,2021,361758,81842,443600,MKT
06079812429210000,2020,288303,86697,375000,MKT
06079812429210000,2019,288303,86697,375000,MKT
06079812429240000,2021,257565,57800,315365,COST
06079812429240000,2020,243162,47010,290172,COST
06079812429240000,2019,243162,47010,290172,COST
06079812430010000,2021,352347,224553,576900,MKT
06079812430010000,2020,393748,114652,508400,MKT
06079812430010000,2019,393748,114652,508400,MKT
06079812430040000,2021,352347,278653,631000,MKT
06079812430040000,2020,393748,204952,598700,MKT
06079812430040000,2019,393748,204952,598700,MKT
06079812430070000,2021,399865,362235,762100,MKT
06079812430070000,2020,419527,179873,599400,MKT
06079812430070000,2019,419527,179873,599400,MKT
06079812430100000,2021,439909,158391,598300,MKT
06079812430100000,2020,440086,146514,586600,MKT
06079812430100000,2019,440086,188830,628916,COST
06079812430120000,2021,399865,475535,875400,MKT
06079812430120000,2020,419527,398473,818000,MKT
06079812430120000,2019,419527,398473,818000,MKT
06079812430130000,2021,292300,462000,754300,MKT
06079812430130000,2020,259082,352318,611400,MKT
06079812430130000,2019,259082,352318,611400,MKT
06079812430160000,2021,284597,413303,697900,MKT
06079812430160000,2020,255636,308764,564400,MKT
06079812430160000,2019,255636,308764,564400,MKT
06079812430180000,2021,288470,104630,393100,MKT
06079812430180000,2020,257374,90126,347500,MKT
06079812430180000,2019,257374,90126,347500,MKT
06079812430200000,2021,288470,342230,630700,MKT
06079812430200000,2020,257374,263826,521200,MKT
06079812430200000,2019,257374,263826,521200,MKT
06079812430220000,2021,279364,224436,503800,MKT
06079812430220000,2020,253269,147231,400500,OVR
06079812430220000,2019,253269,147231,400500,MKT
06079812430240000,2021,297344,695556,992900,MKT
06079812430240000,2020,261313,621687,883000,OVR
06079812430240000,2019,261313,621687,883000,MKT
06079812431016500,2021,550885,0,550885,COST
06079812431016500,2020,195101,0,195101,COST
06079812431016500,2019,195101,0,195101,COST
06079812433010000,2021,309654,246210,555864,COST
06079812433010000,2020,266681,199050,465731,COST
06079812433010000,2019,266681,199050,465731,COST
06079812433040000,2021,309654,247946,557600,MKT
06079812433040000,2020,266681,167619,434300,OVR
06079812433040000,2019,266681,167619,434300,MKT
06079812433060000,2021,309654,208046,517700,MKT
06079812433060000,2020,266681,197419,464100,MKT
06079812433060000,2019,266681,197419,464100,MKT
06079812433080000,2021,309654,437846,747500,MKT
06079812433080000,2020,266681,359419,626100,MKT
06079812433080000,2019,266681,359419,626100,MKT
06079812433100000,2021,309654,333490,643144,COST
06079812433100000,2020,266681,266180,532861,COST
06079812433100000,2019,266681,266180,532861,COST
06079812433110000,2021,227949,231351,459300,MKT
06079812433110000,2020,228720,183680,412400,MKT
06079812433110000,2019,228720,183680,412400,MKT
06079812433120000,2021,194736,165664,360400,MKT
06079812433120000,2020,211359,91141,302500,MKT
06079812433120000,2019,211359,91141,302500,MKT
06079812433150000,2021,460062,409330,869392,COST
06079812433150000,2020,450080,320520,770600,MKT
06079812433150000,2019,450080,320520,770600,MKT
06079812433170000,2021,368489,379311,747800,MKT
06079812433170000,2020,402689,259760,662449,COST
06079812433170000,2019,402689,259760,662449,COST
06079812433190000,2021,368489,327011,695500,MKT
06079812433190000,2020,402689,252640,655329,COST
06079812433190000,2019,402689,295060,697749,COST
06079812433220000,2021,418183,302717,720900,MKT
06079812433220000,2020,429054,236646,665700,MKT
06079812433220000,2019,429054,236646,665700,MKT
06079812433240000,2021,418183,477217,895400,MKT
06079812433240000,2020,429054,393546,822600,MKT
06079812433240000,2019,429054,393546,822600,MKT
06079812434010000,2021,338795,154005,492800,MKT
06079812434010000,2020,278980,194320,473300,MKT
06079812434010000,2019,278980,194320,473300,MKT
06079812434030000,2021,338795,324305,663100,MKT
06079812434030000,2020,278980,307820,586800,MKT
06079812434030000,2019,278980,307820,586800,MKT
06079812434060000,2021,357478,252822,610300,MKT
06079812434060000,2020,286589,249811,536400,MKT
06079812434060000,2019,286589,249811,536400,MKT
06079812434070000,2021,309654,628600,938254,COST
06079812434070000,2020,266681,505250,771931,COST
06079812434070000,2019,266681,505250,771931,COST
06079812434090000,2021,351415,191885,543300,MKT
06079812434090000,2020,284141,174059,458200,MKT
06079812434090000,2019,284141,174059,458200,MKT
06079812434110000,2021,351415,343285,694700,MKT
06079812434110000,2020,284141,359259,643400,MKT
06079812434110000,2019,284141,359259,643400,MKT
06079812434130000,2021,309654,175646,485300,MKT
06079812434130000,2020,266681,127619,394300,MKT
06079812434130000,2019,266681,127619,394300,MKT
06079812434150000,2021,309654,271146,580800,MKT
06079812434150000,2020,266681,197119,463800,MKT
06079812434150000,2019,266681,197119,463800,MKT
06079812434170000,2021,284597,390360,674957,COST
06079812434170000,2020,255636,255564,511200,MKT
06079812434170000,2019,255636,255564,511200,MKT
06079812434180000,2021,243130,200770,443900,MKT
06079812434180000,2020,236232,135968,372200,MKT
06079812434180000,2019,236232,135968,372200,MKT
06079812434195001,2021,248009,129880,377889,COST
06079812434195001,2020,64390,212910,277300,MKT
06079812434195001,2019,64390,212910,277300,MKT
06079812434195002,2021,222159,152040,374199,COST
06079812434195002,2020,57768,171232,229000,MKT
06079812434195002,2019,57768,171232,229000,MKT
06079812434210000,2021,338795,365405,704200,MKT
06079812434210000,2020,278980,284520,563500,MKT
06079812434210000,2019,278980,284520,563500,MKT
06079812434240000,2021,371237,385105,756342,OVR
06079812434240000,2020,292066,314134,606200,MKT
06079812434240000,2019,292066,314134,606200,MKT
06079812435010000,2021,601580,113520,715100,INCOME
06079812435010000,2020,450959,230441,681400,INCOME
06079812435010000,2019,450959,230441,681400,INCOME
06079812435050000,2021,485567,148333,633900,MKT
06079812435050000,2020,405039,144961,550000,OVR
06079812435050000,2019,405039,144961,550000,OVR
06079812435070000,2021,487423,114677,602100,MKT
06079812435070000,2020,405814,77886,483700,MKT
06079812435070000,2019,405814,77886,483700,MKT
06079812435090000,2021,557350,329750,887100,MKT
06079812435090000,2020,434023,330177,764200,MKT
06079812435090000,2019,434023,330177,764200,MKT
06079812435120000,2021,548939,672320,1221259,COST
06079812435120000,2020,430727,448073,878800,MKT
06079812435120000,2019,430727,448073,878800,MKT
06079812437010000,2021,271359,327441,598800,MKT
06079812437010000,2020,249605,244895,494500,MKT
06079812437010000,2019,249605,244895,494500,MKT
06079812437040000,2021,271359,154741,426100,MKT
06079812437040000,2020,249605,127195,376800,MKT
06079812437040000,2019,249605,127195,376800,MKT
06079812437060000,2021,271359,137741,409100,MKT
06079812437060000,2020,249605,103095,352700,MKT
06079812437060000,2019,249605,103095,352700,MKT
06079812437080000,2021,271359,259041,530400,MKT
06079812437080000,2020,249605,188395,438000,MKT
06079812437080000,2019,249605,188395,438000,MKT
06079812437100000,2021,271359,158541,429900,MKT
06079812437100000,2020,249605,100795,350400,MKT
06079812437100000,2019,249605,100795,350400,MKT
06079812437120000,2021,271359,138341,409700,MKT
06079812437120000,2020,249605,104595,354200,MKT
06079812437120000,2019,249605,104595,354200,MKT
06079812437140000,2021,278625,123275,401900,MKT
06079812437140000,2020,252933,94967,347900,MKT
06079812437140000,2019,252933,94967,347900,MKT
06079812437160000,2021,267993,205407,473400,MKT
06079812437160000,2020,248048,155052,403100,MKT
06079812437160000,2019,248048,155052,403100,MKT
06079812437180000,2021,275386,244014,519400,MKT
06079812437180000,2020,251455,190445,441900,OVR
06079812437180000,2019,251455,190445,441900,MKT
06079812437190000,2021,285375,147625,433000,MKT
06079812437190000,2020,255986,98314,354300,MKT
06079812437190000,2019,255986,98314,354300,MKT
06079812437210000,2021,294124,197076,491200,MKT
06079812437210000,2020,259891,125109,385000,MKT
06079812437210000,2019,259891,125109,385000,MKT
06079812437240000,2021,276717,123583,400300,MKT
06079812437240000,2020,252064,71436,323500,MKT
06079812437240000,2019,252064,71436,323500,MKT
06079812438010000,2021,349885,353415,703300,MKT
06079812438010000,2020,283521,277279,560800,MKT
06079812438010000,2019,283521,277279,560800,MKT
06079812438030000,2021,358016,769760,1127776,COST
06079812438030000,2020,286804,653020,939824,OVR
06079812438030000,2019,286804,653020,939824,COST
06079812438080000,2021,391120,71680,462800,MKT
06079812438080000,2020,299805,88095,387900,MKT
06079812438080000,2019,299805,88095,387900,MKT
06079812438100000,2021,313269,88731,402000,MKT
06079812438100000,2020,268238,89662,357900,MKT
06079812438100000,2019,268238,89662,357900,MKT
06079812438120000,2021,313173,115427,428600,MKT
06079812438120000,2020,268196,98204,366400,MKT
06079812438120000,2019,268196,98204,366400,MKT
06079812438130000,2021,443624,253030,696654,COST
06079812438130000,2020,319346,229254,548600,MKT
06079812438130000,2019,319346,229254,548600,MKT
06079812438180000,2021,335613,354987,690600,MKT
06079812438180000,2020,277663,252937,530600,MKT
06079812438180000,2019,277663,252937,530600,MKT
06079812438190000,2021,286461,202239,488700,MKT
06079812438190000,2020,256475,117125,373600,MKT
06079812438190000,2019,256475,117125,373600,MKT
06079812438220000,2021,248407,170693,419100,MKT
06079812438220000,2020,238789,119711,358500,MKT
06079812438220000,2019,238789,119711,358500,MKT
06079812438240000,2021,392615,363530,756145,COST
06079812438240000,2020,300379,298810,599189,COST
06079812438240000,2019,300379,298810,599189,COST
06079812439010000,2021,355327,565973,921300,MKT
06079812439010000,2020,395414,428786,824200,MKT
06079812439010000,2019,395414,428786,824200,MKT
06079812439050000,2021,372798,237802,610600,MKT
06079812439050000,2020,292681,206419,499100,MKT
06079812439050000,2019,292681,208819,501500,MKT
06079812439070000,2021,298594,296906,595500,MKT
06079812439070000,2020,261863,267737,529600,MKT
06079812439070000,2019,261863,267737,529600,MKT
06079812439100000,2021,329932,453068,783000,MKT
06079812439100000,2020,275297,343303,618600,MKT
06079812439100000,2019,275297,343303,618600,MKT
06079812439120000,2021,344710,263190,607900,MKT
06079812439120000,2020,281411,230589,512000,MKT
06079812439120000,2019,281411,230589,512000,MKT
06079812439160000,2021,417818,78282,496100,MKT
06079812439160000,2020,309895,117505,427400,MKT
06079812439160000,2019,309895,117505,427400,MKT
06079812439190000,2021,353732,161668,515400,INCOME
06079812439190000,2020,286372,109828,396200,INCOME
06079812439190000,2019,286372,109828,396200,INCOME
06079812439220000,2021,343711,188789,532500,MKT
06079812439220000,2020,281002,154298,435300,MKT
06079812439220000,2019,281002,154298,435300,MKT
06079812439240000,2021,301205,74995,376200,INCOME
06079812439240000,2020,263009,75291,338300,INCOME
06079812439240000,2019,263009,75291,338300,INCOME
06079812440010000,2021,460781,330620,791401,COST
06079812440010000,2020,450432,266450,716882,COST
06079812440010000,2019,450432,266450,716882,COST
06079812440060000,2021,408487,493950,902437,COST
06079812440060000,2020,424038,391662,815700,MKT
06079812440060000,2019,424038,391662,815700,MKT
06079812440080000,2021,390976,368224,759200,MKT
06079812440080000,2020,414826,337170,751996,OVR
06079812440080000,2019,414826,337170,751996,OVR
06079812440110000,2021,425399,446640,872039,COST
06079812440110000,2020,432749,384600,817349,COST
06079812440110000,2019,432749,384600,817349,COST
06079812440130000,2021,291028,199072,490100,MKT
06079812440130000,2020,258516,152084,410600,MKT
06079812440130000,2019,258516,152084,410600,MKT
06079812440150000,2021,264536,266764,531300,MKT
06079812440150000,2020,246439,182361,428800,MKT
06079812440150000,2019,246439,182361,428800,MKT
06079812440170000,2021,315660,277980,593640,COST
06079812440170000,2020,269262,263238,532500,MKT
06079812440170000,2019,269262,276038,545300,MKT
06079812440180000,2021,198263,192937,391200,MKT
06079812440180000,2020,213269,115631,328900,MKT
06079812440180000,2019,213269,115631,328900,MKT
06079812440190000,2021,208546,224854,433400,MKT
06079812440190000,2020,218744,153556,372300,MKT
06079812440190000,2019,218744,153556,372300,MKT
06079812440210000,2021,298619,263881,562500,MKT
06079812440210000,2020,261874,186926,448800,MKT
06079812440210000,2019,261863,186937,448800,MKT
06079812440230000,2021,298519,184281,482800,MKT
06079812440230000,2020,261830,154670,416500,MKT
06079812440230000,2019,261863,154637,416500,MKT
06079812441010000,2021,364872,356928,721800,MKT
06079812441010000,2020,400703,269097,669800,MKT
06079812441010000,2019,400703,269097,669800,MKT
06079812441050000,2021,306615,519260,825875,COST
06079812441050000,2020,265366,416460,681826,COST
06079812441050000,2019,265366,416460,681826,COST
06079812441070000,2021,338795,522860,861655,COST
06079812441070000,2020,278980,368090,647070,COST
06079812441070000,2019,278980,329350,608330,COST
06079812441090000,2021,291028,437772,728800,MKT
06079812441090000,2020,258516,293084,551600,MKT
06079812441090000,2019,258516,286984,545500,MKT
06079812441120000,2021,363352,360820,724172,COST
06079812441120000,2020,288939,289200,578139,COST
06079812441120000,2019,288939,215420,504359,COST
06079812441140000,2021,291028,201572,492600,MKT
06079812441140000,2020,258516,205384,463900,MKT
06079812441140000,2019,258516,205384,463900,MKT
06079812441160000,2021,291028,250372,541400,MKT
06079812441160000,2020,258516,212784,471300,MKT
06079812441160000,2019,258516,212784,471300,MKT
06079812441180000,2021,291028,259472,550500,MKT
06079812441180000,2020,258516,229884,488400,MKT
06079812441180000,2019,258516,229884,488400,MKT
06079812441200000,2021,291028,249972,541000,MKT
06079812441200000,2020,258516,164784,423300,MKT
06079812441200000,2019,258516,164784,423300,MKT
06079812441210000,2021,338670,439643,778313,OVR
06079812441210000,2020,386011,352211,738222,MRA
06079812441210000,2019,386011,352211,738222,MRA
06079812441240000,2021,353839,310261,664100,MKT
06079812441240000,2020,394583,229660,624243,COST
06079812441240000,2019,394583,229660,624243,COST
06079812442010000,2021,309654,261746,571400,MKT
06079812442010000,2020,266681,174819,441500,MKT
06079812442010000,2019,266681,174819,441500,MKT
06079812442040000,2021,309654,348646,658300,MKT
06079812442040000,2020,266681,285719,552400,OVR
06079812442040000,2019,266681,285719,552400,MKT
06079812442060000,2021,309654,297890,607544,COST
06079812442060000,2020,266681,240260,506941,COST
06079812442060000,2019,266681,237470,504151,COST
06079812442080000,2021,309654,149746,459400,MKT
06079812442080000,2020,266681,139219,405900,MKT
06079812442080000,2019,266681,139219,405900,MKT
06079812442100000,2021,309654,344846,654500,MKT
06079812442100000,2020,266681,326481,593162,OVR
06079812442100000,2019,266681,326481,593162,OVR
06079812442120000,2021,309654,183146,492800,MKT
06079812442120000,2020,266681,131219,397900,MKT
06079812442120000,2019,266681,131219,397900,MKT
06079812442150000,2021,351415,162310,513725,OVR
06079812442150000,2020,284141,225759,509900,MKT
06079812442150000,2019,284141,272159,556300,MKT
06079812442170000,2021,309654,120946,430600,MKT
06079812442170000,2020,266681,136119,402800,MKT
06079812442170000,2019,266681,136119,402800,MKT
06079812442190000,2021,309654,335746,645400,MKT
06079812442190000,2020,266681,270419,537100,MKT
06079812442190000,2019,266681,270419,537100,MKT
06079812442210000,2021,309654,393446,703100,MKT
06079812442210000,2020,266681,282919,549600,MKT
06079812442210000,2019,266681,282919,549600,MKT
06079812442220000,2021,266461,288639,555100,MKT
06079812442220000,2020,247336,215464,462800,MKT
06079812442220000,2019,247336,215464,462800,MKT
06079812442240000,2021,368489,492911,861400,MKT
06079812442240000,2020,402689,294820,697509,OVR
06079812442240000,2019,402689,294820,697509,OVR
06079812443010000,2021,274049,309251,583300,MKT
06079812443010000,2020,250842,274058,524900,MKT
06079812443010000,2019,250842,274058,524900,MKT
06079812443030000,2021,340366,435530,775896,COST
06079812443030000,2020,280363,331637,612000,MKT
06079812443030000,2019,280363,359937,640300,MKT
06079812443050000,2021,339020,720180,1059200,MKT
06079812443050000,2020,279073,797027,1076100,OVR
06079812443050000,2019,279073,797027,1076100,MKT
06079812443060000,2021,165957,128030,293987,COST
06079812443060000,2020,195077,84670,279747,COST
06079812443060000,2019,195077,84670,279747,COST
06079812443070000,2021,307955,410845,718800,MKT
06079812443070000,2020,265947,332353,598300,MKT
06079812443070000,2019,265947,332353,598300,MKT
06079812443080000,2021,223229,428458,651687,MRA
06079812443080000,2020,226333,384567,610900,MKT
06079812443080000,2019,226333,384567,610900,MKT
06079812443100000,2021,319690,453280,772970,COST
06079812443100000,2020,270980,368410,639390,COST
06079812443100000,2019,270980,368410,639390,COST
06079812443120000,2021,292300,319900,612200,MKT
06079812443120000,2020,259082,211318,470400,OVR
06079812443120000,2019,259082,211318,470400,MKT
06079812443130000,2021,309654,342446,652100,MKT
06079812443130000,2020,266681,264719,531400,MKT
06079812443130000,2019,266681,264719,531400,MKT
06079812443140000,2021,309654,382646,692300,MKT
06079812443140000,2020,266681,318519,585200,MKT
06079812443140000,2019,266681,318519,585200,MKT
06079812443160000,2021,264536,309020,573556,COST
06079812443160000,2020,246439,269861,516300,MKT
06079812443160000,2019,246439,269861,516300,MKT
06079812443170000,2021,181010,209190,390200,MKT
06079812443170000,2020,203754,125246,329000,MKT
06079812443170000,2019,203754,125246,329000,MKT
06079812443180000,2021,181010,232090,413100,MKT
06079812443180000,2020,203754,155046,358800,MKT
06079812443180000,2019,203754,155046,358800,MKT
06079812443190000,2021,309654,764490,1074144,COST
06079812443190000,2020,266681,621840,888521,COST
06079812443190000,2019,266681,594180,860861,COST
06079812443210000,2021,309654,373690,683344,COST
06079812443210000,2020,266681,318319,585000,MKT
06079812443210000,2019,266681,318319,585000,MKT
06079812443220000,2021,194736,266264,461000,MKT
06079812443220000,2020,211359,217441,428800,OVR
06079812443220000,2019,211359,217441,428800,MKT
06079812443230000,2021,195764,227636,423400,MKT
06079812443230000,2020,211917,182683,394600,MKT
06079812443230000,2019,211917,182683,394600,MKT
06079812443240000,2021,250549,380751,631300,MKT
06079812443240000,2020,239819,324281,564100,MKT
06079812443240000,2019,239819,324281,564100,MKT
06079812444010000,2021,817322,1177330,1994652,COST
06079812444010000,2020,525845,948540,1474385,COST
06079812444010000,2019,525845,948540,1474385,COST
06079812444060000,2021,498437,760550,1258987,COST
06079812444060000,2020,410385,610720,1021105,COST
06079812444060000,2019,410385,610720,1021105,COST
06079812444080000,2021,498437,716830,1215267,COST
06079812444080000,2020,410385,581880,992265,COST
06079812444080000,2019,410385,581880,992265,COST
06079812444120000,2021,629087,167813,796900,MKT
06079812444120000,2020,461181,183819,645000,MKT
06079812444120000,2019,461181,183819,645000,MKT
06079812446010000,2021,271359,193241,464600,MKT
06079812446010000,2020,249605,143295,392900,MKT
06079812446010000,2019,249605,143295,392900,MKT
06079812446040000,2021,271359,301330,572689,COST
06079812446040000,2020,249605,263320,512925,OVR
06079812446040000,2019,249605,263320,512925,COST
06079812446070000,2021,338795,197605,536400,MKT
06079812446070000,2020,278980,186720,465700,MKT
06079812446070000,2019,278980,186720,465700,MKT
06079812446100000,2021,338795,231105,569900,MKT
06079812446100000,2020,278980,172220,451200,MKT
06079812446100000,2019,278980,172220,451200,MKT
06079812446120000,2021,271359,86441,357800,MKT
06079812446120000,2020,249605,60295,309900,MKT
06079812446120000,2019,249605,60295,309900,MKT
06079812446140000,2021,298644,274256,572900,MKT
06079812446140000,2020,261885,182315,444200,MKT
06079812446140000,2019,261885,182315,444200,MKT
06079812446170000,2021,298644,276456,575100,MKT
06079812446170000,2020,261885,228815,490700,MKT
06079812446170000,2019,261885,228815,490700,MKT
06079812446190000,2021,261376,197924,459300,MKT
06079812446190000,2020,244959,118641,363600,OVR
06079812446190000,2019,244959,118641,363600,MKT
06079812446210000,2021,314801,219499,534300,MKT
06079812446210000,2020,268894,169506,438400,OVR
06079812446210000,2019,268894,169506,438400,MKT
06079812446240000,2021,299839,99361,399200,MKT
06079812446240000,2020,262410,85090,347500,MKT
06079812446240000,2019,262410,85090,347500,MKT
06079812447010000,2021,359623,263577,623200,MKT
06079812447010000,2020,287449,220951,508400,OVR
06079812447010000,2019,287449,220951,508400,MKT
06079812447040000,2021,260372,210028,470400,MKT
06079812447040000,2020,244487,211713,456200,MKT
06079812447040000,2019,244487,211713,456200,MKT
06079812447060000,2021,313269,131231,444500,MKT
06079812447060000,2020,268238,102962,371200,MKT
06079812447060000,2019,268238,102962,371200,MKT
06079812447097000,2021,388343,0,388343,COST
06079812447097000,2020,100187,0,100187,COST
06079812447097000,2019,100187,0,100187,COST
06079812447120000,2021,388257,188643,576900,MKT
06079812447120000,2020,298703,188797,487500,MKT
06079812447120000,2019,298703,188797,487500,MKT
06079812447130000,2021,321573,211227,532800,MKT
06079812447130000,2020,271778,174422,446200,MKT
06079812447130000,2019,271778,174422,446200,MKT
06079812447150000,2021,278467,102433,380900,MKT
06079812447150000,2020,252861,75439,328300,MKT
06079812447150000,2019,252861,75439,328300,MKT
06079812447160000,2021,247534,155266,402800,MKT
06079812447160000,2020,238368,113632,352000,MKT
06079812447160000,2019,238368,113632,352000,MKT
06079812447180000,2021,213006,168494,381500,MKT
06079812447180000,2020,221076,99724,320800,MKT
06079812447180000,2019,221076,99724,320800,MKT
06079812447200000,2021,355517,246583,602100,MKT
06079812447200000,2020,285799,216401,502200,MKT
06079812447200000,2019,285799,216401,502200,MKT
06079812447210000,2021,293593,247607,541200,MKT
06079812447210000,2020,259656,172544,432200,MKT
06079812447210000,2019,259656,172544,432200,MKT
06079812447240000,2021,286926,172274,459200,MKT
06079812447240000,2020,256683,123717,380400,OVR
06079812447240000,2019,256683,123717,380400,MKT
06079812448010000,2021,268511,154589,423100,MKT
06079812448010000,2020,248288,133012,381300,MKT
06079812448010000,2019,248288,133012,381300,MKT
06079812448030000,2021,198962,235738,434700,MKT
06079812448030000,2020,213646,177454,391100,OVR
06079812448030000,2019,213646,177454,391100,MKT
06079812448050000,2021,308271,222729,531000,INCOME
06079812448050000,2020,266084,250416,516500,INCOME
06079812448050000,2019,266084,250416,516500,INCOME
06079812448080000,2021,391459,102141,493600,MKT
06079812448080000,2020,299935,138765,438700,MKT
06079812448080000,2019,299935,138765,438700,MKT
06079812448100000,2021,298594,179506,478100,MKT
06079812448100000,2020,261863,176937,438800,MKT
06079812448100000,2019,261863,176937,438800,MKT
06079812448120000,2021,298594,323906,622500,MKT
06079812448120000,2020,261863,290937,552800,MKT
06079812448120000,2019,261863,290937,552800,MKT
06079812448130000,2021,285608,232592,518200,MKT
06079812448130000,2020,256091,167009,423100,MKT
06079812448130000,2019,256091,167009,423100,MKT
06079812448160000,2021,283036,312964,596000,MKT
06079812448160000,2020,254932,204768,459700,MKT
06079812448160000,2019,254932,204768,459700,MKT
06079812448180000,2021,285893,195407,481300,MKT
06079812448180000,2020,256219,156081,412300,MKT
06079812448180000,2019,256219,156081,412300,MKT
06079812448200000,2021,285893,304307,590200,MKT
06079812448200000,2020,256219,284481,540700,MKT
06079812448200000,2019,256219,284481,540700,MKT
06079812448210000,2021,287184,310816,598000,MKT
06079812448210000,2020,256799,229201,486000,MKT
06079812448210000,2019,256799,229201,486000,MKT
06079812448240000,2021,283036,238564,521600,MKT
06079812448240000,2020,254932,183668,438600,OVR
06079812448240000,2019,254932,183668,438600,MKT
06079812449010000,2021,422990,94210,517200,MKT
06079812449010000,2020,311812,138988,450800,MKT
06079812449010000,2019,311812,138988,450800,MKT
06079812449060000,2021,291028,332272,623300,MKT
06079812449060000,2020,258516,246784,505300,MKT
06079812449060000,2019,258516,246784,505300,MKT
06079812449080000,2021,291028,165572,456600,MKT
06079812449080000,2020,258516,167184,425700,MKT
06079812449080000,2019,258516,167184,425700,MKT
06079812449100000,2021,291028,196772,487800,MKT
06079812449100000,2020,258516,135984,394500,MKT
06079812449100000,2019,258516,135984,394500,MKT
06079812449120000,2021,291028,285872,576900,MKT
06079812449120000,2020,258516,184684,443200,MKT
06079812449120000,2019,258516,189284,447800,MKT
06079812449130000,2021,200007,219893,419900,MKT
06079812449130000,2020,214207,168693,382900,MKT
06079812449130000,2019,214207,168693,382900,MKT
06079812449140000,2021,210219,209781,420000,MKT
06079812449140000,2020,219622,74060,293682,COST
06079812449140000,2019,219622,74060,293682,COST
06079812449160000,2021,298594,306406,605000,MKT
06079812449160000,2020,261863,220437,482300,MKT
06079812449160000,2019,261863,220437,482300,MKT
06079812449180000,2021,298594,163506,462100,MKT
06079812449180000,2020,261863,136637,398500,MKT
06079812449180000,2019,261863,136637,398500,MKT
06079812449200000,2021,298594,147606,446200,MKT
06079812449200000,2020,261863,165437,427300,MKT
06079812449200000,2019,261863,165437,427300,MKT
06079812449220000,2021,298594,194806,493400,MKT
06079812449220000,2020,261863,123837,385700,MKT
06079812449220000,2019,261863,123837,385700,MKT
06079812449240000,2021,298594,209606,508200,MKT
06079812449240000,2020,261863,209737,471600,MKT
06079812449240000,2019,261863,209737,471600,MKT
06079812450010000,2021,291028,491872,782900,MKT
06079812450010000,2020,258516,351284,609800,MKT
06079812450010000,2019,258516,351284,609800,MKT
06079812450040000,2021,306249,271651,577900,MKT
06079812450040000,2020,265207,210093,475300,MKT
06079812450040000,2019,265207,210093,475300,MKT
06079812450060000,2021,291028,217872,508900,MKT
06079812450060000,2020,258516,160984,419500,MKT
06079812450060000,2019,258516,160984,419500,MKT
06079812450090000,2021,360692,332450,693142,COST
06079812450090000,2020,287877,270120,557997,COST
06079812450090000,2019,287877,270120,557997,COST
06079812450120000,2021,360692,253708,614400,MKT
06079812450120000,2020,287877,204423,492300,MKT
06079812450120000,2019,287877,204423,492300,MKT
06079812450150000,2021,287827,272173,560000,MKT
06079812450150000,2020,257087,248913,506000,MKT
06079812450150000,2019,257087,248913,506000,MKT
06079812450160000,2021,306249,301251,607500,MKT
06079812450160000,2020,265207,227093,492300,MKT
06079812450160000,2019,265207,231690,496897,COST
06079812450180000,2021,287827,325673,613500,MKT
06079812450180000,2020,257087,243413,500500,MKT
06079812450180000,2019,257087,243413,500500,MKT
06079812450200000,2021,287827,550390,838217,COST
06079812450200000,2020,257087,442090,699177,COST
06079812450200000,2019,257087,442090,699177,COST
06079812450220000,2021,291028,159272,450300,MKT
06079812450220000,2020,258516,131684,390200,MKT
06079812450220000,2019,258516,131684,390200,MKT
06079812450240000,2021,287827,278673,566500,MKT
06079812450240000,2020,257087,204713,461800,MKT
06079812450240000,2019,257087,204713,461800,MKT
06079812451010000,2021,306249,435030,741279,COST
06079812451010000,2020,265207,346140,611347,COST
06079812451010000,2019,265207,352680,617887,COST
06079812451040000,2021,306249,267760,574009,COST
06079812451040000,2020,265207,255093,520300,MKT
06079812451040000,2019,265207,255093,520300,MKT
06079812451060000,2021,306249,360851,667100,MKT
06079812451060000,2020,265207,282693,547900,MKT
06079812451060000,2019,265207,282693,547900,MKT
06079812451080000,2021,316374,617019,933393,OVR
06079812451080000,2020,269567,524340,793907,COST
06079812451080000,2019,269567,524340,793907,COST
06079812451100000,2021,299342,155258,454600,MKT
06079812451100000,2020,262192,147808,410000,MKT
06079812451100000,2019,262192,147808,410000,MKT
06079812451110000,2021,217617,361083,578700,MKT
06079812451110000,2020,223462,279638,503100,MKT
06079812451110000,2019,223462,279638,503100,MKT
06079812451120000,2021,201221,259279,460500,MKT
06079812451120000,2020,214858,211442,426300,OVR
06079812451120000,2019,214858,211442,426300,MKT
06079812451130000,2021,344438,529762,874200,INCOME
06079812451130000,2020,282897,431103,714000,INCOME
06079812451130000,2019,282897,431103,714000,INCOME
06079812451170000,2021,348350,332350,680700,MKT
06079812451170000,2020,282897,372203,655100,MKT
06079812451170000,2019,282897,372203,655100,MKT
06079812451200000,2021,369357,240443,609800,MKT
06079812451200000,2020,291324,243176,534500,MKT
06079812451200000,2019,291324,243176,534500,MKT
06079812451220000,2021,322978,153822,476800,MKT
06079812451220000,2020,272373,120027,392400,MKT
06079812451220000,2019,272373,120027,392400,MKT
06079812451230000,2021,233049,258651,491700,MKT
06079812451230000,2020,231271,210329,441600,MKT
06079812451230000,2019,231271,210329,441600,MKT
06079812451240000,2021,183636,225564,409200,MKT
06079812451240000,2020,205231,139269,344500,MKT
06079812451240000,2019,205231,139269,344500,MKT
06079812452010000,2021,230588,290612,521200,MKT
06079812452010000,2020,230043,231157,461200,MKT
06079812452010000,2019,230043,231157,461200,MKT
06079812452020000,2021,151306,192794,344100,MKT
06079812452020000,2020,186245,127255,313500,MKT
06079812452020000,2019,186245,127255,313500,MKT
06079812452030000,2021,286461,255539,542000,MKT
06079812452030000,2020,256475,184125,440600,MKT
06079812452030000,2019,256475,184125,440600,MKT
06079812452040000,2021,285323,266877,552200,MKT
06079812452040000,2020,255963,193537,449500,MKT
06079812452040000,2019,255963,193537,449500,MKT
06079812452050000,2021,286461,264439,550900,MKT
06079812452050000,2020,256475,170470,426945,COST
06079812452050000,2019,256475,170470,426945,COST
06079812452060000,2021,333227,600500,933727,COST
06079812452060000,2020,276672,395328,672000,MKT
06079812452060000,2019,276672,395328,672000,MKT
06079812452070000,2021,333227,278873,612100,MKT
06079812452070000,2020,276672,265428,542100,MKT
06079812452070000,2019,276672,265428,542100,MKT
06079812452080000,2021,333227,395773,729000,MKT
06079812452080000,2020,276672,302028,578700,MKT
06079812452080000,2019,276672,302028,578700,MKT
06079812452090000,2021,443624,369223,812847,OVR
06079812452090000,2020,319346,408454,727800,MKT
06079812452090000,2019,319346,414054,733400,MKT
06079812452100000,2021,416038,390962,807000,MKT
06079812452100000,2020,309232,424168,733400,OVR
06079812452100000,2019,309232,424168,733400,MKT
06079812452110000,2021,333227,366073,699300,MKT
06079812452110000,2020,276672,281728,558400,OVR
06079812452110000,2019,276672,281728,558400,MKT
06079812452120000,2021,320020,314580,634600,MKT
06079812452120000,2020,271120,309180,580300,MKT
06079812452120000,2019,271120,309180,580300,MKT
06079812452130000,2021,200111,245060,445171,COST
06079812452130000,2020,214263,191237,405500,MKT
06079812452130000,2019,214263,191237,405500,MKT
06079812452140000,2021,270873,233627,504500,MKT
06079812452140000,2020,249381,166519,415900,MKT
06079812452140000,2019,249381,166519,415900,MKT
06079812453010000,2021,278043,210057,488100,MKT
06079812453010000,2020,252668,194532,447200,MKT
06079812453010000,2019,252668,194532,447200,MKT
06079812453020000,2021,144980,82890,227870,COST
06079812453020000,2020,182300,75400,257700,MKT
06079812453020000,2019,182300,75400,257700,MKT
06079812453040000,2021,320613,195687,516300,INCOME
06079812453040000,2020,273748,151852,425600,INCOME
06079812453040000,2019,273748,151852,425600,INCOME
06079812453060000,2021,307955,223245,531200,MKT
06079812453060000,2020,265947,199053,465000,MKT
06079812453060000,2019,265947,199053,465000,MKT
06079812453080000,2021,328551,266149,594700,MKT
06079812453080000,2020,274719,233381,508100,MKT
06079812453080000,2019,274719,233381,508100,MKT
06079812453120000,2021,444291,586909,1031200,INCOME
06079812453120000,2020,575804,342796,918600,INCOME
06079812453120000,2019,575804,342796,918600,INCOME
06079812455010000,2021,374353,115647,490000,MKT
06079812455010000,2020,293292,160508,453800,MKT
06079812455010000,2019,293292,160508,453800,MKT
06079812455060000,2021,374353,306247,680600,MKT
06079812455060000,2020,293292,264008,557300,MKT
06079812455060000,2019,293292,264008,557300,MKT
06079812455070000,2021,258269,163731,422000,MKT
06079812455070000,2020,243495,147305,390800,MKT
06079812455070000,2019,243495,147305,390800,MKT
06079812455090000,2021,262461,361140,623601,COST
06079812455090000,2020,245468,290060,535528,COST
06079812455090000,2019,245468,290060,535528,COST
06079812455110000,2021,304780,201120,505900,MKT
06079812455110000,2020,264569,145031,409600,OVR
06079812455110000,2019,264569,145031,409600,MKT
06079812455140000,2021,449248,479370,928618,COST
06079812455140000,2020,604150,451500,1055650,COST
06079812455140000,2019,604150,451500,1055650,COST
06079812455160000,2021,284597,156203,440800,MKT
06079812455160000,2020,255636,120464,376100,MKT
06079812455160000,2019,255636,120464,376100,MKT
06079812455200000,2021,418089,122511,540600,INCOME
06079812455200000,2020,309190,165710,474900,INCOME
06079812455200000,2019,309190,165710,474900,INCOME
06079812456010000,2021,360337,114163,474500,INCOME
06079812456010000,2020,288813,145087,433900,INCOME
06079812456010000,2019,288813,145087,433900,INCOME
06079812456020000,2021,323098,147202,470300,INCOME
06079812456020000,2020,274719,121881,396600,INCOME
06079812456020000,2019,274719,121881,396600,INCOME
06079812456070000,2021,342058,198542,540600,INCOME
06079812456070000,2020,281999,192901,474900,INCOME
06079812456070000,2019,281999,192901,474900,INCOME
06079812456090000,2021,383290,188110,571400,MKT
06079812456090000,2020,296781,167319,464100,MKT
06079812456090000,2019,296781,167319,464100,MKT
06079812456110000,2021,341484,172916,514400,MKT
06079812456110000,2020,280088,101712,381800,MKT
06079812456110000,2019,280088,101712,381800,MKT
06079812456130000,2021,284181,158319,442500,MKT
06079812456130000,2020,255449,113851,369300,MKT
06079812456130000,2019,255449,113851,369300,MKT
06079812456150000,2021,284181,195919,480100,MKT
06079812456150000,2020,255449,176351,431800,MKT
06079812456150000,2019,255449,176351,431800,MKT
06079812456160000,2021,330277,111523,441800,MKT
06079812456160000,2020,275441,109959,385400,MKT
06079812456160000,2019,275441,109959,385400,MKT
06079812456180000,2021,169375,104760,274135,COST
06079812456180000,2020,197081,91419,288500,MKT
06079812456180000,2019,197081,91419,288500,MKT
06079812456200000,2021,346148,294052,640200,MKT
06079812456200000,2020,281999,205801,487800,OVR
06079812456200000,2019,281999,205801,487800,MKT
06079812456220000,2021,346148,230600,576748,COST
06079812456220000,2020,281999,187140,469139,COST
06079812456220000,2019,281999,187140,469139,COST
06079812456230000,2021,279891,227109,507000,MKT
06079812456230000,2020,253509,154191,407700,MKT
06079812456230000,2019,253509,154191,407700,MKT
06079812456240000,2021,186048,180970,367018,COST
06079812456240000,2020,206578,165722,372300,MKT
06079812456240000,2019,206578,153622,360200,MKT
06079812457010000,2021,235944,182556,418500,MKT
06079812457010000,2020,232706,124294,357000,MKT
06079812457010000,2019,232706,124294,357000,MKT
06079812457020000,2021,215174,299826,515000,MKT
06079812457020000,2020,222202,248598,470800,MKT
06079812457020000,2019,222202,238698,460900,MKT
06079812457040000,2021,329932,223768,553700,MKT
06079812457040000,2020,275297,204103,479400,MKT
06079812457040000,2019,275297,204103,479400,MKT
06079812457060000,2021,329932,333668,663600,MKT
06079812457060000,2020,275297,221303,496600,MKT
06079812457060000,2019,275297,221303,496600,MKT
06079812457070000,2021,260484,132216,392700,INCOME
06079812457070000,2020,244539,99361,343900,INCOME
06079812457070000,2019,244539,99361,343900,INCOME
06079812457090000,2021,189346,367850,557196,COST
06079812457090000,2020,399575,199725,599300,INCOME
06079812457090000,2019,399575,199725,599300,INCOME
06079812457100000,2021,252533,248467,501000,MKT
06079812457100000,2020,240769,168631,409400,MKT
06079812457100000,2019,240769,163831,404600,MKT
06079812457130000,2021,392615,129585,522200,MKT
06079812457130000,2020,300379,156221,456600,MKT
06079812457130000,2019,300379,156221,456600,MKT
06079812457160000,2021,218079,381121,599200,INCOME
06079812457160000,2020,424505,169295,593800,INCOME
06079812457160000,2019,424505,169295,593800,INCOME
06079812457180000,2021,309523,174977,484500,INCOME
06079812457180000,2020,269364,191436,460800,INCOME
06079812457180000,2019,269364,191436,460800,INCOME
06079812457200000,2021,315898,250302,566200,MKT
06079812457200000,2020,269364,222436,491800,MKT
06079812457200000,2019,269364,222436,491800,MKT
06079812457220000,2021,315898,75702,391600,INCOME
06079812457220000,2020,269364,62936,332300,INCOME
06079812457220000,2019,269364,62936,332300,INCOME
06079812458010000,2021,321573,227927,549500,MKT
06079812458010000,2020,271778,200222,472000,MKT
06079812458010000,2019,271778,200222,472000,MKT
06079812458040000,2021,321573,6090,327663,COST
06079812458040000,2020,271778,5940,277718,COST
06079812458040000,2019,271778,5940,277718,COST
06079812458060000,2021,321573,73327,394900,MKT
06079812458060000,2020,271778,67860,339638,COST
06079812458060000,2019,271778,67860,339638,COST
06079812458137000,2021,492321,0,492321,COST
06079812458137000,2020,601690,0,601690,COST
06079812458137000,2019,601690,0,601690,COST
06079812458170000,2021,203178,417622,620800,INCOME
06079812458170000,2020,411827,172773,584600,INCOME
06079812458170000,2019,411827,172773,584600,INCOME
06079812458190000,2021,338120,228180,566300,MKT
06079812458190000,2020,278701,148199,426900,MKT
06079812458190000,2019,278701,148199,426900,MKT
06079812458200000,2021,67614,0,67614,COST
06079812458200000,2020,68227,0,68227,COST
06079812458200000,2019,68227,0,68227,COST
06079812458210000,2021,258325,293075,551400,MKT
06079812458210000,2020,243521,242979,486500,MKT
06079812458210000,2019,243521,242979,486500,MKT
06079812458220000,2021,215174,148126,363300,MKT
06079812458220000,2020,222202,56898,279100,MKT
06079812458220000,2019,222202,56898,279100,MKT
06079812458230000,2021,200007,149693,349700,MKT
06079812458230000,2020,214207,75293,289500,MKT
06079812458230000,2019,214207,75293,289500,MKT
06079812459010000,2021,291028,543380,834408,COST
06079812459010000,2020,258516,392430,650946,COST
06079812459010000,2019,258516,392430,650946,COST
06079812459050000,2021,389119,507320,896439,COST
06079812459050000,2020,299035,403940,702975,COST
06079812459050000,2019,299035,403940,702975,COST
06079812459060000,2021,274718,123582,398300,MKT
06079812459060000,2020,251149,96751,347900,MKT
06079812459060000,2019,251149,96751,347900,MKT
06079812459090000,2021,352939,489100,842039,COST
06079812459090000,2020,284758,405510,690268,OVR
06079812459090000,2019,284758,405510,690268,COST
06079812459110000,2021,309291,212309,521600,INCOME
06079812459110000,2020,266525,193075,459600,INCOME
06079812459110000,2019,266525,193075,459600,INCOME
06079812459130000,2021,278308,257692,536000,MKT
06079812459130000,2020,252789,218511,471300,MKT
06079812459130000,2019,252789,218511,471300,MKT
06079812459150000,2021,294831,59069,353900,INCOME
06079812459150000,2020,260204,91096,351300,INCOME
06079812459150000,2019,260204,91096,351300,INCOME
06079812459170000,2021,294831,130069,424900,MKT
06079812459170000,2020,260204,101796,362000,MKT
06079812459170000,2019,260204,101796,362000,MKT
06079812459180000,2021,206794,212406,419200,MKT
06079812459180000,2020,217821,171679,389500,MKT
06079812459180000,2019,217821,171679,389500,MKT
06079812459200000,2021,345883,386517,732400,MKT
06079812459200000,2020,281890,273310,555200,OVR
06079812459200000,2019,281890,273310,555200,MKT
06079812459230000,2021,420457,159243,579700,MKT
06079812459230000,2020,310875,173825,484700,OVR
06079812459230000,2019,310875,173825,484700,MKT
06079812460010000,2021,436836,175864,612700,MKT
06079812460010000,2020,316887,200613,517500,MKT
06079812460010000,2019,316887,196113,513000,MKT
06079812460040000,2021,321573,593750,915323,COST
06079812460040000,2020,271778,483150,754928,COST
06079812460040000,2019,271778,476620,748398,COST
06079812460060000,2021,274718,178482,453200,MKT
06079812460060000,2020,251149,148451,399600,MKT
06079812460060000,2019,251149,148451,399600,MKT
06079812460090000,2021,366523,349077,715600,MKT
06079812460090000,2020,290201,301399,591600,MKT
06079812460090000,2019,290201,301399,591600,MKT
06079812460120000,2021,257756,637344,895100,INCOME
06079812460120000,2020,456017,313483,769500,INCOME
06079812460120000,2019,456017,313483,769500,INCOME
06079812460130000,2021,321573,262627,584200,MKT
06079812460130000,2020,271778,148122,419900,MKT
06079812460130000,2019,271778,148122,419900,MKT
06079812460140000,2021,222364,583636,806000,INCOME
06079812460140000,2020,428058,205942,634000,INCOME
06079812460140000,2019,428058,205942,634000,INCOME
06079812460150000,2021,299839,165261,465100,MKT
06079812460150000,2020,262410,104690,367100,MKT
06079812460150000,2019,262410,104690,367100,MKT
06079812460170000,2021,222364,448336,670700,INCOME
06079812460170000,2020,271778,142622,414400,INCOME
06079812460170000,2019,271778,142622,414400,INCOME
06079812460170900,2021,222364,558736,781100,INCOME
06079812460170900,2020,271778,142622,414400,INCOME
06079812460170900,2019,271778,142622,414400,INCOME
06079812460180000,2021,335455,154445,489900,MKT
06079812460180000,2020,277598,207902,485500,MKT
06079812460180000,2019,277598,207902,485500,MKT
06079812460190000,2021,229386,359614,589000,INCOME
06079812460190000,2020,275681,199219,474900,INCOME
06079812460190000,2019,275681,199219,474900,INCOME
06079812460207000,2021,334531,0,334531,COST
06079812460207000,2020,86486,0,86486,COST
06079812460207000,2019,86486,0,86486,COST
06079812460237000,2021,552848,0,552848,COST
06079812460237000,2020,141916,0,141916,COST
06079812460237000,2019,141916,0,141916,COST
06079812460240000,2021,321573,403627,725200,MKT
06079812460240000,2020,271778,282822,554600,OVR
06079812460240000,2019,271778,282822,554600,MKT
06079812460250000,2021,321573,252327,573900,MKT
06079812460250000,2020,271778,244622,516400,MKT
06079812460250000,2019,271778,244622,516400,MKT
06079812460270000,2021,443624,461176,904800,MKT
06079812460270000,2020,319346,414050,733396,COST
06079812460270000,2019,319346,414050,733396,COST
06079812460280000,2021,321573,666420,987993,COST
06079812460280000,2020,271778,529130,800908,COST
06079812460280000,2019,271778,351722,623500,MKT
06079812460290000,2021,321573,290027,611600,MKT
06079812460290000,2020,271778,266522,538300,MKT
06079812460290000,2019,271778,266522,538300,MKT
06079812460300000,2021,321573,233927,555500,MKT
06079812460300000,2020,271778,219922,491700,MKT
06079812460300000,2019,271778,219922,491700,MKT
06079812460310000,2021,321573,136750,458323,COST
06079812460310000,2020,271778,111110,382888,COST
06079812460310000,2019,271778,111110,382888,COST
06079812460320000,2021,443624,206276,649900,MKT
06079812460320000,2020,319346,231854,551200,MKT
06079812460320000,2019,319346,231854,551200,MKT
06079812460330000,2021,299839,276961,576800,MKT
06079812460330000,2020,262410,199890,462300,MKT
06079812460330000,2019,262410,199890,462300,MKT
06079812460340000,2021,284597,192803,477400,MKT
06079812460340000,2020,255636,144564,400200,MKT
06079812460340000,2019,255636,144564,400200,MKT
06079812461010000,2021,1376311,0,1376311,COST
06079812461010000,2020,532783,0,532783,COST
06079812461010000,2019,532783,0,532783,COST
06079812461030000,2021,3156153,0,3156153,COST
06079812461030000,2020,1849358,0,1849358,COST
06079812461030000,2019,1849358,0,1849358,COST
06079813101010000,2021,9527916,0,9527916,COST
06079813101010000,2020,2432810,0,2432810,COST
06079813101010000,2019,2432810,0,2432810,COST
06079813101050000,2021,964470,0,964470,COST
06079813101050000,2020,425449,0,425449,COST
06079813101050000,2019,425449,0,425449,COST
06079813106010000,2021,371529,211971,583500,MKT
06079813106010000,2020,292181,162519,454700,OVR
06079813106010000,2019,292181,162519,454700,MKT
06079813106090000,2021,571602,390130,961732,COST
06079813106090000,2020,362612,314320,676932,COST
06079813106090000,2019,362612,314320,676932,COST
06079813106120000,2021,390914,203486,594400,INCOME
06079813106120000,2020,299805,236295,536100,INCOME
06079813106120000,2019,299805,236295,536100,INCOME
06079813106160000,2021,457827,458610,916437,COST
06079813106160000,2020,324431,365270,689701,COST
06079813106160000,2019,324431,365270,689701,COST
06079813106180000,2021,319336,534480,853816,COST
06079813106180000,2020,270829,440170,710999,COST
06079813106180000,2019,270829,440170,710999,COST
06079813107010000,2021,391659,206041,597700,MKT
06079813107010000,2020,300012,190388,490400,MKT
06079813107010000,2019,300012,190388,490400,MKT
06079813107060000,2021,472016,277850,749866,COST
06079813107060000,2020,329433,246067,575500,MKT
06079813107060000,2019,329433,246067,575500,MKT
06079813107090000,2021,457476,161624,619100,MKT
06079813107090000,2020,324306,173694,498000,OVR
06079813107090000,2019,324306,173694,498000,MKT
06079813107130000,2021,500040,409590,909630,COST
06079813107130000,2020,339096,330060,669156,COST
06079813107130000,2019,339096,330060,669156,COST
06079813107140000,2021,292300,174200,466500,MKT
06079813107140000,2020,259082,120518,379600,MKT
06079813107140000,2019,259082,120518,379600,MKT
06079813107160000,2021,292300,260400,552700,MKT
06079813107160000,2020,259082,201718,460800,MKT
06079813107160000,2019,259082,201718,460800,MKT
06079813107170000,2021,257565,249410,506975,COST
06079813107170000,2020,243162,205270,448432,COST
06079813107170000,2019,243162,205270,448432,COST
06079813107180000,2021,412115,229740,641855,COST
06079813107180000,2020,307767,98733,406500,INCOME
06079813107180000,2019,307767,98733,406500,INCOME
06079813107220000,2021,342153,206947,549100,MKT
06079813107220000,2020,280363,178937,459300,MKT
06079813107220000,2019,280363,178937,459300,MKT
06079813107250000,2021,427182,377918,805100,MKT
06079813107250000,2020,313357,193343,506700,INCOME
06079813107250000,2019,313357,193343,506700,INCOME
06079813107290000,2021,466245,357290,823535,COST
06079813107290000,2020,327408,285860,613268,COST
06079813107290000,2019,327408,285860,613268,COST
06079813107320000,2021,457476,326490,783966,COST
06079813107320000,2020,324306,263420,587726,COST
06079813107320000,2019,324306,263420,587726,COST
06079813108010000,2021,392615,398040,790655,COST
06079813108010000,2020,300379,316921,617300,MKT
06079813108010000,2019,300379,316921,617300,MKT
06079813108040000,2021,284597,0,284597,COST
06079813108040000,2020,255636,0,255636,COST
06079813108040000,2019,255636,0,255636,COST
06079813108080000,2021,355323,447300,802623,COST
06079813108080000,2020,285721,389179,674900,MKT
06079813108080000,2019,285721,389179,674900,MKT
06079813108110000,2021,351980,287720,639700,INCOME
06079813108110000,2020,285721,266979,552700,INCOME
06079813108110000,2019,285721,266979,552700,INCOME
06079813108140000,2021,321573,308227,629800,MKT
06079813108140000,2020,272373,260427,532800,OVR
06079813108140000,2019,272373,260427,532800,MKT
06079813108160000,2021,351415,322285,673700,MKT
06079813108160000,2020,284141,288259,572400,MKT
06079813108160000,2019,284141,288259,572400,MKT
06079813115010000,2021,591817,662870,1254687,COST
06079813115010000,2020,560363,585880,1146243,COST
06079813115010000,2019,560363,585880,1146243,COST
06079813115080000,2021,313269,83531,396800,INCOME
06079813115080000,2020,268238,171662,439900,INCOME
06079813115080000,2019,268238,171662,439900,INCOME
06079813115090000,2021,314466,269034,583500,MKT
06079813115090000,2020,268751,176949,445700,MKT
06079813115090000,2019,268751,176949,445700,MKT
06079813115120000,2021,313269,273631,586900,MKT
06079813115120000,2020,268238,223962,492200,OVR
06079813115120000,2019,268238,223962,492200,MKT
06079813115130000,2021,265913,208287,474200,MKT
06079813115130000,2020,247081,145219,392300,MKT
06079813115130000,2019,247081,145219,392300,MKT
06079813115160000,2021,355323,250177,605500,MKT
06079813115160000,2020,285721,196379,482100,OVR
06079813115160000,2019,285721,196379,482100,MKT
06079813115180000,2021,312525,287875,600400,MKT
06079813115180000,2020,267918,211482,479400,MKT
06079813115180000,2019,267918,211482,479400,MKT
06079813115200000,2021,313269,274531,587800,MKT
06079813115200000,2020,268238,191562,459800,OVR
06079813115200000,2019,268238,191562,459800,MKT
06079813115220000,2021,313269,237531,550800,MKT
06079813115220000,2020,268238,175662,443900,MKT
06079813115220000,2019,268238,175662,443900,MKT
06079813115240000,2021,313269,280331,593600,MKT
06079813115240000,2020,268238,193262,461500,MKT
06079813115240000,2019,268238,193262,461500,MKT
06079813116010000,2021,328090,202410,530500,MKT
06079813116010000,2020,274526,158274,432800,MKT
06079813116010000,2019,274526,160674,435200,MKT
06079813116017000,2021,356500,0,356500,COST
06079813116017000,2020,92083,0,92083,COST
06079813116017000,2019,92083,0,92083,COST
06079813116087000,2021,483407,0,483407,COST
06079813116087000,2020,124326,0,124326,COST
06079813116087000,2019,124326,0,124326,COST
06079813116120000,2021,342153,349147,691300,MKT
06079813116120000,2020,280363,310137,590500,MKT
06079813116120000,2019,280363,310137,590500,MKT
06079813116140000,2021,337746,15554,353300,INCOME
06079813116140000,2020,280363,126137,406500,INCOME
06079813116140000,2019,280363,126137,406500,INCOME
06079813116180000,2021,651707,1392310,2044017,COST
06079813116180000,2020,583988,1217760,1801748,COST
06079813116180000,2019,583988,1217760,1801748,COST
06079813116240000,2021,653377,454460,1107837,COST
06079813116240000,2020,584628,426410,1011038,COST
06079813116240000,2019,584628,426410,1011038,COST
06079813117010000,2021,469962,280410,750372,COST
06079813117010000,2020,328713,238287,567000,MKT
06079813117010000,2019,328713,238287,567000,MKT
06079813117090000,2021,415924,419470,835394,COST
06079813117090000,2020,309190,364510,673700,OVR
06079813117090000,2019,309190,364510,673700,MKT
06079813117120000,2021,355323,230277,585600,MKT
06079813117120000,2020,285721,201679,487400,MKT
06079813117120000,2019,285721,201679,487400,MKT
06079813124010000,2021,391120,224080,615200,MKT
06079813124010000,2020,299805,218495,518300,MKT
06079813124010000,2019,299805,218495,518300,MKT
06079813124060000,2021,390914,110886,501800,INCOME
06079813124060000,2020,299805,251595,551400,INCOME
06079813124060000,2019,299805,251595,551400,INCOME
06079813124090000,2021,391120,388680,779800,COST
06079813124090000,2020,299805,315900,615705,COST
06079813124090000,2019,299805,315900,615705,COST
06079813124120000,2021,390914,69086,460000,INCOME
06079813124120000,2020,299805,197095,496900,INCOME
06079813124120000,2019,299805,197095,496900,INCOME
06079813124160000,2021,470139,1234610,1704749,COST
06079813124160000,2020,326284,1079910,1406194,COST
06079813124160000,2019,326284,1079910,1406194,COST
06079813124220000,2021,591817,666770,1258587,COST
06079813124220000,2020,362612,617130,979742,COST
06079813124220000,2019,362612,617130,979742,COST
06079813124240000,2021,313269,279431,592700,MKT
06079813124240000,2020,268238,216962,485200,MKT
06079813124240000,2019,268238,216962,485200,MKT
06079813125010000,2021,328551,137449,466000,MKT
06079813125010000,2020,274719,162781,437500,MKT
06079813125010000,2019,274719,162781,437500,MKT
06079813125040000,2021,351980,171620,523600,INCOME
06079813125040000,2020,285721,162279,448000,INCOME
06079813125040000,2019,285721,162279,448000,INCOME
06079813125060000,2021,342153,379147,721300,MKT
06079813125060000,2020,280363,298737,579100,MKT
06079813125060000,2019,280363,298737,579100,MKT
06079813125080000,2021,342153,279047,621200,MKT
06079813125080000,2020,280363,203237,483600,MKT
06079813125080000,2019,280363,203237,483600,MKT
06079813125120000,2021,500040,0,500040,COST
06079813125120000,2020,298405,0,298405,COST
06079813125120000,2019,526346,0,526346,COST
06079813125130000,2021,442623,809477,1252100,INCOME
06079813125130000,2020,494798,621002,1115800,INCOME
06079813125130000,2019,494798,621002,1115800,INCOME
06079813125180000,2021,418089,192211,610300,INCOME
06079813125180000,2020,309190,275910,585100,INCOME
06079813125180000,2019,309190,275910,585100,INCOME
06079813125210000,2021,430473,102527,533000,INCOME
06079813125210000,2020,313357,298043,611400,INCOME
06079813125210000,2019,313357,298043,611400,INCOME
06079813125220000,2021,231821,227879,459700,MKT
06079813125220000,2020,230659,139441,370100,MKT
06079813125220000,2019,230659,139441,370100,MKT
06079813125240000,2021,343822,248678,592500,MKT
06079813125240000,2020,281047,203053,484100,MKT
06079813125240000,2019,281047,203053,484100,MKT
06079813126010000,2021,355323,247177,602500,MKT
06079813126010000,2020,285721,219779,505500,MKT
06079813126010000,2019,285721,219779,505500,MKT
06079813126060000,2021,355323,309677,665000,MKT
06079813126060000,2020,285721,266779,552500,MKT
06079813126060000,2019,285721,266779,552500,MKT
06079813126090000,2021,355323,299977,655300,MKT
06079813126090000,2020,285721,239079,524800,MKT
06079813126090000,2019,285721,239079,524800,MKT
06079813126120000,2021,355323,235677,591000,MKT
06079813126120000,2020,285721,216879,502600,MKT
06079813126120000,2019,285721,216879,502600,MKT
06079813132010000,2021,464336,1689364,2153700,INCOME
06079813132010000,2020,505053,1131947,1637000,INCOME
06079813132010000,2019,505053,1131947,1637000,INCOME
06079813132070000,2021,391120,383601,774721,OVR
06079813132070000,2020,299805,404560,704365,COST
06079813132070000,2019,299805,376280,676085,COST
06079813132100000,2021,391120,420680,811800,MKT
06079813132100000,2020,299805,336090,635895,COST
06079813132100000,2019,299805,336090,635895,COST
06079813132120000,2021,313269,466231,779500,MKT
06079813132120000,2020,268238,313362,581600,OVR
06079813132120000,2019,268238,313362,581600,MKT
06079813132140000,2021,306708,387770,694478,COST
06079813132140000,2020,268238,333620,601858,COST
06079813132140000,2019,268238,333620,601858,COST
06079813132160000,2021,306708,222900,529608,COST
06079813132160000,2020,268238,192700,460938,COST
06079813132160000,2019,268238,192700,460938,COST
06079813132180000,2021,313269,167731,481000,MKT
06079813132180000,2020,268238,129762,398000,MKT
06079813132180000,2019,268238,129762,398000,MKT
06079813132240000,2021,313269,103131,416400,MKT
06079813132240000,2020,268238,109662,377900,MKT
06079813132240000,2019,268238,109662,377900,MKT
06079813132260000,2021,464336,338760,803096,COST
06079813132260000,2020,324431,333140,657571,COST
06079813132260000,2019,324431,333140,657571,COST
06079813133010000,2021,511325,883370,1394695,COST
06079813133010000,2020,526346,780590,1306936,COST
06079813133010000,2019,526346,780590,1306936,COST
06079813133050000,2021,427182,295490,722672,COST
06079813133050000,2020,313357,282843,596200,MKT
06079813133050000,2019,313357,282843,596200,MKT
06079813133090000,2021,342153,266947,609100,MKT
06079813133090000,2020,280363,214037,494400,MKT
06079813133090000,2019,280363,214037,494400,MKT
06079813133120000,2021,427182,161218,588400,MKT
06079813133120000,2020,313357,204843,518200,MKT
06079813133120000,2019,313357,204843,518200,MKT
06079813133150000,2021,427182,334090,761272,COST
06079813133150000,2020,313357,291943,605300,MKT
06079813133150000,2019,313357,291943,605300,MKT
06079813133180000,2021,427182,253618,680800,MKT
06079813133180000,2020,313357,301990,615347,COST
06079813133180000,2019,313357,301990,615347,COST
06079813133210000,2021,427182,324918,752100,MKT
06079813133210000,2020,313357,354943,668300,MKT
06079813133210000,2019,313357,354943,668300,MKT
06079813133240000,2021,427182,198618,625800,MKT
06079813133240000,2020,313357,195443,508800,MKT
06079813133240000,2019,313357,195443,508800,MKT
06079813134010000,2021,314466,240334,554800,MKT
06079813134010000,2020,268751,156549,425300,MKT
06079813134010000,2019,268751,156549,425300,MKT
06079813134050000,2021,322978,315822,638800,MKT
06079813134050000,2020,272373,259927,532300,MKT
06079813134050000,2019,272373,259927,532300,MKT
06079813134080000,2021,322978,279422,602400,MKT
06079813134080000,2020,272373,200727,473100,MKT
06079813134080000,2019,272373,200727,473100,MKT
06079813134100000,2021,322978,407922,730900,MKT
06079813134100000,2020,272373,363027,635400,MKT
06079813134100000,2019,272373,363027,635400,MKT
06079813134120000,2021,284597,338603,623200,MKT
06079813134120000,2020,255636,241564,497200,MKT
06079813134120000,2019,255636,241564,497200,MKT
06079813142010000,2021,812729,1010210,1822939,COST
06079813142010000,2020,432577,819640,1252217,COST
06079813142010000,2019,432577,819640,1252217,COST
06079813142130000,2021,391120,277480,668600,MKT
06079813142130000,2020,299805,258795,558600,MKT
06079813142130000,2019,299805,258795,558600,MKT
06079813142150000,2021,303551,283440,586991,COST
06079813142150000,2020,264033,262467,526500,MKT
06079813142150000,2019,264033,259367,523400,MKT
06079813142180000,2021,227168,250032,477200,MKT
06079813142180000,2020,228326,200274,428600,MKT
06079813142180000,2019,228326,200274,428600,MKT
06079813142220000,2021,418762,453730,872492,COST
06079813142220000,2020,310246,369154,679400,OVR
06079813142220000,2019,310246,369154,679400,MKT
06079813142240000,2021,348835,203865,552700,INCOME
06079813142240000,2020,284547,250353,534900,INCOME
06079813142240000,2019,284547,250353,534900,INCOME
06079813143010000,2021,234119,312181,546300,MKT
06079813143010000,2020,231802,191298,423100,MKT
06079813143010000,2019,231802,191298,423100,MKT
06079813143020000,2021,234119,219481,453600,MKT
06079813143020000,2020,231802,169498,401300,MKT
06079813143020000,2019,231802,169498,401300,MKT
06079813143040000,2021,342153,363850,706003,COST
06079813143040000,2020,280363,292170,572533,COST
06079813143040000,2019,280363,292170,572533,COST
06079813143060000,2021,342153,177947,520100,MKT
06079813143060000,2020,280363,115337,395700,MKT
06079813143060000,2019,280363,115337,395700,MKT
06079813143100000,2021,363882,568330,932212,COST
06079813143100000,2020,289151,470200,759351,COST
06079813143100000,2019,289151,470200,759351,COST
06079813143110000,2021,319218,228082,547300,MKT
06079813143110000,2020,270779,171721,442500,MKT
06079813143110000,2019,270779,171721,442500,MKT
06079813143120000,2021,342153,200847,543000,MKT
06079813143120000,2020,280363,174737,455100,MKT
06079813143120000,2019,280363,174737,455100,MKT
06079813143180000,2021,624305,622720,1247025,COST
06079813143180000,2020,379003,503180,882183,COST
06079813143180000,2019,379003,503180,882183,COST
06079813143210000,2021,430473,222927,653400,INCOME
06079813143210000,2020,313357,406343,719700,INCOME
06079813143210000,2019,313357,406343,719700,INCOME
06079813143240000,2021,427182,432180,859362,COST
06079813143240000,2020,313357,350390,663747,COST
06079813143240000,2019,313357,350390,663747,COST
06079813144010000,2021,415924,1042860,1458784,COST
06079813144010000,2020,309190,831570,1140760,COST
06079813144010000,2019,309190,831570,1140760,COST
06079813144070000,2021,355323,320277,675600,MKT
06079813144070000,2020,285721,280179,565900,MKT
06079813144070000,2019,285721,280179,565900,MKT
06079813144120000,2021,469962,429038,899000,MKT
06079813144120000,2020,328713,343460,672173,COST
06079813144120000,2019,328713,343460,672173,COST
06079813150010000,2021,380521,400550,781071,COST
06079813150010000,2020,295704,377996,673700,MKT
06079813150010000,2019,295704,377996,673700,MKT
06079813150060000,2021,380521,675370,1055891,COST
06079813150060000,2020,295704,536070,831774,COST
06079813150060000,2019,295704,536070,831774,COST
06079813150090000,2021,380521,292179,672700,MKT
06079813150090000,2020,295704,270696,566400,MKT
06079813150090000,2019,295704,270696,566400,MKT
06079813150120000,2021,380521,708500,1089021,COST
06079813150120000,2020,295704,572974,868678,MRA
06079813150120000,2019,295704,572974,868678,MRA
06079813150140000,2021,329702,286198,615900,MKT
06079813150140000,2020,275201,248199,523400,MKT
06079813150140000,2019,275201,248199,523400,MKT
06079813150150000,2021,314466,263134,577600,MKT
06079813150150000,2020,268751,201049,469800,MKT
06079813150150000,2019,268751,201049,469800,MKT
06079813150180000,2021,314466,218734,533200,MKT
06079813150180000,2020,268751,149849,418600,MKT
06079813150180000,2019,268751,149849,418600,MKT
06079813150200000,2021,266297,158103,424400,MKT
06079813150200000,2020,247260,120040,367300,MKT
06079813150200000,2019,247260,120040,367300,MKT
06079813150210000,2021,270900,158000,428900,MKT
06079813150210000,2020,249393,121907,371300,MKT
06079813150210000,2019,249393,121907,371300,MKT
06079813150240000,2021,401487,206913,608400,MKT
06079813150240000,2020,303763,216537,520300,MKT
06079813150240000,2019,303763,216537,520300,MKT
06079813151010000,2021,304780,240520,545300,MKT
06079813151010000,2020,264569,190331,454900,MKT
06079813151010000,2019,264569,190331,454900,MKT
06079813151040000,2021,304780,223220,528000,MKT
06079813151040000,2020,264569,152231,416800,MKT
06079813151040000,2019,264569,152231,416800,MKT
06079813151060000,2021,304780,418720,723500,MKT
06079813151060000,2020,264569,335131,599700,MKT
06079813151060000,2019,264569,335131,599700,MKT
06079813151080000,2021,304780,242020,546800,MKT
06079813151080000,2020,264569,195231,459800,MKT
06079813151080000,2019,264569,195231,459800,MKT
06079813151100000,2021,304780,253020,557800,MKT
06079813151100000,2020,264569,160331,424900,MKT
06079813151100000,2019,264569,160331,424900,MKT
06079813151140000,2021,445420,722080,1167500,COST
06079813151140000,2020,319993,596830,916823,COST
06079813151140000,2019,319993,596830,916823,COST
06079813151150000,2021,352068,373032,725100,MKT
06079813151150000,2020,284406,278394,562800,MKT
06079813151150000,2019,284406,224794,509200,MKT
06079813151180000,2021,348458,187642,536100,INCOME
06079813151180000,2020,284406,302494,586900,INCOME
06079813151180000,2019,284406,302494,586900,INCOME
06079813151200000,2021,345485,282315,627800,MKT
06079813151200000,2020,281728,244372,526100,MKT
06079813151200000,2019,281728,244372,526100,MKT
06079813151210000,2021,364940,546160,911100,MKT
06079813151210000,2020,289572,455728,745300,MKT
06079813151210000,2019,289572,455728,745300,MKT
06079813151220000,2021,289751,272849,562600,MKT
06079813151220000,2020,257947,202053,460000,MKT
06079813151220000,2019,257947,202053,460000,MKT
06079813151250000,2021,274049,203551,477600,MKT
06079813151250000,2020,250842,156758,407600,MKT
06079813151250000,2019,250842,156758,407600,MKT
06079813151260000,2021,257565,261535,519100,MKT
06079813151260000,2020,243162,199638,442800,OVR
06079813151260000,2019,243162,199638,442800,MKT
06079813152010000,2021,526177,797360,1323537,COST
06079813152010000,2020,421679,716900,1138579,OVR
06079813152010000,2019,421679,716900,1138579,COST
06079813152040000,2021,526177,388570,914747,COST
06079813152040000,2020,421679,286321,708000,MKT
06079813152040000,2019,421679,286321,708000,MKT
06079813152070000,2021,500616,319930,820546,COST
06079813152070000,2020,411284,198116,609400,MKT
06079813152070000,2019,411284,198116,609400,MKT
06079813152100000,2021,440763,132737,573500,MKT
06079813152100000,2020,385852,96748,482600,MKT
06079813152100000,2019,386011,96589,482600,MKT
06079813152120000,2021,441125,117175,558300,MKT
06079813152120000,2020,386011,93089,479100,MKT
06079813152120000,2019,386011,93089,479100,MKT
06079813157010000,2021,310622,17778,328400,INCOME
06079813157010000,2020,267099,89301,356400,INCOME
06079813157010000,2019,267099,89301,356400,INCOME
06079813157030000,2021,278308,293792,572100,MKT
06079813157030000,2020,252789,173211,426000,MKT
06079813157030000,2019,252789,173211,426000,MKT
06079813157060000,2021,294831,12060,306891,COST
06079813157060000,2020,260204,9820,270024,COST
06079813157060000,2019,260204,9820,270024,COST
06079813157080000,2021,294831,201169,496000,MKT
06079813157080000,2020,260204,195596,455800,MKT
06079813157080000,2019,260204,195596,455800,MKT
06079813157100000,2021,294831,264469,559300,MKT
06079813157100000,2020,260204,191196,451400,OVR
06079813157100000,2019,260204,191196,451400,MKT
06079813157130000,2021,381337,105663,487000,INCOME
06079813157130000,2020,296022,241678,537700,INCOME
06079813157130000,2019,296022,241678,537700,INCOME
06079813157160000,2021,267904,100600,368504,COST
06079813157160000,2020,296022,89820,385842,COST
06079813157160000,2019,296022,89820,385842,COST
06079813157180000,2021,302318,102482,404800,INCOME
06079813157180000,2020,263495,243205,506700,INCOME
06079813157180000,2019,263495,243205,506700,INCOME
06079813157210000,2021,378986,173714,552700,MKT
06079813157210000,2020,295106,208794,503900,MKT
06079813157210000,2019,295106,208794,503900,MKT
06079813157240000,2021,354457,171743,526200,MKT
06079813157240000,2020,285372,184528,469900,MKT
06079813157240000,2019,285372,184528,469900,MKT
06079813157260000,2021,318509,284991,603500,MKT
06079813157260000,2020,270477,292023,562500,MKT
06079813157260000,2019,270477,292023,562500,MKT
06079813158010000,2021,368100,227100,595200,MKT
06079813158010000,2020,290826,203274,494100,MKT
06079813158010000,2019,290826,203274,494100,MKT
06079813158050000,2021,294831,270069,564900,MKT
06079813158050000,2020,260204,167296,427500,MKT
06079813158050000,2019,260204,167296,427500,MKT
06079813158070000,2021,294831,287969,582800,MKT
06079813158070000,2020,260204,196096,456300,OVR
06079813158070000,2019,260204,196096,456300,MKT
06079813158090000,2021,294831,504510,799341,COST
06079813158090000,2020,260204,404860,665064,COST
06079813158090000,2019,260204,404860,665064,COST
06079813158120000,2021,304387,278313,582700,MKT
06079813158120000,2020,264398,197002,461400,MKT
06079813158120000,2019,264398,197002,461400,MKT
06079813158130000,2021,301229,237371,538600,MKT
06079813158130000,2020,263019,181281,444300,MKT
06079813158130000,2019,263019,181281,444300,MKT
06079813158160000,2021,381337,203863,585200,MKT
06079813158160000,2020,296022,172078,468100,OVR
06079813158160000,2019,296022,172078,468100,MKT
06079813158180000,2021,141036,0,141036,COST
06079813158180000,2020,179797,0,179797,COST
06079813158180000,2019,179797,0,179797,COST
06079813158190000,2021,334592,268408,603000,MKT
06079813158190000,2020,277240,230060,507300,OVR
06079813158190000,2019,277240,230060,507300,MKT
06079813158200000,2021,201739,0,201739,COST
06079813158200000,2020,215135,0,215135,COST
06079813158200000,2019,215135,0,215135,COST
06079813158220000,2021,294831,267710,562541,COST
06079813158220000,2020,260204,217530,477734,COST
06079813158220000,2019,260204,217530,477734,COST
06079813158240000,2021,237154,280046,517200,MKT
06079813158240000,2020,233304,161196,394500,MKT
06079813158240000,2019,233304,161196,394500,MKT
06079813158250000,2021,237154,192946,430100,MKT
06079813158250000,2020,233304,139696,373000,MKT
06079813158250000,2019,233304,153596,386900,MKT
06079813158260000,2021,234119,201781,435900,MKT
06079813158260000,2020,231802,136798,368600,MKT
06079813158260000,2019,231802,136798,368600,MKT
06079813159010000,2021,314466,244334,558800,MKT
06079813159010000,2020,268751,176149,444900,MKT
06079813159010000,2019,268751,176149,444900,MKT
06079813159040000,2021,314466,212334,526800,MKT
06079813159040000,2020,268751,205149,473900,MKT
06079813159040000,2019,268751,205149,473900,MKT
06079813159060000,2021,313269,209431,522700,MKT
06079813159060000,2020,268238,168862,437100,MKT
06079813159060000,2019,268238,168862,437100,MKT
06079813159080000,2021,313269,329680,642949,COST
06079813159080000,2020,268238,266930,535168,COST
06079813159080000,2019,268238,266930,535168,COST
06079813159100000,2021,313269,229631,542900,MKT
06079813159100000,2020,268238,162062,430300,MKT
06079813159100000,2019,268238,162062,430300,MKT
06079813159130000,2021,405184,186916,592100,MKT
06079813159130000,2020,305162,218238,523400,MKT
06079813159130000,2019,305162,218238,523400,MKT
06079813159140000,2021,288444,538356,826800,MKT
06079813159140000,2020,257363,390260,647623,COST
06079813159140000,2019,257363,390260,647623,COST
06079813159150000,2021,269572,478028,747600,MKT
06079813159150000,2020,248780,364720,613500,MKT
06079813159150000,2019,248780,364720,613500,MKT
06079813159180000,2021,313269,392231,705500,MKT
06079813159180000,2020,268238,346662,614900,MKT
06079813159180000,2019,268238,346662,614900,MKT
06079813159200000,2021,313269,223231,536500,MKT
06079813159200000,2020,268238,151862,420100,MKT
06079813159200000,2019,268238,151862,420100,MKT
06079813159220000,2021,313269,380431,693700,MKT
06079813159220000,2020,268238,293762,562000,MKT
06079813159220000,2019,268238,263262,531500,MKT
06079813159230000,2021,361758,403810,765568,COST
06079813159230000,2020,288303,346397,634700,OVR
06079813159230000,2019,288303,346397,634700,MKT
06079813159260000,2021,257565,309435,567000,MKT
06079813159260000,2020,243162,208738,451900,OVR
06079813159260000,2019,243162,208738,451900,MKT
06079813160010000,2021,413070,543970,957040,COST
06079813160010000,2020,308125,434170,742295,OVR
06079813160010000,2019,308125,434170,742295,COST
06079813160050000,2021,330850,352050,682900,MKT
06079813160050000,2020,275681,304419,580100,OVR
06079813160050000,2019,275681,304419,580100,MKT
06079813160070000,2021,330850,238350,569200,MKT
06079813160070000,2020,275681,169019,444700,MKT
06079813160070000,2019,275681,169019,444700,MKT
06079813160090000,2021,330850,242850,573700,MKT
06079813160090000,2020,275681,162919,438600,MKT
06079813160090000,2019,275681,162919,438600,MKT
06079813160110000,2021,330850,109750,440600,MKT
06079813160110000,2020,275681,118119,393800,MKT
06079813160110000,2019,275681,118119,393800,MKT
06079813160120000,2021,318036,189464,507500,MKT
06079813160120000,2020,270276,135624,405900,OVR
06079813160120000,2019,270276,135624,405900,MKT
06079813160140000,2021,247534,256370,503904,COST
06079813160140000,2020,238368,265632,504000,MKT
06079813160140000,2019,238368,265632,504000,MKT
06079813160150000,2021,238660,193240,431900,MKT
06079813160150000,2020,234045,120655,354700,MKT
06079813160150000,2019,234045,120655,354700,MKT
06079813160170000,2021,321573,438660,760233,COST
06079813160170000,2020,271778,353630,625408,COST
06079813160170000,2019,271778,353630,625408,COST
06079813160190000,2021,330850,196350,527200,MKT
06079813160190000,2020,275681,175819,451500,MKT
06079813160190000,2019,275681,175819,451500,MKT
06079813160210000,2021,312308,189792,502100,MKT
06079813160210000,2020,267825,141375,409200,MKT
06079813160210000,2019,267825,141375,409200,MKT
06079813160230000,2021,312308,178992,491300,MKT
06079813160230000,2020,267825,144375,412200,MKT
06079813160230000,2019,267825,144375,412200,MKT
06079813160250000,2021,292808,139292,432100,MKT
06079813160250000,2020,259307,83593,342900,MKT
06079813160250000,2019,259307,83593,342900,MKT
06079813160260000,2021,312308,230200,542508,COST
06079813160260000,2020,267825,186600,454425,COST
06079813160260000,2019,267825,186600,454425,COST
06079813160280000,2021,330850,92250,423100,MKT
06079813160280000,2020,275681,80719,356400,MKT
06079813160280000,2019,275681,80719,356400,MKT
06079813161010000,2021,145614,233186,378800,MKT
06079813161010000,2020,182699,176901,359600,MKT
06079813161010000,2019,182699,176901,359600,MKT
06079813161030000,2021,423945,134255,558200,MKT
06079813161030000,2020,378400,107800,486200,MKT
06079813161030000,2019,378400,107800,486200,MKT
06079813161050000,2021,441125,187075,628200,MKT
06079813161050000,2020,386011,138989,525000,MKT
06079813161050000,2019,386011,138989,525000,MKT
06079813161070000,2021,441125,299140,740265,COST
06079813161070000,2020,386011,242620,628631,COST
06079813161070000,2019,386011,242620,628631,COST
06079813161090000,2021,441125,277980,719105,COST
06079813161090000,2020,386011,227989,614000,MKT
06079813161090000,2019,386011,227989,614000,MKT
06079813161110000,2021,441125,155775,596900,MKT
06079813161110000,2020,386011,130289,516300,MKT
06079813161110000,2019,386011,130289,516300,MKT
06079813161130000,2021,521989,617550,1139539,COST
06079813161130000,2020,419994,512560,932554,COST
06079813161130000,2019,419994,512560,932554,COST
06079813201010000,2021,19283129,0,19283129,COST
06079813201010000,2020,2813783,0,2813783,COST
06079813201010000,2019,2813783,0,2813783,COST
06079813301010000,2021,437033,148750,585783,COST
06079813301010000,2020,359241,144980,504221,COST
06079813301010000,2019,359241,144980,504221,COST
06079813301050000,2021,1163,0,1163,COST
06079813301050000,2020,1082,0,1082,COST
06079813301050000,2019,1030,1090,2120,COST
06079813301060000,2021,209791,189670,399461,COST
06079813301060000,2020,154147,196453,350600,MKT
06079813301060000,2019,154147,196453,350600,MKT
06079813301070000,2021,598144,1870156,2468300,INCOME
06079813301070000,2020,654026,1265474,1919500,INCOME
06079813301070000,2019,654026,1265474,1919500,INCOME
06079813301080000,2021,233437,160763,394200,MKT
06079813301080000,2020,174345,162755,337100,MKT
06079813301080000,2019,174345,162755,337100,MKT
06079813301097000,2021,924678,2440920,3365598,COST
06079813301097000,2020,265262,11750,277012,COST
06079813301097000,2019,212904,11750,224654,COST
06079813301130000,2021,149839,264530,414369,COST
06079813301130000,2020,104575,256050,360625,COST
06079813301130000,2019,104575,256050,360625,COST
06079813301140000,2021,497742,86658,584400,INCOME
06079813301140000,2020,212543,325157,537700,INCOME
06079813301140000,2019,212543,325157,537700,INCOME
06079813301187000,2021,479351,0,479351,COST
06079813301187000,2020,342639,0,342639,COST
06079813301187000,2019,342639,0,342639,COST
06079813302010000,2021,437033,0,437033,COST
06079813302010000,2020,359241,0,359241,COST
06079813302010000,2019,359241,0,359241,COST
06079813302040000,2021,637063,622037,1259100,INCOME
06079813302040000,2020,671928,638472,1310400,INCOME
06079813302040000,2019,671928,638472,1310400,INCOME
06079813302100000,2021,1338183,0,1338183,COST
06079813302100000,2020,1049353,0,1049353,COST
06079813302100000,2019,1049353,0,1049353,COST
06079813303050000,2021,1179199,6261101,7440300,INCOME
06079813303050000,2020,1282274,4820026,6102300,INCOME
06079813303050000,2019,1282274,4820026,6102300,INCOME
06079813303070000,2021,371680,0,371680,COST
06079813303070000,2020,533578,0,533578,COST
06079813303070000,2019,533578,0,533578,COST
06079813303100000,2021,461543,1153757,1615300,INCOME
06079813303100000,2020,665089,562711,1227800,INCOME
06079813303100000,2019,665089,562711,1227800,INCOME
06079813303150000,2021,389812,1225488,1615300,INCOME
06079813303150000,2020,618664,609136,1227800,INCOME
06079813303150000,2019,618664,609136,1227800,INCOME
06079813303200000,2021,549715,0,549715,COST
06079813303200000,2020,788619,0,788619,COST
06079813303200000,2019,788619,0,788619,COST
06079813303250000,2021,635047,642653,1277700,INCOME
06079813303250000,2020,838906,378294,1217200,INCOME
06079813303250000,2019,838906,378294,1217200,INCOME
06079813303300000,2021,291653,12210,303863,COST
06079813303300000,2020,546367,11820,558187,COST
06079813303300000,2019,546367,11820,558187,COST
06079813304010000,2021,3623519,33544020,37167539,COST
06079813304010000,2020,1768919,34016681,35785600,INCOME
06079813304010000,2019,1768919,34016681,35785600,INCOME
06079813304050000,2021,355,0,355,COST
06079813304050000,2020,330,0,330,COST
06079813304050000,2019,330,0,330,COST
06079813316420000,2021,546797,784803,1331600,INCOME
06079813316420000,2020,577942,697858,1275800,INCOME
06079813316420000,2019,577942,697858,1275800,INCOME
06079813316440000,2021,696720,749680,1446400,INCOME
06079813316440000,2020,641155,690345,1331500,INCOME
06079813316440000,2019,641155,690345,1331500,INCOME
06079813316477000,2021,692122,12680,704802,COST
06079813316477000,2020,639339,12280,651619,COST
06079813316477000,2019,639339,12280,651619,COST
06079813316500000,2021,709768,794532,1504300,INCOME
06079813316500000,2020,646272,791828,1438100,INCOME
06079813316500000,2019,646272,791828,1438100,INCOME
06079813316527000,2021,634567,0,634567,COST
06079813316527000,2020,615998,0,615998,COST
06079813316527000,2019,615998,0,615998,COST
06079813316540000,2021,613788,1153112,1766900,INCOME
06079813316540000,2020,607275,849525,1456800,INCOME
06079813316540000,2019,607275,849525,1456800,INCOME
06079813316560000,2021,503177,564523,1067700,INCOME
06079813316560000,2020,557721,494579,1052300,INCOME
06079813316560000,2019,557721,494579,1052300,INCOME
06079813316580000,2021,503177,326823,830000,INCOME
06079813316580000,2020,557721,248879,806600,INCOME
06079813316580000,2019,557721,248879,806600,INCOME
06079813316600000,2021,516928,734672,1251600,INCOME
06079813316600000,2020,564200,587900,1152100,INCOME
06079813316600000,2019,564200,587900,1152100,INCOME
06079813317010000,2021,576506,371394,947900,INCOME
06079813317010000,2020,591190,322910,914100,INCOME
06079813317010000,2019,591190,322910,914100,INCOME
06079813317047000,2021,566705,0,566705,COST
06079813317047000,2020,586863,0,586863,COST
06079813317047000,2019,586863,0,586863,COST
06079813317070000,2021,566705,0,566705,COST
06079813317070000,2020,586863,0,586863,COST
06079813317070000,2019,586863,0,586863,COST
06079813317100000,2021,576506,1009994,1586500,INCOME
06079813317100000,2020,762636,706264,1468900,INCOME
06079813317100000,2019,762636,706264,1468900,INCOME
06079813317137000,2021,586331,3470,589801,COST
06079813317137000,2020,768176,3360,771536,COST
06079813317137000,2019,768176,3360,771536,COST
06079813318016500,2021,1964525,0,1964525,COST
06079813318016500,2020,647920,0,647920,COST
06079813318016500,2019,647920,0,647920,COST
06079813318057000,2021,630093,5250,635343,COST
06079813318057000,2020,614134,5080,619214,COST
06079813318057000,2019,614134,5080,619214,COST
06079813318100000,2021,672225,1607875,2280100,INCOME
06079813318100000,2020,631401,1538699,2170100,INCOME
06079813318100000,2019,631401,1538699,2170100,INCOME
06079813318150000,2021,1022663,1829037,2851700,INCOME
06079813318150000,2020,974884,1636016,2610900,INCOME
06079813318150000,2019,974884,1636016,2610900,INCOME
06079813319010000,2021,685346,0,685346,COST
06079813319010000,2020,821279,0,821279,COST
06079813319010000,2019,821279,0,821279,COST
06079813319060000,2021,798976,0,798976,COST
06079813319060000,2020,877064,0,877064,COST
06079813319060000,2019,877064,0,877064,COST
06079813328010000,2021,868494,1964206,2832700,INCOME
06079813328010000,2020,656141,1308259,1964400,INCOME
06079813328010000,2019,656141,1308259,1964400,INCOME
06079813328027000,2021,848112,17440,865552,COST
06079813328027000,2020,649500,16880,666380,COST
06079813328027000,2019,649500,16880,666380,COST
06079813328030000,2021,949648,3391852,4341500,INCOME
06079813328030000,2020,681737,2454863,3136600,INCOME
06079813328030000,2019,681737,2454863,3136600,INCOME
06079813328040000,2021,1731953,752060,2484013,COST
06079813328040000,2020,1002143,706010,1708153,COST
06079813328040000,2019,1002143,706010,1708153,COST
06079813328050000,2021,576956,0,576956,COST
06079813328050000,2020,135336,0,135336,COST
06079813328050000,2019,135336,0,135336,COST
06079813328067000,2021,363792,0,363792,COST
06079813328067000,2020,261054,0,261054,COST
06079813328067000,2019,261054,0,261054,COST
06079813328070000,2021,533420,316470,849890,COST
06079813328070000,2020,532489,117611,650100,INCOME
06079813328070000,2019,532489,117611,650100,INCOME
06079813328090000,2021,675617,595983,1271600,INCOME
06079813328090000,2020,589217,502083,1091300,INCOME
06079813328090000,2019,589217,502083,1091300,INCOME
06079813328100000,2021,655239,475761,1131000,INCOME
06079813328100000,2020,581537,357763,939300,INCOME
06079813328100000,2019,581537,357763,939300,INCOME
06079813328110000,2021,631254,808246,1439500,INCOME
06079813328110000,2020,572321,382679,955000,INCOME
06079813328110000,2019,572321,382679,955000,INCOME
06079813328127000,2021,365456,0,365456,COST
06079813328127000,2020,262231,0,262231,COST
06079813328127000,2019,262231,0,262231,COST
06079813330030000,2021,168031,272569,440600,MKT
06079813330030000,2020,119344,238556,357900,MKT
06079813330030000,2019,119344,238556,357900,MKT
06079813330050000,2021,185337,398963,584300,MKT
06079813330050000,2020,133623,328377,462000,MKT
06079813330050000,2019,133623,328377,462000,MKT
06079813330060000,2021,201932,326668,528600,MKT
06079813330060000,2020,147509,280791,428300,MKT
06079813330060000,2019,147509,280791,428300,MKT
06079813330070000,2021,182112,384830,566942,COST
06079813330070000,2020,130946,380270,511216,COST
06079813330070000,2019,130946,380270,511216,COST
06079813330090000,2021,201932,208368,410300,MKT
06079813330090000,2020,147509,243791,391300,MKT
06079813330090000,2019,147509,243791,391300,MKT
06079813330110000,2021,201932,199468,401400,MKT
06079813330110000,2020,147509,202691,350200,MKT
06079813330110000,2019,147509,202691,350200,MKT
06079813330130000,2021,258071,380929,639000,MKT
06079813330130000,2020,195721,348679,544400,MKT
06079813330130000,2019,195721,348679,544400,MKT
06079813330210000,2021,191138,271362,462500,MKT
06079813330210000,2020,138413,269987,408400,MKT
06079813330210000,2019,138413,269987,408400,MKT
06079813330220000,2021,177758,0,177758,COST
06079813330220000,2020,127343,0,127343,COST
06079813330220000,2019,127343,0,127343,COST
06079813330230000,2021,138461,253639,392100,MKT
06079813330230000,2020,95475,142360,237835,COST
06079813330230000,2019,95475,142360,237835,COST
06079813330250000,2021,149683,269417,419100,MKT
06079813330250000,2020,104450,243850,348300,MKT
06079813330250000,2019,104450,243850,348300,MKT
06079813330260000,2021,149683,259317,409000,MKT
06079813330260000,2020,104450,173340,277790,COST
06079813330260000,2019,104450,173340,277790,COST
06079813330270000,2021,149683,294917,444600,MKT
06079813330270000,2020,104450,255670,360120,COST
06079813330270000,2019,104450,241450,345900,MKT
06079813330290000,2021,149683,205617,355300,MKT
06079813330290000,2020,104450,199050,303500,MKT
06079813330290000,2019,104450,199050,303500,MKT
06079813330310000,2021,148423,267477,415900,MKT
06079813330310000,2020,103437,164220,267657,COST
06079813330310000,2019,103437,164220,267657,COST
06079813330330000,2021,212625,193175,405800,MKT
06079813330330000,2020,156550,209750,366300,MKT
06079813330330000,2019,156550,209750,366300,MKT
06079813330350000,2021,205843,405670,611513,COST
06079813330350000,2020,150807,400650,551457,COST
06079813330350000,2019,150807,400650,551457,COST
06079813330370000,2021,208944,209956,418900,MKT
06079813330370000,2020,153430,217170,370600,MKT
06079813330370000,2019,153430,217170,370600,MKT
06079813330390000,2021,210966,200934,411900,MKT
06079813330390000,2020,155143,208157,363300,MKT
06079813330390000,2019,155143,208157,363300,MKT
06079813330410000,2021,137555,262845,400400,MKT
06079813330410000,2020,94755,234445,329200,MKT
06079813330410000,2019,94755,234445,329200,MKT
06079813330420000,2021,138821,268379,407200,MKT
06079813330420000,2020,95761,185739,281500,MKT
06079813330420000,2019,95761,185739,281500,MKT
06079813330430000,2021,138821,217679,356500,MKT
06079813330430000,2020,95761,211939,307700,MKT
06079813330430000,2019,95761,211939,307700,MKT
06079813330450000,2021,138821,252479,391300,MKT
06079813330450000,2020,95761,151770,247531,COST
06079813330450000,2019,95761,151770,247531,COST
06079813330470000,2021,139000,155930,294930,COST
06079813330470000,2020,95903,175297,271200,MKT
06079813330470000,2019,95903,175297,271200,MKT
06079813330490000,2021,138821,303479,442300,MKT
06079813330490000,2020,95761,210139,305900,MKT
06079813330490000,2019,95761,210139,305900,MKT
06079813330510000,2021,143852,237448,381300,MKT
06079813330510000,2020,99773,183927,283700,MKT
06079813330510000,2019,99773,183927,283700,MKT
06079813350037000,2021,941278,24930,966208,COST
06079813350037000,2020,992953,24140,1017093,COST
06079813350037000,2019,992953,24140,1017093,COST
06079813350040000,2021,1852250,1603070,3455320,COST
06079813350040000,2020,1326981,1566710,2893691,COST
06079813350040000,2019,1326981,1566710,2893691,COST
06079813350100000,2021,2287759,9108741,11396500,INCOME
06079813350100000,2020,1452619,6780981,8233600,INCOME
06079813350100000,2019,1452619,6780981,8233600,INCOME
06079813350120000,2021,895253,2653547,3548800,INCOME
06079813350120000,2020,971856,1677744,2649600,INCOME
06079813350120000,2019,971856,1677744,2649600,INCOME
06079813350150000,2021,472612,0,472612,COST
06079813350150000,2020,591416,0,591416,COST
06079813350150000,2019,591416,0,591416,COST
06079813350200000,2021,357977,0,357977,COST
06079813350200000,2020,525060,0,525060,COST
06079813350200000,2019,525060,0,525060,COST
06079813350250000,2021,556812,1120560,1677372,COST
06079813350250000,2020,720761,759339,1480100,INCOME
06079813350250000,2019,720761,759339,1480100,INCOME
06079813350300000,2021,852411,701490,1553901,COST
06079813350300000,2020,951654,756346,1708000,INCOME
06079813350300000,2019,951654,756346,1708000,INCOME
06079813401020000,2021,3520,0,3520,COST
06079813401020000,2020,3276,0,3276,COST
06079813401020000,2019,3276,0,3276,COST
06079813402010000,2021,7660747,0,7660747,COST
06079813402010000,2020,2215792,0,2215792,COST
06079813402010000,2019,2215792,0,2215792,COST
06079813406010000,2021,223172,190928,414100,MKT
06079813406010000,2020,165536,180464,346000,MKT
06079813406010000,2019,165536,180464,346000,MKT
06079813406020000,2021,564914,8930,573844,COST
06079813406020000,2020,638207,8640,646847,COST
06079813406020000,2019,638207,8640,646847,COST
06079813406030000,2021,527378,0,527378,COST
06079813406030000,2020,446138,0,446138,COST
06079813406030000,2019,446138,0,446138,COST
06079813406060000,2021,219500,0,219500,COST
06079813406060000,2020,162400,0,162400,COST
06079813406060000,2019,162400,0,162400,COST
06079813433010000,2021,1146219,2652581,3798800,INCOME
06079813433010000,2020,982005,3078195,4060200,INCOME
06079813433010000,2019,982005,3078195,4060200,INCOME
06079813433030000,2021,683209,1428150,2111359,COST
06079813433030000,2020,207973,1349530,1557503,COST
06079813433030000,2019,207973,1349530,1557503,COST
06079813433040000,2021,276958,0,276958,COST
06079813433040000,2020,199511,0,199511,COST
06079813433040000,2019,199511,0,199511,COST
06079813433050000,2021,675549,0,675549,COST
06079813433050000,2020,206097,0,206097,COST
06079813433050000,2019,206097,0,206097,COST
06079813434010000,2021,747056,0,747056,COST
06079813434010000,2020,223460,0,223460,COST
06079813434010000,2019,223460,0,223460,COST
06079813434020000,2021,684302,0,684302,COST
06079813434020000,2020,208241,0,208241,COST
06079813434020000,2019,208241,0,208241,COST
06079813434030000,2021,750471,0,750471,COST
06079813434030000,2020,224281,0,224281,COST
06079813434030000,2019,224281,0,224281,COST
06079813434040000,2021,748077,638400,1386477,COST
06079813434040000,2020,223706,567030,790736,COST
06079813434040000,2019,223706,567030,790736,COST
06079814101010000,2021,2323,0,2323,COST
06079814101010000,2020,2162,0,2162,COST
06079814101010000,2019,2162,0,2162,COST
06079814101300000,2021,4900,0,4900,COST
06079814101300000,2020,4560,0,4560,COST
06079814101300000,2019,4560,0,4560,COST
06079814101350000,2021,1842268,7370550,9212818,COST
06079814101350000,2020,1203363,7157130,8360493,COST
06079814101350000,2019,1203363,7157130,8360493,COST
06079814101400000,2021,1438094,3082440,4520534,COST
06079814101400000,2020,1082225,8880475,9962700,INCOME
06079814101400000,2019,1082225,8880475,9962700,INCOME
06079814101450000,2021,934908,3782980,4717888,COST
06079814101450000,2020,791927,4248873,5040800,INCOME
06079814101450000,2019,791927,4248873,5040800,INCOME
06079814101490000,2021,835376,1821900,2657276,COST
06079814101490000,2020,754645,2123555,2878200,INCOME
06079814101490000,2019,754645,2123555,2878200,INCOME
06079814101510000,2021,637063,735937,1373000,INCOME
06079814101510000,2020,671928,691372,1363300,INCOME
06079814101510000,2019,671928,691372,1363300,INCOME
06079814101530000,2021,655934,883300,1539234,COST
06079814101530000,2020,680383,980817,1661200,INCOME
06079814101530000,2019,680383,980817,1661200,INCOME
06079814102010000,2021,929722,71778,1001500,INCOME
06079814102010000,2020,725500,234600,960100,INCOME
06079814102010000,2019,725500,234600,960100,INCOME
06079814102030000,2021,898211,251289,1149500,INCOME
06079814102030000,2020,714862,381138,1096000,INCOME
06079814102030000,2019,714862,381138,1096000,INCOME
06079814102050000,2021,774849,634951,1409800,INCOME
06079814102050000,2020,671022,662278,1333300,INCOME
06079814102050000,2019,671022,941978,1613000,INCOME
06079814102070000,2021,772232,213868,986100,INCOME
06079814102070000,2020,670050,276950,947000,INCOME
06079814102070000,2019,670050,276950,947000,INCOME
06079814102090000,2021,858846,367754,1226600,INCOME
06079814102090000,2020,701269,472731,1174000,INCOME
06079814102090000,2019,701269,472731,1174000,INCOME
06079814102116500,2021,528766,32630,561396,COST
06079814102116500,2020,286258,31590,317848,COST
06079814102116500,2019,286258,31590,317848,COST
06079814108010000,2021,1275262,2224238,3499500,INCOME
06079814108010000,2020,1027925,2143175,3171100,INCOME
06079814108010000,2019,1027925,2143175,3171100,INCOME
06079814201100000,2021,3274777,0,3274777,COST
06079814201100000,2020,795,0,795,COST
06079814201100000,2019,1156,0,1156,COST
06079814201200000,2021,1723832,3802368,5526200,INCOME
06079814201200000,2020,1169592,3768108,4937700,INCOME
06079814201200000,2019,1169592,3768108,4937700,INCOME
06079814201206500,2021,1007681,0,1007681,COST
06079814201206500,2020,377337,0,377337,COST
06079814201206500,2019,377337,0,377337,COST
06079814201216500,2021,704570,0,704570,COST
06079814201216500,2020,323713,0,323713,COST
06079814201216500,2019,323713,0,323713,COST
06079814201226500,2021,656377,0,656377,COST
06079814201226500,2020,279370,0,279370,COST
06079814201226500,2019,279370,0,279370,COST
06079814201300000,2021,4538242,7298158,11836400,INCOME
06079814201300000,2020,1272893,8256707,9529600,INCOME
06079814201300000,2019,1272893,8256707,9529600,INCOME
06079814201500000,2021,1856737,3050163,4906900,INCOME
06079814201500000,2020,868004,3649096,4517100,INCOME
06079814201500000,2019,868004,3649096,4517100,INCOME
06079814202200000,2021,1353763,3521737,4875500,INCOME
06079814202200000,2020,852206,3316194,4168400,INCOME
06079814202200000,2019,852997,3234210,4087207,COST
06079814202300000,2021,22,0,22,COST
06079814202300000,2020,726294,0,726294,COST
06079814202300000,2019,726294,0,726294,COST
06079814202400000,2021,25,0,25,COST
06079814202400000,2020,753060,0,753060,COST
06079814202400000,2019,753060,0,753060,COST
06079814202500000,2021,993748,839750,1833498,COST
06079814202500000,2020,746496,837550,1584046,COST
06079814202500000,2019,746496,837550,1584046,COST
06079814202600000,2021,1041293,925280,1966573,COST
06079814202600000,2020,649524,433460,1082984,COST
06079814202600000,2019,649524,0,649524,COST
06079814202700000,2021,948825,403675,1352500,INCOME
06079814202700000,2020,624158,401742,1025900,INCOME
06079814202700000,2019,624158,401742,1025900,INCOME
06079814203016500,2021,128939,0,128939,COST
06079814203016500,2020,156391,0,156391,COST
06079814203016500,2019,156391,0,156391,COST
06079814203050000,2021,1161266,0,1161266,COST
06079814203050000,2020,581333,0,581333,COST
06079814203050000,2019,581333,0,581333,COST
06079814203100000,2021,1291578,0,1291578,COST
06079814203100000,2020,608431,0,608431,COST
06079814203100000,2019,608431,0,608431,COST
06079814203150000,2021,978274,0,978274,COST
06079814203150000,2020,540161,0,540161,COST
06079814203150000,2019,540161,0,540161,COST
06079814203200000,2021,1141904,0,1141904,COST
06079814203200000,2020,577161,0,577161,COST
06079814203200000,2019,577161,0,577161,COST
06079814204050000,2021,3595304,5189396,8784700,INCOME
06079814204050000,2020,1071996,7340904,8412900,INCOME
06079814204050000,2019,1071996,7340904,8412900,INCOME
06079814204350000,2021,1585698,0,1585698,COST
06079814204350000,2020,664324,0,664324,COST
06079814204350000,2019,664324,0,664324,COST
06079814204400000,2021,1263967,0,1263967,COST
06079814204400000,2020,386000,0,386000,OVR
06079814204400000,2019,602825,0,602825,COST
06079814205010000,2021,1006407,6065870,7072277,COST
06079814205010000,2020,750555,5918750,6669305,COST
06079814205010000,2019,750555,0,750555,COST
06079814205050000,2021,793806,0,793806,COST
06079814205050000,2020,600000,0,600000,COST
06079814205050000,2019,600000,0,600000,COST
06079814205106500,2021,766026,0,766026,COST
06079814205106500,2020,335520,0,335520,COST
06079814205106500,2019,335520,0,335520,COST
06079814205150000,2021,866555,0,866555,COST
06079814205150000,2020,703959,0,703959,COST
06079814205150000,2019,703959,0,703959,COST
06079814205200000,2021,1117114,0,1117114,COST
06079814205200000,2020,784871,0,784871,COST
06079814205200000,2019,784871,0,784871,COST
06079814206010000,2021,510766,0,510766,COST
06079814206010000,2020,408900,0,408900,COST
06079814206010000,2019,408900,0,408900,COST
06079814206100000,2021,610466,0,610466,COST
06079814206100000,2020,441358,0,441358,COST
06079814206100000,2019,441358,0,441358,COST
06079814206150000,2021,599071,0,599071,COST
06079814206150000,2020,437810,0,437810,COST
06079814206150000,2019,437810,0,437810,COST
06079814206200000,2021,3755097,4412303,8167400,INCOME
06079814206200000,2020,1173683,5395117,6568800,INCOME
06079814206200000,2019,1173683,5395117,6568800,INCOME
06079814206256500,2021,1264552,0,1264552,COST
06079814206256500,2020,415886,0,415886,COST
06079814206256500,2019,415886,0,415886,COST
06079814206300000,2021,974553,2475747,3450300,INCOME
06079814206300000,2020,740285,2164870,2905155,COST
06079814206300000,2019,740285,2164870,2905155,COST
06079814206360000,2021,1250290,5300410,6550700,INCOME
06079814206360000,2020,823667,4802533,5626200,INCOME
06079814206360000,2019,823667,4802533,5626200,INCOME
06079814206450000,2021,1004521,0,1004521,COST
06079814206450000,2020,749952,0,749952,COST
06079814206450000,2019,749952,0,749952,COST
06079814206510000,2021,811179,863970,1675149,COST
06079814206510000,2020,684324,836960,1521284,COST
06079814206510000,2019,684324,836960,1521284,COST
06079814206546500,2021,613152,0,613152,COST
06079814206546500,2020,305003,0,305003,COST
06079814206546500,2019,305003,0,305003,COST
06079814207011001,2021,2279,0,2279,COST
06079814207011001,2020,2121,0,2121,COST
06079814207011001,2019,2121,0,2121,COST
06079814207011002,2021,2279,0,2279,COST
06079814207011002,2020,2121,0,2121,COST
06079814207011002,2019,2121,0,2121,COST
06079814301011001,2021,2246,0,2246,COST
06079814301011001,2020,2090,0,2090,COST
06079814301011001,2019,2090,0,2090,COST
06079814301011002,2021,4573,0,4573,COST
06079814301011002,2020,4255,0,4255,COST
06079814301011002,2019,4255,0,4255,COST
06079814301150000,2021,7661,0,7661,COST
06079814301150000,2020,7124,0,7124,COST
06079814301150000,2019,7124,0,7124,COST
06079814401010000,2021,1185,0,1185,COST
06079814401010000,2020,1103,0,1103,COST
06079814401010000,2019,1103,0,1103,COST
06079814401070000,2021,1128394,0,1128394,COST
06079814401070000,2020,311310,0,311310,COST
06079814401070000,2019,311310,0,311310,COST
06079814401100000,2021,2595358,6703860,9299218,COST
06079814401100000,2020,453349,6506020,6959369,COST
06079814401100000,2019,453349,6506020,6959369,COST
06079814401120000,2021,1178151,7495949,8674100,INCOME
06079814401120000,2020,993632,7238468,8232100,INCOME
06079814401120000,2019,993632,7238468,8232100,INCOME
06079814401140000,2021,925727,6418873,7344600,INCOME
06079814401140000,2020,788586,6341514,7130100,INCOME
06079814401140000,2019,788586,6341514,7130100,INCOME
06079814401187000,2021,1365167,92910,1458077,COST
06079814401187000,2020,1058365,96630,1154995,COST
06079814401187000,2019,1058365,96630,1154995,COST
06079814401206500,2021,156005,0,156005,COST
06079814401206500,2020,209987,0,209987,COST
06079814401206500,2019,209987,0,209987,COST
06079814401220000,2021,1658761,24990,1683751,COST
06079814401220000,2020,965678,27330,993008,COST
06079814401220000,2019,965678,27330,993008,COST
06079814401267000,2021,971932,23110,995042,COST
06079814401267000,2020,688544,24000,712544,COST
06079814401267000,2019,688544,24000,712544,COST
06079814401280000,2021,971932,3194268,4166200,INCOME
06079814401280000,2020,688544,3329156,4017700,INCOME
06079814401280000,2019,688544,3329156,4017700,INCOME
06079814401300000,2021,1487985,2669815,4157800,INCOME
06079814401300000,2020,939039,2660060,3599099,COST
06079814401300000,2019,939039,2660060,3599099,COST
06079814402026500,2021,79286,0,79286,COST
06079814402026500,2020,134367,0,134367,COST
06079814402040000,2021,1202392,0,1202392,COST
06079814402040000,2020,730290,0,730290,COST
06079814402060000,2021,1264536,0,1264536,COST
06079814402060000,2020,736192,0,736192,COST
06079814402080000,2021,932871,3723529,4656400,INCOME
06079814402080000,2020,768808,3517692,4286500,INCOME
06079814402080000,2019,1013685,3272815,4286500,INCOME
06079814402200000,2021,44114,0,44114,COST
06079814402200000,2020,53146,0,53146,COST
06079814402200000,2019,53146,0,53146,COST
06079815101010000,2021,2885,0,2885,COST
06079815101010000,2020,2685,0,2685,COST
06079815101010000,2019,2685,0,2685,COST
06079815101100000,2021,2943499,0,2943499,COST
06079815101100000,2020,1257760,0,1257760,COST
06079815101300000,2021,1166,0,1166,COST
06079815101300000,2020,1085,0,1085,COST
06079815101300000,2019,1085,0,1085,COST
06079815102010000,2021,101774,0,101774,COST
06079815102010000,2020,127353,0,127353,COST
06079815102010000,2019,127353,0,127353,COST
06079815201050000,2021,6446162,515040,6961202,COST
06079815201050000,2020,2207268,2590732,4798000,INCOME
06079815201050000,2019,2207268,2590732,4798000,INCOME
06079815201200000,2021,2471278,130222,2601500,INCOME
06079815201200000,2020,833173,492020,1325193,COST
06079815201200000,2019,833173,492020,1325193,COST
06079815201900000,2021,29057,846870,875927,COST
06079815201900000,2020,28642,822780,851422,COST
06079815201900000,2019,28642,822780,851422,COST
06079815202010000,2021,2599240,2416160,5015400,COST
06079815202010000,2020,1092945,2373270,3466215,COST
06079815202010000,2019,1092945,2373270,3466215,COST
06079815202100000,2021,2925873,0,2925873,COST
06079815202100000,2020,357982,0,357982,COST
06079815202100000,2019,357982,0,357982,COST
06079815301010000,2021,12623,0,12623,COST
06079815301010000,2020,11744,0,11744,COST
06079815301010000,2019,11744,0,11744,COST
06079815301100000,2021,13946,0,13946,COST
06079815301100000,2020,12949,0,12949,COST
06079815301100000,2019,12949,0,12949,COST
06079815301200000,2021,4245,117050,121295,COST
06079815301200000,2020,4358,114320,118678,COST
06079815301200000,2019,4358,114320,118678,COST
06079815401100000,2021,11468,0,11468,COST
06079815401100000,2020,10667,0,10667,COST
06079815401100000,2019,10667,0,10667,COST
06079816101010000,2021,158831,245069,403900,MKT
06079816101010000,2020,125340,208160,333500,MKT
06079816101010000,2019,125340,208160,333500,MKT
06079816101020000,2021,321289,243811,565100,MKT
06079816101020000,2020,299165,187735,486900,MKT
06079816101020000,2019,299165,187735,486900,MKT
06079816101040000,2021,419213,193090,612303,COST
06079816101040000,2020,415514,182870,598384,COST
06079816101040000,2019,415514,183960,599474,COST
06079816101080000,2021,246317,194840,441157,COST
06079816101080000,2020,215480,181660,397140,COST
06079816101080000,2019,215480,181660,397140,COST
06079816101090000,2021,206911,131590,338501,COST
06079816101090000,2020,173746,124300,298046,COST
06079816101090000,2019,173746,124300,298046,COST
06079816101100000,2021,8081,0,8081,COST
06079816101100000,2020,7520,0,7520,COST
06079816101100000,2019,7520,0,7520,COST
06079816101130000,2021,299004,351380,650384,COST
06079816101130000,2020,273754,328070,601824,COST
06079816101130000,2019,273754,328070,601824,COST
06079816101150000,2021,419213,167690,586903,COST
06079816101150000,2020,415514,156390,571904,COST
06079816101150000,2019,415514,156390,571904,COST
06079816101160000,2021,380919,506280,887199,COST
06079816101160000,2020,350731,475610,826341,COST
06079816101160000,2019,350731,475610,826341,COST
06079816101170000,2021,195900,275600,471500,MKT
06079816101170000,2020,162400,245100,407500,MKT
06079816101170000,2019,162400,245100,407500,MKT
06079816101180000,2021,290696,329804,620500,MKT
06079816101180000,2020,264391,308209,572600,MKT
06079816101180000,2019,264391,308209,572600,MKT
06079816101190000,2021,345295,417310,762605,COST
06079816101190000,2020,313160,265300,578460,COST
06079816101190000,2019,313160,87040,400200,COST
06079816101200000,2021,345295,41670,386965,COST
06079816101200000,2020,313160,38070,351230,COST
06079816101200000,2019,313160,38070,351230,COST
06079816102016500,2021,173106,0,173106,COST
06079816102016500,2020,119710,0,119710,COST
06079816102016500,2019,119710,0,119710,COST
06079816102016501,2021,204589,0,204589,COST
06079816102016501,2020,141147,0,141147,COST
06079816102016501,2019,141147,0,141147,COST
06079816102020000,2021,3497023,5304580,8801603,COST
06079816102020000,2020,1016275,0,1016275,COST
06079816102020000,2019,785043,477257,1262300,INCOME
06079816102060000,2021,117009,436891,553900,MKT
06079816102060000,2020,70303,394197,464500,MKT
06079816102060000,2019,70303,394197,464500,MKT
06079816102080000,2021,111981,291519,403500,MKT
06079816102080000,2020,67323,287177,354500,MKT
06079816102080000,2019,67323,287177,354500,MKT
06079816102100000,2021,111981,292019,404000,MKT
06079816102100000,2020,67323,289077,356400,MKT
06079816102100000,2019,67323,289077,356400,MKT
06079816102120000,2021,111981,277819,389800,MKT
06079816102120000,2020,67323,277077,344400,OVR
06079816102120000,2019,67323,277077,344400,MKT
06079816102140000,2021,111981,280919,392900,MKT
06079816102140000,2020,67323,282177,349500,MKT
06079816102140000,2019,67323,282177,349500,MKT
06079816102160000,2021,111981,319819,431800,MKT
06079816102160000,2020,67323,314177,381500,MKT
06079816102160000,2019,67323,314177,381500,MKT
06079816102180000,2021,127274,434526,561800,MKT
06079816102180000,2020,76379,380371,456750,OVR
06079816102180000,2019,76379,380371,456750,OVR
06079816102207000,2021,2019307,64420,2083727,COST
06079816102207000,2020,437208,69380,506588,COST
06079816102207000,2019,437208,69380,506588,COST
06079816103020000,2021,109370,351730,461100,MKT
06079816103020000,2020,77433,319967,397400,MKT
06079816103020000,2019,77433,319967,397400,MKT
06079816103040000,2021,94899,289401,384300,MKT
06079816103040000,2020,67323,283077,350400,MKT
06079816103040000,2019,67323,271177,338500,MKT
06079816103060000,2021,94899,291401,386300,MKT
06079816103060000,2020,67323,266277,333600,MKT
06079816103060000,2019,67323,266277,333600,MKT
06079816103080000,2021,94899,291401,386300,MKT
06079816103080000,2020,67323,266277,333600,MKT
06079816103080000,2019,67323,266277,333600,MKT
06079816103100000,2021,94899,291401,386300,MKT
06079816103100000,2020,67323,266277,333600,MKT
06079816103100000,2019,67323,266277,333600,MKT
06079816103120000,2021,97636,448864,546500,MKT
06079816103120000,2020,69237,413763,483000,MKT
06079816103120000,2019,69237,399963,469200,MKT
06079816103140000,2021,103728,428872,532600,MKT
06079816103140000,2020,73494,388406,461900,MKT
06079816103140000,2019,73494,388406,461900,MKT
06079816103160000,2021,103728,264872,368600,MKT
06079816103160000,2020,73494,256906,330400,MKT
06079816103160000,2019,73494,256906,330400,MKT
06079816103180000,2021,94899,285701,380600,MKT
06079816103180000,2020,67323,278277,345600,MKT
06079816103180000,2019,67323,278277,345600,MKT
06079816103200000,2021,94899,291301,386200,MKT
06079816103200000,2020,67323,286377,353700,MKT
06079816103200000,2019,67323,286377,353700,MKT
06079816103220000,2021,94899,290801,385700,MKT
06079816103220000,2020,67323,285677,353000,MKT
06079816103220000,2019,67323,285677,353000,MKT
06079816103240000,2021,123202,0,123202,COST
06079816103240000,2020,87080,0,87080,COST
06079816103240000,2019,87080,0,87080,COST
06079816104020000,2021,117428,399572,517000,INCOME
06079816104020000,2020,83055,423645,506700,INCOME
06079816104020000,2019,83055,423645,506700,INCOME
06079816104040000,2021,94899,292101,387000,MKT
06079816104040000,2020,67323,283277,350600,MKT
06079816104040000,2019,67323,283277,350600,MKT
06079816104060000,2021,94899,289601,384500,MKT
06079816104060000,2020,67323,267677,335000,MKT
06079816104060000,2019,67323,267677,335000,MKT
06079816104080000,2021,94899,290101,385000,MKT
06079816104080000,2020,67323,268477,335800,MKT
06079816104080000,2019,67323,268477,335800,MKT
06079816104100000,2021,94899,302201,397100,MKT
06079816104100000,2020,67323,288277,355600,MKT
06079816104100000,2019,67323,288277,355600,MKT
06079816104120000,2021,94899,367001,461900,MKT
06079816104120000,2020,67323,356677,424000,MKT
06079816104120000,2019,67323,356677,424000,MKT
06079816104126500,2021,92323,0,92323,COST
06079816104126500,2020,64415,0,64415,COST
06079816104126500,2019,64415,0,64415,COST
06079816104160000,2021,94899,287001,381900,MKT
06079816104160000,2020,67323,263977,331300,MKT
06079816104160000,2019,67323,263977,331300,MKT
06079816104180000,2021,94899,284801,379700,MKT
06079816104180000,2020,67323,267877,335200,MKT
06079816104180000,2019,67323,267877,335200,MKT
06079816104200000,2021,94899,295501,390400,MKT
06079816104200000,2020,67323,272077,339400,MKT
06079816104200000,2019,67323,272077,339400,MKT
06079816104220000,2021,119358,448642,568000,MKT
06079816104220000,2020,84401,419899,504300,MKT
06079816104220000,2019,84401,419899,504300,MKT
06079816105020000,2021,117116,436984,554100,MKT
06079816105020000,2020,82838,407062,489900,MKT
06079816105020000,2019,82838,407062,489900,MKT
06079816105040000,2021,116483,321617,438100,MKT
06079816105040000,2020,82396,295604,378000,MKT
06079816105040000,2019,82396,295604,378000,MKT
06079816105060000,2021,129451,350449,479900,MKT
06079816105060000,2020,91432,349168,440600,MKT
06079816105060000,2019,91432,349168,440600,MKT
06079816105080000,2021,139114,417286,556400,MKT
06079816105080000,2020,83379,405021,488400,MKT
06079816105080000,2019,83379,405021,488400,MKT
06079816105100000,2021,152317,284383,436700,MKT
06079816105100000,2020,91176,291724,382900,MKT
06079816105100000,2019,91176,291724,382900,MKT
06079816105120000,2021,122588,338212,460800,MKT
06079816105120000,2020,86652,336048,422700,MKT
06079816105120000,2019,86652,336048,422700,MKT
06079816105140000,2021,122588,319912,442500,MKT
06079816105140000,2020,86652,315748,402400,MKT
06079816105140000,2019,86652,315748,402400,MKT
06079816105160000,2021,122588,432612,555200,MKT
06079816105160000,2020,86652,406548,493200,MKT
06079816105160000,2019,86652,406548,493200,MKT
06079816105180000,2021,122588,358612,481200,MKT
06079816105180000,2020,86652,347448,434100,MKT
06079816105180000,2019,86652,347448,434100,MKT
06079816105207000,2021,121746,0,121746,COST
06079816105207000,2020,84401,0,84401,COST
06079816105207000,2019,84401,0,84401,COST
06079816105220000,2021,96797,290603,387400,MKT
06079816105220000,2020,67323,283277,350600,MKT
06079816105220000,2019,67323,283277,350600,MKT
06079816105240000,2021,96797,293303,390100,MKT
06079816105240000,2020,67323,269077,336400,MKT
06079816105240000,2019,67323,269077,336400,MKT
06079816105260000,2021,121746,332354,454100,MKT
06079816105260000,2020,84401,322399,406800,MKT
06079816105260000,2019,84401,322399,406800,MKT
06079816105280000,2021,122588,428212,550800,MKT
06079816105280000,2020,86652,400648,487300,MKT
06079816105280000,2019,86652,400648,487300,MKT
06079816105300000,2021,122588,349312,471900,MKT
06079816105300000,2020,86652,337348,424000,MKT
06079816105300000,2019,86652,337348,424000,MKT
06079816105320000,2021,122588,362912,485500,MKT
06079816105320000,2020,86652,349748,436400,MKT
06079816105320000,2019,86652,349748,436400,MKT
06079816105340000,2021,122588,376412,499000,MKT
06079816105340000,2020,86652,364348,451000,MKT
06079816105340000,2019,86652,364348,451000,MKT
06079816105360000,2021,152309,331491,483800,MKT
06079816105360000,2020,91171,325529,416700,MKT
06079816105360000,2019,91171,325529,416700,MKT
06079816105380000,2021,144110,432290,576400,MKT
06079816105380000,2020,86331,405469,491800,MKT
06079816105380000,2019,86331,405469,491800,MKT
06079816105400000,2021,113039,304961,418000,MKT
06079816105400000,2020,79994,303306,383300,MKT
06079816105400000,2019,79994,303306,383300,MKT
06079816105420000,2021,114532,505268,619800,MKT
06079816105420000,2020,81035,422465,503500,MKT
06079816105420000,2019,81035,422465,503500,MKT
06079816105440000,2021,117723,348077,465800,MKT
06079816105440000,2020,83261,331639,414900,OVR
06079816105440000,2019,83261,331639,414900,MKT
06079816105460000,2021,122588,422812,545400,MKT
06079816105460000,2020,86652,397248,483900,MKT
06079816105460000,2019,86652,397248,483900,MKT
06079816106020000,2021,122588,411612,534200,MKT
06079816106020000,2020,86652,351948,438600,MKT
06079816106020000,2019,86652,351948,438600,MKT
06079816106040000,2021,153240,454660,607900,MKT
06079816106040000,2020,91720,397580,489300,MKT
06079816106040000,2019,91720,397580,489300,MKT
06079816106050000,2021,142244,371256,513500,MKT
06079816106050000,2020,85229,338171,423400,MKT
06079816106050000,2019,85229,338171,423400,MKT
06079816106067000,2021,120438,0,120438,COST
06079816106067000,2020,85153,0,85153,COST
06079816106067000,2019,85153,480600,565753,COST
06079816106070000,2021,120438,483200,603638,COST
06079816106070000,2020,85153,468410,553563,COST
06079816106070000,2019,85153,468410,553563,COST
06079816106080000,2021,120438,356662,477100,MKT
06079816106080000,2020,85153,335047,420200,MKT
06079816106080000,2019,85153,335047,420200,MKT
06079816106090000,2021,120416,303784,424200,MKT
06079816106090000,2020,85138,298262,383400,MKT
06079816106090000,2019,85138,294262,379400,MKT
06079816106100000,2021,96797,293303,390100,MKT
06079816106100000,2020,67323,285677,353000,MKT
06079816106100000,2019,67323,285677,353000,MKT
06079816106117000,2021,138125,0,138125,COST
06079816106117000,2020,95585,0,95585,COST
06079816106117000,2019,95585,0,95585,COST
06079816106120000,2021,121746,364054,485800,MKT
06079816106120000,2020,84401,339299,423700,MKT
06079816106120000,2019,84401,332199,416600,MKT
06079816106140000,2021,122588,474350,596938,COST
06079816106140000,2020,86652,455720,542372,COST
06079816106140000,2019,86652,455720,542372,COST
06079816106160000,2021,122588,433512,556100,MKT
06079816106160000,2020,86652,396048,482700,MKT
06079816106160000,2019,86652,396048,482700,MKT
06079816106180000,2021,122588,454012,576600,MKT
06079816106180000,2020,86652,418948,505600,MKT
06079816106180000,2019,86652,418948,505600,MKT
06079816106200000,2021,122588,444812,567400,MKT
06079816106200000,2020,86652,405218,491870,OVR
06079816106200000,2019,86652,405218,491870,OVR
06079816106220000,2021,152333,345667,498000,MKT
06079816106220000,2020,91185,341515,432700,MKT
06079816106220000,2019,91185,341515,432700,MKT
06079816106240000,2021,146331,472069,618400,MKT
06079816106240000,2020,87642,406158,493800,MKT
06079816106240000,2019,87642,406158,493800,MKT
06079816106260000,2021,126151,379349,505500,MKT
06079816106260000,2020,89134,349866,439000,MKT
06079816106260000,2019,89134,349866,439000,MKT
06079816106280000,2021,127964,469936,597900,MKT
06079816106280000,2020,90397,429103,519500,MKT
06079816106280000,2019,90397,429103,519500,MKT
06079816107010000,2021,129283,438717,568000,MKT
06079816107010000,2020,91316,403784,495100,MKT
06079816107010000,2019,91316,405284,496600,MKT
06079816107030000,2021,126117,393583,519700,MKT
06079816107030000,2020,89110,383390,472500,MKT
06079816107030000,2019,89110,383390,472500,MKT
06079816107050000,2021,129878,388122,518000,MKT
06079816107050000,2020,91730,385770,477500,MKT
06079816107050000,2019,91730,385770,477500,MKT
06079816107070000,2021,125910,431490,557400,MKT
06079816107070000,2020,88967,407233,496200,MKT
06079816107070000,2019,88967,407233,496200,MKT
06079816107090000,2021,123841,361459,485300,MKT
06079816107090000,2020,87525,344775,432300,MKT
06079816107090000,2019,87525,344775,432300,MKT
06079816107110000,2021,147874,424226,572100,MKT
06079816107110000,2020,88553,421847,510400,MKT
06079816107110000,2019,88553,421847,510400,MKT
06079816107130000,2021,122588,382812,505400,MKT
06079816107130000,2020,86652,373248,459900,MKT
06079816107130000,2019,86652,373148,459800,MKT
06079816107150000,2021,122588,424812,547400,MKT
06079816107150000,2020,86652,399648,486300,MKT
06079816107150000,2019,86652,399648,486300,MKT
06079816107170000,2021,122588,350412,473000,MKT
06079816107170000,2020,86652,354748,441400,MKT
06079816107170000,2019,86652,355548,442200,MKT
06079816107190000,2021,119794,414306,534100,MKT
06079816107190000,2020,84705,399095,483800,MKT
06079816107190000,2019,84705,401295,486000,MKT
06079816107210000,2021,121746,363054,484800,MKT
06079816107210000,2020,84401,350599,435000,MKT
06079816107210000,2019,84401,350599,435000,MKT
06079816107230000,2021,96797,293103,389900,MKT
06079816107230000,2020,67323,268877,336200,MKT
06079816107230000,2019,67323,268877,336200,MKT
06079816107250000,2021,96797,293103,389900,MKT
06079816107250000,2020,67323,268877,336200,MKT
06079816107250000,2019,67323,268877,336200,MKT
06079816107270000,2021,121746,480454,602200,INCOME
06079816107270000,2020,84401,491899,576300,INCOME
06079816107270000,2019,84401,491899,576300,INCOME
06079816107290000,2021,119794,379706,499500,MKT
06079816107290000,2020,84705,367595,452300,MKT
06079816107290000,2019,84705,367595,452300,MKT
06079816107310000,2021,119794,445406,565200,MKT
06079816107310000,2020,84705,423295,508000,MKT
06079816107310000,2019,84705,423295,508000,MKT
06079816107330000,2021,119794,355906,475700,MKT
06079816107330000,2020,84705,346495,431200,MKT
06079816107330000,2019,84705,347295,432000,MKT
06079816107350000,2021,119794,352806,472600,MKT
06079816107350000,2020,84705,332895,417600,MKT
06079816107350000,2019,84705,332895,417600,MKT
06079816107370000,2021,144654,494246,638900,MKT
06079816107370000,2020,86652,427248,513900,MKT
06079816107370000,2019,86652,427248,513900,MKT
06079816107390000,2021,148623,327277,475900,MKT
06079816107390000,2020,88995,320905,409900,MKT
06079816107390000,2019,88995,320905,409900,MKT
06079816107410000,2021,117642,370458,488100,MKT
06079816107410000,2020,83204,362596,445800,MKT
06079816107410000,2019,83204,362596,445800,MKT
06079816107430000,2021,117642,349158,466800,MKT
06079816107430000,2020,83204,331096,414300,MKT
06079816107430000,2019,83204,331096,414300,MKT
06079816107450000,2021,123659,375741,499400,MKT
06079816107450000,2020,87398,365702,453100,MKT
06079816107450000,2019,87398,365702,453100,MKT
06079816107470000,2021,124149,475151,599300,MKT
06079816107470000,2020,87740,429460,517200,MKT
06079816107470000,2019,87740,429460,517200,MKT
06079816107490000,2021,133165,427535,560700,MKT
06079816107490000,2020,94018,405282,499300,MKT
06079816107490000,2019,94018,405282,499300,MKT
06079816108010000,2021,130741,446459,577200,MKT
06079816108010000,2020,92331,405769,498100,MKT
06079816108010000,2019,92331,405769,498100,MKT
06079816108030000,2021,124846,481954,606800,MKT
06079816108030000,2020,88225,432775,521000,MKT
06079816108030000,2019,88225,432775,521000,MKT
06079816108050000,2021,127041,513359,640400,MKT
06079816108050000,2020,89754,436346,526100,MKT
06079816108050000,2019,89754,436346,526100,MKT
06079816108070000,2021,127041,420059,547100,MKT
06079816108070000,2020,89754,404446,494200,MKT
06079816108070000,2019,89754,404446,494200,MKT
06079816108090000,2021,122170,415530,537700,MKT
06079816108090000,2020,86361,377939,464300,MKT
06079816108090000,2019,86361,377939,464300,MKT
06079816108110000,2021,121836,442864,564700,MKT
06079816108110000,2020,86128,399572,485700,MKT
06079816108110000,2019,86128,399572,485700,MKT
06079816108130000,2021,141357,498543,639900,MKT
06079816108130000,2020,84705,436595,521300,MKT
06079816108130000,2019,84705,436595,521300,MKT
06079816108150000,2021,144654,506446,651100,MKT
06079816108150000,2020,86652,436248,522900,MKT
06079816108150000,2019,86652,427548,514200,MKT
06079816108170000,2021,122588,489012,611600,MKT
06079816108170000,2020,86652,421048,507700,MKT
06079816108170000,2019,86652,421048,507700,MKT
06079816108190000,2021,122588,349712,472300,MKT
06079816108190000,2020,86652,344048,430700,MKT
06079816108190000,2019,86652,344048,430700,MKT
06079816108210000,2021,122610,474790,597400,MKT
06079816108210000,2020,86667,404933,491600,MKT
06079816108210000,2019,86667,404933,491600,MKT
06079816108230000,2021,134205,419695,553900,MKT
06079816108230000,2020,94742,406258,501000,MKT
06079816108230000,2019,94742,406258,501000,MKT
06079816108250000,2021,152844,0,152844,COST
06079816108250000,2020,105620,0,105620,COST
06079816108250000,2019,105620,0,105620,COST
06079816108270000,2021,138046,403454,541500,MKT
06079816108270000,2020,95532,356268,451800,MKT
06079816108270000,2019,95532,356268,451800,MKT
06079816108290000,2021,136008,410392,546400,MKT
06079816108290000,2020,95997,364203,460200,MKT
06079816108290000,2019,95997,364203,460200,MKT
06079816108310000,2021,133366,500334,633700,MKT
06079816108310000,2020,94158,431942,526100,MKT
06079816108310000,2019,94158,431942,526100,MKT
06079816108330000,2021,127102,408898,536000,MKT
06079816108330000,2020,89797,393203,483000,MKT
06079816108330000,2019,89797,391303,481100,MKT
06079816108350000,2021,149980,531020,681000,MKT
06079816108350000,2020,89797,471103,560900,MKT
06079816108350000,2019,89797,471103,560900,MKT
06079816108370000,2021,149787,404313,554100,MKT
06079816108370000,2020,89683,371917,461600,MKT
06079816108370000,2019,89683,371917,461600,MKT
06079816108390000,2021,119133,524067,643200,MKT
06079816108390000,2020,84243,441357,525600,MKT
06079816108390000,2019,84243,441357,525600,MKT
06079816108410000,2021,119133,442267,561400,MKT
06079816108410000,2020,84243,401357,485600,MKT
06079816108410000,2019,84243,401357,485600,MKT
06079816108430000,2021,123519,511981,635500,MKT
06079816108430000,2020,87301,441599,528900,MKT
06079816108430000,2019,87301,441599,528900,MKT
06079816108450000,2021,116341,439559,555900,MKT
06079816108450000,2020,82297,396103,478400,MKT
06079816108450000,2019,82297,398003,480300,MKT
06079816108470000,2021,121857,339543,461400,MKT
06079816108470000,2020,86142,346058,432200,MKT
06079816108470000,2019,86142,346058,432200,MKT
06079816108490000,2021,121657,485543,607200,MKT
06079816108490000,2020,86003,412997,499000,MKT
06079816108490000,2019,86003,412997,499000,MKT
06079816108510000,2021,132044,527056,659100,MKT
06079816108510000,2020,93238,462762,556000,MKT
06079816108510000,2019,93238,462762,556000,MKT
06079816109020000,2021,119358,511442,630800,MKT
06079816109020000,2020,84401,421799,506200,MKT
06079816109020000,2019,84401,421799,506200,MKT
06079816109040000,2021,94899,284701,379600,MKT
06079816109040000,2020,67323,277277,344600,MKT
06079816109040000,2019,67323,277277,344600,MKT
06079816109060000,2021,94899,284701,379600,MKT
06079816109060000,2020,67323,277277,344600,MKT
06079816109060000,2019,67323,277277,344600,MKT
06079816109080000,2021,94899,284701,379600,MKT
06079816109080000,2020,67323,277277,344600,MKT
06079816109080000,2019,67323,277277,344600,MKT
06079816109100000,2021,94899,431001,525900,MKT
06079816109100000,2020,67323,391977,459300,MKT
06079816109100000,2019,67323,391977,459300,MKT
06079816109120000,2021,111854,457046,568900,MKT
06079816109120000,2020,79167,403333,482500,MKT
06079816109120000,2019,79167,403333,482500,MKT
06079816109140000,2021,108722,0,108722,COST
06079816109140000,2020,76981,0,76981,COST
06079816109140000,2019,76981,0,76981,COST
06079816109160000,2021,108746,442354,551100,MKT
06079816109160000,2020,76998,390602,467600,MKT
06079816109160000,2019,76998,390602,467600,MKT
06079816109180000,2021,134564,456336,590900,MKT
06079816109180000,2020,93156,424044,517200,MKT
06079816109180000,2019,93156,424044,517200,MKT
06079816110010000,2021,136369,526931,663300,MKT
06079816110010000,2020,96248,487852,584100,MKT
06079816110010000,2019,96248,487852,584100,MKT
06079816110030000,2021,133838,390862,524700,MKT
06079816110030000,2020,94487,359213,453700,MKT
06079816110030000,2019,94487,359213,453700,MKT
06079816110050000,2021,133586,523114,656700,MKT
06079816110050000,2020,94311,466089,560400,MKT
06079816110050000,2019,94311,466089,560400,MKT
06079816110070000,2021,133586,425514,559100,MKT
06079816110070000,2020,94311,393589,487900,MKT
06079816110070000,2019,94311,393589,487900,MKT
06079816110090000,2021,133586,509214,642800,MKT
06079816110090000,2020,94311,428589,522900,MKT
06079816110090000,2019,94311,415789,510100,MKT
06079816110110000,2021,135486,506314,641800,MKT
06079816110110000,2020,95634,448666,544300,MKT
06079816110110000,2019,95634,448666,544300,MKT
06079816110130000,2021,135486,549814,685300,MKT
06079816110130000,2020,95634,506866,602500,MKT
06079816110130000,2019,95634,506866,602500,MKT
06079816110150000,2021,133877,459223,593100,MKT
06079816110150000,2020,94514,423086,517600,MKT
06079816110150000,2019,94514,320800,415314,COST
06079816110170000,2021,160826,529174,690000,MKT
06079816110170000,2020,96195,480805,577000,MKT
06079816110170000,2019,96195,480805,577000,MKT
06079816110190000,2021,135448,501052,636500,MKT
06079816110190000,2020,95607,454293,549900,MKT
06079816110190000,2019,95607,454293,549900,MKT
06079816110210000,2021,134764,465436,600200,MKT
06079816110210000,2020,95131,431569,526700,MKT
06079816110210000,2019,95131,431569,526700,MKT
06079816110230000,2021,144307,443193,587500,MKT
06079816110230000,2020,99802,424998,524800,MKT
06079816110230000,2019,99802,424998,524800,MKT
06079816110250000,2021,146029,498071,644100,MKT
06079816110250000,2020,100976,438724,539700,MKT
06079816110250000,2019,100976,438724,539700,MKT
06079816110270000,2021,144611,512989,657600,MKT
06079816110270000,2020,100009,455191,555200,MKT
06079816110270000,2019,100009,455191,555200,MKT
06079816110290000,2021,166019,448581,614600,MKT
06079816110290000,2020,97338,423562,520900,MKT
06079816110290000,2019,97338,0,97338,COST
06079816110310000,2021,160488,494412,654900,MKT
06079816110310000,2020,94140,465160,559300,MKT
06079816110310000,2019,94140,465160,559300,MKT
06079816110330000,2021,133497,518103,651600,MKT
06079816110330000,2020,92427,461473,553900,MKT
06079816110330000,2019,92427,461473,553900,MKT
06079816110350000,2021,132121,433679,565800,MKT
06079816110350000,2020,91488,404912,496400,MKT
06079816110350000,2019,91488,404912,496400,MKT
06079816110370000,2021,132496,348704,481200,MKT
06079816110370000,2020,91744,336256,428000,MKT
06079816110370000,2019,91744,336256,428000,MKT
06079816110390000,2021,131978,422322,554300,MKT
06079816110390000,2020,91390,389810,481200,MKT
06079816110390000,2019,91390,389810,481200,MKT
06079816110410000,2021,132346,454054,586400,MKT
06079816110410000,2020,91641,422559,514200,MKT
06079816110410000,2019,91641,422559,514200,MKT
06079816110430000,2021,132713,533487,666200,MKT
06079816110430000,2020,91892,464308,556200,MKT
06079816110430000,2019,91892,464308,556200,MKT
06079816110450000,2021,132631,437269,569900,MKT
06079816110450000,2020,91836,410264,502100,MKT
06079816110450000,2019,91836,410264,502100,MKT
06079816110470000,2021,139180,619420,758600,MKT
06079816110470000,2020,96305,609295,705600,MKT
06079816110470000,2019,96305,609295,705600,MKT
06079816111016500,2021,188297,0,188297,COST
06079816111016500,2020,130060,0,130060,COST
06079816111016500,2019,130060,0,130060,COST
06079816201150000,2021,102269,234410,336679,COST
06079816201150000,2020,89160,0,89160,COST
06079816201150000,2019,89160,0,89160,COST
06079816201220000,2021,2241603,7379397,9621000,INCOME
06079816201220000,2020,793362,5774638,6568000,INCOME
06079816201220000,2019,793362,5774638,6568000,INCOME
06079816201300000,2021,441084,347680,788764,COST
06079816201300000,2020,442446,383580,826026,COST
06079816201300000,2019,442446,383580,826026,COST
06079816201310000,2021,205863,0,205863,COST
06079816201310000,2020,172659,0,172659,COST
06079816201310000,2019,172659,0,172659,COST
06079816250010000,2021,2177214,1147586,3324800,INCOME
06079816250010000,2020,657281,2097319,2754600,INCOME
06079816250010000,2019,657281,2097319,2754600,INCOME
06079816250040000,2021,189544,257056,446600,MKT
06079816250040000,2020,155919,203481,359400,MKT
06079816250040000,2019,155919,203481,359400,MKT
06079816250060000,2021,2963801,144600,3108401,COST
06079816250060000,2020,376065,132150,508215,COST
06079816250060000,2019,376065,132150,508215,COST
06079816250080000,2021,1896756,1229544,3126300,INCOME
06079816250080000,2020,600111,2122689,2722800,INCOME
06079816250080000,2019,600111,275330,875441,COST
06079816301010000,2021,392864,944010,1336874,COST
06079816301010000,2020,325790,872670,1198460,COST
06079816301010000,2019,163441,316570,480011,COST
06079816301050000,2021,7429,472910,480339,COST
06079816301050000,2020,7313,447120,454433,COST
06079816301050000,2019,7313,447120,454433,COST
06079816301070000,2021,6627,145090,151717,COST
06079816301070000,2020,6567,138900,145467,COST
06079816301070000,2019,6567,138900,145467,COST
06079816301090000,2021,4957,0,4957,COST
06079816301090000,2020,4605,0,4605,COST
06079816301090000,2019,4605,0,4605,COST
06079816301110000,2021,6155,0,6155,COST
06079816301110000,2020,5713,0,5713,COST
06079816301110000,2019,5713,0,5713,COST
06079816302030000,2021,3254,644410,647664,COST
06079816302030000,2020,3435,542480,545915,COST
06079816302030000,2019,3435,542480,545915,COST
06079816340010000,2021,118788,292612,411400,MKT
06079816340010000,2020,87558,253642,341200,MKT
06079816340010000,2019,87558,253642,341200,MKT
06079816340020000,2021,113171,218129,331300,MKT
06079816340020000,2020,82474,179426,261900,MKT
06079816340020000,2019,82474,179426,261900,MKT
06079816340030000,2021,113171,219929,333100,MKT
06079816340030000,2020,82474,210326,292800,MKT
06079816340030000,2019,82474,210326,292800,MKT
06079816340040000,2021,115673,187727,303400,MKT
06079816340040000,2020,84731,169169,253900,OVR
06079816340040000,2019,84731,169169,253900,MKT
06079816340050000,2021,120545,187355,307900,MKT
06079816340050000,2020,89160,173940,263100,MKT
06079816340050000,2019,89160,173940,263100,MKT
06079816340060000,2021,113171,207629,320800,MKT
06079816340060000,2020,82474,180626,263100,MKT
06079816340060000,2019,82474,180626,263100,MKT
06079816340070000,2021,113171,269529,382700,MKT
06079816340070000,2020,82474,223926,306400,MKT
06079816340070000,2019,82474,223926,306400,MKT
06079816345010000,2021,85388,3460,88848,COST
06079816345010000,2020,58244,3390,61634,COST
06079816345010000,2019,58244,3390,61634,COST
06079816345020000,2021,118788,222412,341200,MKT
06079816345020000,2020,87558,201642,289200,MKT
06079816345020000,2019,87558,201642,289200,MKT
06079816345030000,2021,118788,210812,329600,MKT
06079816345030000,2020,87558,200942,288500,MKT
06079816345030000,2019,87558,200942,288500,MKT
06079816345040000,2021,118788,181812,300600,MKT
06079816345040000,2020,87558,174942,262500,MKT
06079816345040000,2019,87558,174942,262500,MKT
06079816345050000,2021,118788,184412,303200,MKT
06079816345050000,2020,87558,170942,258500,MKT
06079816345050000,2019,87558,170942,258500,MKT
06079816345060000,2021,118788,249912,368700,MKT
06079816345060000,2020,87558,234942,322500,MKT
06079816345060000,2019,87558,234942,322500,MKT
06079816345075001,2021,94474,157726,252200,MKT
06079816345075001,2020,71929,148171,220100,MKT
06079816345075001,2019,71929,148171,220100,MKT
06079816345075002,2021,94474,153926,248400,MKT
06079816345075002,2020,71929,150871,222800,MKT
06079816345075002,2019,71929,150871,222800,MKT
06079816345080000,2021,118788,250312,369100,INCOME
06079816345080000,2020,87558,268642,356200,INCOME
06079816345080000,2019,87558,268642,356200,INCOME
06079816345090000,2021,118788,250312,369100,INCOME
06079816345090000,2020,87558,268642,356200,INCOME
06079816345090000,2019,87558,268642,356200,INCOME
06079816345100000,2021,118788,250312,369100,INCOME
06079816345100000,2020,87558,268642,356200,INCOME
06079816345100000,2019,87558,268642,356200,INCOME
06079816345110000,2021,118788,188912,307700,INCOME
06079816345110000,2020,87558,209842,297400,INCOME
06079816345110000,2019,87558,209842,297400,INCOME
06079816350010000,2021,122252,198448,320700,MKT
06079816350010000,2020,90722,189078,279800,MKT
06079816350010000,2019,90722,189078,279800,MKT
06079816350020000,2021,112776,222824,335600,MKT
06079816350020000,2020,82119,204681,286800,MKT
06079816350020000,2019,82119,204681,286800,MKT
06079816350030000,2021,111167,228533,339700,MKT
06079816350030000,2020,80675,208425,289100,MKT
06079816350030000,2019,80675,208425,289100,MKT
06079816350040000,2021,111167,229733,340900,MKT
06079816350040000,2020,80675,210425,291100,MKT
06079816350040000,2019,80675,210425,291100,MKT
06079816350050000,2021,111167,213833,325000,MKT
06079816350050000,2020,80675,205825,286500,MKT
06079816350050000,2019,80675,205825,286500,MKT
06079816350060000,2021,111167,204333,315500,MKT
06079816350060000,2020,80675,195825,276500,MKT
06079816350060000,2019,80675,195825,276500,MKT
06079816350070000,2021,111977,209123,321100,MKT
06079816350070000,2020,81401,192599,274000,MKT
06079816350070000,2019,81401,192599,274000,MKT
06079816350080000,2021,111167,220433,331600,MKT
06079816350080000,2020,80675,203825,284500,MKT
06079816350080000,2019,80675,203825,284500,MKT
06079816350090000,2021,111167,209333,320500,MKT
06079816350090000,2020,80675,196125,276800,MKT
06079816350090000,2019,80675,196125,276800,MKT
06079816350100000,2021,115105,201995,317100,MKT
06079816350100000,2020,84218,187782,272000,MKT
06079816350100000,2019,84218,194382,278600,MKT
06079816350110000,2021,115105,212895,328000,MKT
06079816350110000,2020,84218,195282,279500,OVR
06079816350110000,2019,84218,195282,279500,MKT
06079816350120000,2021,115105,193395,308500,MKT
06079816350120000,2020,84218,170982,255200,MKT
06079816350120000,2019,84218,157482,241700,MKT
06079816350130000,2021,115105,218795,333900,MKT
06079816350130000,2020,84218,205882,290100,MKT
06079816350130000,2019,84218,205882,290100,MKT
06079816350140000,2021,115105,217495,332600,MKT
06079816350140000,2020,84218,196482,280700,MKT
06079816350140000,2019,84218,196482,280700,MKT
06079816350150000,2021,115105,208395,323500,MKT
06079816350150000,2020,84218,196482,280700,MKT
06079816350150000,2019,84218,187782,272000,MKT
06079816350160000,2021,115105,219295,334400,MKT
06079816350160000,2020,84218,208482,292700,MKT
06079816350160000,2019,84218,205082,289300,MKT
06079816350170000,2021,115105,222395,337500,MKT
06079816350170000,2020,84218,205482,289700,MKT
06079816350170000,2019,84218,205482,289700,MKT
06079816350180000,2021,119320,218780,338100,MKT
06079816350180000,2020,88043,196857,284900,MKT
06079816350180000,2019,88043,196857,284900,MKT
06079816355010000,2021,123912,220588,344500,MKT
06079816355010000,2020,92246,175654,267900,MKT
06079816355010000,2019,92246,175654,267900,MKT
06079816355020000,2021,118788,209112,327900,MKT
06079816355020000,2020,87558,206842,294400,MKT
06079816355020000,2019,87558,206842,294400,MKT
06079816355030000,2021,118788,210112,328900,MKT
06079816355030000,2020,87558,196642,284200,MKT
06079816355030000,2019,87558,196642,284200,MKT
06079816355040000,2021,118788,211612,330400,MKT
06079816355040000,2020,87558,198342,285900,MKT
06079816355040000,2019,87558,198342,285900,MKT
06079816355050000,2021,118788,207812,326600,MKT
06079816355050000,2020,87558,197842,285400,MKT
06079816355050000,2019,87558,197842,285400,MKT
06079816355060000,2021,118788,218312,337100,MKT
06079816355060000,2020,87558,211442,299000,MKT
06079816355060000,2019,87558,209742,297300,MKT
06079816355070000,2021,118788,237312,356100,MKT
06079816355070000,2020,87558,224942,312500,MKT
06079816355070000,2019,87558,224942,312500,MKT
06079816360017000,2021,174451,0,174451,COST
06079816360017000,2020,143192,0,143192,COST
06079816360017000,2019,143192,0,143192,COST
06079816360076500,2021,62296,0,62296,COST
06079816360076500,2020,52300,0,52300,COST
06079816360076500,2019,52300,0,52300,COST
06079816360105000,2021,30416,0,30416,COST
06079816360105000,2020,23331,0,23331,COST
06079816360105000,2019,23331,0,23331,COST
06079816360105001,2021,67632,146868,214500,MKT
06079816360105001,2020,49426,122210,171636,COST
06079816360105001,2019,49426,122210,171636,COST
06079816360115002,2021,67632,145068,212700,MKT
06079816360115002,2020,49426,122210,171636,COST
06079816360115002,2019,49426,122210,171636,COST
06079816360125003,2021,67632,146868,214500,MKT
06079816360125003,2020,49426,134774,184200,MKT
06079816360125003,2019,49426,134774,184200,MKT
06079816360130000,2021,128183,299117,427300,INCOME
06079816360130000,2020,96187,318213,414400,INCOME
06079816360130000,2019,96187,318213,414400,INCOME
06079816360170000,2021,128640,298660,427300,INCOME
06079816360170000,2020,96611,317789,414400,INCOME
06079816360170000,2019,96611,317789,414400,INCOME
06079816365010000,2021,109720,293780,403500,MKT
06079816365010000,2020,79380,256920,336300,MKT
06079816365010000,2019,79380,256920,336300,MKT
06079816365030000,2021,109929,310871,420800,MKT
06079816365030000,2020,79566,308234,387800,OVR
06079816365030000,2019,79566,308234,387800,MKT
06079816365050000,2021,109929,259071,369000,MKT
06079816365050000,2020,79566,234634,314200,MKT
06079816365050000,2019,79566,234634,314200,MKT
06079816365070000,2021,109929,356171,466100,MKT
06079816365070000,2020,79566,330034,409600,MKT
06079816365070000,2019,79566,330034,409600,MKT
06079816365090000,2021,109929,265071,375000,MKT
06079816365090000,2020,79566,254434,334000,MKT
06079816365090000,2019,79566,254434,334000,MKT
06079816365115001,2021,110137,205163,315300,MKT
06079816365115001,2020,85447,213853,299300,MKT
06079816365115001,2019,85447,213853,299300,MKT
06079816365135002,2021,110137,199163,309300,MKT
06079816365135002,2020,85447,202653,288100,MKT
06079816365135002,2019,85447,202653,288100,MKT
06079816365150000,2021,110552,300748,411300,MKT
06079816365150000,2020,80123,257177,337300,MKT
06079816365150000,2019,80123,257177,337300,MKT
06079816365170000,2021,108875,319525,428400,MKT
06079816365170000,2020,78626,287574,366200,MKT
06079816365170000,2019,78626,287574,366200,MKT
06079816366010000,2021,131896,231604,363500,MKT
06079816366010000,2020,90967,217733,308700,MKT
06079816366010000,2019,90967,217733,308700,MKT
06079816366030000,2021,131657,284443,416100,MKT
06079816366030000,2020,90764,266936,357700,MKT
06079816366030000,2019,90764,266936,357700,MKT
06079816366050000,2021,131657,309643,441300,MKT
06079816366050000,2020,90764,290336,381100,MKT
06079816366050000,2019,90764,290336,381100,MKT
06079816366070000,2021,130936,299764,430700,MKT
06079816366070000,2020,80492,263208,343700,MKT
06079816366070000,2019,80492,263208,343700,MKT
06079816366090000,2021,132370,279930,412300,MKT
06079816366090000,2020,91371,258029,349400,MKT
06079816366090000,2019,91371,258029,349400,MKT
06079816366110000,2021,131896,286104,418000,MKT
06079816366110000,2020,90967,278333,369300,MKT
06079816366110000,2019,90967,278333,369300,MKT
06079816366130000,2021,131896,273804,405700,MKT
06079816366130000,2020,90967,263333,354300,MKT
06079816366130000,2019,90967,263333,354300,MKT
06079816366150000,2021,131896,276204,408100,MKT
06079816366150000,2020,90967,251233,342200,MKT
06079816366150000,2019,90967,251233,342200,MKT
06079816366170000,2021,131896,338604,470500,MKT
06079816366170000,2020,90967,328433,419400,MKT
06079816366170000,2019,90967,328433,419400,MKT
06079816366190000,2021,139535,263865,403400,MKT
06079816366190000,2020,97517,267283,364800,MKT
06079816366190000,2019,97517,267283,364800,MKT
06079816366210000,2021,146602,334598,481200,MKT
06079816366210000,2020,103651,313449,417100,MKT
06079816366210000,2019,103651,277649,381300,MKT
06079816366230000,2021,134920,448980,583900,MKT
06079816366230000,2020,93550,429250,522800,MKT
06079816366230000,2019,93550,429250,522800,MKT
06079816366250000,2021,129222,267078,396300,MKT
06079816366250000,2020,88695,256805,345500,MKT
06079816366250000,2019,88695,256805,345500,MKT
06079816366270000,2021,116235,297265,413500,MKT
06079816366270000,2020,85240,256760,342000,MKT
06079816366270000,2019,85240,256760,342000,MKT
06079816367010000,2021,109720,317780,427500,MKT
06079816367010000,2020,79380,274420,353800,MKT
06079816367010000,2019,79380,274420,353800,MKT
06079816367030000,2021,110758,298542,409300,MKT
06079816367030000,2020,80308,278992,359300,MKT
06079816367030000,2019,80308,278992,359300,MKT
06079816367050000,2021,110758,293042,403800,MKT
06079816367050000,2020,80308,267092,347400,MKT
06079816367050000,2019,80308,267092,347400,MKT
06079816367070000,2021,110758,284642,395400,MKT
06079816367070000,2020,80308,262592,342900,MKT
06079816367070000,2019,80308,262592,342900,MKT
06079816367090000,2021,110758,302942,413700,MKT
06079816367090000,2020,80308,240192,320500,MKT
06079816367090000,2019,80308,240192,320500,MKT
06079816367110000,2021,116235,342465,458700,MKT
06079816367110000,2020,85240,295960,381200,OVR
06079816367110000,2019,85240,295960,381200,MKT
06079816367130000,2021,110552,381348,491900,MKT
06079816367130000,2020,80123,329477,409600,MKT
06079816367130000,2019,80123,329477,409600,MKT
06079816367150000,2021,113367,290233,403600,MKT
06079816367150000,2020,82651,263949,346600,MKT
06079816367150000,2019,82651,263949,346600,MKT
06079816367170000,2021,106258,270042,376300,MKT
06079816367170000,2020,76298,248302,324600,MKT
06079816367170000,2019,76298,247202,323500,MKT
06079816367190000,2021,109299,302501,411800,MKT
06079816367190000,2020,79004,275396,354400,MKT
06079816367190000,2019,79004,275396,354400,MKT
06079816367210000,2021,110758,272342,383100,MKT
06079816367210000,2020,80308,253592,333900,MKT
06079816367210000,2019,80308,253592,333900,MKT
06079816367230000,2021,110758,227842,338600,MKT
06079816367230000,2020,80308,200592,280900,MKT
06079816367230000,2019,80308,200592,280900,MKT
06079816367250000,2021,110758,364442,475200,MKT
06079816367250000,2020,80308,322492,402800,MKT
06079816367250000,2019,80308,322492,402800,MKT
06079816367270000,2021,110345,355555,465900,MKT
06079816367270000,2020,79938,329362,409300,MKT
06079816367270000,2019,79938,329362,409300,MKT
06079816367290000,2021,108662,266738,375400,MKT
06079816367290000,2020,78435,239965,318400,MKT
06079816367290000,2019,78435,239965,318400,MKT
06079816367310000,2021,109510,318290,427800,MKT
06079816367310000,2020,79192,296408,375600,MKT
06079816367310000,2019,79192,296408,375600,MKT
06079816367330000,2021,108017,284183,392200,MKT
06079816367330000,2020,77861,254039,331900,MKT
06079816367330000,2019,77861,254039,331900,MKT
06079816368010000,2021,115673,294427,410100,MKT
06079816368010000,2020,84731,259569,344300,MKT
06079816368010000,2019,84731,259569,344300,MKT
06079816368030000,2021,111371,324729,436100,MKT
06079816368030000,2020,80857,289243,370100,MKT
06079816368030000,2019,80857,289243,370100,MKT
06079816368050000,2021,111371,326229,437600,MKT
06079816368050000,2020,80857,297643,378500,MKT
06079816368050000,2019,80857,297643,378500,MKT
06079816368070000,2021,111167,453533,564700,MKT
06079816368070000,2020,80675,456325,537000,MKT
06079816368070000,2019,80675,456325,537000,MKT
06079816368090000,2021,111371,302529,413900,MKT
06079816368090000,2020,80857,268243,349100,MKT
06079816368090000,2019,80857,268243,349100,MKT
06079816368110000,2021,111574,316226,427800,MKT
06079816368110000,2020,81039,279761,360800,MKT
06079816368110000,2019,81039,279761,360800,MKT
06079816368130000,2021,111371,299829,411200,MKT
06079816368130000,2020,80857,271743,352600,MKT
06079816368130000,2019,80857,271743,352600,MKT
06079816368150000,2021,111371,460229,571600,MKT
06079816368150000,2020,80857,429043,509900,MKT
06079816368150000,2019,80857,429043,509900,MKT
06079816368170000,2021,111574,265126,376700,MKT
06079816368170000,2020,81039,246061,327100,MKT
06079816368170000,2019,81039,246061,327100,MKT
06079816368190000,2021,111574,325826,437400,MKT
06079816368190000,2020,81039,292061,373100,MKT
06079816368190000,2019,81039,289661,370700,MKT
06079816368210000,2021,111574,329426,441000,MKT
06079816368210000,2020,81039,288261,369300,MKT
06079816368210000,2019,81039,288261,369300,MKT
06079816368230000,2021,111574,258626,370200,MKT
06079816368230000,2020,81039,250961,332000,MKT
06079816368230000,2019,81039,250961,332000,MKT
06079816368250000,2021,111776,302324,414100,MKT
06079816368250000,2020,81221,256679,337900,MKT
06079816368250000,2019,81221,256679,337900,MKT
06079816368270000,2021,111776,303124,414900,MKT
06079816368270000,2020,81221,257079,338300,MKT
06079816368270000,2019,81221,257079,338300,MKT
06079816368290000,2021,111977,392123,504100,MKT
06079816368290000,2020,81401,349899,431300,MKT
06079816368290000,2019,81401,349899,431300,MKT
06079816368310000,2021,111371,302129,413500,MKT
06079816368310000,2020,80857,279743,360600,MKT
06079816368310000,2019,80857,279743,360600,MKT
06079816368336500,2021,81988,0,81988,COST
06079816368336500,2020,73419,0,73419,COST
06079816368336500,2019,73419,0,73419,COST
06079816401010000,2021,1068,0,1068,COST
06079816401010000,2020,994,0,994,COST
06079816401010000,2019,994,0,994,COST
06079816401020000,2021,217897,224350,442247,COST
06079816401020000,2020,185207,204460,389667,COST
06079816401020000,2019,185207,204460,389667,COST
06079816401030000,2021,217897,212003,429900,MKT
06079816401030000,2020,151869,200731,352600,MKT
06079816401030000,2019,151869,200731,352600,MKT
06079816401040000,2021,217897,231703,449600,MKT
06079816401040000,2020,185207,225293,410500,MKT
06079816401040000,2019,185207,225293,410500,MKT
06079816401050000,2021,217897,520303,738200,MKT
06079816401050000,2020,185207,379470,564677,COST
06079816401050000,2019,185207,379470,564677,COST
06079816401060000,2021,217897,369303,587200,MKT
06079816401060000,2020,185207,323730,508937,COST
06079816401060000,2019,185207,323730,508937,COST
06079816401070000,2021,217897,234403,452300,MKT
06079816401070000,2020,185207,259693,444900,MKT
06079816401070000,2019,185207,259693,444900,MKT
06079816401080000,2021,217897,295003,512900,MKT
06079816401080000,2020,185207,259593,444800,MKT
06079816401080000,2019,185207,259593,444800,MKT
06079816401090000,2021,217897,294803,512700,MKT
06079816401090000,2020,185207,245840,431047,COST
06079816401090000,2019,185207,245840,431047,COST
06079816401100000,2021,217897,180230,398127,COST
06079816401100000,2020,185207,169320,354527,COST
06079816401100000,2019,185207,169320,354527,COST
06079816401110000,2021,217897,223403,441300,MKT
06079816401110000,2020,185207,247493,432700,MKT
06079816401110000,2019,185207,249893,435100,MKT
06079816401120000,2021,120,0,120,COST
06079816401120000,2020,111,0,111,COST
06079816401120000,2019,111,0,111,COST
06079816401210000,2021,253316,179660,432976,COST
06079816401210000,2020,223065,166790,389855,COST
06079816401210000,2019,223065,166790,389855,COST
06079816402100000,2021,290463,274737,565200,MKT
06079816402100000,2020,264130,217770,481900,MKT
06079816402100000,2019,264130,217770,481900,MKT
06079816402200000,2021,298729,416430,715159,COST
06079816402200000,2020,273443,392800,666243,COST
06079816402200000,2019,273443,392800,666243,COST
06079816402300000,2021,298729,296480,595209,COST
06079816402300000,2020,273443,281710,555153,COST
06079816402300000,2019,273443,281710,555153,COST
06079816430350000,2021,419628,384400,804028,COST
06079816430350000,2020,416022,356010,772032,COST
06079816430350000,2019,416022,356010,772032,COST
06079816450010000,2021,217740,0,217740,COST
06079816450010000,2020,185042,0,185042,COST
06079816450010000,2019,185042,0,185042,COST
06079816450040000,2021,217740,242460,460200,MKT
06079816450040000,2020,185042,230558,415600,MKT
06079816450040000,2019,185042,230558,415600,MKT
06079816450060000,2021,217897,198903,416800,MKT
06079816450060000,2020,185207,183993,369200,MKT
06079816450060000,2019,185207,183993,369200,MKT
06079816450080000,2021,217897,337680,555577,COST
06079816450080000,2020,185207,348993,534200,MKT
06079816450080000,2019,185207,335593,520800,MKT
06079816450090000,2021,173214,449286,622500,MKT
06079816450090000,2020,139502,410198,549700,MKT
06079816450090000,2019,139502,400898,540400,MKT
06079816450100000,2021,173214,0,173214,COST
06079816450100000,2020,139502,0,139502,COST
06079816450100000,2019,139502,0,139502,COST
06079816450120000,2021,217740,288760,506500,MKT
06079816450120000,2020,185042,251758,436800,MKT
06079816450120000,2019,185042,251758,436800,MKT
06079816450140000,2021,172547,246353,418900,MKT
06079816450140000,2020,138839,249361,388200,MKT
06079816450140000,2019,138839,249361,388200,MKT
06079816450150000,2021,173214,218486,391700,MKT
06079816450150000,2020,139502,205098,344600,MKT
06079816450150000,2019,139502,205098,344600,MKT
06079816450180000,2021,198518,277282,475800,MKT
06079816450180000,2020,165084,260416,425500,MKT
06079816450180000,2019,165084,260416,425500,MKT
06079816450190000,2021,173214,425086,598300,MKT
06079816450190000,2020,139502,407898,547400,MKT
06079816450190000,2019,139502,407898,547400,MKT
06079816450200000,2021,173214,0,173214,COST
06079816450200000,2020,139502,0,139502,COST
06079816450200000,2019,139502,0,139502,COST
06079816450220000,2021,198455,243645,442100,MKT
06079816450220000,2020,165020,202780,367800,MKT
06079816450220000,2019,165020,202780,367800,MKT
06079816450240000,2021,173214,277186,450400,MKT
06079816450240000,2020,139502,247798,387300,MKT
06079816450240000,2019,139502,247798,387300,MKT
06079816450260000,2021,217740,293200,510940,COST
06079816450260000,2020,185042,320158,505200,MKT
06079816450260000,2019,185042,320158,505200,MKT
06079816450280000,2021,217740,750,218490,COST
06079816450280000,2020,185042,700,185742,COST
06079816450280000,2019,185042,700,185742,COST
06079816460010000,2021,316858,772280,1089138,COST
06079816460010000,2020,294079,688459,982538,MRA
06079816460010000,2019,294079,688459,982538,MRA
06079816460050000,2021,230332,288120,518452,COST
06079816460050000,2020,168714,288786,457500,MKT
06079816460050000,2019,168714,0,168714,COST
06079816460080000,2021,230332,673268,903600,MKT
06079816460080000,2020,168714,557586,726300,MKT
06079816460080000,2019,168714,0,168714,COST
06079816460110000,2021,244289,941711,1186000,MKT
06079816460110000,2020,181427,810373,991800,MKT
06079816460110000,2019,181427,0,181427,COST
06079816460140000,2021,232597,402903,635500,MKT
06079816460140000,2020,170765,331335,502100,MKT
06079816460140000,2019,170765,0,170765,COST
06079816470010000,2021,24538,419330,443868,COST
06079816470010000,2020,33157,392930,426087,COST
06079816470010000,2019,33157,392930,426087,COST
06079817101020000,2021,414108,432470,846578,COST
06079817101020000,2020,260312,403340,663652,COST
06079817101020000,2019,260312,403340,663652,COST
06079817101030000,2021,1693478,18096222,19789700,INCOME
06079817101030000,2020,1088145,16551855,17640000,INCOME
06079817101030000,2019,1088145,16551855,17640000,INCOME
06079817101050000,2021,1317411,783889,2101300,INCOME
06079817101050000,2020,921982,1024518,1946500,INCOME
06079817101050000,2019,921982,1024518,1946500,INCOME
06079817101060000,2021,498919,601081,1100000,INCOME
06079817101060000,2020,294367,680033,974400,INCOME
06079817101060000,2019,294367,680033,974400,INCOME
06079817101090000,2021,306347,362100,668447,COST
06079817101090000,2020,270797,334830,605627,COST
06079817101090000,2019,311621,334830,646451,COST
06079817101120000,2021,364317,0,364317,COST
06079817101120000,2020,349393,0,349393,COST
06079817101120000,2019,349393,0,349393,COST
06079817101130000,2021,297628,565550,863178,COST
06079817101130000,2020,263868,294120,557988,COST
06079817101130000,2019,263868,294120,557988,COST
06079817101140000,2021,419213,0,419213,COST
06079817101140000,2020,415514,0,415514,COST
06079817101140000,2019,415514,0,415514,COST
06079817101150000,2021,140543,297557,438100,MKT
06079817101150000,2020,103456,277444,380900,MKT
06079817101150000,2019,103456,277444,380900,MKT
06079817101160000,2021,140922,297078,438000,MKT
06079817101160000,2020,103802,280798,384600,MKT
06079817101160000,2019,103802,280798,384600,MKT
06079817101180000,2021,155078,388522,543600,MKT
06079817101180000,2020,116826,372374,489200,MKT
06079817101180000,2019,116826,372374,489200,MKT
06079817101190000,2021,156008,520892,676900,MKT
06079817101190000,2020,117691,485509,603200,MKT
06079817101190000,2019,117691,485509,603200,MKT
06079817101200000,2021,749164,3009736,3758900,INCOME
06079817101200000,2020,635272,2631428,3266700,INCOME
06079817101200000,2019,635272,2631428,3266700,INCOME
06079817101210000,2021,97761,0,97761,COST
06079817101210000,2020,66083,0,66083,COST
06079817101210000,2019,66083,0,66083,COST
06079817101260000,2021,135407,335493,470900,MKT
06079817101260000,2020,98808,329392,428200,MKT
06079817101260000,2019,98808,329392,428200,MKT
06079817101280000,2021,135816,0,135816,COST
06079817101280000,2020,99177,0,99177,COST
06079817101300000,2021,125528,0,125528,COST
06079817101300000,2020,89984,0,89984,COST
06079817101320000,2021,123912,0,123912,COST
06079817101320000,2020,88556,0,88556,COST
06079817101340000,2021,122252,0,122252,COST
06079817101340000,2020,87093,0,87093,COST
06079817104016500,2021,83014,0,83014,COST
06079817104016500,2020,71574,0,71574,COST
06079817104016500,2019,71574,0,71574,COST
06079817104037000,2021,154088,2150,156238,COST
06079817104037000,2020,110688,2180,112868,COST
06079817104037000,2019,110688,2180,112868,COST
06079817104077000,2021,238772,4640,243412,COST
06079817104077000,2020,180979,4290,185269,COST
06079817104077000,2019,180979,4290,185269,COST
06079817104137000,2021,173131,4240,177371,COST
06079817104137000,2020,136297,4440,140737,COST
06079817104137000,2019,136297,4440,140737,COST
06079817104170000,2021,131315,460185,591500,INCOME
06079817104170000,2020,95134,465466,560600,INCOME
06079817104170000,2019,95134,465466,560600,INCOME
06079817104190000,2021,135544,611556,747100,INCOME
06079817104190000,2020,98931,576769,675700,INCOME
06079817104190000,2019,98931,576769,675700,INCOME
06079817105016500,2021,40519,0,40519,COST
06079817105016500,2020,29519,0,29519,COST
06079817105016500,2019,29519,0,29519,COST
06079817105037000,2021,153926,0,153926,COST
06079817105037000,2020,119445,0,119445,COST
06079817105037000,2019,119445,0,119445,COST
06079817105077000,2021,170427,0,170427,COST
06079817105077000,2020,133911,0,133911,COST
06079817105077000,2019,133911,0,133911,COST
06079817105117000,2021,169824,0,169824,COST
06079817105117000,2020,133379,0,133379,COST
06079817105117000,2019,133379,0,133379,COST
06079817105157000,2021,133039,0,133039,COST
06079817105157000,2020,101408,0,101408,COST
06079817105157000,2019,101408,0,101408,COST
06079817105177000,2021,134164,0,134164,COST
06079817105177000,2020,102371,0,102371,COST
06079817105177000,2019,102371,0,102371,COST
06079817106017000,2021,243057,0,243057,COST
06079817106017000,2020,184629,0,184629,COST
06079817106017000,2019,184629,0,184629,COST
06079817106057000,2021,135133,0,135133,COST
06079817106057000,2020,103201,0,103201,COST
06079817106057000,2019,103201,0,103201,COST
06079817106077000,2021,131315,0,131315,COST
06079817106077000,2020,99934,0,99934,COST
06079817106077000,2019,99934,0,99934,COST
06079817106090000,2021,139649,454151,593800,INCOME
06079817106090000,2020,102645,457955,560600,INCOME
06079817106090000,2019,102645,457955,560600,INCOME
06079817106110000,2021,137826,511774,649600,INCOME
06079817106110000,2020,100992,512008,613000,INCOME
06079817106110000,2019,100992,512008,613000,INCOME
06079817106130000,2021,137957,514243,652200,INCOME
06079817106130000,2020,101111,511889,613000,INCOME
06079817106130000,2019,101111,511889,613000,INCOME
06079817106150000,2021,137957,0,137957,COST
06079817106150000,2020,101111,0,101111,COST
06079817106150000,2019,101111,0,101111,COST
06079817106175001,2021,98549,208251,306800,MKT
06079817106175001,2020,72405,204895,277300,MKT
06079817106175001,2019,72405,201095,273500,MKT
06079817106185002,2021,77751,211249,289000,MKT
06079817106185002,2020,55489,213711,269200,MKT
06079817106185002,2019,55489,209711,265200,MKT
06079817106195003,2021,77751,201349,279100,MKT
06079817106195003,2020,55489,208111,263600,MKT
06079817106195003,2019,55489,208111,263600,MKT
06079817106205004,2021,101087,201713,302800,MKT
06079817106205004,2020,74502,202398,276900,MKT
06079817106205004,2019,74502,202398,276900,MKT
06079817107010000,2021,122755,299945,422700,MKT
06079817107010000,2020,87536,262764,350300,MKT
06079817107010000,2019,87536,262764,350300,MKT
06079817107030000,2021,122922,348678,471600,MKT
06079817107030000,2020,87682,316318,404000,MKT
06079817107030000,2019,87682,316318,404000,MKT
06079817107050000,2021,122922,318978,441900,MKT
06079817107050000,2020,87682,279918,367600,MKT
06079817107050000,2019,87682,279918,367600,MKT
06079817107070000,2021,122922,310878,433800,MKT
06079817107070000,2020,87682,266818,354500,MKT
06079817107070000,2019,87682,266818,354500,MKT
06079817107090000,2021,115295,0,115295,COST
06079817107090000,2020,81014,0,81014,COST
06079817107090000,2019,81014,0,81014,COST
06079817107110000,2021,113563,288437,402000,MKT
06079817107110000,2020,79514,273186,352700,MKT
06079817107110000,2019,79514,273186,352700,MKT
06079817107130000,2021,113563,339737,453300,MKT
06079817107130000,2020,79514,295386,374900,MKT
06079817107130000,2019,79514,295386,374900,MKT
06079817107150000,2021,115295,289105,404400,MKT
06079817107150000,2020,81014,263786,344800,MKT
06079817107150000,2019,81014,263786,344800,MKT
06079817108010000,2021,111776,290424,402200,MKT
06079817108010000,2020,77972,266528,344500,MKT
06079817108010000,2019,77972,266528,344500,MKT
06079817108030000,2021,119673,341427,461100,MKT
06079817108030000,2020,84830,331570,416400,MKT
06079817108030000,2019,84830,331570,416400,MKT
06079817108050000,2021,132183,0,132183,COST
06079817108050000,2020,95911,0,95911,COST
06079817108050000,2019,95911,0,95911,COST
06079817108070000,2021,113758,292542,406300,MKT
06079817108070000,2020,79683,260117,339800,MKT
06079817108070000,2019,79683,253517,333200,MKT
06079817108090000,2021,114724,375676,490400,MKT
06079817108090000,2020,80519,334281,414800,MKT
06079817108090000,2019,80519,334281,414800,MKT
06079817108110000,2021,114724,453376,568100,MKT
06079817108110000,2020,80519,389170,469689,OVR
06079817108110000,2019,80519,389170,469689,OVR
06079817108130000,2021,114724,368076,482800,MKT
06079817108130000,2020,80519,332981,413500,MKT
06079817108130000,2019,80519,332981,413500,MKT
06079817108150000,2021,114724,317776,432500,MKT
06079817108150000,2020,80519,291581,372100,MKT
06079817108150000,2019,80519,291581,372100,MKT
06079817108170000,2021,113367,308733,422100,MKT
06079817108170000,2020,79345,270655,350000,MKT
06079817108170000,2019,79345,270655,350000,MKT
06079817108190000,2021,111977,317023,429000,MKT
06079817108190000,2020,78145,271855,350000,MKT
06079817108190000,2019,78145,271855,350000,MKT
06079817108210000,2021,111977,350923,462900,MKT
06079817108210000,2020,78145,331055,409200,MKT
06079817108210000,2019,78145,331055,409200,MKT
06079817108230000,2021,112974,334526,447500,MKT
06079817108230000,2020,79005,312695,391700,MKT
06079817108230000,2019,79005,312695,391700,MKT
06079817108250000,2021,116791,312509,429300,MKT
06079817108250000,2020,82315,274185,356500,MKT
06079817108250000,2019,82315,274185,356500,MKT
06079817108270000,2021,101824,315276,417100,MKT
06079817108270000,2020,69491,290409,359900,MKT
06079817108270000,2019,69491,281009,350500,MKT
06079817108290000,2021,109087,292613,401700,MKT
06079817108290000,2020,75662,265938,341600,MKT
06079817108290000,2019,75662,265938,341600,MKT
06079817108310000,2021,130730,353670,484400,MKT
06079817108310000,2020,94611,352989,447600,MKT
06079817108310000,2019,94611,352989,447600,MKT
06079817108330000,2021,122252,324148,446400,MKT
06079817108330000,2020,87093,275507,362600,MKT
06079817108330000,2019,87093,275507,362600,MKT
06079817108350000,2021,117343,386357,503700,MKT
06079817108350000,2020,82795,352205,435000,MKT
06079817108350000,2019,82795,352205,435000,MKT
06079817108370000,2021,117159,332041,449200,MKT
06079817108370000,2020,82635,307565,390200,MKT
06079817108370000,2019,82635,221450,304085,COST
06079817108395001,2021,97761,181939,279700,MKT
06079817108395001,2020,71756,174844,246600,MKT
06079817108395001,2019,71756,174844,246600,MKT
06079817108415002,2021,97761,183639,281400,MKT
06079817108415002,2020,71756,178244,250000,MKT
06079817108415002,2019,71756,174844,246600,MKT
06079817108435001,2021,97761,199839,297600,MKT
06079817108435001,2020,71756,194144,265900,MKT
06079817108435001,2019,71756,194144,265900,MKT
06079817108455002,2021,97761,199839,297600,MKT
06079817108455002,2020,71756,194144,265900,MKT
06079817108455002,2019,71756,194144,265900,MKT
06079817108475001,2021,97761,221139,318900,MKT
06079817108475001,2020,71756,213544,285300,MKT
06079817108475001,2019,71756,213544,285300,MKT
06079817108495002,2021,97761,221139,318900,MKT
06079817108495002,2020,71756,213544,285300,MKT
06079817108495002,2019,71756,213544,285300,MKT
06079817108515001,2021,97761,181939,279700,MKT
06079817108515001,2020,71756,174744,246500,MKT
06079817108515001,2019,71756,174744,246500,MKT
06079817108535002,2021,97496,185504,283000,MKT
06079817108535002,2020,71537,176063,247600,MKT
06079817108535002,2019,71537,176063,247600,MKT
06079817108555001,2021,97496,182604,280100,MKT
06079817108555001,2020,71537,176163,247700,MKT
06079817108555001,2019,71537,176163,247700,MKT
06079817108575002,2021,97496,182604,280100,MKT
06079817108575002,2020,71537,176163,247700,MKT
06079817108575002,2019,71537,176163,247700,MKT
06079817108595001,2021,97496,183304,280800,MKT
06079817108595001,2020,71537,176463,248000,MKT
06079817108595001,2019,71537,176463,248000,MKT
06079817108615002,2021,118250,187050,305300,MKT
06079817108615002,2020,88842,176158,265000,MKT
06079817108615002,2019,88842,176158,265000,MKT
06079817109010000,2021,110137,316963,427100,MKT
06079817109010000,2020,76563,272337,348900,MKT
06079817109010000,2019,76563,272337,348900,MKT
06079817109030000,2021,110137,324063,434200,MKT
06079817109030000,2020,76563,299437,376000,MKT
06079817109030000,2019,76563,299437,376000,MKT
06079817109050000,2021,109929,314571,424500,MKT
06079817109050000,2020,76384,284716,361100,MKT
06079817109050000,2019,76384,284716,361100,MKT
06079817109070000,2021,109929,310971,420900,MKT
06079817109070000,2020,76384,285516,361900,MKT
06079817109070000,2019,76384,285516,361900,MKT
06079817109090000,2021,109929,307671,417600,MKT
06079817109090000,2020,76384,263816,340200,MKT
06079817109090000,2019,76384,263816,340200,MKT
06079817109110000,2021,109929,315971,425900,MKT
06079817109110000,2020,76384,290316,366700,MKT
06079817109110000,2019,76384,290316,366700,MKT
06079817109130000,2021,110345,340655,451000,MKT
06079817109130000,2020,76741,318559,395300,MKT
06079817109130000,2019,76741,318559,395300,MKT
06079817109140000,2021,122755,359245,482000,MKT
06079817109140000,2020,87536,323764,411300,MKT
06079817109140000,2019,87536,323764,411300,MKT
06079817109150000,2021,114532,312668,427200,MKT
06079817109150000,2020,80353,278747,359100,MKT
06079817109150000,2019,80353,278747,359100,MKT
06079817109170000,2021,109720,367680,477400,MKT
06079817109170000,2020,76204,322796,399000,MKT
06079817109170000,2019,76204,322796,399000,MKT
06079817109190000,2021,108875,345625,454500,MKT
06079817109190000,2020,75481,310919,386400,MKT
06079817109190000,2019,75481,310919,386400,MKT
06079817109210000,2021,107364,326936,434300,MKT
06079817109210000,2020,74189,316211,390400,MKT
06079817109210000,2019,74189,316211,390400,MKT
06079817109230000,2021,108233,318467,426700,MKT
06079817109230000,2020,74931,277369,352300,MKT
06079817109230000,2019,74931,277369,352300,MKT
06079817109250000,2021,107800,299000,406800,MKT
06079817109250000,2020,74561,269914,344475,MRA
06079817109250000,2019,74561,269914,344475,MRA
06079817109270000,2021,109929,317071,427000,MKT
06079817109270000,2020,76384,290416,366800,MKT
06079817109270000,2019,76384,290416,366800,MKT
06079817110016500,2021,86371,0,86371,COST
06079817110016500,2020,75164,0,75164,COST
06079817110016500,2019,75164,0,75164,COST
06079817110030000,2021,108017,320183,428200,MKT
06079817110030000,2020,74746,291754,366500,MKT
06079817110030000,2019,74746,291754,366500,MKT
06079817110050000,2021,109299,376001,485300,MKT
06079817110050000,2020,75844,330456,406300,MKT
06079817110050000,2019,75844,330456,406300,MKT
06079817110070000,2021,107144,325956,433100,MKT
06079817110070000,2020,74002,305398,379400,MKT
06079817110070000,2019,74002,300598,374600,MKT
06079817110090000,2021,108662,335538,444200,MKT
06079817110090000,2020,75298,315502,390800,MKT
06079817110090000,2019,75298,315502,390800,MKT
06079817110110000,2021,113563,466237,579800,MKT
06079817110110000,2020,79514,433886,513400,MKT
06079817110110000,2019,79514,433886,513400,MKT
06079817110130000,2021,107582,307518,415100,MKT
06079817110130000,2020,74375,280825,355200,MKT
06079817110130000,2019,74375,280825,355200,MKT
06079817110150000,2021,115861,322739,438600,MKT
06079817110150000,2020,81505,294010,375515,COST
06079817110150000,2019,81505,294010,375515,COST
06079817110170000,2021,113953,299347,413300,MKT
06079817110170000,2020,79851,258249,338100,MKT
06079817110170000,2019,79851,258249,338100,MKT
06079817111010000,2021,113758,337042,450800,MKT
06079817111010000,2020,79683,324417,404100,MKT
06079817111010000,2019,79683,324417,404100,MKT
06079817111030000,2021,113171,328029,441200,MKT
06079817111030000,2020,79175,299425,378600,MKT
06079817111030000,2019,79175,299425,378600,MKT
06079817111050000,2021,113563,369937,483500,MKT
06079817111050000,2020,79514,330286,409800,MKT
06079817111050000,2019,79514,330286,409800,MKT
06079817111070000,2021,113758,321842,435600,MKT
06079817111070000,2020,79683,278617,358300,MKT
06079817111070000,2019,79683,278617,358300,MKT
06079817111090000,2021,113758,318342,432100,MKT
06079817111090000,2020,79683,275817,355500,MKT
06079817111090000,2019,79683,275817,355500,MKT
06079817111110000,2021,113758,364742,478500,MKT
06079817111110000,2020,79683,313517,393200,MKT
06079817111110000,2019,79683,313517,393200,MKT
06079817111130000,2021,115484,298416,413900,MKT
06079817111130000,2020,81178,265522,346700,MKT
06079817111130000,2019,81178,265522,346700,MKT
06079817111150000,2021,121745,384555,506300,MKT
06079817111150000,2020,86647,355553,442200,MKT
06079817111150000,2019,86647,355553,442200,MKT
06079817111170000,2021,107582,306618,414200,MKT
06079817111170000,2020,74375,279025,353400,MKT
06079817111170000,2019,74375,279025,353400,MKT
06079817111190000,2021,115295,347105,462400,MKT
06079817111190000,2020,81014,327686,408700,MKT
06079817111190000,2019,81014,327686,408700,MKT
06079817111210000,2021,111574,361026,472600,MKT
06079817111210000,2020,77798,332402,410200,MKT
06079817111210000,2019,77798,332402,410200,MKT
06079817111230000,2021,105582,323118,428700,MKT
06079817111230000,2020,72672,291354,364026,MRA
06079817111230000,2019,72672,291354,364026,MRA
06079817111250000,2021,105355,251045,356400,MKT
06079817111250000,2020,72479,238921,311400,MKT
06079817111250000,2019,72479,238921,311400,MKT
06079817111270000,2021,105355,369845,475200,MKT
06079817111270000,2020,72479,327721,400200,MKT
06079817111270000,2019,72479,327721,400200,MKT
06079817111290000,2021,105355,369845,475200,MKT
06079817111290000,2020,72479,327721,400200,MKT
06079817111290000,2019,72479,327721,400200,MKT
06079817111310000,2021,112378,275822,388200,MKT
06079817111310000,2020,78491,265409,343900,MKT
06079817111310000,2019,78491,265409,343900,MKT
06079817111330000,2021,116048,353452,469500,MKT
06079817111330000,2020,81668,344932,426600,MKT
06079817111330000,2019,81668,338132,419800,MKT
06079817111350000,2021,108875,249225,358100,MKT
06079817111350000,2020,75481,231919,307400,MKT
06079817111350000,2019,75481,231919,307400,MKT
06079817111370000,2021,109087,317413,426500,MKT
06079817111370000,2020,75662,290538,366200,MKT
06079817111370000,2019,75662,290538,366200,MKT
06079817111390000,2021,108875,360825,469700,MKT
06079817111390000,2020,75481,332119,407600,MKT
06079817111390000,2019,75481,332119,407600,MKT
06079817111410000,2021,110137,305463,415600,MKT
06079817111410000,2020,76563,271837,348400,MKT
06079817111410000,2019,76563,272337,348900,MKT
06079817111430000,2021,111776,277324,389100,MKT
06079817111430000,2020,77972,263128,341100,MKT
06079817111430000,2019,77972,263128,341100,MKT
06079817111450000,2021,113367,296033,409400,MKT
06079817111450000,2020,79345,267155,346500,MKT
06079817111450000,2019,79345,267155,346500,MKT
06079817111470000,2021,111574,354026,465600,MKT
06079817111470000,2020,77798,327202,405000,MKT
06079817111470000,2019,77798,327202,405000,MKT
06079817112010000,2021,38197,0,38197,COST
06079817112010000,2020,27444,0,27444,COST
06079817112010000,2019,27444,0,27444,COST
06079817112030000,2021,145797,359903,505700,MKT
06079817112030000,2020,108253,332747,441000,MKT
06079817112030000,2019,108253,332747,441000,MKT
06079817112050000,2021,129992,365308,495300,MKT
06079817112050000,2020,93951,325049,419000,MKT
06079817112050000,2019,93951,325049,419000,MKT
06079817112070000,2021,117343,356157,473500,MKT
06079817112070000,2020,82795,336505,419300,MKT
06079817112070000,2019,82795,336505,419300,MKT
06079817112090000,2021,110137,335763,445900,MKT
06079817112090000,2020,76563,325637,402200,MKT
06079817112090000,2019,76563,325637,402200,MKT
06079817112110000,2021,110137,304063,414200,MKT
06079817112110000,2020,76563,267437,344000,MKT
06079817112110000,2019,76563,267437,344000,MKT
06079817112130000,2021,111574,315226,426800,MKT
06079817112130000,2020,77798,290002,367800,MKT
06079817112130000,2019,77798,290002,367800,MKT
06079817112150000,2021,112378,300822,413200,MKT
06079817112150000,2020,78491,274309,352800,MKT
06079817112150000,2019,78491,274309,352800,MKT
06079817113010000,2021,105175,291825,397000,MKT
06079817113010000,2020,70686,267714,338400,MKT
06079817113010000,2019,70686,267714,338400,MKT
06079817113030000,2021,101929,284671,386600,MKT
06079817113030000,2020,68002,266498,334500,MKT
06079817113030000,2019,68002,266498,334500,MKT
06079817113050000,2021,103500,351100,454600,MKT
06079817113050000,2020,69299,348401,417700,MKT
06079817113050000,2019,69299,348401,417700,MKT
06079817113070000,2021,104420,324380,428800,MKT
06079817113070000,2020,70060,295040,365100,MKT
06079817113070000,2019,70060,295040,365100,MKT
06079817113090000,2021,104874,293226,398100,MKT
06079817113090000,2020,70437,268063,338500,MKT
06079817113090000,2019,70437,268063,338500,MKT
06079817113110000,2021,104874,296626,401500,MKT
06079817113110000,2020,70437,263463,333900,MKT
06079817113110000,2019,70437,263463,333900,MKT
06079817113130000,2021,104874,321026,425900,MKT
06079817113130000,2020,70437,280163,350600,MKT
06079817113130000,2019,70437,280163,350600,MKT
06079817113155001,2021,103738,230862,334600,MKT
06079817113155001,2020,76698,228102,304800,MKT
06079817113155001,2019,76698,228102,304800,MKT
06079817113175002,2021,103738,222162,325900,MKT
06079817113175002,2020,76698,224002,300700,MKT
06079817113175002,2019,76698,224002,300700,MKT
06079817113195001,2021,103738,230562,334300,MKT
06079817113195001,2020,76698,244302,321000,MKT
06079817113195001,2019,76698,240102,316800,MKT
06079817113215002,2021,103738,237062,340800,MKT
06079817113215002,2020,76698,244302,321000,MKT
06079817113215002,2019,76698,244302,321000,MKT
06079817113235001,2021,103738,228362,332100,MKT
06079817113235001,2020,76698,240102,316800,MKT
06079817113235001,2019,76698,240102,316800,MKT
06079817113255002,2021,103738,228362,332100,MKT
06079817113255002,2020,76698,240102,316800,MKT
06079817113255002,2019,76698,240102,316800,MKT
06079817113275001,2021,103738,225962,329700,MKT
06079817113275001,2020,76698,227502,304200,MKT
06079817113275001,2019,76698,227502,304200,MKT
06079817113295002,2021,103738,225962,329700,MKT
06079817113295002,2020,76698,227502,304200,MKT
06079817113295002,2019,76698,227502,304200,MKT
06079817113310000,2021,103738,0,103738,COST
06079817113310000,2020,71107,0,71107,COST
06079817113310000,2019,71107,0,71107,COST
06079817113330000,2021,115673,0,115673,COST
06079817113330000,2020,81342,0,81342,COST
06079817113330000,2019,81342,0,81342,COST
06079817114010000,2021,114339,342961,457300,MKT
06079817114010000,2020,80186,336214,416400,MKT
06079817114010000,2019,80186,336214,416400,MKT
06079817114030000,2021,114339,346961,461300,MKT
06079817114030000,2020,80186,336614,416800,MKT
06079817114030000,2019,80186,336614,416800,MKT
06079817114050000,2021,114339,317761,432100,MKT
06079817114050000,2020,80186,290214,370400,MKT
06079817114050000,2019,80186,290214,370400,MKT
06079817114070000,2021,114339,342261,456600,MKT
06079817114070000,2020,80186,320514,400700,MKT
06079817114070000,2019,80186,320514,400700,MKT
06079817114090000,2021,114339,340761,455100,MKT
06079817114090000,2020,80186,311814,392000,MKT
06079817114090000,2019,80186,311814,392000,MKT
06079817114110000,2021,120023,362277,482300,MKT
06079817114110000,2020,85137,327063,412200,MKT
06079817114110000,2019,85137,327063,412200,MKT
06079817115010000,2021,118430,378870,497300,MKT
06079817115010000,2020,83743,352157,435900,MKT
06079817115010000,2019,83743,352157,435900,MKT
06079817116010000,2021,120198,337602,457800,MKT
06079817116010000,2020,85289,322011,407300,MKT
06079817116010000,2019,85289,322011,407300,MKT
06079817116030000,2021,120023,359777,479800,MKT
06079817116030000,2020,85137,326463,411600,MKT
06079817116030000,2019,85137,326463,411600,MKT
06079817116050000,2021,120023,389977,510000,MKT
06079817116050000,2020,85137,366163,451300,MKT
06079817116050000,2019,85137,366163,451300,MKT
06079817116070000,2021,120198,368102,488300,MKT
06079817116070000,2020,85289,365411,450700,MKT
06079817116070000,2019,85289,365411,450700,MKT
06079817117010000,2021,124239,306061,430300,MKT
06079817117010000,2020,88844,277856,366700,MKT
06079817117010000,2019,88844,277856,366700,MKT
06079817117030000,2021,120545,371155,491700,MKT
06079817117030000,2020,85594,336206,421800,MKT
06079817117030000,2019,85594,336206,421800,MKT
06079817117050000,2021,124564,384636,509200,MKT
06079817117050000,2020,89131,369469,458600,MKT
06079817117050000,2019,89131,0,89131,COST
06079817117070000,2021,118430,313870,432300,MKT
06079817117070000,2020,83743,301357,385100,MKT
06079817117070000,2019,83743,301357,385100,MKT
06079817117090000,2021,117343,394957,512300,MKT
06079817117090000,2020,82795,0,82795,COST
06079817117090000,2019,82795,0,82795,COST
06079817118010000,2021,136271,312829,449100,MKT
06079817118010000,2020,90480,287020,377500,MKT
06079817118010000,2019,90480,287020,377500,MKT
06079817118030000,2021,120372,345028,465400,MKT
06079817118030000,2020,85442,322958,408400,MKT
06079817118030000,2019,85442,322958,408400,MKT
06079817118050000,2021,139109,290891,430000,MKT
06079817118050000,2020,92812,276288,369100,MKT
06079817118050000,2019,92812,276288,369100,MKT
06079817118070000,2021,138248,299152,437400,MKT
06079817118070000,2020,92104,280096,372200,MKT
06079817118070000,2019,92104,280096,372200,MKT
06079817118090000,2021,137377,309923,447300,MKT
06079817118090000,2020,91387,284513,375900,MKT
06079817118090000,2019,91387,274913,366300,MKT
06079817118110000,2021,136494,368706,505200,MKT
06079817118110000,2020,90663,338237,428900,MKT
06079817118110000,2019,90663,338237,428900,MKT
06079817118130000,2021,135599,333501,469100,MKT
06079817118130000,2020,89929,333171,423100,MKT
06079817118130000,2019,89929,333171,423100,MKT
06079817118150000,2021,136494,380006,516500,MKT
06079817118150000,2020,90663,349737,440400,MKT
06079817118150000,2019,90663,349737,440400,MKT
06079817118170000,2021,120372,346128,466500,MKT
06079817118170000,2020,85442,332058,417500,MKT
06079817118170000,2019,85442,334658,420100,MKT
06079817118190000,2021,138464,361736,500200,MKT
06079817118190000,2020,92282,331318,423600,MKT
06079817118190000,2019,92282,331318,423600,MKT
06079817118210000,2021,138895,367905,506800,MKT
06079817118210000,2020,92636,364264,456900,MKT
06079817118210000,2019,92636,364264,456900,MKT
06079817118230000,2021,136048,305552,441600,MKT
06079817118230000,2020,90297,279203,369500,MKT
06079817118230000,2019,90297,279203,369500,MKT
06079817118250000,2021,136494,367006,503500,MKT
06079817118250000,2020,90663,358637,449300,MKT
06079817118250000,2019,90663,358637,449300,MKT
06079817118270000,2021,139958,343242,483200,MKT
06079817118270000,2020,93513,318687,412200,MKT
06079817118270000,2019,93513,318687,412200,MKT
06079817118290000,2021,127204,0,127204,COST
06079817118290000,2020,83105,0,83105,COST
06079817118290000,2019,83105,0,83105,COST
06079817118310000,2021,127460,339340,466800,MKT
06079817118310000,2020,83311,316489,399800,MKT
06079817118310000,2019,83311,316489,399800,MKT
06079817118330000,2021,127714,327886,455600,MKT
06079817118330000,2020,83517,306583,390100,MKT
06079817118330000,2019,83517,306583,390100,MKT
06079817118350000,2021,128723,335977,464700,MKT
06079817118350000,2020,84332,331268,415600,MKT
06079817118350000,2019,84332,331268,415600,MKT
06079817118370000,2021,127460,304240,431700,MKT
06079817118370000,2020,83311,281489,364800,MKT
06079817118370000,2019,83311,278889,362200,MKT
06079817118390000,2021,129962,352938,482900,MKT
06079817118390000,2020,85335,324465,409800,MKT
06079817118390000,2019,85335,324465,409800,MKT
06079817118410000,2021,120545,315955,436500,MKT
06079817118410000,2020,85594,299006,384600,MKT
06079817118410000,2019,85594,299806,385400,MKT
06079817118430000,2021,141214,455386,596600,MKT
06079817118430000,2020,94550,390450,485000,OVR
06079817118430000,2019,94550,390450,485000,MKT
06079817118450000,2021,29813,0,29813,COST
06079817118450000,2020,20209,0,20209,COST
06079817118450000,2019,20209,0,20209,COST
06079817120010000,2021,105582,281918,387500,MKT
06079817120010000,2020,72672,246928,319600,MKT
06079817120010000,2019,72672,246928,319600,MKT
06079817120030000,2021,105582,306218,411800,MKT
06079817120030000,2020,72672,279428,352100,MKT
06079817120030000,2019,72672,279428,352100,MKT
06079817120050000,2021,105582,329018,434600,MKT
06079817120050000,2020,72672,306028,378700,MKT
06079817120050000,2019,72672,306028,378700,MKT
06079817120070000,2021,105582,349618,455200,MKT
06079817120070000,2020,72672,328128,400800,MKT
06079817120070000,2019,72672,324828,397500,MKT
06079817120090000,2021,105582,285418,391000,MKT
06079817120090000,2020,72672,250328,323000,MKT
06079817120090000,2019,72672,250328,323000,MKT
06079817120110000,2021,105582,306218,411800,MKT
06079817120110000,2020,72672,279428,352100,MKT
06079817120110000,2019,72672,279428,352100,MKT
06079817120130000,2021,105582,329018,434600,MKT
06079817120130000,2020,72672,306028,378700,MKT
06079817120130000,2019,72672,306028,378700,MKT
06079817120150000,2021,105582,346418,452000,MKT
06079817120150000,2020,72672,321228,393900,MKT
06079817120150000,2019,72672,324828,397500,MKT
06079817120170000,2021,105582,285418,391000,MKT
06079817120170000,2020,72672,250328,323000,MKT
06079817120170000,2019,72672,250328,323000,MKT
06079817120190000,2021,105582,331518,437100,MKT
06079817120190000,2020,72672,308228,380900,MKT
06079817120190000,2019,72672,308228,380900,MKT
06079817120200000,2021,105582,340918,446500,MKT
06079817120200000,2020,72672,324828,397500,MKT
06079817120200000,2019,72672,324828,397500,MKT
06079817120226500,2021,68678,0,68678,COST
06079817120226500,2020,56635,0,56635,COST
06079817120226500,2019,56635,0,56635,COST
06079817120240000,2021,108017,360083,468100,MKT
06079817120240000,2020,74746,338754,413500,MKT
06079817120240000,2019,74746,338754,413500,MKT
06079817120260000,2021,110345,338855,449200,MKT
06079817120260000,2020,76741,317159,393900,MKT
06079817120260000,2019,76741,317159,393900,MKT
06079817120280000,2021,110345,306055,416400,MKT
06079817120280000,2020,76741,278759,355500,MKT
06079817120280000,2019,76741,278759,355500,MKT
06079817120290000,2021,110345,289855,400200,MKT
06079817120290000,2020,76741,255659,332400,MKT
06079817120290000,2019,76741,255659,332400,MKT
06079817120315001,2021,97229,219171,316400,MKT
06079817120315001,2020,71317,222883,294200,MKT
06079817120315001,2019,71317,222883,294200,MKT
06079817120335002,2021,97229,219171,316400,MKT
06079817120335002,2020,71317,222883,294200,MKT
06079817120335002,2019,71317,222883,294200,MKT
06079817120355001,2021,97229,221471,318700,MKT
06079817120355001,2020,71317,221183,292500,MKT
06079817120355001,2019,71317,221183,292500,MKT
06079817120375002,2021,97229,221471,318700,MKT
06079817120375002,2020,71317,221183,292500,MKT
06079817120375002,2019,71317,221183,292500,MKT
06079817120395002,2021,97229,232571,329800,MKT
06079817120395002,2020,71317,237883,309200,MKT
06079817120395002,2019,71317,237883,309200,MKT
06079817120415001,2021,97229,232471,329700,MKT
06079817120415001,2020,71317,237783,309100,MKT
06079817120415001,2019,71317,237783,309100,MKT
06079817121010000,2021,106924,326376,433300,MKT
06079817121010000,2020,73814,304986,378800,MKT
06079817121010000,2019,73814,304986,378800,MKT
06079817121030000,2021,106924,273076,380000,MKT
06079817121030000,2020,73814,261886,335700,MKT
06079817121030000,2019,73814,265386,339200,MKT
06079817121050000,2021,106924,335376,442300,MKT
06079817121050000,2020,73814,313586,387400,MKT
06079817121050000,2019,73814,313586,387400,MKT
06079817121070000,2021,106924,312476,419400,MKT
06079817121070000,2020,73814,285186,359000,MKT
06079817121070000,2019,73814,285186,359000,MKT
06079817121090000,2021,106924,327176,434100,MKT
06079817121090000,2020,73814,304286,378100,MKT
06079817121090000,2019,73814,304286,378100,MKT
06079817121110000,2021,106924,291376,398300,MKT
06079817121110000,2020,73814,252686,326500,MKT
06079817121110000,2019,73814,252686,326500,MKT
06079817121130000,2021,106924,327176,434100,MKT
06079817121130000,2020,73814,304286,378100,MKT
06079817121130000,2019,73814,304286,378100,MKT
06079817121150000,2021,106924,304676,411600,MKT
06079817121150000,2020,73814,277886,351700,MKT
06079817121150000,2019,73814,277886,351700,MKT
06079817121170000,2021,106924,291376,398300,MKT
06079817121170000,2020,73814,252686,326500,MKT
06079817121170000,2019,73814,252686,326500,MKT
06079817121190000,2021,106924,328976,435900,MKT
06079817121190000,2020,73814,305986,379800,MKT
06079817121190000,2019,73814,305986,379800,MKT
06079817121210000,2021,107800,0,107800,COST
06079817121210000,2020,74561,0,74561,COST
06079817121210000,2019,74561,0,74561,COST
06079817121230000,2021,102067,328633,430700,MKT
06079817121230000,2020,69696,299404,369100,MKT
06079817121230000,2019,69696,299404,369100,MKT
06079817121250000,2021,100340,305060,405400,MKT
06079817121250000,2020,68242,285558,353800,MKT
06079817121250000,2019,68242,285558,353800,MKT
06079817121270000,2021,100340,338860,439200,MKT
06079817121270000,2020,68242,318658,386900,MKT
06079817121270000,2019,68242,318658,386900,MKT
06079817121290000,2021,100340,329160,429500,MKT
06079817121290000,2020,68242,299258,367500,MKT
06079817121290000,2019,68242,299258,367500,MKT
06079817121310000,2021,100340,283660,384000,MKT
06079817121310000,2020,68242,251858,320100,MKT
06079817121310000,2019,68242,251858,320100,MKT
06079817121335002,2021,88087,216113,304200,MKT
06079817121335002,2020,63834,213666,277500,MKT
06079817121335002,2019,63834,213666,277500,MKT
06079817121355001,2021,88087,216313,304400,MKT
06079817121355001,2020,63834,213866,277700,MKT
06079817121355001,2019,63834,213866,277700,MKT
06079817121375002,2021,89057,221143,310200,MKT
06079817121375002,2020,64624,221376,286000,MKT
06079817121375002,2019,64624,221376,286000,MKT
06079817121395001,2021,87428,221172,308600,MKT
06079817121395001,2020,63298,221502,284800,MKT
06079817121395001,2019,63298,221502,284800,MKT
06079817121415002,2021,88087,232413,320500,MKT
06079817121415002,2020,63834,238566,302400,MKT
06079817121415002,2019,63834,238566,302400,MKT
06079817121435001,2021,88087,232613,320700,MKT
06079817121435001,2020,63834,238666,302500,MKT
06079817121435001,2019,63834,238666,302500,MKT
06079817150017000,2021,401431,138740,540171,COST
06079817150017000,2020,255026,150510,405536,COST
06079817150017000,2019,255026,150510,405536,COST
06079817150107000,2021,418165,93030,511195,COST
06079817150107000,2020,261993,96450,358443,COST
06079817150107000,2019,261993,96450,358443,COST
06079817150150000,2021,224962,0,224962,COST
06079817150150000,2020,174031,0,174031,COST
06079817150150000,2019,174031,0,174031,COST
06079817150200000,2021,224962,0,224962,COST
06079817150200000,2020,174031,0,174031,COST
06079817150200000,2019,174031,0,174031,COST
06079817150250000,2021,222426,0,222426,COST
06079817150250000,2020,172734,0,172734,COST
06079817150250000,2019,172734,0,172734,COST
06079817150300000,2021,222426,0,222426,COST
06079817150300000,2020,172734,0,172734,COST
06079817150300000,2019,172734,0,172734,COST
06079817155010000,2021,177422,554678,732100,INCOME
06079817155010000,2020,148797,256203,405000,INCOME
06079817155010000,2019,148797,256203,405000,INCOME
06079817155040000,2021,239212,1805988,2045200,INCOME
06079817155040000,2020,181229,1272090,1453319,COST
06079817155040000,2019,181229,1272090,1453319,COST
06079817155070000,2021,195996,15560,211556,COST
06079817155070000,2020,158901,0,158901,COST
06079817155070000,2019,158901,0,158901,COST
06079817155120000,2021,530964,2111336,2642300,INCOME
06079817155120000,2020,506177,2044523,2550700,INCOME
06079817155120000,2019,506177,2044523,2550700,INCOME
06079817157016500,2021,15714,0,15714,COST
06079817157016500,2020,19955,0,19955,COST
06079817157016500,2019,19955,0,19955,COST
06079817201010000,2021,2813,0,2813,COST
06079817201010000,2020,2618,0,2618,COST
06079817201010000,2019,165127,157750,322877,COST
06079817201050000,2021,1871131,168180,2039311,COST
06079817201050000,2020,390909,150060,540969,COST
06079817201050000,2019,390909,0,390909,COST
06079817201101001,2021,93081,0,93081,COST
06079817201101001,2020,125780,0,125780,COST
06079817201101001,2019,125780,0,125780,COST
06079817201101002,2021,64287,0,64287,COST
06079817201101002,2020,87826,0,87826,COST
06079817201101002,2019,87826,0,87826,COST
06079817201200000,2021,14079,0,14079,COST
06079817201200000,2020,20393,0,20393,COST
06079817201200000,2019,1837,0,1837,COST
06079817202016500,2021,76583,0,76583,COST
06079817202016500,2020,67490,0,67490,COST
06079817202016500,2019,67490,0,67490,COST
06079817202050000,2021,551161,3413339,3964500,INCOME
06079817202050000,2020,518801,3417099,3935900,INCOME
06079817202050000,2019,518801,3417099,3935900,INCOME
06079817202100000,2021,705132,0,705132,COST
06079817202100000,2020,427037,0,427037,COST
06079817202100000,2019,85,0,85,COST
06079817202150000,2021,756767,0,756767,COST
06079817202150000,2020,447423,0,447423,COST
06079817202150000,2019,95,0,95,COST
06079817202200000,2021,754238,0,754238,COST
06079817202200000,2020,446435,0,446435,COST
06079817202200000,2019,95,0,95,COST
06079817202257000,2021,794103,0,794103,COST
06079817202257000,2020,461869,0,461869,COST
06079817202257000,2019,103,0,103,COST
06079817203010000,2021,311492,1732508,2044000,INCOME
06079817203010000,2020,356012,1472588,1828600,INCOME
06079817203010000,2019,356012,1472588,1828600,INCOME
06079817203047000,2021,256465,9200,265665,COST
06079817203047000,2020,189752,9910,199662,COST
06079817203047000,2019,189752,9910,199662,COST
06079817204010000,2021,803389,2637011,3440400,INCOME
06079817204010000,2020,223762,3042538,3266300,INCOME
06079817204010000,2019,223762,2549610,2773372,COST
06079817204050000,2021,832765,0,832765,COST
06079817204050000,2020,476587,0,476587,COST
06079817204050000,2019,476587,0,476587,COST
06079817204107000,2021,827994,10370,838364,COST
06079817204107000,2020,228261,2326800,2555061,COST
06079817204107000,2019,228261,620600,848861,COST
06079817204156500,2021,141380,0,141380,COST
06079817204156500,2020,47207,0,47207,COST
06079817204156500,2019,47207,0,47207,COST
06079817204206500,2021,213806,0,213806,COST
06079817204206500,2020,62021,0,62021,COST
06079817204206500,2019,62021,0,62021,COST
06079817205010000,2021,684620,518580,1203200,INCOME
06079817205010000,2020,201346,928154,1129500,INCOME
06079817205010000,2019,201346,928154,1129500,INCOME
06079817205056500,2021,24190,0,24190,COST
06079817205056500,2020,16263,0,16263,COST
06079817205056500,2019,16263,0,16263,COST
06079817206010000,2021,114532,397068,511600,MKT
06079817206010000,2020,83701,372399,456100,MKT
06079817206010000,2019,83701,372399,456100,MKT
06079817206030000,2021,114532,352068,466600,MKT
06079817206030000,2020,83701,321299,405000,OVR
06079817206030000,2019,83701,321299,405000,OVR
06079817206050000,2021,114532,324968,439500,MKT
06079817206050000,2020,83701,293399,377100,MKT
06079817206050000,2019,83701,293399,377100,MKT
06079817206070000,2021,114532,326568,441100,MKT
06079817206070000,2020,83701,295099,378800,MKT
06079817206070000,2019,83701,295099,378800,MKT
06079817206090000,2021,111119,391081,502200,MKT
06079817206090000,2020,95761,0,95761,COST
06079817206090000,2019,95761,0,95761,COST
06079817206110000,2021,149022,477978,627000,MKT
06079817206110000,2020,115852,456348,572200,MKT
06079817206110000,2019,115852,456348,572200,MKT
06079817206130000,2021,116235,420765,537000,MKT
06079817206130000,2020,85240,417020,502260,COST
06079817206130000,2019,85240,417020,502260,COST
06079817206150000,2021,111977,297323,409300,MKT
06079817206150000,2020,81401,268099,349500,MKT
06079817206150000,2019,81401,268099,349500,MKT
06079817207010000,2021,113758,393542,507300,MKT
06079817207010000,2020,83003,364497,447500,MKT
06079817207010000,2019,83003,364497,447500,MKT
06079817207030000,2021,112178,405122,517300,MKT
06079817207030000,2020,81582,384418,466000,MKT
06079817207030000,2019,81582,384418,466000,MKT
06079817207050000,2021,112178,362922,475100,MKT
06079817207050000,2020,81582,345718,427300,MKT
06079817207050000,2019,81582,345718,427300,MKT
06079817207070000,2021,112178,410722,522900,MKT
06079817207070000,2020,81582,379318,460900,MKT
06079817207070000,2019,81582,379318,460900,MKT
06079817207090000,2021,113758,470942,584700,MKT
06079817207090000,2020,83003,420597,503600,MKT
06079817207090000,2019,83003,420597,503600,MKT
06079817207110000,2021,112974,313226,426200,MKT
06079817207110000,2020,82297,308303,390600,MKT
06079817207110000,2019,82297,308303,390600,MKT
06079817207130000,2021,112178,350422,462600,MKT
06079817207130000,2020,81582,313218,394800,MKT
06079817207130000,2019,81582,313218,394800,MKT
06079817207150000,2021,112178,322022,434200,MKT
06079817207150000,2020,81582,292318,373900,MKT
06079817207150000,2019,81582,292318,373900,MKT
06079817207170000,2021,112178,409822,522000,MKT
06079817207170000,2020,81582,367318,448900,MKT
06079817207170000,2019,81582,367318,448900,MKT
06079817207190000,2021,112974,302326,415300,MKT
06079817207190000,2020,82297,261703,344000,MKT
06079817207190000,2019,82297,261703,344000,MKT
06079817208010000,2021,119673,465127,584800,MKT
06079817208010000,2020,88364,426736,515100,MKT
06079817208010000,2019,88364,426736,515100,MKT
06079817208030000,2021,112178,487022,599200,MKT
06079817208030000,2020,81582,434818,516400,MKT
06079817208030000,2019,81582,434818,516400,MKT
06079817208050000,2021,112178,400622,512800,MKT
06079817208050000,2020,81582,369818,451400,MKT
06079817208050000,2019,81582,369818,451400,MKT
06079817208070000,2021,112178,404622,516800,MKT
06079817208070000,2020,81582,374618,456200,MKT
06079817208070000,2019,81582,374618,456200,MKT
06079817208090000,2021,112178,423722,535900,MKT
06079817208090000,2020,81582,387418,469000,MKT
06079817208090000,2019,81582,387418,469000,MKT
06079817208110000,2021,112178,405122,517300,MKT
06079817208110000,2020,81582,367318,448900,MKT
06079817208110000,2019,81582,367318,448900,MKT
06079817208130000,2021,112577,343423,456000,MKT
06079817208130000,2020,81940,328360,410300,MKT
06079817208130000,2019,81940,328360,410300,MKT
06079817209010000,2021,116421,361179,477600,MKT
06079817209010000,2020,85409,339991,425400,MKT
06079817209010000,2019,85409,339991,425400,MKT
06079817209030000,2021,113758,370142,483900,MKT
06079817209030000,2020,83003,329397,412400,MKT
06079817209030000,2019,83003,332397,415400,MKT
06079817209050000,2021,113758,354242,468000,MKT
06079817209050000,2020,83003,321597,404600,MKT
06079817209050000,2019,83003,321597,404600,MKT
06079817209070000,2021,118430,320170,438600,MKT
06079817209070000,2020,87232,297068,384300,MKT
06079817209070000,2019,87232,297068,384300,MKT
06079817209090000,2021,141675,294025,435700,MKT
06079817209090000,2020,108841,284859,393700,MKT
06079817209090000,2019,108841,284859,393700,MKT
06079817210010000,2021,112974,329826,442800,MKT
06079817210010000,2020,82297,299303,381600,MKT
06079817210010000,2019,82297,299303,381600,MKT
06079817210030000,2021,113563,314937,428500,MKT
06079817210030000,2020,82827,281673,364500,MKT
06079817210030000,2019,82827,287473,370300,MKT
06079817210050000,2021,113563,344037,457600,MKT
06079817210050000,2020,82827,323873,406700,MKT
06079817210050000,2019,82827,323873,406700,MKT
06079817210070000,2021,114146,334854,449000,MKT
06079817210070000,2020,83353,326347,409700,MKT
06079817210070000,2019,83353,326347,409700,MKT
06079817210090000,2021,112974,438226,551200,MKT
06079817210090000,2020,82297,388803,471100,MKT
06079817210090000,2019,82297,388803,471100,MKT
06079817210110000,2021,113563,387137,500700,MKT
06079817210110000,2020,82827,357073,439900,MKT
06079817210110000,2019,82827,357073,439900,MKT
06079817210130000,2021,113563,468937,582500,MKT
06079817210130000,2020,82827,416373,499200,MKT
06079817210130000,2019,82827,416373,499200,MKT
06079817210150000,2021,113953,316647,430600,MKT
06079817210150000,2020,83178,314522,397700,MKT
06079817210150000,2019,83178,314522,397700,MKT
06079817211010000,2021,113367,366033,479400,MKT
06079817211010000,2020,82651,340349,423000,MKT
06079817211010000,2019,82651,340349,423000,MKT
06079817211030000,2021,113953,333447,447400,MKT
06079817211030000,2020,83178,300022,383200,MKT
06079817211030000,2019,83178,300022,383200,MKT
06079817211050000,2021,114532,415768,530300,MKT
06079817211050000,2020,83701,364099,447800,MKT
06079817211050000,2019,83701,364099,447800,MKT
06079817211070000,2021,114724,374776,489500,MKT
06079817211070000,2020,83874,347126,431000,MKT
06079817211070000,2019,83874,347126,431000,MKT
06079817211090000,2021,139003,324697,463700,MKT
06079817211090000,2020,106311,318089,424400,MKT
06079817211090000,2019,106311,318089,424400,MKT
06079817211110000,2021,121745,400555,522300,MKT
06079817211110000,2020,90258,285100,375358,COST
06079817211110000,2019,90258,0,90258,COST
06079817211130000,2021,120023,453477,573500,MKT
06079817211130000,2020,88684,418016,506700,MKT
06079817211130000,2019,88684,418016,506700,MKT
06079817212016500,2021,53492,0,53492,COST
06079817212016500,2020,43330,0,43330,COST
06079817212016500,2019,43330,0,43330,COST
06079817212030000,2021,114532,324868,439400,MKT
06079817212030000,2020,83701,293299,377000,MKT
06079817212030000,2019,83701,293299,377000,MKT
06079817212050000,2021,114532,314168,428700,MKT
06079817212050000,2020,83701,296099,379800,MKT
06079817212050000,2019,83701,296099,379800,MKT
06079817212070000,2021,114532,329668,444200,MKT
06079817212070000,2020,83701,293299,377000,MKT
06079817212070000,2019,83701,293299,377000,MKT
06079817212090000,2021,113563,339937,453500,MKT
06079817212090000,2020,82827,322173,405000,MKT
06079817212090000,2019,82827,322173,405000,MKT
06079817212110000,2021,104268,0,104268,COST
06079817212110000,2020,88524,0,88524,COST
06079817212110000,2019,88524,0,88524,COST
06079817212130000,2021,120372,316628,437000,MKT
06079817212130000,2020,89002,313198,402200,MKT
06079817212130000,2019,89002,313198,402200,MKT
06079817212150000,2021,120372,417728,538100,MKT
06079817212150000,2020,89002,381798,470800,MKT
06079817212150000,2019,89002,381798,470800,MKT
06079817212170000,2021,121234,429066,550300,MKT
06079817212170000,2020,89790,403710,493500,MKT
06079817212170000,2019,89790,403710,493500,MKT
06079817213010000,2021,117707,376093,493800,MKT
06079817213010000,2020,86575,336925,423500,MKT
06079817213010000,2019,86575,336925,423500,MKT
06079817213030000,2021,113953,352847,466800,MKT
06079817213030000,2020,83178,339122,422300,MKT
06079817213030000,2019,83178,339122,422300,MKT
06079817213050000,2021,114532,322768,437300,MKT
06079817213050000,2020,83701,288899,372600,MKT
06079817213050000,2019,83701,288899,372600,MKT
06079817213070000,2021,114339,317561,431900,MKT
06079817213070000,2020,83527,299373,382900,MKT
06079817213070000,2019,83527,299373,382900,MKT
06079817213090000,2021,134857,373543,508400,MKT
06079817213090000,2020,102410,360690,463100,MKT
06079817213090000,2019,102410,360690,463100,MKT
06079817213110000,2021,120372,367628,488000,MKT
06079817213110000,2020,89002,168060,257062,COST
06079817213110000,2019,89002,0,89002,COST
06079817213130000,2021,120372,354228,474600,MKT
06079817213130000,2020,89002,0,89002,COST
06079817213130000,2019,89002,0,89002,COST
06079817214010000,2021,112378,386822,499200,MKT
06079817214010000,2020,81761,366739,448500,MKT
06079817214010000,2019,81761,366739,448500,MKT
06079817214030000,2021,113171,315329,428500,MKT
06079817214030000,2020,82474,269626,352100,MKT
06079817214030000,2019,82474,262526,345000,MKT
06079817214050000,2021,113171,324929,438100,MKT
06079817214050000,2020,82474,290826,373300,MKT
06079817214050000,2019,82474,290826,373300,MKT
06079817214070000,2021,113758,303142,416900,MKT
06079817214070000,2020,83003,261697,344700,MKT
06079817214070000,2019,83003,261697,344700,MKT
06079817214090000,2021,112577,386223,498800,MKT
06079817214090000,2020,81940,362460,444400,MKT
06079817214090000,2019,81940,362460,444400,MKT
06079817214110000,2021,113171,332429,445600,MKT
06079817214110000,2020,82474,296626,379100,MKT
06079817214110000,2019,82474,296626,379100,MKT
06079817214130000,2021,113171,418629,531800,MKT
06079817214130000,2020,82474,375626,458100,MKT
06079817214130000,2019,82474,375626,458100,MKT
06079817214150000,2021,113563,312237,425800,MKT
06079817214150000,2020,82827,307573,390400,MKT
06079817214150000,2019,82827,307573,390400,MKT
06079817215010000,2021,113367,369933,483300,MKT
06079817215010000,2020,82651,317449,400100,MKT
06079817215010000,2019,82651,317449,400100,MKT
06079817215030000,2021,112974,343226,456200,MKT
06079817215030000,2020,82297,314703,397000,MKT
06079817215030000,2019,82297,314703,397000,MKT
06079817215050000,2021,112974,336126,449100,MKT
06079817215050000,2020,82297,316003,398300,MKT
06079817215050000,2019,82297,316003,398300,MKT
06079817215070000,2021,112974,357726,470700,MKT
06079817215070000,2020,82297,319403,401700,MKT
06079817215070000,2019,82297,315103,397400,MKT
06079817215090000,2021,113367,390733,504100,MKT
06079817215090000,2020,82651,367349,450000,MKT
06079817215090000,2019,82651,367349,450000,MKT
06079817215110000,2021,112776,320924,433700,MKT
06079817215110000,2020,82119,285181,367300,MKT
06079817215110000,2019,82119,285181,367300,MKT
06079817215130000,2021,112974,295826,408800,MKT
06079817215130000,2020,82297,264903,347200,MKT
06079817215130000,2019,82297,264903,347200,MKT
06079817215150000,2021,112974,292326,405300,MKT
06079817215150000,2020,82297,263003,345300,MKT
06079817215150000,2019,82297,263003,345300,MKT
06079817215170000,2021,112974,388826,501800,MKT
06079817215170000,2020,82297,358103,440400,MKT
06079817215170000,2019,82297,358103,440400,MKT
06079817215190000,2021,112577,404423,517000,MKT
06079817215190000,2020,81940,367760,449700,MKT
06079817215190000,2019,81940,367760,449700,MKT
06079817216010000,2021,126792,332008,458800,MKT
06079817216010000,2020,94900,318400,413300,MKT
06079817216010000,2019,94900,318400,413300,MKT
06079817216030000,2021,112178,320922,433100,MKT
06079817216030000,2020,81582,288418,370000,MKT
06079817216030000,2019,81582,288418,370000,MKT
06079817216050000,2021,112178,382222,494400,MKT
06079817216050000,2020,81582,391518,473100,MKT
06079817216050000,2019,81582,391518,473100,MKT
06079817216070000,2021,112178,326022,438200,MKT
06079817216070000,2020,81582,295618,377200,OVR
06079817216070000,2019,81582,295618,377200,MKT
06079817216090000,2021,112178,337022,449200,MKT
06079817216090000,2020,81582,306418,388000,MKT
06079817216090000,2019,81582,294318,375900,MKT
06079817216110000,2021,112178,301922,414100,MKT
06079817216110000,2020,81582,253718,335300,MKT
06079817216110000,2019,81582,253718,335300,MKT
06079817216130000,2021,112577,403523,516100,MKT
06079817216130000,2020,81940,343860,425800,MKT
06079817216130000,2019,81940,0,81940,COST
06079817216150000,2021,115105,312795,427900,MKT
06079817216150000,2020,84218,299882,384100,MKT
06079817216150000,2019,84218,299882,384100,MKT
06079817216170000,2021,111167,341533,452700,MKT
06079817216170000,2020,80675,324525,405200,MKT
06079817216170000,2019,80675,324525,405200,MKT
06079817216190000,2021,111167,351933,463100,MKT
06079817216190000,2020,80675,336225,416900,MKT
06079817216190000,2019,80675,336225,416900,MKT
06079817216210000,2021,111167,371333,482500,MKT
06079817216210000,2020,80675,339825,420500,MKT
06079817216210000,2019,80675,339825,420500,MKT
06079817216230000,2021,109087,308913,418000,MKT
06079817216230000,2020,78815,274185,353000,MKT
06079817216230000,2019,78815,274185,353000,MKT
06079817216250000,2021,115105,341995,457100,MKT
06079817216250000,2020,84218,314282,398500,MKT
06079817216250000,2019,84218,314282,398500,MKT
06079817216270000,2021,116976,322124,439100,MKT
06079817216270000,2020,85912,280488,366400,MKT
06079817216270000,2019,85912,280488,366400,MKT
06079817216290000,2021,111167,355933,467100,MKT
06079817216290000,2020,80675,332325,413000,MKT
06079817216290000,2019,80675,332325,413000,MKT
06079817216310000,2021,111167,0,111167,COST
06079817216310000,2020,80675,0,80675,COST
06079817216310000,2019,80675,0,80675,COST
06079817217010000,2021,113563,414937,528500,MKT
06079817217010000,2020,82827,380473,463300,MKT
06079817217010000,2019,82827,380473,463300,MKT
06079817217030000,2021,117525,385975,503500,MKT
06079817217030000,2020,86410,359190,445600,MKT
06079817217030000,2019,86410,359190,445600,MKT
06079817217050000,2021,117525,328275,445800,MKT
06079817217050000,2020,86410,296190,382600,MKT
06079817217050000,2019,86410,296190,382600,MKT
06079817217070000,2021,118609,417091,535700,MKT
06079817217070000,2020,87395,386805,474200,MKT
06079817217070000,2019,87395,386805,474200,MKT
06079817217090000,2021,129544,347156,476700,MKT
06079817217090000,2020,97450,337750,435200,MKT
06079817217090000,2019,97450,337750,435200,MKT
06079817217116500,2021,38150,0,38150,COST
06079817217116500,2020,28545,0,28545,COST
06079817217116500,2019,28545,0,28545,COST
06079817217136500,2021,50475,0,50475,COST
06079817217136500,2020,40333,0,40333,COST
06079817217136500,2019,40333,0,40333,COST
06079817217150000,2021,116976,410124,527100,MKT
06079817217150000,2020,85912,377988,463900,MKT
06079817217150000,2019,85912,377988,463900,MKT
06079817217170000,2021,116976,387124,504100,MKT
06079817217170000,2020,85912,344988,430900,MKT
06079817217170000,2019,85912,344988,430900,MKT
06079817217190000,2021,115105,345795,460900,MKT
06079817217190000,2020,84218,333282,417500,MKT
06079817217190000,2019,84218,333282,417500,MKT
06079817217210000,2021,138482,301618,440100,MKT
06079817217210000,2020,105820,259580,365400,MKT
06079817217210000,2019,105820,259580,365400,MKT
06079817217230000,2021,120545,320855,441400,MKT
06079817217230000,2020,89160,268740,357900,MKT
06079817217230000,2019,89160,268740,357900,MKT
06079817217250000,2021,120545,330455,451000,MKT
06079817217250000,2020,89160,306040,395200,MKT
06079817217250000,2019,89160,306040,395200,MKT
06079817218010000,2021,113171,411029,524200,MKT
06079817218010000,2020,82474,388126,470600,MKT
06079817218010000,2019,82474,388126,470600,MKT
06079817218030000,2021,111167,327433,438600,MKT
06079817218030000,2020,80675,319125,399800,MKT
06079817218030000,2019,80675,319125,399800,MKT
06079817218050000,2021,111167,347733,458900,MKT
06079817218050000,2020,80675,335125,415800,MKT
06079817218050000,2019,80675,335125,415800,MKT
06079817218070000,2021,115105,299795,414900,MKT
06079817218070000,2020,84218,265082,349300,MKT
06079817218070000,2019,84218,265082,349300,MKT
06079817218090000,2021,113171,310429,423600,MKT
06079817218090000,2020,82474,264826,347300,MKT
06079817218090000,2019,82474,264826,347300,MKT
06079817218110000,2021,111167,365333,476500,MKT
06079817218110000,2020,80675,324625,405300,MKT
06079817218110000,2019,80675,324625,405300,MKT
06079817218130000,2021,111167,299333,410500,MKT
06079817218130000,2020,80675,265725,346400,MKT
06079817218130000,2019,80675,265725,346400,MKT
06079817218150000,2021,115105,329595,444700,MKT
06079817218150000,2020,84218,306182,390400,MKT
06079817218150000,2019,84218,306182,390400,MKT
06079817219010000,2021,120545,403855,524400,MKT
06079817219010000,2020,89160,384040,473200,MKT
06079817219010000,2019,89160,384040,473200,MKT
06079817219030000,2021,115105,334795,449900,MKT
06079817219030000,2020,84218,320382,404600,MKT
06079817219030000,2019,84218,320382,404600,MKT
06079817219050000,2021,115105,371395,486500,MKT
06079817219050000,2020,84218,347082,431300,MKT
06079817219050000,2019,84218,347882,432100,MKT
06079817219070000,2021,120545,381855,502400,MKT
06079817219070000,2020,89160,375940,465100,MKT
06079817219070000,2019,89160,375940,465100,MKT
06079817219090000,2021,120545,391955,512500,MKT
06079817219090000,2020,89160,359940,449100,MKT
06079817219090000,2019,89160,359940,449100,MKT
06079817219110000,2021,115105,384495,499600,MKT
06079817219110000,2020,84218,350382,434600,MKT
06079817219110000,2019,84218,350382,434600,MKT
06079817219130000,2021,115105,324395,439500,MKT
06079817219130000,2020,84218,296282,380500,MKT
06079817219130000,2019,84218,296282,380500,MKT
06079817219150000,2021,118788,333512,452300,MKT
06079817219150000,2020,87558,304942,392500,MKT
06079817219150000,2019,87558,304942,392500,MKT
06079817220010000,2021,116976,336724,453700,MKT
06079817220010000,2020,85912,322988,408900,MKT
06079817220010000,2019,85912,322988,408900,MKT
06079817220030000,2021,111167,323933,435100,MKT
06079817220030000,2020,80675,315125,395800,MKT
06079817220030000,2019,80675,315125,395800,MKT
06079817220050000,2021,111167,358733,469900,MKT
06079817220050000,2020,80675,317325,398000,MKT
06079817220050000,2019,80675,317325,398000,MKT
06079817220070000,2021,111167,321733,432900,MKT
06079817220070000,2020,80675,296725,377400,MKT
06079817220070000,2019,80675,296725,377400,MKT
06079817220090000,2021,111167,337133,448300,MKT
06079817220090000,2020,80675,322025,402700,MKT
06079817220090000,2019,80675,322025,402700,MKT
06079817220110000,2021,111167,326333,437500,MKT
06079817220110000,2020,80675,296425,377100,MKT
06079817220110000,2019,80675,296425,377100,MKT
06079817220130000,2021,113171,301629,414800,MKT
06079817220130000,2020,82474,267626,350100,MKT
06079817220130000,2019,82474,267626,350100,MKT
06079817220150000,2021,120545,326210,446755,COST
06079817220150000,2020,89160,0,89160,COST
06079817220170000,2021,115105,340595,455700,MKT
06079817220170000,2020,84218,0,84218,COST
06079817220190000,2021,115105,331995,447100,MKT
06079817220190000,2020,84218,0,84218,COST
06079817220210000,2021,115105,331695,446800,MKT
06079817220210000,2020,84218,0,84218,COST
06079817220230000,2021,115105,0,115105,COST
06079817220230000,2020,84218,0,84218,COST
06079817220250000,2021,115105,194870,309975,COST
06079817220250000,2020,84218,0,84218,COST
06079817220270000,2021,125528,365572,491100,MKT
06079817220270000,2020,93734,0,93734,COST
06079817221010000,2021,123912,324288,448200,MKT
06079817221010000,2020,92246,291654,383900,MKT
06079817221010000,2019,92246,291654,383900,MKT
06079817221030000,2021,123912,380288,504200,MKT
06079817221030000,2020,92246,349954,442200,MKT
06079817221030000,2019,92246,349954,442200,MKT
06079817221050000,2021,113171,325329,438500,MKT
06079817221050000,2020,82474,292826,375300,MKT
06079817221050000,2019,82474,292826,375300,MKT
06079817221070000,2021,113171,332929,446100,MKT
06079817221070000,2020,82474,303226,385700,MKT
06079817221070000,2019,82474,303226,385700,MKT
06079817221090000,2021,118788,333812,452600,MKT
06079817221090000,2020,87558,311242,398800,MKT
06079817221090000,2019,87558,311242,398800,MKT
06079817221110000,2021,115105,381195,496300,MKT
06079817221110000,2020,84218,0,84218,COST
06079817221130000,2021,116976,376370,493346,COST
06079817221130000,2020,85912,0,85912,COST
06079817221150000,2021,116976,0,116976,COST
06079817221150000,2020,85912,0,85912,COST
06079817221170000,2021,113171,0,113171,COST
06079817221170000,2020,82474,0,82474,COST
06079817221190000,2021,120545,0,120545,COST
06079817221190000,2020,89160,0,89160,COST
06079817221210000,2021,113171,201390,314561,COST
06079817221210000,2020,82474,0,82474,COST
06079817221230000,2021,128640,0,128640,COST
06079817221230000,2020,96611,0,96611,COST
06079817221250000,2021,115105,481895,597000,MKT
06079817221250000,2020,84218,0,84218,COST
06079817221270000,2021,116976,0,116976,COST
06079817221270000,2020,85912,0,85912,COST
06079817221290000,2021,122252,352848,475100,MKT
06079817221290000,2020,90722,0,90722,COST
06079817221310000,2021,133039,390761,523800,MKT
06079817221310000,2020,100707,0,100707,COST
06079817221330000,2021,125528,350572,476100,MKT
06079817221330000,2020,93734,0,93734,COST
06079817221356500,2021,46170,0,46170,COST
06079817221356500,2020,36128,0,36128,COST
06079817301010000,2021,389417,0,389417,COST
06079817301010000,2020,379356,0,379356,COST
06079817301106500,2021,73933,0,73933,COST
06079817301106500,2020,64617,0,64617,COST
06079817301200000,2021,28949,0,28949,COST
06079817301200000,2020,30518,0,30518,COST
06079817301200000,2019,30518,0,30518,COST
06079817302010000,2021,127103,345697,472800,MKT
06079817302010000,2020,95188,0,95188,COST
06079817302030000,2021,130140,392260,522400,MKT
06079817302030000,2020,98004,0,98004,COST
06079817401050000,2021,470477,325960,796437,COST
06079817401050000,2020,479134,305140,784274,COST
06079817401050000,2019,479134,305140,784274,COST
06079817401180000,2021,2352,0,2352,COST
06079817401180000,2020,2183,0,2183,COST
06079817401180000,2019,2183,0,2183,COST
06079817401190000,2021,2352,0,2352,COST
06079817401190000,2020,2183,0,2183,COST
06079817401190000,2019,2183,0,2183,COST
06079817401200000,2021,11743,0,11743,COST
06079817401200000,2020,14891,0,14891,COST
06079817401200000,2019,14891,0,14891,COST
06079817402050000,2021,374883,388450,763333,COST
06079817402050000,2020,361948,364950,726898,COST
06079817402050000,2019,361948,364950,726898,COST
06079817402100000,2021,357392,217880,575272,COST
06079817402100000,2020,341210,202230,543440,COST
06079817402100000,2019,341210,202230,543440,COST
06079817402150000,2021,332079,272260,604339,COST
06079817402150000,2020,311621,256040,567661,COST
06079817402150000,2019,311621,256040,567661,COST
06079817402200000,2021,6972,400130,407102,COST
06079817402200000,2020,7995,356790,364785,COST
06079817402200000,2019,490265,297900,788165,COST
06079817402250000,2021,1127,0,1127,COST
06079817402250000,2020,1049,0,1049,COST
06079817402250000,2019,1049,0,1049,COST
06079817403010000,2021,1661,0,1661,COST
06079817403010000,2020,1546,0,1546,COST
06079817403010000,2019,1546,0,1546,COST
06079817404010000,2021,196953,324620,521573,COST
06079817404010000,2020,163380,230780,394160,COST
06079817404010000,2019,163380,230780,394160,COST
06079818101150000,2021,253815,108810,362625,COST
06079818101150000,2020,218135,100070,318205,COST
06079818101150000,2019,218135,96320,314455,COST
06079818102030000,2021,219617,612183,831800,INCOME
06079818102030000,2020,171291,578909,750200,INCOME
06079818102030000,2019,171291,578909,750200,INCOME
06079818102040000,2021,454971,1550390,2005361,COST
06079818102040000,2020,457127,1460400,1917527,COST
06079818102040000,2019,457127,1460400,1917527,COST
06079818102040900,2021,219617,253083,472700,INCOME
06079818102040900,2020,171291,246609,417900,INCOME
06079818102040900,2019,171291,246609,417900,INCOME
06079818102050000,2021,225719,942881,1168600,INCOME
06079818102050000,2020,174417,856683,1031100,INCOME
06079818102050000,2019,174417,856683,1031100,INCOME
06079818102060000,2021,223570,148330,371900,INCOME
06079818102060000,2020,173320,163280,336600,INCOME
06079818102060000,2019,173320,163280,336600,INCOME
06079818102087000,2021,219617,24660,244277,COST
06079818102087000,2020,171291,23870,195161,COST
06079818102087000,2019,171291,23870,195161,COST
06079818102090000,2021,219617,495783,715400,INCOME
06079818102090000,2020,171291,455709,627000,INCOME
06079818102090000,2019,171291,455709,627000,INCOME
06079818102090900,2021,614712,1775388,2390100,INCOME
06079818102090900,2020,557537,1568863,2126400,INCOME
06079818102090900,2019,557537,1568863,2126400,INCOME
06079818102107000,2021,311856,27140,338996,COST
06079818102107000,2020,356286,27120,383406,COST
06079818102107000,2019,356286,27120,383406,COST
06079818103020000,2021,311856,259144,571000,INCOME
06079818103020000,2020,356286,192714,549000,INCOME
06079818103020000,2019,356286,192714,549000,INCOME
06079818103020900,2021,314942,0,314942,COST
06079818103020900,2020,358609,0,358609,COST
06079818103020900,2019,358609,0,358609,COST
06079818103030000,2021,219617,388283,607900,INCOME
06079818103030000,2020,171291,413209,584500,INCOME
06079818103030000,2019,171291,413209,584500,INCOME
06079818103030900,2021,314942,388758,703700,INCOME
06079818103030900,2020,358609,268491,627100,INCOME
06079818103030900,2019,358609,268491,627100,INCOME
06079818103040000,2021,219617,488283,707900,INCOME
06079818103040000,2020,171291,509409,680700,INCOME
06079818103040000,2019,171291,509409,680700,INCOME
06079818103040900,2021,216655,165345,382000,INCOME
06079818103040900,2020,169764,183036,352800,INCOME
06079818103040900,2019,169764,183036,352800,INCOME
06079818103050900,2021,216655,391245,607900,INCOME
06079818103050900,2020,169764,414736,584500,INCOME
06079818103050900,2019,169764,414736,584500,INCOME
06079818103057000,2021,219617,14750,234367,COST
06079818103057000,2020,171291,15360,186651,COST
06079818103057000,2019,171291,15360,186651,COST
06079818103060000,2021,216655,391245,607900,INCOME
06079818103060000,2020,169764,414736,584500,INCOME
06079818103060000,2019,169764,414736,584500,INCOME
06079818103060900,2021,220769,229431,450200,INCOME
06079818103060900,2020,171884,261016,432900,INCOME
06079818103060900,2019,171884,261016,432900,INCOME
06079818103070000,2021,216655,412045,628700,INCOME
06079818103070000,2020,169764,434736,604500,INCOME
06079818103070000,2019,169764,434736,604500,INCOME
06079818103090000,2021,332442,1427058,1759500,INCOME
06079818103090000,2020,225188,1353812,1579000,INCOME
06079818103090000,2019,225188,1353812,1579000,INCOME
06079818104040000,2021,212362,494238,706600,INCOME
06079818104040000,2020,167536,459364,626900,INCOME
06079818104040000,2019,167536,459364,626900,INCOME
06079818104060000,2021,417218,1050970,1468188,COST
06079818104060000,2020,261601,978140,1239741,COST
06079818104060000,2019,261601,978140,1239741,COST
06079818104080000,2021,212493,616307,828800,INCOME
06079818104080000,2020,167605,430095,597700,INCOME
06079818104080000,2019,167605,430095,597700,INCOME
06079818104100000,2021,325954,1215940,1541894,COST
06079818104100000,2020,222278,1142880,1365158,COST
06079818104100000,2019,222278,1142880,1365158,COST
06079818105010900,2021,258,0,258,COST
06079818105010900,2020,240,0,240,COST
06079818105010900,2019,240,0,240,COST
06079818105030000,2021,401340,899130,1300470,COST
06079818105030000,2020,346866,499200,846066,COST
06079818105030000,2019,346866,499200,846066,COST
06079818105057000,2021,326456,26820,353276,COST
06079818105057000,2020,222504,27920,250424,COST
06079818105057000,2019,222504,27920,250424,COST
06079818105100000,2021,452252,675650,1127902,COST
06079818105100000,2020,417194,603320,1020514,COST
06079818105100000,2019,417194,603320,1020514,COST
06079818105200000,2021,483415,351485,834900,INCOME
06079818105200000,2020,288298,449902,738200,INCOME
06079818105200000,2019,288298,449902,738200,INCOME
06079818105240000,2021,2570,315620,318190,COST
06079818105240000,2020,326598,294160,620758,COST
06079818105240000,2019,326598,294160,620758,COST
06079818105350000,2021,467206,782790,1249996,COST
06079818105350000,2020,420967,728500,1149467,COST
06079818105350000,2019,420967,728500,1149467,COST
06079818105400000,2021,287251,262840,550091,COST
06079818105400000,2020,250644,234270,484914,COST
06079818105400000,2019,250644,234270,484914,COST
06079818105410000,2021,260417,286800,547217,COST
06079818105410000,2020,224514,263040,487554,COST
06079818105410000,2019,224514,263040,487554,COST
06079818105420000,2021,260417,517483,777900,MKT
06079818105420000,2020,224514,476630,701144,COST
06079818105420000,2019,224514,476630,701144,COST
06079818105430000,2021,330975,172120,503095,COST
06079818105430000,2020,283415,114950,398365,COST
06079818105430000,2019,283415,115130,398545,COST
06079818105430100,2021,57017,0,57017,COST
06079818105430100,2020,47238,0,47238,COST
06079818105430100,2019,47238,0,47238,COST
06079818105440000,2021,260417,517783,778200,MKT
06079818105440000,2020,224514,452386,676900,MKT
06079818105440000,2019,224514,25180,249694,COST
06079818105450000,2021,338867,20710,359577,COST
06079818105450000,2020,301733,21240,322973,COST
06079818105450000,2019,301733,21240,322973,COST
06079818105460000,2021,343453,677380,1020833,COST
06079818105460000,2020,294624,346900,641524,COST
06079818105460000,2019,294624,346990,641614,COST
06079818105470000,2021,195965,70460,266425,COST
06079818105470000,2020,163160,64790,227950,COST
06079818105470000,2019,163160,64790,227950,COST
06079818105500000,2021,195355,167145,362500,MKT
06079818105500000,2020,163100,109520,272620,COST
06079818105500000,2019,163100,109520,272620,COST
06079818105550000,2021,279124,287076,566200,MKT
06079818105550000,2020,242697,222740,465437,COST
06079818105550000,2019,242697,222740,465437,COST
06079818105650000,2021,52040,0,52040,COST
06079818105650000,2020,42635,0,42635,COST
06079818105650000,2019,42635,0,42635,COST
06079818105700000,2021,427987,439240,867227,COST
06079818105700000,2020,392150,402020,794170,COST
06079818105700000,2019,392150,402020,794170,COST
06079818106010000,2021,266820,482080,748900,INCOME
06079818106010000,2020,194773,452327,647100,INCOME
06079818106010000,2019,194773,452327,647100,INCOME
06079818106030000,2021,247038,500120,747158,COST
06079818106030000,2020,185120,362480,547600,INCOME
06079818106030000,2019,185120,362480,547600,INCOME
06079818106050000,2021,247038,232962,480000,INCOME
06079818106050000,2020,185120,239780,424900,INCOME
06079818106050000,2019,185120,239780,424900,INCOME
06079818106070000,2021,234932,245068,480000,INCOME
06079818106070000,2020,179083,245817,424900,INCOME
06079818106070000,2019,179083,245817,424900,INCOME
06079818106090000,2021,234932,0,234932,COST
06079818106090000,2020,179083,0,179083,COST
06079818106090000,2019,179083,0,179083,COST
