id,year,land,building,total,method
06079809427010000,2021,213713,0,213713,COST
06079809428010000,2021,229229,0,229229,COST
06079809428040000,2021,228707,0,228707,COST
06079809428070000,2021,229308,0,229308,COST
06079809428100000,2021,228693,0,228693,COST
06079809429016500,2021,59977,0,59977,COST
06079809430020000,2021,1115625,1800575,2916200,INCOME
06079809430020000,2020,970690,1338210,2308900,INCOME
06079809430020000,2019,970690,1338210,2308900,INCOME
06079809440020000,2021,761687,788413,1550100,INCOME
06079809440020000,2020,725375,595325,1320700,INCOME
06079809440020000,2019,725375,595325,1320700,INCOME
06079809440040000,2021,785976,114324,900300,INCOME
06079809440040000,2020,735195,100970,836165,COST
06079809440040000,2019,735195,100970,836165,COST
06079809466010000,2021,776,0,776,COST
06079809466010000,2020,722,0,722,COST
06079809466010000,2019,817556,0,817556,COST
06079809466050000,2021,67131,0,67131,COST
06079809466050000,2020,233709,0,233709,COST
06079809466050000,2019,233709,0,233709,COST
06079810109015001,2021,100023,194677,294700,MKT
06079810109015001,2020,54660,203640,258300,MKT
06079810109015001,2019,54660,203640,258300,MKT
06079810109035002,2021,99954,198646,298600,MKT
06079810109035002,2020,48474,205526,254000,MKT
06079810109035002,2019,48474,205526,254000,MKT
06079810109055003,2021,99904,198596,298500,MKT
06079810109055003,2020,48427,205473,253900,MKT
06079810109055003,2019,48427,205473,253900,MKT
06079810109075004,2021,105005,194595,299600,MKT
06079810109075004,2020,53371,203729,257100,MKT
06079810109075004,2019,53371,203729,257100,MKT
06079810109095001,2021,112797,194403,307200,MKT
06079810109095001,2020,61373,200927,262300,MKT
06079810109095001,2019,61373,200927,262300,MKT
06079810109115002,2021,100681,191419,292100,MKT
06079810109115002,2020,49165,200235,249400,OVR
06079810109115002,2019,49165,200235,249400,MKT
06079810109135003,2021,105831,194369,300200,MKT
06079810109135003,2020,54193,202907,257100,MKT
06079810109135003,2019,54193,203607,257800,MKT
06079810109155001,2021,118171,194229,312400,MKT
06079810109155001,2020,67210,200990,268200,MKT
06079810109155001,2019,67210,200990,268200,MKT
06079810109175002,2021,99529,198571,298100,MKT
06079810109175002,2020,48073,205527,253600,MKT
06079810109175002,2019,48073,205527,253600,MKT
06079810109195003,2021,109479,194421,303900,MKT
06079810109195003,2020,57898,201402,259300,MKT
06079810109195003,2019,57898,201402,259300,MKT
06079810109215001,2021,117255,190245,307500,MKT
06079810109215001,2020,66197,196403,262600,MKT
06079810109215001,2019,66197,196403,262600,MKT
06079810109235002,2021,95444,195756,291200,MKT
06079810109235002,2020,44297,202203,246500,MKT
06079810109235002,2019,44297,202203,246500,MKT
06079810109255003,2021,112136,190364,302500,MKT
06079810109255003,2020,60673,196427,257100,MKT
06079810109255003,2019,60673,196427,257100,MKT
06079810109276500,2021,35323,0,35323,COST
06079810109276500,2020,20021,0,20021,COST
06079810109276500,2019,20021,0,20021,COST
06079810109295001,2021,111172,194328,305500,MKT
06079810109295001,2020,59659,200841,260500,MKT
06079810109295001,2019,59659,200841,260500,MKT
06079810109315002,2021,97052,195148,292200,MKT
06079810109315002,2020,45765,202035,247800,MKT
06079810109315002,2019,45765,202035,247800,MKT
06079810109335003,2021,119996,194204,314200,MKT
06079810109335003,2020,69250,200950,270200,MKT
06079810109335003,2019,69250,200950,270200,MKT
06079810109355001,2021,109339,194661,304000,MKT
06079810109355001,2020,65037,200863,265900,MKT
06079810109355001,2019,65037,200863,265900,MKT
06079810109375002,2021,97814,194886,292700,MKT
06079810109375002,2020,52329,203571,255900,MKT
06079810109375002,2019,52329,203571,255900,MKT
06079810109395001,2021,97843,194957,292800,MKT
06079810109395001,2020,52359,203641,256000,MKT
06079810109395001,2019,52359,203641,256000,MKT
06079810109415002,2021,97866,194934,292800,MKT
06079810109415002,2020,52384,203616,256000,MKT
06079810109415002,2019,52384,203616,256000,MKT
06079810109435001,2021,97040,194760,291800,MKT
06079810109435001,2020,51524,203576,255100,MKT
06079810109435001,2019,51524,203576,255100,MKT
06079810109455002,2021,96745,198655,295400,MKT
06079810109455002,2020,45483,205517,251000,MKT
06079810109455002,2019,45483,205517,251000,MKT
06079810109475003,2021,106199,194501,300700,MKT
06079810109475003,2020,54561,203639,258200,MKT
06079810109475003,2019,54561,203639,258200,MKT
06079810109495001,2021,120304,197796,318100,MKT
06079810109495001,2020,69598,197402,267000,OVR
06079810109495001,2019,69598,197402,267000,MKT
06079810109515002,2021,98767,198633,297400,MKT
06079810109515002,2020,47357,205443,252800,MKT
06079810109515002,2019,47357,205443,252800,MKT
06079810109535003,2021,103564,191136,294700,MKT
06079810109535003,2020,51950,200250,252200,MKT
06079810109535003,2019,51950,200250,252200,MKT
06079810109555001,2021,123587,191713,315300,MKT
06079810109555001,2020,73354,197746,271100,MKT
06079810109555001,2019,73354,197746,271100,MKT
06079810109575002,2021,97508,196292,293800,MKT
06079810109575002,2020,46186,200614,246800,MKT
06079810109575002,2019,46186,200614,246800,MKT
06079810109595003,2021,96767,196233,293000,MKT
06079810109595003,2020,45504,200596,246100,MKT
06079810109595003,2019,45504,200596,246100,MKT
06079810109615004,2021,113681,195419,309100,MKT
06079810109615004,2020,62316,201884,264200,MKT
06079810109615004,2019,62316,201884,264200,MKT
06079810109635001,2021,112180,184420,296600,MKT
06079810109635001,2020,60719,193481,254200,OVR
06079810109635001,2019,60719,193481,254200,MKT
06079810109655002,2021,95444,184856,280300,MKT
06079810109655002,2020,44297,199303,243600,OVR
06079810109655002,2019,44297,199303,243600,MKT
06079810109675003,2021,112136,192364,304500,MKT
06079810109675003,2020,60673,193627,254300,MKT
06079810109675003,2019,60673,193427,254100,MKT
06079810109696500,2021,31509,0,31509,COST
06079810109696500,2020,16019,0,16019,COST
06079810109696500,2019,16019,0,16019,COST
06079810109715001,2021,111172,188928,300100,MKT
06079810109715001,2020,59659,192941,252600,OVR
06079810109715001,2019,59659,192941,252600,MKT
06079810109735002,2021,97052,194248,291300,MKT
06079810109735002,2020,45765,204335,250100,MKT
06079810109735002,2019,45765,204335,250100,MKT
06079810109755003,2021,120353,188647,309000,MKT
06079810109755003,2020,69653,195147,264800,MKT
06079810109755003,2019,69653,197447,267100,MKT
06079810110107000,2021,340744,0,340744,COST
06079810110107000,2020,531042,0,531042,COST
06079810110107000,2019,531042,0,531042,COST
06079810111017000,2021,255276,0,255276,COST
06079810111017000,2020,302223,0,302223,COST
06079810111017000,2019,302223,0,302223,COST
06079810111035013,2021,90051,182049,272100,MKT
06079810111035013,2020,44530,197370,241900,MKT
06079810111035013,2019,44530,197370,241900,MKT
06079810111055014,2021,80805,175595,256400,MKT
06079810111055014,2020,36042,203758,239800,MKT
06079810111055014,2019,36042,203758,239800,MKT
06079810111075015,2021,80805,175595,256400,MKT
06079810111075015,2020,36042,203758,239800,MKT
06079810111075015,2019,36042,203758,239800,MKT
06079810111095016,2021,91027,181973,273000,MKT
06079810111095016,2020,45476,197324,242800,MKT
06079810111095016,2019,45476,197324,242800,MKT
06079810111115012,2021,102697,182003,284700,MKT
06079810111115012,2020,51104,186196,237300,MKT
06079810111115012,2019,51104,186196,237300,MKT
06079810111135011,2021,92272,174928,267200,MKT
06079810111135011,2020,41469,203731,245200,MKT
06079810111135011,2019,41469,203731,245200,MKT
06079810111155010,2021,92272,174928,267200,MKT
06079810111155010,2020,41469,203731,245200,MKT
06079810111155010,2019,41469,203731,245200,MKT
06079810111175008,2021,108246,188654,296900,MKT
06079810111175008,2020,56633,189067,245700,MKT
06079810111175008,2019,56633,189067,245700,MKT
06079810111195009,2021,103946,181954,285900,MKT
06079810111195009,2020,52324,186176,238500,MKT
06079810111195009,2019,52324,186176,238500,MKT
06079810111215007,2021,108246,181854,290100,MKT
06079810111215007,2020,56633,185667,242300,MKT
06079810111215007,2019,56633,185667,242300,MKT
06079810111235004,2021,102743,188657,291400,MKT
06079810111235004,2020,51150,189550,240700,MKT
06079810111235004,2019,51150,189550,240700,MKT
06079810111255003,2021,92184,175416,267600,MKT
06079810111255003,2020,41392,203808,245200,MKT
06079810111255003,2019,41392,203808,245200,MKT
06079810111275006,2021,108246,183754,292000,MKT
06079810111275006,2020,56633,211167,267800,OVR
06079810111275006,2019,56633,211167,267800,MKT
06079810111295002,2021,92045,175455,267500,MKT
06079810111295002,2020,41270,203930,245200,MKT
06079810111295002,2019,41270,203930,245200,MKT
06079810111315005,2021,108246,186054,294300,MKT
06079810111315005,2020,56633,212167,268800,MKT
06079810111315005,2019,56633,212167,268800,MKT
06079810111335001,2021,102771,182429,285200,MKT
06079810111335001,2020,51177,186223,237400,MKT
06079810111335001,2019,51177,186223,237400,MKT
06079810111416500,2021,36973,0,36973,COST
06079810111416500,2020,21887,0,21887,COST
06079810111416500,2019,21887,0,21887,COST
06079810111436500,2021,54356,0,54356,COST
06079810111436500,2020,46436,0,46436,COST
06079810111436500,2019,46436,0,46436,COST
06079810112010000,2021,110436,349364,459800,MKT
06079810112010000,2020,66317,332583,398900,MKT
06079810112010000,2019,66317,332583,398900,MKT
06079810112030000,2021,102279,376021,478300,MKT
06079810112030000,2020,57093,357407,414500,MKT
06079810112030000,2019,57093,345307,402400,MKT
06079810112050000,2021,102315,386385,488700,MKT
06079810112050000,2020,57132,357068,414200,MKT
06079810112050000,2019,57132,357068,414200,MKT
06079810112080000,2021,109851,380549,490400,MKT
06079810112080000,2020,65634,366166,431800,MKT
06079810112080000,2019,65634,366166,431800,MKT
06079810112106500,2021,36328,0,36328,COST
06079810112106500,2020,21148,0,21148,COST
06079810112106500,2019,21148,0,21148,COST
06079810112120000,2021,130536,385864,516400,MKT
06079810112120000,2020,81619,360581,442200,MKT
06079810112120000,2019,81619,360581,442200,MKT
06079810112140000,2021,122066,343034,465100,MKT
06079810112140000,2020,71602,334698,406300,MKT
06079810112140000,2019,71602,334698,406300,MKT
06079810112160000,2021,122066,347534,469600,MKT
06079810112160000,2020,71602,338698,410300,MKT
06079810112160000,2019,71602,338698,410300,MKT
06079810112180000,2021,125656,420244,545900,MKT
06079810112180000,2020,75770,357230,433000,MKT
06079810112180000,2019,75770,357230,433000,MKT
06079810112200000,2021,130430,385870,516300,MKT
06079810112200000,2020,81489,360611,442100,MKT
06079810112200000,2019,81489,360611,442100,MKT
06079810112220000,2021,130541,389259,519800,MKT
06079810112220000,2020,81625,356975,438600,MKT
06079810112220000,2019,81625,356975,438600,MKT
06079810113010000,2021,117708,285792,403500,MKT
06079810113010000,2020,75107,283793,358900,MKT
06079810113010000,2019,75107,283793,358900,MKT
06079810113030000,2021,138480,312620,451100,MKT
06079810113030000,2020,91594,294006,385600,MKT
06079810113030000,2019,91594,294006,385600,MKT
06079810113050000,2021,138480,283620,422100,MKT
06079810113050000,2020,91594,286606,378200,MKT
06079810113050000,2019,91594,286606,378200,MKT
06079810113070000,2021,138480,245420,383900,MKT
06079810113070000,2020,91594,250706,342300,MKT
06079810113070000,2019,91594,250706,342300,MKT
06079810114010000,2021,118054,232546,350600,MKT
06079810114010000,2020,75539,236461,312000,MKT
06079810114010000,2019,75539,236461,312000,MKT
06079810114030000,2021,138480,216220,354700,MKT
06079810114030000,2020,91594,225406,317000,MKT
06079810114030000,2019,91594,225406,317000,MKT
06079810114050000,2021,138480,308320,446800,MKT
06079810114050000,2020,91594,275806,367400,OVR
06079810114050000,2019,91594,275806,367400,MKT
06079810114070000,2021,138480,227120,365600,MKT
06079810114070000,2020,91594,237506,329100,MKT
06079810114070000,2019,91594,237506,329100,MKT
06079810115010000,2021,129087,275113,404200,MKT
06079810115010000,2020,89930,274970,364900,MKT
06079810115010000,2019,89930,274970,364900,MKT
06079810115030000,2021,139452,236048,375500,MKT
06079810115030000,2020,92854,244546,337400,MKT
06079810115030000,2019,92854,244546,337400,MKT
06079810115050000,2021,142716,295784,438500,MKT
06079810115050000,2020,97143,299057,396200,MKT
06079810115050000,2019,97143,299057,396200,MKT
06079810115070000,2021,142034,272366,414400,MKT
06079810115070000,2020,96239,271561,367800,MKT
06079810115070000,2019,96239,271561,367800,MKT
06079810115090000,2021,128816,267684,396500,MKT
06079810115090000,2020,89563,252437,342000,MKT
06079810115090000,2019,89563,252137,341700,MKT
06079810115110000,2021,137916,311384,449300,MKT
06079810115110000,2020,90868,314532,405400,MKT
06079810115110000,2019,90868,314532,405400,MKT
06079810115130000,2021,146069,264331,410400,MKT
06079810115130000,2020,101648,259152,360800,MKT
06079810115130000,2019,101648,259152,360800,MKT
06079810115150000,2021,145715,222485,368200,MKT
06079810115150000,2020,101167,225933,327100,MKT
06079810115150000,2019,101167,225933,327100,MKT
06079810115170000,2021,145715,279385,425100,MKT
06079810115170000,2020,101167,285933,387100,MKT
06079810115170000,2019,101167,285933,387100,MKT
06079810115190000,2021,145358,237642,383000,MKT
06079810115190000,2020,100684,246116,346800,MKT
06079810115190000,2019,100684,246116,346800,MKT
06079810115210000,2021,145358,285242,430600,MKT
06079810115210000,2020,100684,287116,387800,MKT
06079810115210000,2019,100684,278316,379000,MKT
06079810115230000,2021,144999,285601,430600,MKT
06079810115230000,2020,100199,285501,385700,MKT
06079810115230000,2019,100199,285501,385700,MKT
06079810115250000,2021,144999,270101,415100,MKT
06079810115250000,2020,100199,269501,369700,MKT
06079810115250000,2019,100199,269501,369700,MKT
06079810115270000,2021,144999,269401,414400,MKT
06079810115270000,2020,100199,269801,370000,MKT
06079810115270000,2019,100199,269801,370000,MKT
06079810115290000,2021,143471,243229,386700,MKT
06079810115290000,2020,98148,251152,349300,MKT
06079810115290000,2019,98148,251152,349300,MKT
06079810123010000,2021,135426,227074,362500,MKT
06079810123010000,2020,87693,231307,319000,MKT
06079810123010000,2019,87693,231307,319000,MKT
06079810123020000,2021,132853,253147,386000,MKT
06079810123020000,2020,84470,241930,326400,MKT
06079810123020000,2019,84470,241930,326400,MKT
06079810123030000,2021,132853,235347,368200,MKT
06079810123030000,2020,84470,238630,323100,MKT
06079810123030000,2019,84470,238630,323100,MKT
06079810123040000,2021,132853,229347,362200,MKT
06079810123040000,2020,84470,236130,320600,MKT
06079810123040000,2019,84470,236130,320600,MKT
06079810123050000,2021,132853,229247,362100,MKT
06079810123050000,2020,84470,232130,316600,MKT
06079810123050000,2019,84470,232130,316600,MKT
06079810123060000,2021,132853,235847,368700,MKT
06079810123060000,2020,84470,241530,326000,MKT
06079810123060000,2019,84470,241530,326000,MKT
06079810123070000,2021,132853,232647,365500,MKT
06079810123070000,2020,84470,234530,319000,MKT
06079810123070000,2019,84470,234530,319000,MKT
06079810123080000,2021,132853,226547,359400,MKT
06079810123080000,2020,84470,220755,305225,OVR
06079810123080000,2019,84470,220755,305225,OVR
06079810123090000,2021,132853,292147,425000,MKT
06079810123090000,2020,84470,291830,376300,MKT
06079810123090000,2019,84470,286930,371400,MKT
06079810123100000,2021,139951,231849,371800,MKT
06079810123100000,2020,93503,245297,338800,MKT
06079810123100000,2019,93503,245297,338800,MKT
06079810124010000,2021,140126,250474,390600,MKT
06079810124010000,2020,93731,229269,323000,MKT
06079810124010000,2019,93731,229269,323000,MKT
06079810124020000,2021,132853,236647,369500,MKT
06079810124020000,2020,84470,240430,324900,MKT
06079810124020000,2019,84470,240430,324900,MKT
06079810124030000,2021,132853,245847,378700,MKT
06079810124030000,2020,84470,242830,327300,MKT
06079810124030000,2019,84470,242830,327300,MKT
06079810124040000,2021,132853,230247,363100,MKT
06079810124040000,2020,84470,234330,318800,MKT
06079810124040000,2019,84470,234330,318800,MKT
06079810124050000,2021,132853,229247,362100,MKT
06079810124050000,2020,84470,236130,320600,MKT
06079810124050000,2019,84470,236130,320600,MKT
06079810124060000,2021,132853,228047,360900,MKT
06079810124060000,2020,84470,236430,320900,MKT
06079810124060000,2019,84470,236430,320900,MKT
06079810124070000,2021,132853,221147,354000,MKT
06079810124070000,2020,84470,232630,317100,MKT
06079810124070000,2019,84470,232630,317100,MKT
06079810124080000,2021,132853,230947,363800,MKT
06079810124080000,2020,84470,240530,325000,MKT
06079810124080000,2019,84470,240530,325000,MKT
06079810124090000,2021,139780,241820,381600,MKT
06079810124090000,2020,93280,234320,327600,MKT
06079810124090000,2019,93280,234320,327600,MKT
06079810124100000,2021,140126,252474,392600,MKT
06079810124100000,2020,93731,260369,354100,MKT
06079810124100000,2019,93731,260369,354100,MKT
06079810124110000,2021,132853,261347,394200,MKT
06079810124110000,2020,84470,244330,328800,MKT
06079810124110000,2019,84470,244330,328800,MKT
06079810124120000,2021,132853,235647,368500,MKT
06079810124120000,2020,84470,246830,331300,MKT
06079810124120000,2019,84470,246830,331300,MKT
06079810124130000,2021,132853,242447,375300,MKT
06079810124130000,2020,84470,244930,329400,MKT
06079810124130000,2019,84470,244930,329400,MKT
06079810124140000,2021,132853,228347,361200,MKT
06079810124140000,2020,84470,236230,320700,MKT
06079810124140000,2019,84470,236230,320700,MKT
06079810124150000,2021,132853,238947,371800,MKT
06079810124150000,2020,84470,240930,325400,MKT
06079810124150000,2019,84470,240930,325400,MKT
06079810124160000,2021,132853,324347,457200,MKT
06079810124160000,2020,84470,320530,405000,MKT
06079810124160000,2019,84470,320530,405000,MKT
06079810124170000,2021,132853,233447,366300,MKT
06079810124170000,2020,84470,237030,321500,MKT
06079810124170000,2019,84470,237030,321500,MKT
06079810124180000,2021,139780,240920,380700,MKT
06079810124180000,2020,93280,242620,335900,MKT
06079810124180000,2019,93280,242620,335900,MKT
06079810125010000,2021,142319,0,142319,COST
06079810125010000,2020,96616,0,96616,COST
06079810125010000,2019,96616,0,96616,COST
06079810125020000,2021,141919,210481,352400,MKT
06079810125020000,2020,96087,220513,316600,MKT
06079810125020000,2019,96087,220513,316600,MKT
06079810125030000,2021,141919,290181,432100,MKT
06079810125030000,2020,96087,291713,387800,MKT
06079810125030000,2019,96087,291713,387800,MKT
06079810125040000,2021,141919,204381,346300,MKT
06079810125040000,2020,96087,202813,298900,MKT
06079810125040000,2019,96087,202813,298900,MKT
06079810125050000,2021,141919,223181,365100,MKT
06079810125050000,2020,96087,218713,314800,MKT
06079810125050000,2019,96087,218713,314800,MKT
06079810125060000,2021,141919,225181,367100,MKT
06079810125060000,2020,96087,225213,321300,MKT
06079810125060000,2019,96087,225213,321300,MKT
06079810125070000,2021,142319,225681,368000,MKT
06079810125070000,2020,96616,224184,320800,MKT
06079810125070000,2019,96616,224184,320800,MKT
06079810125080000,2021,139951,226149,366100,MKT
06079810125080000,2020,93503,216497,310000,MKT
06079810125080000,2019,93503,216497,310000,MKT
06079810125090000,2021,132853,246947,379800,MKT
06079810125090000,2020,84470,247330,331800,MKT
06079810125090000,2019,84470,247330,331800,MKT
06079810125100000,2021,132853,226047,358900,MKT
06079810125100000,2020,84470,236430,320900,MKT
06079810125100000,2019,84470,236430,320900,MKT
06079810125110000,2021,132853,223147,356000,MKT
06079810125110000,2020,84470,233930,318400,MKT
06079810125110000,2019,84470,233930,318400,MKT
06079810125120000,2021,132853,245547,378400,MKT
06079810125120000,2020,84470,249630,334100,MKT
06079810125120000,2019,84470,249630,334100,MKT
06079810125130000,2021,132853,226947,359800,MKT
06079810125130000,2020,84470,230230,314700,MKT
06079810125130000,2019,84470,230230,314700,MKT
06079810125140000,2021,132853,245047,377900,MKT
06079810125140000,2020,84470,237230,321700,MKT
06079810125140000,2019,84470,237230,321700,MKT
06079810125150000,2021,132853,230347,363200,MKT
06079810125150000,2020,84470,240530,325000,MKT
06079810125150000,2019,84470,240530,325000,MKT
06079810125160000,2021,139951,260049,400000,MKT
06079810125160000,2020,93503,257997,351500,MKT
06079810125160000,2019,93503,257997,351500,MKT
06079810126010000,2021,144091,205009,349100,MKT
06079810126010000,2020,98977,208023,307000,MKT
06079810126010000,2019,98977,208023,307000,MKT
06079810126020000,2021,143686,288314,432000,MKT
06079810126020000,2020,98435,282265,380700,MKT
06079810126020000,2019,98435,282265,380700,MKT
06079810126030000,2021,143686,270914,414600,MKT
06079810126030000,2020,98435,272065,370500,MKT
06079810126030000,2019,98435,272065,370500,MKT
06079810126040000,2021,143686,229514,373200,MKT
06079810126040000,2020,98435,227965,326400,MKT
06079810126040000,2019,98435,227965,326400,MKT
06079810126050000,2021,143686,281314,425000,MKT
06079810126050000,2020,98435,282565,381000,MKT
06079810126050000,2019,98435,273865,372300,MKT
06079810126060000,2021,143686,237114,380800,MKT
06079810126060000,2020,98435,248965,347400,MKT
06079810126060000,2019,98435,248965,347400,MKT
06079810126070000,2021,144091,244509,388600,MKT
06079810126070000,2020,98977,248723,347700,MKT
06079810126070000,2019,98977,248723,347700,MKT
06079810126080000,2021,144091,199409,343500,MKT
06079810126080000,2020,98977,159240,258217,COST
06079810126080000,2019,98977,159240,258217,COST
06079810126090000,2021,143686,226414,370100,MKT
06079810126090000,2020,98435,223865,322300,MKT
06079810126090000,2019,98435,223865,322300,MKT
06079810126100000,2021,143686,240214,383900,MKT
06079810126100000,2020,98435,244565,343000,MKT
06079810126100000,2019,98435,244565,343000,MKT
06079810126110000,2021,143686,214314,358000,MKT
06079810126110000,2020,98435,214865,313300,MKT
06079810126110000,2019,98435,214865,313300,MKT
06079810126120000,2021,143686,272414,416100,MKT
06079810126120000,2020,98435,277065,375500,MKT
06079810126120000,2019,98435,277065,375500,MKT
06079810126130000,2021,143686,324714,468400,MKT
06079810126130000,2020,98435,303365,401800,MKT
06079810126130000,2019,98435,303365,401800,MKT
06079810126140000,2021,144091,241009,385100,MKT
06079810126140000,2020,98977,247823,346800,MKT
06079810126140000,2019,98977,247823,346800,MKT
06079810127010000,2021,144091,221109,365200,MKT
06079810127010000,2020,98977,222223,321200,MKT
06079810127010000,2019,98977,222223,321200,MKT
06079810127020000,2021,143686,219214,362900,MKT
06079810127020000,2020,98435,223765,322200,MKT
06079810127020000,2019,98435,223765,322200,MKT
06079810127030000,2021,143686,228114,371800,MKT
06079810127030000,2020,98435,224865,323300,MKT
06079810127030000,2019,98435,224865,323300,MKT
06079810127040000,2021,143686,253914,397600,MKT
06079810127040000,2020,98435,255865,354300,MKT
06079810127040000,2019,98435,255865,354300,MKT
06079810127050000,2021,143686,251014,394700,MKT
06079810127050000,2020,98435,255065,353500,MKT
06079810127050000,2019,98435,255065,353500,MKT
06079810127060000,2021,143686,216114,359800,MKT
06079810127060000,2020,98435,213365,311800,MKT
06079810127060000,2019,98435,213365,311800,MKT
06079810127070000,2021,144091,265109,409200,MKT
06079810127070000,2020,98977,245323,344300,OVR
06079810127070000,2019,98977,245323,344300,MKT
06079810127080000,2021,142319,232081,374400,MKT
06079810127080000,2020,96616,231984,328600,MKT
06079810127080000,2019,96616,231984,328600,MKT
06079810127090000,2021,141919,283681,425600,MKT
06079810127090000,2020,96087,282113,378200,MKT
06079810127090000,2019,96087,282113,378200,MKT
06079810127100000,2021,141919,201981,343900,MKT
06079810127100000,2020,96087,207013,303100,MKT
06079810127100000,2019,96087,207013,303100,MKT
06079810127110000,2021,141919,204081,346000,MKT
06079810127110000,2020,96087,206613,302700,MKT
06079810127110000,2019,96087,206613,302700,MKT
06079810127120000,2021,141919,209081,351000,MKT
06079810127120000,2020,96087,209813,305900,OVR
06079810127120000,2019,96087,209813,305900,MKT
06079810127130000,2021,141919,177581,319500,MKT
06079810127130000,2020,96087,186613,282700,MKT
06079810127130000,2019,96087,186613,282700,MKT
06079810127140000,2021,142319,205481,347800,MKT
06079810127140000,2020,96616,207384,304000,MKT
06079810127140000,2019,96616,207384,304000,MKT
06079810128080000,2021,140485,231715,372200,MKT
06079810128080000,2020,94201,237799,332000,MKT
06079810128080000,2019,94201,237799,332000,MKT
06079810128090000,2021,140090,185810,325900,MKT
06079810128090000,2020,93685,185315,279000,MKT
06079810128090000,2019,93685,185315,279000,MKT
06079810128100000,2021,140090,250610,390700,MKT
06079810128100000,2020,93685,261515,355200,MKT
06079810128100000,2019,93685,261515,355200,MKT
06079810128110000,2021,140090,209410,349500,MKT
06079810128110000,2020,93685,220915,314600,MKT
06079810128110000,2019,93685,205215,298900,MKT
06079810128120000,2021,140090,245210,385300,MKT
06079810128120000,2020,93685,245815,339500,MKT
06079810128120000,2019,93685,245815,339500,MKT
06079810128130000,2021,140090,219510,359600,MKT
06079810128130000,2020,93685,216415,310100,MKT
06079810128130000,2019,93685,216415,310100,MKT
06079810128140000,2021,140485,259515,400000,MKT
06079810128140000,2020,94201,259899,354100,MKT
06079810128140000,2019,94201,259899,354100,MKT
06079810129010000,2021,136604,280596,417200,MKT
06079810129010000,2020,89188,278912,368100,MKT
06079810129010000,2019,89188,278912,368100,MKT
06079810129020000,2021,136220,264980,401200,MKT
06079810129020000,2020,88699,274401,363100,MKT
06079810129020000,2019,88699,274401,363100,MKT
06079810129030000,2021,136220,233080,369300,MKT
06079810129030000,2020,88699,241101,329800,MKT
06079810129030000,2019,88699,241101,329800,MKT
06079810129040000,2021,136220,280380,416600,MKT
06079810129040000,2020,88699,286401,375100,OVR
06079810129040000,2019,88699,286401,375100,MKT
06079810129050000,2021,136220,253580,389800,MKT
06079810129050000,2020,88699,260201,348900,MKT
06079810129050000,2019,88699,260201,348900,MKT
06079810129060000,2021,136220,308980,445200,MKT
06079810129060000,2020,88699,302601,391300,MKT
06079810129060000,2019,88699,302601,391300,MKT
06079810129070000,2021,136604,249496,386100,MKT
06079810129070000,2020,89188,257512,346700,MKT
06079810129070000,2019,89188,257512,346700,MKT
06079810130010000,2021,142319,294481,436800,MKT
06079810130010000,2020,96616,286084,382700,MKT
06079810130010000,2019,96616,286084,382700,MKT
06079810130020000,2021,141919,303581,445500,MKT
06079810130020000,2020,96087,270413,366500,MKT
06079810130020000,2019,96087,270413,366500,MKT
06079810130030000,2021,141919,281881,423800,MKT
06079810130030000,2020,96087,296813,392900,MKT
06079810130030000,2019,96087,296813,392900,MKT
06079810130040000,2021,141919,341181,483100,MKT
06079810130040000,2020,96087,342513,438600,MKT
06079810130040000,2019,96087,342513,438600,MKT
06079810130050000,2021,141919,230681,372600,MKT
06079810130050000,2020,96087,240013,336100,MKT
06079810130050000,2019,96087,240013,336100,MKT
06079810130060000,2021,141919,257181,399100,MKT
06079810130060000,2020,96087,257013,353100,MKT
06079810130060000,2019,96087,257013,353100,MKT
06079810130070000,2021,142319,297981,440300,MKT
06079810130070000,2020,96616,283184,379800,MKT
06079810130070000,2019,96616,283184,379800,MKT
06079810130080000,2021,142319,341481,483800,MKT
06079810130080000,2020,96616,321984,418600,MKT
06079810130080000,2019,96616,321984,418600,MKT
06079810130090000,2021,141919,318281,460200,MKT
06079810130090000,2020,96087,301413,397500,MKT
06079810130090000,2019,96087,301413,397500,MKT
06079810130100000,2021,141919,238381,380300,MKT
06079810130100000,2020,96087,235113,331200,MKT
06079810130100000,2019,96087,235113,331200,MKT
06079810130110000,2021,141919,290681,432600,MKT
06079810130110000,2020,96087,281713,377800,MKT
06079810130110000,2019,96087,281713,377800,MKT
06079810130120000,2021,141919,324081,466000,MKT
06079810130120000,2020,96087,315013,411100,MKT
06079810130120000,2019,96087,315013,411100,MKT
06079810130130000,2021,141919,295081,437000,MKT
06079810130130000,2020,96087,283513,379600,MKT
06079810130130000,2019,96087,283513,379600,MKT
06079810130140000,2021,142319,244381,386700,MKT
06079810130140000,2020,96616,253884,350500,MKT
06079810130140000,2019,96616,250784,347400,MKT
06079810131080000,2021,140485,255215,395700,MKT
06079810131080000,2020,94201,262399,356600,MKT
06079810131080000,2019,94201,262399,356600,MKT
06079810131090000,2021,140090,288510,428600,MKT
06079810131090000,2020,93685,284115,377800,MKT
06079810131090000,2019,93685,284115,377800,MKT
06079810131100000,2021,140090,270410,410500,MKT
06079810131100000,2020,93685,265615,359300,MKT
06079810131100000,2019,93685,265615,359300,MKT
06079810131110000,2021,140090,270110,410200,MKT
06079810131110000,2020,93685,265515,359200,MKT
06079810131110000,2019,93685,265515,359200,MKT
06079810131120000,2021,140090,233210,373300,MKT
06079810131120000,2020,93685,242915,336600,MKT
06079810131120000,2019,93685,242915,336600,MKT
06079810131130000,2021,140090,282210,422300,MKT
06079810131130000,2020,93685,268315,362000,MKT
06079810131130000,2019,93685,268315,362000,MKT
06079810131140000,2021,140485,279115,419600,MKT
06079810131140000,2020,94201,276699,370900,MKT
06079810131140000,2019,94201,270999,365200,MKT
06079810132010000,2021,140485,226715,367200,MKT
06079810132010000,2020,94201,241999,336200,MKT
06079810132010000,2019,94201,241999,336200,MKT
06079810132030000,2021,140090,247510,387600,MKT
06079810132030000,2020,93685,250615,344300,MKT
06079810132030000,2019,93685,250615,344300,MKT
06079810132050000,2021,140090,264310,404400,MKT
06079810132050000,2020,93685,269315,363000,MKT
06079810132050000,2019,93685,269315,363000,MKT
06079810132070000,2021,140090,283210,423300,MKT
06079810132070000,2020,93685,273615,367300,MKT
06079810132070000,2019,93685,273615,367300,MKT
06079810132090000,2021,140090,273810,413900,MKT
06079810132090000,2020,93685,273515,367200,MKT
06079810132090000,2019,93685,273515,367200,MKT
06079810132110000,2021,140090,333910,474000,MKT
06079810132110000,2020,93685,308915,402600,MKT
06079810132110000,2019,93685,308915,402600,MKT
06079810132120000,2021,140485,224815,365300,MKT
06079810132120000,2020,94201,224999,319200,MKT
06079810132120000,2019,94201,224999,319200,MKT
06079810133010000,2021,144091,245809,389900,MKT
06079810133010000,2020,98977,257823,356800,MKT
06079810133010000,2019,98977,257823,356800,MKT
06079810133030000,2021,144091,241109,385200,MKT
06079810133030000,2020,98977,246123,345100,MKT
06079810133030000,2019,98977,246123,345100,MKT
06079810133050000,2021,160300,257300,417600,MKT
06079810133050000,2020,121872,256228,378100,MKT
06079810133050000,2019,121872,256228,378100,MKT
06079810133070000,2021,160043,227457,387500,MKT
06079810133070000,2020,121491,216509,338000,MKT
06079810133070000,2019,121491,216509,338000,MKT
06079810133090000,2021,160043,257857,417900,MKT
06079810133090000,2020,121491,263009,384500,MKT
06079810133090000,2019,121491,263009,384500,MKT
06079810133110000,2021,159525,232275,391800,MKT
06079810133110000,2020,120724,240776,361500,MKT
06079810133110000,2019,120724,240776,361500,MKT
06079810133130000,2021,159264,329036,488300,MKT
06079810133130000,2020,120339,313461,433800,MKT
06079810133130000,2019,120339,313461,433800,MKT
06079810133150000,2021,144091,241809,385900,MKT
06079810133150000,2020,98977,235023,334000,MKT
06079810133150000,2019,98977,235023,334000,MKT
06079810134010000,2021,146140,314260,460400,MKT
06079810134010000,2020,101744,289456,391200,MKT
06079810134010000,2019,101744,289456,391200,MKT
06079810134030000,2021,160556,286844,447400,MKT
06079810134030000,2020,122253,279447,401700,MKT
06079810134030000,2019,122253,279447,401700,MKT
06079810134050000,2021,160043,312657,472700,MKT
06079810134050000,2020,121491,297609,419100,MKT
06079810134050000,2019,121491,297609,419100,MKT
06079810134070000,2021,159784,231616,391400,MKT
06079810134070000,2020,121108,220292,341400,MKT
06079810134070000,2019,121108,220292,341400,MKT
06079810134090000,2021,159525,221375,380900,MKT
06079810134090000,2020,120724,212376,333100,MKT
06079810134090000,2019,120724,212376,333100,MKT
06079810134110000,2021,159264,318236,477500,MKT
06079810134110000,2020,120339,299761,420100,MKT
06079810134110000,2019,120339,299761,420100,MKT
06079810134130000,2021,142678,264122,406800,MKT
06079810134130000,2020,97093,265507,362600,MKT
06079810134130000,2019,97093,265507,362600,MKT
06079810134150000,2021,142319,265881,408200,MKT
06079810134150000,2020,96616,265184,361800,MKT
06079810134150000,2019,96616,265184,361800,MKT
06079810138020000,2021,132853,314447,447300,MKT
06079810138020000,2020,84470,311530,396000,MKT
06079810138020000,2019,84470,311530,396000,MKT
06079810138030000,2021,132853,287647,420500,MKT
06079810138030000,2020,84470,303730,388200,MKT
06079810138030000,2019,84470,296630,381100,MKT
06079810138040000,2021,132853,241647,374500,MKT
06079810138040000,2020,84470,245930,330400,MKT
06079810138040000,2019,84470,245930,330400,MKT
06079810138050000,2021,132853,229547,362400,MKT
06079810138050000,2020,84470,241430,325900,MKT
06079810138050000,2019,84470,241430,325900,MKT
06079810138060000,2021,132853,258047,390900,MKT
06079810138060000,2020,84470,242430,326900,MKT
06079810138060000,2019,84470,242430,326900,MKT
06079810138070000,2021,132853,227347,360200,MKT
06079810138070000,2020,84470,238530,323000,MKT
06079810138070000,2019,84470,238530,323000,MKT
06079810138080000,2021,132853,278947,411800,MKT
06079810138080000,2020,84470,275630,360100,MKT
06079810138080000,2019,84470,275630,360100,MKT
06079810138090000,2021,132853,241647,374500,MKT
06079810138090000,2020,84470,245930,330400,MKT
06079810138090000,2019,84470,245930,330400,MKT
06079810138100000,2021,139951,234449,374400,MKT
06079810138100000,2020,93503,236497,330000,MKT
06079810138100000,2019,93503,236497,330000,MKT
06079810139016500,2021,55159,0,55159,COST
06079810139016500,2020,47785,0,47785,COST
06079810139016500,2019,47785,0,47785,COST
06079810139020000,2021,132853,291147,424000,MKT
06079810139020000,2020,84470,282630,367100,MKT
06079810139020000,2019,84470,282630,367100,MKT
06079810139030000,2021,132853,277447,410300,MKT
06079810139030000,2020,84470,282930,367400,MKT
06079810139030000,2019,84470,282930,367400,MKT
06079810139040000,2021,132853,226547,359400,MKT
06079810139040000,2020,84470,237230,321700,MKT
06079810139040000,2019,84470,237230,321700,MKT
06079810139050000,2021,132853,291147,424000,MKT
06079810139050000,2020,84470,289330,373800,MKT
06079810139050000,2019,84470,289330,373800,MKT
06079810139060000,2021,132853,229347,362200,MKT
06079810139060000,2020,84470,240830,325300,MKT
06079810139060000,2019,84470,240830,325300,MKT
06079810139070000,2021,132853,269847,402700,MKT
06079810139070000,2020,84470,259030,343500,MKT
06079810139070000,2019,84470,259030,343500,MKT
06079810139080000,2021,132853,239147,372000,MKT
06079810139080000,2020,84470,243130,327600,MKT
06079810139080000,2019,84470,243130,327600,MKT
06079810139090000,2021,139780,358320,498100,MKT
06079810139090000,2020,93280,342820,436100,MKT
06079810139090000,2019,93280,342820,436100,MKT
06079810139100000,2021,140126,273574,413700,MKT
06079810139100000,2020,93731,271169,364900,MKT
06079810139100000,2019,93731,271169,364900,MKT
06079810139110000,2021,132853,232547,365400,MKT
06079810139110000,2020,84470,246430,330900,MKT
06079810139110000,2019,84470,246430,330900,MKT
06079810139120000,2021,132853,259947,392800,MKT
06079810139120000,2020,84470,262230,346700,MKT
06079810139120000,2019,84470,262230,346700,MKT
06079810139130000,2021,132853,232147,365000,MKT
06079810139130000,2020,84470,245930,330400,MKT
06079810139130000,2019,84470,245930,330400,MKT
06079810139140000,2021,132853,254147,387000,MKT
06079810139140000,2020,84470,252630,337100,MKT
06079810139140000,2019,84470,252630,337100,MKT
06079810139150000,2021,132853,316047,448900,MKT
06079810139150000,2020,84470,308030,392500,MKT
06079810139150000,2019,84470,308030,392500,MKT
06079810139160000,2021,132853,307747,440600,MKT
06079810139160000,2020,84470,311430,395900,MKT
06079810139160000,2019,84470,311430,395900,MKT
06079810139170000,2021,132853,291447,424300,MKT
06079810139170000,2020,84470,304530,389000,MKT
06079810139170000,2019,84470,304530,389000,MKT
06079810140010000,2021,134830,266170,401000,MKT
06079810140010000,2020,86942,263558,350500,MKT
06079810140010000,2019,86942,263558,350500,MKT
06079810140020000,2021,134830,288770,423600,MKT
06079810140020000,2020,86942,294058,381000,MKT
06079810140020000,2019,86942,294058,381000,MKT
06079810140030000,2021,134830,289670,424500,MKT
06079810140030000,2020,86942,280158,367100,MKT
06079810140030000,2019,86942,280158,367100,MKT
06079810140040000,2021,134830,273670,408500,MKT
06079810140040000,2020,86942,275058,362000,MKT
06079810140040000,2019,86942,275058,362000,MKT
06079810140050000,2021,134830,299870,434700,MKT
06079810140050000,2020,86942,298758,385700,MKT
06079810140050000,2019,86942,298758,385700,MKT
06079810140060000,2021,134830,292170,427000,MKT
06079810140060000,2020,86942,305258,392200,MKT
06079810140060000,2019,86942,305258,392200,MKT
06079810140070000,2021,134830,390370,525200,MKT
06079810140070000,2020,86942,391158,478100,MKT
06079810140070000,2019,86942,391158,478100,MKT
06079810140080000,2021,139951,331149,471100,MKT
06079810140080000,2020,93503,315597,409100,MKT
06079810140080000,2019,93503,315597,409100,MKT
06079810140090000,2021,140288,280812,421100,MKT
06079810140090000,2020,93943,278057,372000,MKT
06079810140090000,2019,93943,278057,372000,MKT
06079810140100000,2021,138172,209928,348100,MKT
06079810140100000,2020,91197,214103,305300,MKT
06079810140100000,2019,91197,214103,305300,MKT
06079810140110000,2021,138172,161628,299800,MKT
06079810140110000,2020,91197,166203,257400,MKT
06079810140110000,2019,91197,166203,257400,MKT
06079810140120000,2021,138172,338028,476200,MKT
06079810140120000,2020,91197,271203,362400,MKT
06079810140120000,2019,91197,273603,364800,MKT
06079810140130000,2021,138172,282028,420200,MKT
06079810140130000,2020,91197,297003,388200,MKT
06079810140130000,2019,91197,297003,388200,MKT
06079810140140000,2021,138172,272128,410300,MKT
06079810140140000,2020,91197,269303,360500,MKT
06079810140140000,2019,91197,269303,360500,MKT
06079810140150000,2021,138172,281728,419900,MKT
06079810140150000,2020,91197,264503,355700,MKT
06079810140150000,2019,91197,264503,355700,MKT
06079810140160000,2021,140288,274912,415200,MKT
06079810140160000,2020,93943,292757,386700,MKT
06079810140160000,2019,93943,292757,386700,MKT
06079810140170000,2021,140810,276490,417300,MKT
06079810140170000,2020,94627,296073,390700,MKT
06079810140170000,2019,94627,296073,390700,MKT
06079810141010000,2021,142034,354166,496200,MKT
06079810141010000,2020,96239,332461,428700,MKT
06079810141010000,2019,96239,332461,428700,MKT
06079810141020000,2021,139892,224408,364300,MKT
06079810141020000,2020,93426,221374,314800,MKT
06079810141020000,2019,93426,221374,314800,MKT
06079810141030000,2021,139892,258408,398300,MKT
06079810141030000,2020,93426,265474,358900,MKT
06079810141030000,2019,93426,265474,358900,MKT
06079810141040000,2021,139892,208008,347900,MKT
06079810141040000,2020,93426,210274,303700,MKT
06079810141040000,2019,93426,210274,303700,MKT
06079810141050000,2021,139892,222308,362200,MKT
06079810141050000,2020,93426,219874,313300,MKT
06079810141050000,2019,93426,219874,313300,MKT
06079810141060000,2021,139892,237108,377000,MKT
06079810141060000,2020,93426,238974,332400,MKT
06079810141060000,2019,93426,238974,332400,MKT
06079810141070000,2021,139892,273808,413700,MKT
06079810141070000,2020,93426,282974,376400,MKT
06079810141070000,2019,93426,282974,376400,MKT
06079810141080000,2021,142034,231466,373500,MKT
06079810141080000,2020,96239,245561,341800,OVR
06079810141080000,2019,96239,245561,341800,MKT
06079810141090000,2021,142034,200566,342600,MKT
06079810141090000,2020,96239,200061,296300,MKT
06079810141090000,2019,96239,200061,296300,MKT
06079810141100000,2021,139892,263008,402900,MKT
06079810141100000,2020,93426,258474,351900,MKT
06079810141100000,2019,93426,258474,351900,MKT
06079810141110000,2021,139892,237908,377800,MKT
06079810141110000,2020,93426,239374,332800,MKT
06079810141110000,2019,93426,239374,332800,MKT
06079810141120000,2021,139892,255608,395500,MKT
06079810141120000,2020,93426,257774,351200,OVR
06079810141120000,2019,93426,257774,351200,MKT
06079810141130000,2021,139892,233308,373200,MKT
06079810141130000,2020,93426,236474,329900,MKT
06079810141130000,2019,93426,236474,329900,MKT
06079810141140000,2021,139892,279008,418900,MKT
06079810141140000,2020,93426,287174,380600,MKT
06079810141140000,2019,93426,287174,380600,MKT
06079810141150000,2021,139892,247008,386900,MKT
06079810141150000,2020,93426,250474,343900,MKT
06079810141150000,2019,93426,250474,343900,MKT
06079810141160000,2021,142034,228866,370900,MKT
06079810141160000,2020,96239,226761,323000,MKT
06079810141160000,2019,96239,226761,323000,MKT
06079810142010000,2021,140288,300712,441000,MKT
06079810142010000,2020,93943,281557,375500,MKT
06079810142010000,2019,93943,281557,375500,MKT
06079810142020000,2021,138172,226028,364200,MKT
06079810142020000,2020,91197,224703,315900,MKT
06079810142020000,2019,91197,224703,315900,MKT
06079810142030000,2021,138172,197628,335800,MKT
06079810142030000,2020,91197,203703,294900,MKT
06079810142030000,2019,91197,203703,294900,MKT
06079810142040000,2021,138172,190328,328500,MKT
06079810142040000,2020,91197,190603,281800,MKT
06079810142040000,2019,91197,190603,281800,MKT
06079810142050000,2021,138172,241828,380000,MKT
06079810142050000,2020,91197,250703,341900,MKT
06079810142050000,2019,91197,250703,341900,MKT
06079810142060000,2021,138172,229028,367200,MKT
06079810142060000,2020,91197,230603,321800,MKT
06079810142060000,2019,91197,230603,321800,MKT
06079810142070000,2021,138172,277828,416000,MKT
06079810142070000,2020,91197,279803,371000,MKT
06079810142070000,2019,91197,279803,371000,MKT
06079810142080000,2021,140288,243412,383700,MKT
06079810142080000,2020,93943,240757,334700,MKT
06079810142080000,2019,93943,240757,334700,MKT
06079810142090000,2021,142034,225766,367800,MKT
06079810142090000,2020,96239,224361,320600,MKT
06079810142090000,2019,96239,224361,320600,MKT
06079810142100000,2021,139892,221608,361500,MKT
06079810142100000,2020,93426,218974,312400,MKT
06079810142100000,2019,93426,218974,312400,MKT
06079810142110000,2021,139892,216008,355900,MKT
06079810142110000,2020,93426,216774,310200,MKT
06079810142110000,2019,93426,216774,310200,MKT
06079810142120000,2021,139892,361208,501100,MKT
06079810142120000,2020,93426,321274,414700,MKT
06079810142120000,2019,93426,321274,414700,MKT
06079810142130000,2021,139892,255308,395200,MKT
06079810142130000,2020,93426,253074,346500,MKT
06079810142130000,2019,93426,253074,346500,MKT
06079810142140000,2021,139892,239008,378900,MKT
06079810142140000,2020,93426,249574,343000,MKT
06079810142140000,2019,93426,249574,343000,MKT
06079810142150000,2021,139892,213508,353400,MKT
06079810142150000,2020,93426,209974,303400,MKT
06079810142150000,2019,93426,209974,303400,MKT
06079810142160000,2021,142034,270866,412900,MKT
06079810142160000,2020,96239,274961,371200,MKT
06079810142160000,2019,96239,274961,371200,MKT
06079810143010000,2021,152328,205572,357900,MKT
06079810143010000,2020,114492,205908,320400,MKT
06079810143010000,2019,114492,205908,320400,MKT
06079810143020000,2021,150030,236070,386100,MKT
06079810143020000,2020,111146,228854,340000,MKT
06079810143020000,2019,111146,228854,340000,MKT
06079810143030000,2021,150030,241370,391400,MKT
06079810143030000,2020,111146,234454,345600,MKT
06079810143030000,2019,111146,234454,345600,MKT
06079810143040000,2021,150030,226670,376700,MKT
06079810143040000,2020,111146,225354,336500,MKT
06079810143040000,2019,111146,225354,336500,MKT
06079810143050000,2021,150030,203670,353700,MKT
06079810143050000,2020,111146,200054,311200,MKT
06079810143050000,2019,111146,200054,311200,MKT
06079810143060000,2021,153881,224119,378000,MKT
06079810143060000,2020,116782,219818,336600,MKT
06079810143060000,2019,116782,219818,336600,MKT
06079810143070000,2021,150030,208570,358600,MKT
06079810143070000,2020,111146,206554,317700,MKT
06079810143070000,2019,111146,206554,317700,MKT
06079810143080000,2021,152328,212772,365100,MKT
06079810143080000,2020,114492,211108,325600,MKT
06079810143080000,2019,114492,211108,325600,MKT
06079810158016500,2021,71332,0,71332,COST
06079810158016500,2020,78931,0,78931,COST
06079810158016500,2019,78931,0,78931,COST
06079810158020000,2021,132853,275747,408600,MKT
06079810158020000,2020,84470,267630,352100,MKT
06079810158020000,2019,84470,267630,352100,MKT
06079810158030000,2021,132853,243947,376800,MKT
06079810158030000,2020,84470,251130,335600,MKT
06079810158030000,2019,84470,251130,335600,MKT
06079810158040000,2021,132853,265447,398300,MKT
06079810158040000,2020,84470,263830,348300,MKT
06079810158040000,2019,84470,263830,348300,MKT
06079810158050000,2021,132853,259647,392500,MKT
06079810158050000,2020,84470,269530,354000,MKT
06079810158050000,2019,84470,269530,354000,MKT
06079810158060000,2021,132853,236447,369300,MKT
06079810158060000,2020,84470,243030,327500,MKT
06079810158060000,2019,84470,243030,327500,MKT
06079810158070000,2021,132853,265247,398100,MKT
06079810158070000,2020,84470,271630,356100,MKT
06079810158070000,2019,84470,271630,356100,MKT
06079810158080000,2021,132853,222647,355500,MKT
06079810158080000,2020,84470,218530,303000,MKT
06079810158080000,2019,84470,218530,303000,MKT
06079810158090000,2021,132853,231247,364100,MKT
06079810158090000,2020,84470,237630,322100,MKT
06079810158090000,2019,84470,237630,322100,MKT
06079810158116500,2021,34961,0,34961,COST
06079810158116500,2020,19622,0,19622,COST
06079810158116500,2019,19622,0,19622,COST
06079810159010000,2021,140126,270174,410300,MKT
06079810159010000,2020,93731,268469,362200,MKT
06079810159010000,2019,93731,268469,362200,MKT
06079810159020000,2021,132853,246147,379000,MKT
06079810159020000,2020,84470,239530,324000,MKT
06079810159020000,2019,84470,239530,324000,MKT
06079810159030000,2021,132853,269547,402400,MKT
06079810159030000,2020,84470,261530,346000,MKT
06079810159030000,2019,84470,261530,346000,MKT
06079810159040000,2021,132853,229747,362600,MKT
06079810159040000,2020,84470,232030,316500,MKT
06079810159040000,2019,84470,232030,316500,MKT
06079810159050000,2021,132853,226247,359100,MKT
06079810159050000,2020,84470,230130,314600,MKT
06079810159050000,2019,84470,230130,314600,MKT
06079810159060000,2021,132853,265947,398800,MKT
06079810159060000,2020,84470,255630,340100,MKT
06079810159060000,2019,84470,255630,340100,MKT
06079810159070000,2021,132853,242547,375400,MKT
06079810159070000,2020,84470,247430,331900,MKT
06079810159070000,2019,84470,247430,331900,MKT
06079810159080000,2021,132853,293747,426600,MKT
06079810159080000,2020,84470,303530,388000,MKT
06079810159080000,2019,84470,303530,388000,MKT
06079810159090000,2021,132853,255547,388400,MKT
06079810159090000,2020,84470,255930,340400,MKT
06079810159090000,2019,84470,255930,340400,MKT
06079810159106500,2021,42547,0,42547,COST
06079810159106500,2020,28789,0,28789,COST
06079810159106500,2019,28789,0,28789,COST
06079810159110000,2021,132853,286947,419800,MKT
06079810159110000,2020,84470,284230,368700,MKT
06079810159110000,2019,84470,284230,368700,MKT
06079810159120000,2021,132853,253347,386200,MKT
06079810159120000,2020,84470,250130,334600,MKT
06079810159120000,2019,84470,250130,334600,MKT
06079810159130000,2021,132853,243047,375900,MKT
06079810159130000,2020,84470,251230,335700,MKT
06079810159130000,2019,84470,251230,335700,MKT
06079810159140000,2021,132853,280347,413200,MKT
06079810159140000,2020,84470,267130,351600,MKT
06079810159140000,2019,84470,267130,351600,MKT
06079810159150000,2021,132853,273947,406800,MKT
06079810159150000,2020,84470,278130,362600,MKT
06079810159150000,2019,84470,278130,362600,MKT
06079810159160000,2021,132853,257647,390500,MKT
06079810159160000,2020,84470,267430,351900,MKT
06079810159160000,2019,84470,267430,351900,MKT
06079810159170000,2021,132853,301647,434500,MKT
06079810159170000,2020,84470,284130,368600,MKT
06079810159170000,2019,84470,284130,368600,MKT
06079810159180000,2021,132853,280547,413400,MKT
06079810159180000,2020,84470,272330,356800,MKT
06079810159180000,2019,84470,272330,356800,MKT
06079810159190000,2021,139780,328120,467900,MKT
06079810159190000,2020,93280,317020,410300,MKT
06079810159190000,2019,93280,317020,410300,MKT
06079810160010000,2021,119245,356255,475500,MKT
06079810160010000,2020,77033,328967,406000,OVR
06079810160010000,2019,77033,328967,406000,MKT
06079810160020000,2021,138172,238328,376500,MKT
06079810160020000,2020,91197,234803,326000,MKT
06079810160020000,2019,91197,234803,326000,MKT
06079810160030000,2021,138172,287428,425600,MKT
06079810160030000,2020,91197,302103,393300,MKT
06079810160030000,2019,91197,302103,393300,MKT
06079810160040000,2021,138172,223428,361600,MKT
06079810160040000,2020,91197,233003,324200,MKT
06079810160040000,2019,91197,233003,324200,MKT
06079810160050000,2021,138172,236528,374700,MKT
06079810160050000,2020,91197,243603,334800,MKT
06079810160050000,2019,91197,243603,334800,MKT
06079810160060000,2021,138172,207028,345200,MKT
06079810160060000,2020,91197,206903,298100,MKT
06079810160060000,2019,91197,206903,298100,MKT
06079810160070000,2021,138172,229828,368000,MKT
06079810160070000,2020,91197,232003,323200,MKT
06079810160070000,2019,91197,232003,323200,MKT
06079810160080000,2021,140288,190012,330300,MKT
06079810160080000,2020,93943,188857,282800,MKT
06079810160080000,2019,93943,188857,282800,MKT
06079810160090000,2021,139951,269749,409700,MKT
06079810160090000,2020,93503,265197,358700,MKT
06079810160090000,2019,93503,265197,358700,MKT
06079810160100000,2021,132853,270847,403700,MKT
06079810160100000,2020,84470,261730,346200,MKT
06079810160100000,2019,84470,261730,346200,MKT
06079810160110000,2021,132853,270447,403300,MKT
06079810160110000,2020,84470,258830,343300,MKT
06079810160110000,2019,84470,258830,343300,MKT
06079810160120000,2021,132853,296747,429600,MKT
06079810160120000,2020,84470,309830,394300,MKT
06079810160120000,2019,84470,309830,394300,MKT
06079810160130000,2021,132853,246347,379200,MKT
06079810160130000,2020,84470,265130,349600,MKT
06079810160130000,2019,84470,265130,349600,MKT
06079810160140000,2021,132853,256547,389400,MKT
06079810160140000,2020,84470,253330,337800,MKT
06079810160140000,2019,84470,253330,337800,MKT
06079810160150000,2021,132853,304447,437300,MKT
06079810160150000,2020,84470,303830,388300,MKT
06079810160150000,2019,84470,302830,387300,MKT
06079810160160000,2021,132853,249747,382600,MKT
06079810160160000,2020,84470,253030,337500,MKT
06079810160160000,2019,84470,253030,337500,MKT
06079810160170000,2021,132853,224847,357700,MKT
06079810160170000,2020,84470,235830,320300,MKT
06079810160170000,2019,84470,235830,320300,MKT
06079810160186500,2021,35384,0,35384,COST
06079810160186500,2020,20089,0,20089,COST
06079810160186500,2019,20089,0,20089,COST
06079810161010000,2021,120729,235471,356200,MKT
06079810161010000,2020,78916,243584,322500,MKT
06079810161010000,2019,78916,243584,322500,MKT
06079810161020000,2021,139892,210508,350400,MKT
06079810161020000,2020,93426,219574,313000,MKT
06079810161020000,2019,93426,219574,313000,MKT
06079810161030000,2021,139892,288108,428000,MKT
06079810161030000,2020,93426,284174,377600,MKT
06079810161030000,2019,93426,284174,377600,MKT
06079810161040000,2021,139892,245608,385500,MKT
06079810161040000,2020,93426,196710,290136,COST
06079810161040000,2019,93426,196710,290136,COST
06079810161050000,2021,139892,232408,372300,MKT
06079810161050000,2020,93426,233374,326800,MKT
06079810161050000,2019,93426,233374,326800,MKT
06079810161060000,2021,139892,283108,423000,MKT
06079810161060000,2020,93426,289074,382500,MKT
06079810161060000,2019,93426,289074,382500,MKT
06079810161070000,2021,139892,175808,315700,MKT
06079810161070000,2020,93426,176674,270100,MKT
06079810161070000,2019,93426,176674,270100,MKT
06079810161080000,2021,142034,230666,372700,MKT
06079810161080000,2020,96239,230761,327000,MKT
06079810161080000,2019,96239,230761,327000,MKT
06079810161090000,2021,142034,250566,392600,MKT
06079810161090000,2020,96239,252161,348400,MKT
06079810161090000,2019,96239,252161,348400,MKT
06079810161100000,2021,139892,249608,389500,MKT
06079810161100000,2020,93426,242774,336200,MKT
06079810161100000,2019,93426,242774,336200,MKT
06079810161110000,2021,139892,260408,400300,MKT
06079810161110000,2020,93426,256074,349500,MKT
06079810161110000,2019,93426,256074,349500,MKT
06079810161120000,2021,139892,240908,380800,MKT
06079810161120000,2020,93426,251474,344900,MKT
06079810161120000,2019,93426,251474,344900,MKT
06079810161130000,2021,139892,273108,413000,MKT
06079810161130000,2020,93426,269974,363400,MKT
06079810161130000,2019,93426,269974,363400,MKT
06079810161140000,2021,139892,226008,365900,MKT
06079810161140000,2020,93426,226574,320000,MKT
06079810161140000,2019,93426,226574,320000,MKT
06079810161150000,2021,139892,209708,349600,MKT
06079810161150000,2020,93426,206474,299900,MKT
06079810161150000,2019,93426,206474,299900,MKT
06079810161160000,2021,120729,212571,333300,MKT
06079810161160000,2020,78916,224284,303200,MKT
06079810161160000,2019,78916,224284,303200,MKT
06079810162010000,2021,120729,219371,340100,MKT
06079810162010000,2020,78916,222184,301100,MKT
06079810162010000,2019,78916,222184,301100,MKT
06079810162020000,2021,139892,227008,366900,MKT
06079810162020000,2020,93426,226274,319700,MKT
06079810162020000,2019,93426,226274,319700,MKT
06079810162030000,2021,139892,273208,413100,MKT
06079810162030000,2020,93426,273274,366700,MKT
06079810162030000,2019,93426,273274,366700,MKT
06079810162040000,2021,139892,239308,379200,MKT
06079810162040000,2020,93426,236174,329600,OVR
06079810162040000,2019,93426,236174,329600,MKT
06079810162050000,2021,139892,225708,365600,MKT
06079810162050000,2020,93426,232574,326000,MKT
06079810162050000,2019,93426,232574,326000,MKT
06079810162060000,2021,139892,223408,363300,MKT
06079810162060000,2020,93426,218274,311700,MKT
06079810162060000,2019,93426,218274,311700,MKT
06079810162070000,2021,139892,223908,363800,MKT
06079810162070000,2020,93426,221874,315300,MKT
06079810162070000,2019,93426,222174,315600,MKT
06079810162080000,2021,142034,232866,374900,MKT
06079810162080000,2020,96239,228161,324400,OVR
06079810162080000,2019,96239,228161,324400,MKT
06079810162090000,2021,140288,321512,461800,MKT
06079810162090000,2020,93943,307957,401900,MKT
06079810162090000,2019,93943,307957,401900,MKT
06079810162100000,2021,138172,221628,359800,MKT
06079810162100000,2020,91197,222503,313700,MKT
06079810162100000,2019,91197,222503,313700,MKT
06079810162110000,2021,138172,182528,320700,MKT
06079810162110000,2020,91197,184703,275900,MKT
06079810162110000,2019,91197,184703,275900,MKT
06079810162120000,2021,138172,211128,349300,MKT
06079810162120000,2020,91197,217803,309000,MKT
06079810162120000,2019,91197,217803,309000,MKT
06079810162130000,2021,138172,217128,355300,MKT
06079810162130000,2020,91197,212303,303500,MKT
06079810162130000,2019,91197,212303,303500,MKT
06079810162140000,2021,138172,250528,388700,MKT
06079810162140000,2020,91197,250803,342000,MKT
06079810162140000,2019,91197,250803,342000,MKT
06079810162150000,2021,138172,305228,443400,MKT
06079810162150000,2020,91197,276303,367500,MKT
06079810162150000,2019,91197,276303,367500,MKT
06079810162160000,2021,119245,319155,438400,MKT
06079810162160000,2020,77033,310467,387500,MKT
06079810162160000,2019,77033,310467,387500,MKT
06079810163010000,2021,154317,214083,368400,MKT
06079810163010000,2020,117429,212171,329600,MKT
06079810163010000,2019,117429,212171,329600,MKT
06079810163020000,2021,150030,220670,370700,MKT
06079810163020000,2020,111146,217854,329000,MKT
06079810163020000,2019,111146,217854,329000,MKT
06079810163030000,2021,150030,182370,332400,MKT
06079810163030000,2020,111146,175854,287000,MKT
06079810163030000,2019,111146,175854,287000,MKT
06079810163040000,2021,150030,211470,361500,MKT
06079810163040000,2020,111146,206654,317800,MKT
06079810163040000,2019,111146,206654,317800,MKT
06079810163050000,2021,150030,185470,335500,MKT
06079810163050000,2020,111146,177854,289000,MKT
06079810163050000,2019,111146,177854,289000,MKT
06079810163060000,2021,150030,219770,369800,MKT
06079810163060000,2020,111146,220154,331300,MKT
06079810163060000,2019,111146,220154,331300,MKT
06079810163070000,2021,150030,213570,363600,MKT
06079810163070000,2020,111146,213554,324700,MKT
06079810163070000,2019,111146,213554,324700,MKT
06079810163080000,2021,129478,263722,393200,MKT
06079810163080000,2020,93884,260016,353900,MKT
06079810163080000,2019,93884,260016,353900,MKT
06079810163096500,2021,111946,0,111946,COST
06079810163096500,2020,190229,0,190229,COST
06079810163096500,2019,190229,0,190229,COST
06079810164010000,2021,129478,289122,418600,MKT
06079810164010000,2020,93884,273116,367000,MKT
06079810164010000,2019,93884,273116,367000,MKT
06079810164030000,2021,150030,287070,437100,MKT
06079810164030000,2020,111146,289954,401100,MKT
06079810164030000,2019,111146,289954,401100,MKT
06079810164050000,2021,150030,262370,412400,MKT
06079810164050000,2020,111146,273954,385100,MKT
06079810164050000,2019,111146,273954,385100,MKT
06079810164070000,2021,150030,335270,485300,MKT
06079810164070000,2020,111146,311354,422500,MKT
06079810164070000,2019,111146,311354,422500,MKT
06079810164090000,2021,150030,346070,496100,MKT
06079810164090000,2020,111146,321854,433000,MKT
06079810164090000,2019,111146,321854,433000,MKT
06079810164110000,2021,150030,305370,455400,MKT
06079810164110000,2020,111146,281554,392700,MKT
06079810164110000,2019,111146,281554,392700,MKT
06079810164130000,2021,150030,279270,429300,MKT
06079810164130000,2020,111146,261954,373100,MKT
06079810164130000,2019,111146,261954,373100,MKT
06079810164150000,2021,158701,324799,483500,MKT
06079810164150000,2020,124029,321371,445400,OVR
06079810164150000,2019,124029,321371,445400,MKT
06079810164170000,2021,158701,506999,665700,MKT
06079810164170000,2020,124029,485771,609800,MKT
06079810164170000,2019,124029,485771,609800,MKT
06079810164190000,2021,150030,325170,475200,MKT
06079810164190000,2020,111146,303154,414300,MKT
06079810164190000,2019,111146,303154,414300,MKT
06079810164210000,2021,150030,272870,422900,MKT
06079810164210000,2020,111146,279354,390500,MKT
06079810164210000,2019,111146,279354,390500,MKT
06079810164230000,2021,150030,307770,457800,MKT
06079810164230000,2020,111146,301954,413100,MKT
06079810164230000,2019,111146,301954,413100,MKT
06079810164250000,2021,150030,288570,438600,MKT
06079810164250000,2020,111146,299954,411100,MKT
06079810164250000,2019,111146,299954,411100,MKT
06079810164270000,2021,150030,385670,535700,MKT
06079810164270000,2020,111146,330054,441200,MKT
06079810164270000,2019,111146,330054,441200,MKT
06079810164290000,2021,150030,284870,434900,MKT
06079810164290000,2020,111146,264254,375400,MKT
06079810164290000,2019,111146,264254,375400,MKT
06079810164310000,2021,152328,310072,462400,MKT
06079810164310000,2020,114492,298908,413400,MKT
06079810164310000,2019,114492,298908,413400,MKT
06079810165170000,2021,138480,239720,378200,MKT
06079810165170000,2020,91594,241106,332700,MKT
06079810165170000,2019,91594,241106,332700,MKT
06079810165190000,2021,136391,234409,370800,MKT
06079810165190000,2020,88917,244683,333600,MKT
06079810165190000,2019,88917,244683,333600,MKT
06079810165210000,2021,136391,257609,394000,MKT
06079810165210000,2020,88917,266483,355400,MKT
06079810165210000,2019,88917,266483,355400,MKT
06079810165230000,2021,136391,287209,423600,MKT
06079810165230000,2020,88917,279283,368200,MKT
06079810165230000,2019,88917,279283,368200,MKT
06079810165250000,2021,136391,337909,474300,MKT
06079810165250000,2020,88917,314883,403800,MKT
06079810165250000,2019,88917,314883,403800,MKT
06079810165270000,2021,136391,247109,383500,MKT
06079810165270000,2020,88917,250683,339600,MKT
06079810165270000,2019,88917,250683,339600,MKT
06079810165290000,2021,136391,332109,468500,MKT
06079810165290000,2020,88917,307283,396200,MKT
06079810165290000,2019,88917,307283,396200,MKT
06079810165310000,2021,138480,269220,407700,MKT
06079810165310000,2020,91594,280806,372400,MKT
06079810165310000,2019,91594,280806,372400,MKT
06079810166170000,2021,138480,269120,407600,MKT
06079810166170000,2020,91594,262006,353600,MKT
06079810166170000,2019,91594,262006,353600,MKT
06079810166190000,2021,136391,274409,410800,MKT
06079810166190000,2020,88917,282583,371500,MKT
06079810166190000,2019,88917,282583,371500,MKT
06079810166210000,2021,136391,229909,366300,MKT
06079810166210000,2020,88917,234683,323600,OVR
06079810166210000,2019,88917,234683,323600,MKT
06079810166230000,2021,136391,240709,377100,MKT
06079810166230000,2020,88917,250883,339800,MKT
06079810166230000,2019,88917,250883,339800,MKT
06079810166250000,2021,136391,276609,413000,MKT
06079810166250000,2020,88917,268483,357400,MKT
06079810166250000,2019,88917,268483,357400,MKT
06079810166270000,2021,136391,258209,394600,MKT
06079810166270000,2020,88917,270483,359400,MKT
06079810166270000,2019,88917,270483,359400,MKT
06079810166290000,2021,136391,230109,366500,MKT
06079810166290000,2020,88917,238183,327100,MKT
06079810166290000,2019,88917,238183,327100,MKT
06079810166310000,2021,117708,249792,367500,MKT
06079810166310000,2020,75107,252993,328100,MKT
06079810166310000,2019,75107,252993,328100,MKT
06079810167010000,2021,138480,283420,421900,MKT
06079810167010000,2020,91594,271906,363500,MKT
06079810167010000,2019,91594,271906,363500,MKT
06079810167030000,2021,136391,235309,371700,MKT
06079810167030000,2020,88917,236583,325500,MKT
06079810167030000,2019,88917,236583,325500,MKT
06079810167050000,2021,136391,316309,452700,MKT
06079810167050000,2020,88917,320583,409500,MKT
06079810167050000,2019,88917,320583,409500,MKT
06079810167070000,2021,136391,252709,389100,MKT
06079810167070000,2020,88917,265783,354700,MKT
06079810167070000,2019,88917,265783,354700,MKT
06079810167090000,2021,136391,288109,424500,MKT
06079810167090000,2020,88917,280383,369300,MKT
06079810167090000,2019,88917,280383,369300,MKT
06079810167110000,2021,136391,229509,365900,MKT
06079810167110000,2020,88917,227583,316500,MKT
06079810167110000,2019,88917,227583,316500,MKT
06079810167130000,2021,136391,249809,386200,MKT
06079810167130000,2020,88917,262383,351300,MKT
06079810167130000,2019,88917,262383,351300,MKT
06079810167150000,2021,138480,286520,425000,MKT
06079810167150000,2020,91594,265406,357000,MKT
06079810167150000,2019,91594,265406,357000,MKT
06079810168010000,2021,144091,247109,391200,MKT
06079810168010000,2020,98977,257423,356400,MKT
06079810168010000,2019,98977,257423,356400,MKT
06079810168030000,2021,158118,252182,410300,MKT
06079810168030000,2020,118655,258745,377400,MKT
06079810168030000,2019,118655,258745,377400,MKT
06079810168050000,2021,155861,292539,448400,MKT
06079810168050000,2020,115372,300428,415800,MKT
06079810168050000,2019,115372,300428,415800,MKT
06079810168070000,2021,155595,264805,420400,MKT
06079810168070000,2020,114987,273113,388100,MKT
06079810168070000,2019,114987,273113,388100,MKT
06079810168090000,2021,155327,310373,465700,MKT
06079810168090000,2020,114601,299899,414500,MKT
06079810168090000,2019,114601,299899,414500,MKT
06079810168110000,2021,155058,240242,395300,MKT
06079810168110000,2020,114215,231085,345300,MKT
06079810168110000,2019,114215,231085,345300,MKT
06079810168130000,2021,154788,234712,389500,MKT
06079810168130000,2020,113827,232573,346400,MKT
06079810168130000,2019,113827,232573,346400,MKT
06079810168150000,2021,154517,273383,427900,MKT
06079810168150000,2020,113437,273863,387300,MKT
06079810168150000,2019,113437,273863,387300,MKT
06079810168170000,2021,153970,259530,413500,MKT
06079810168170000,2020,112655,266845,379500,MKT
06079810168170000,2019,112655,266845,379500,MKT
06079810168190000,2021,153695,229505,383200,MKT
06079810168190000,2020,112262,209138,321400,MKT
06079810168190000,2019,112262,211938,324200,MKT
06079810168210000,2021,153418,289582,443000,MKT
06079810168210000,2020,111868,279032,390900,MKT
06079810168210000,2019,111868,279032,390900,MKT
06079810168230000,2021,153139,261461,414600,MKT
06079810168230000,2020,111472,269228,380700,MKT
06079810168230000,2019,111472,269228,380700,MKT
06079810168250000,2021,155073,235627,390700,MKT
06079810168250000,2020,114236,229864,344100,MKT
06079810168250000,2019,114236,229864,344100,MKT
06079810168270000,2021,140485,200515,341000,MKT
06079810168270000,2020,94201,204599,298800,MKT
06079810168270000,2019,94201,204599,298800,MKT
06079810168720000,2021,121052,220248,341300,MKT
06079810168720000,2020,79328,226272,305600,MKT
06079810168720000,2019,79328,226272,305600,MKT
06079810169010000,2021,141958,303142,445100,MKT
06079810169010000,2020,96138,298062,394200,MKT
06079810169010000,2019,96138,298062,394200,MKT
06079810169030000,2021,141958,233242,375200,MKT
06079810169030000,2020,96138,227762,323900,MKT
06079810169030000,2019,96138,227762,323900,MKT
06079810169050000,2021,158654,232046,390700,MKT
06079810169050000,2020,119442,229658,349100,MKT
06079810169050000,2019,119442,225858,345300,MKT
06079810169070000,2021,177515,347150,524665,COST
06079810169070000,2020,115372,345040,460412,COST
06079810169070000,2019,115372,345040,460412,COST
06079810169090000,2021,155595,334505,490100,MKT
06079810169090000,2020,114987,320713,435700,MKT
06079810169090000,2019,114987,320713,435700,MKT
06079810169110000,2021,155327,340073,495400,MKT
06079810169110000,2020,114601,310899,425500,MKT
06079810169110000,2019,114601,310899,425500,MKT
06079810169130000,2021,155058,305442,460500,MKT
06079810169130000,2020,114215,287785,402000,MKT
06079810169130000,2019,114215,287785,402000,MKT
06079810169150000,2021,154788,282312,437100,MKT
06079810169150000,2020,113827,268873,382700,MKT
06079810169150000,2019,113827,268873,382700,MKT
06079810169170000,2021,154788,299212,454000,MKT
06079810169170000,2020,113827,279173,393000,OVR
06079810169170000,2019,113827,279173,393000,MKT
06079810169190000,2021,153970,241230,395200,MKT
06079810169190000,2020,112655,241345,354000,MKT
06079810169190000,2019,112655,241345,354000,MKT
06079810169210000,2021,153695,259505,413200,MKT
06079810169210000,2020,112262,269538,381800,MKT
06079810169210000,2019,112262,269538,381800,MKT
06079810169230000,2021,153418,213082,366500,MKT
06079810169230000,2020,111868,215432,327300,MKT
06079810169230000,2019,111868,215432,327300,MKT
06079810169250000,2021,153139,342761,495900,MKT
06079810169250000,2020,111472,320728,432200,MKT
06079810169250000,2019,111472,320728,432200,MKT
06079810169270000,2021,152860,291640,444500,MKT
06079810169270000,2020,111075,284225,395300,MKT
06079810169270000,2019,111075,284225,395300,MKT
06079810169290000,2021,138192,199208,337400,MKT
06079810169290000,2020,91224,208076,299300,MKT
06079810169290000,2019,91224,208076,299300,MKT
06079810169310000,2021,138192,231408,369600,MKT
06079810169310000,2020,91224,241476,332700,MKT
06079810169310000,2019,91224,241476,332700,MKT
06079810170010000,2021,141919,254281,396200,MKT
06079810170010000,2020,96087,261313,357400,MKT
06079810170010000,2019,96087,261313,357400,MKT
06079810170030000,2021,141919,275681,417600,MKT
06079810170030000,2020,96087,276613,372700,MKT
06079810170030000,2019,96087,276613,372700,MKT
06079810170050000,2021,141919,233581,375500,MKT
06079810170050000,2020,96087,243113,339200,MKT
06079810170050000,2019,96087,243113,339200,MKT
06079810170070000,2021,141559,261641,403200,MKT
06079810170070000,2020,95611,270789,366400,MKT
06079810170070000,2019,95611,257989,353600,MKT
06079810170090000,2021,141559,279641,421200,MKT
06079810170090000,2020,95611,278389,374000,MKT
06079810170090000,2019,95611,278389,374000,MKT
06079810170110000,2021,141195,229205,370400,MKT
06079810170110000,2020,95133,233767,328900,MKT
06079810170110000,2019,95133,233767,328900,MKT
06079810170130000,2021,141195,296205,437400,MKT
06079810170130000,2020,95133,289767,384900,MKT
06079810170130000,2019,95133,289767,384900,MKT
06079810170150000,2021,140830,261370,402200,MKT
06079810170150000,2020,94652,263948,358600,MKT
06079810170150000,2019,94652,263948,358600,MKT
06079810170170000,2021,140830,275670,416500,MKT
06079810170170000,2020,94652,281748,376400,MKT
06079810170170000,2019,94652,281748,376400,MKT
06079810170190000,2021,140830,255370,396200,MKT
06079810170190000,2020,94652,263248,357900,MKT
06079810170190000,2019,94652,263248,357900,MKT
06079810170210000,2021,140461,289339,429800,MKT
06079810170210000,2020,94170,290330,384500,MKT
06079810170210000,2019,94170,290330,384500,MKT
06079810170230000,2021,140461,224839,365300,MKT
06079810170230000,2020,94170,221730,315900,MKT
06079810170230000,2019,94170,221730,315900,MKT
06079810170250000,2021,141651,231649,373300,MKT
06079810170250000,2020,95733,238367,334100,MKT
06079810170250000,2019,95733,238367,334100,MKT
06079810170270000,2021,145294,227406,372700,MKT
06079810170270000,2020,100597,241003,341600,MKT
06079810170270000,2019,100597,241003,341600,MKT
06079810170290000,2021,125910,209590,335500,MKT
06079810170290000,2020,85661,216939,302600,MKT
06079810170290000,2019,85661,216939,302600,MKT
06079810170310000,2021,120066,247634,367700,MKT
06079810170310000,2020,78072,247628,325700,MKT
06079810170310000,2019,78072,225728,303800,MKT
06079810170330000,2021,121052,260948,382000,MKT
06079810170330000,2020,79328,258072,337400,MKT
06079810170330000,2019,79328,258072,337400,MKT
06079810171010000,2021,138480,263920,402400,MKT
06079810171010000,2020,91594,222210,313804,COST
06079810171010000,2019,91594,206106,297700,MKT
06079810171030000,2021,136391,217709,354100,MKT
06079810171030000,2020,88917,227183,316100,MKT
06079810171030000,2019,88917,227183,316100,MKT
06079810171050000,2021,136391,253309,389700,MKT
06079810171050000,2020,88917,258483,347400,MKT
06079810171050000,2019,88917,258483,347400,MKT
06079810171070000,2021,136391,197309,333700,MKT
06079810171070000,2020,88917,207583,296500,MKT
06079810171070000,2019,88917,207583,296500,MKT
06079810171090000,2021,136391,219309,355700,MKT
06079810171090000,2020,88917,225883,314800,MKT
06079810171090000,2019,88917,225883,314800,MKT
06079810171110000,2021,136391,301009,437400,MKT
06079810171110000,2020,88917,284783,373700,MKT
06079810171110000,2019,88917,284783,373700,MKT
06079810171130000,2021,136391,229209,365600,MKT
06079810171130000,2020,88917,245783,334700,MKT
06079810171130000,2019,88917,245783,334700,MKT
06079810171150000,2021,117708,228492,346200,MKT
06079810171150000,2020,75107,228593,303700,MKT
06079810171150000,2019,75107,228593,303700,MKT
06079810201037000,2021,165424,0,165424,COST
06079810201037000,2020,129591,0,129591,COST
06079810201037000,2019,129591,0,129591,COST
06079810201057000,2021,162203,0,162203,COST
06079810201057000,2020,124711,0,124711,COST
06079810201057000,2019,124711,0,124711,COST
06079810201077000,2021,162200,0,162200,COST
06079810201077000,2020,124707,0,124707,COST
06079810201077000,2019,124707,0,124707,COST
06079810201086500,2021,65487,0,65487,COST
06079810201086500,2020,66801,0,66801,COST
06079810201086500,2019,66801,0,66801,COST
06079810201097000,2021,163407,0,163407,COST
06079810201097000,2020,126524,0,126524,COST
06079810201097000,2019,126524,0,126524,COST
06079810201106500,2021,64752,0,64752,COST
06079810201106500,2020,65345,0,65345,COST
06079810201106500,2019,65345,0,65345,COST
06079810201115001,2021,105485,161815,267300,MKT
06079810201115001,2020,53848,178152,232000,MKT
06079810201115001,2019,53848,178152,232000,MKT
06079810201115002,2021,103918,163082,267000,MKT
06079810201115002,2020,52298,177302,229600,MKT
06079810201115002,2019,52298,177302,229600,MKT
06079810201115003,2021,103909,163091,267000,MKT
06079810201115003,2020,52289,177211,229500,MKT
06079810201115003,2019,52289,177211,229500,MKT
06079810201115004,2021,103909,163091,267000,MKT
06079810201115004,2020,52289,177211,229500,MKT
06079810201115004,2019,52289,177211,229500,MKT
06079810201115005,2021,114269,156431,270700,MKT
06079810201115005,2020,62947,171553,234500,MKT
06079810201115005,2019,62947,171553,234500,MKT
06079810201137000,2021,131926,0,131926,COST
06079810201137000,2020,83324,0,83324,COST
06079810201137000,2019,83324,0,83324,COST
06079810201140000,2021,273113,0,273113,COST
06079810201140000,2020,344811,0,344811,COST
06079810201140000,2019,344811,0,344811,COST
06079810201150000,2021,125683,448417,574100,INCOME
06079810201150000,2020,75801,346499,422300,INCOME
06079810201150000,2019,75801,346499,422300,INCOME
06079810201170000,2021,125683,278517,404200,MKT
06079810201170000,2020,75801,261899,337700,MKT
06079810201170000,2019,75801,261899,337700,MKT
06079810201190000,2021,125683,319917,445600,MKT
06079810201190000,2020,75801,314399,390200,MKT
06079810201190000,2019,75801,314399,390200,MKT
06079810201210000,2021,125683,264917,390600,MKT
06079810201210000,2020,75801,244299,320100,MKT
06079810201210000,2019,75801,244299,320100,MKT
06079810201237000,2021,125683,0,125683,COST
06079810201237000,2020,75801,0,75801,COST
06079810201237000,2019,75801,0,75801,COST
06079810201250000,2021,125683,645217,770900,INCOME
06079810201250000,2020,75801,554199,630000,INCOME
06079810201250000,2019,75801,554199,630000,INCOME
06079810201270000,2021,131912,512088,644000,INCOME
06079810201270000,2020,83307,423393,506700,INCOME
06079810201270000,2019,83307,423393,506700,INCOME
06079810201400000,2021,2955933,5884250,8840183,COST
06079810201400000,2020,1377701,5623400,7001101,COST
06079810201400000,2019,1377701,5623400,7001101,COST
06079810201457000,2021,333304,32990,366294,COST
06079810201457000,2020,508645,32740,541385,COST
06079810201457000,2019,508645,32740,541385,COST
06079810202010000,2021,127291,226909,354200,MKT
06079810202010000,2020,77705,234895,312600,MKT
06079810202010000,2019,77705,234895,312600,MKT
06079810202016500,2021,87711,0,87711,COST
06079810202016500,2020,118161,0,118161,COST
06079810202016500,2019,118161,0,118161,COST
06079810202030000,2021,118443,235057,353500,MKT
06079810202030000,2020,67512,240288,307800,MKT
06079810202030000,2019,67512,240288,307800,MKT
06079810202050000,2021,118443,266057,384500,MKT
06079810202050000,2020,67512,262088,329600,MKT
06079810202050000,2019,67512,262088,329600,MKT
06079810202070000,2021,124266,422130,546396,COST
06079810202070000,2020,74142,424000,498142,COST
06079810202070000,2019,74142,424000,498142,COST
06079810202090000,2021,122751,277549,400300,MKT
06079810202090000,2020,72388,273512,345900,MKT
06079810202090000,2019,72388,273512,345900,MKT
06079810202110000,2021,122916,271984,394900,MKT
06079810202110000,2020,72578,267822,340400,MKT
06079810202110000,2019,72578,267822,340400,MKT
06079810202130000,2021,123086,281714,404800,MKT
06079810202130000,2020,72774,278926,351700,MKT
06079810202130000,2019,72774,278926,351700,MKT
06079810202150000,2021,123250,273950,397200,MKT
06079810202150000,2020,72964,264636,337600,MKT
06079810202150000,2019,72964,264636,337600,MKT
06079810202170000,2021,126104,248896,375000,MKT
06079810202170000,2020,76297,253803,330100,MKT
06079810202170000,2019,76297,253803,330100,MKT
06079810202190000,2021,118443,285657,404100,MKT
06079810202190000,2020,67512,261688,329200,MKT
06079810202190000,2019,67512,261688,329200,MKT
06079810202206500,2021,41545,0,41545,COST
06079810202206500,2020,27480,0,27480,COST
06079810202206500,2019,27480,0,27480,COST
06079810202210000,2021,118443,231357,349800,MKT
06079810202210000,2020,67512,238288,305800,MKT
06079810202210000,2019,67512,238288,305800,MKT
06079810202230000,2021,127291,233609,360900,MKT
06079810202230000,2020,77705,237595,315300,MKT
06079810202230000,2019,77705,237595,315300,MKT
06079810202250000,2021,123900,241100,365000,MKT
06079810202250000,2020,73716,239484,313200,MKT
06079810202250000,2019,73716,239484,313200,MKT
06079810202270000,2021,123900,241100,365000,MKT
06079810202270000,2020,73716,239484,313200,MKT
06079810202270000,2019,73716,239484,313200,MKT
06079810202290000,2021,123900,232200,356100,MKT
06079810202290000,2020,73716,239884,313600,MKT
06079810202290000,2019,73716,239884,313600,MKT
06079810202310000,2021,123900,232200,356100,MKT
06079810202310000,2020,73716,239884,313600,MKT
06079810202310000,2019,73716,239884,313600,MKT
06079810202330000,2021,118663,277637,396300,MKT
06079810202330000,2020,67757,288243,356000,MKT
06079810202330000,2019,67757,288243,356000,MKT
06079810202350000,2021,118443,195457,313900,MKT
06079810202350000,2020,67512,182088,249600,MKT
06079810202350000,2019,67512,182088,249600,MKT
06079810202370000,2021,118443,285257,403700,MKT
06079810202370000,2020,67512,267588,335100,MKT
06079810202370000,2019,67512,267588,335100,MKT
06079810202390000,2021,118443,276057,394500,MKT
06079810202390000,2020,67512,259688,327200,MKT
06079810202390000,2019,67512,259688,327200,MKT
06079810202410000,2021,121330,301370,422700,MKT
06079810202410000,2020,70761,276439,347200,MKT
06079810202410000,2019,70761,276439,347200,MKT
06079810202430000,2021,137646,305654,443300,MKT
06079810202430000,2020,90521,319579,410100,MKT
06079810202430000,2019,90521,319579,410100,MKT
06079810202450000,2021,120629,322071,442700,MKT
06079810202450000,2020,69965,329035,399000,MKT
06079810202450000,2019,69965,329035,399000,MKT
06079810202470000,2021,120623,248377,369000,MKT
06079810202470000,2020,69959,252241,322200,MKT
06079810202470000,2019,69959,252241,322200,MKT
06079810202490000,2021,120629,262271,382900,MKT
06079810202490000,2020,69965,257735,327700,MKT
06079810202490000,2019,69965,257735,327700,MKT
06079810202510000,2021,131922,322778,454700,MKT
06079810202510000,2020,83319,339181,422500,MKT
06079810202510000,2019,83319,339181,422500,MKT
06079810203010000,2021,118443,245457,363900,MKT
06079810203010000,2020,67512,253888,321400,MKT
06079810203010000,2019,67512,253888,321400,MKT
06079810203020000,2021,118443,263257,381700,MKT
06079810203020000,2020,67512,266588,334100,MKT
06079810203020000,2019,67512,266588,334100,MKT
06079810203030000,2021,118443,279657,398100,MKT
06079810203030000,2020,67512,276788,344300,MKT
06079810203030000,2019,67512,276788,344300,MKT
06079810203050000,2021,131894,354606,486500,MKT
06079810203050000,2020,83284,341916,425200,MKT
06079810203050000,2019,83284,341916,425200,MKT
06079810203070000,2021,138549,287251,425800,MKT
06079810203070000,2020,91684,282516,374200,MKT
06079810203070000,2019,91684,282516,374200,MKT
06079810203090000,2021,131894,301506,433400,MKT
06079810203090000,2020,83284,296916,380200,MKT
06079810203090000,2019,83284,296916,380200,MKT
06079810203110000,2021,131894,401770,533664,COST
06079810203110000,2020,83284,403280,486564,COST
06079810203110000,2019,83284,403280,486564,COST
06079810203136500,2021,64962,0,64962,COST
06079810203136500,2020,65759,0,65759,COST
06079810203136500,2019,65759,0,65759,COST
06079810203150000,2021,131894,420406,552300,MKT
06079810203150000,2020,83284,369416,452700,MKT
06079810203150000,2019,83284,369416,452700,MKT
06079810203170000,2021,131894,474300,606194,COST
06079810203170000,2020,83284,476830,560114,COST
06079810203170000,2019,83284,401220,484504,COST
06079810203190000,2021,138549,423840,562389,COST
06079810203190000,2020,91684,425970,517654,COST
06079810203190000,2019,91684,425970,517654,COST
06079810203210000,2021,131894,431260,563154,COST
06079810203210000,2020,83284,434190,517474,COST
06079810203210000,2019,83284,434190,517474,COST
06079810203230000,2021,131894,451420,583314,COST
06079810203230000,2020,83284,452310,535594,COST
06079810203230000,2019,83284,452310,535594,COST
06079810203250000,2021,131894,288206,420100,MKT
06079810203250000,2020,83284,286216,369500,MKT
06079810203250000,2019,83284,286216,369500,MKT
06079810203270000,2021,131894,323706,455600,MKT
06079810203270000,2020,83284,330016,413300,MKT
06079810203270000,2019,83284,330016,413300,MKT
06079810203290000,2021,138549,354900,493449,COST
06079810203290000,2020,91684,353580,445264,COST
06079810203290000,2019,91684,353580,445264,COST
06079810203310000,2021,138549,313051,451600,MKT
06079810203310000,2020,91684,307916,399600,MKT
06079810203310000,2019,91684,307916,399600,MKT
06079810203330000,2021,139965,471035,611000,MKT
06079810203330000,2020,80477,407123,487600,MKT
06079810203330000,2019,80477,407123,487600,MKT
06079810203357000,2021,145645,0,145645,COST
06079810203357000,2020,86975,0,86975,COST
06079810203357000,2019,86975,0,86975,COST
06079810204016500,2021,95937,0,95937,COST
06079810204016500,2020,140755,0,140755,COST
06079810204016500,2019,140755,0,140755,COST
06079810204037000,2021,265573,0,265573,COST
06079810204037000,2020,280939,0,280939,COST
06079810204037000,2019,280939,0,280939,COST
06079810204077000,2021,196812,0,196812,COST
06079810204077000,2020,181907,0,181907,COST
06079810204077000,2019,181907,0,181907,COST
06079810204097000,2021,196812,0,196812,COST
06079810204097000,2020,181907,0,181907,COST
06079810204097000,2019,181907,0,181907,COST
06079810205017000,2021,134210,0,134210,COST
06079810205017000,2020,86163,0,86163,COST
06079810205017000,2019,86163,0,86163,COST
06079810205037000,2021,129528,0,129528,COST
06079810205037000,2020,80394,0,80394,COST
06079810205037000,2019,80394,0,80394,COST
06079810205137000,2021,155743,0,155743,COST
06079810205137000,2020,115201,0,115201,COST
06079810205137000,2019,115201,0,115201,COST
06079810205237000,2021,332682,0,332682,COST
06079810205237000,2020,436106,0,436106,COST
06079810205237000,2019,436106,0,436106,COST
06079810205337000,2021,204173,0,204173,COST
06079810205337000,2020,195423,0,195423,COST
06079810205337000,2019,195423,0,195423,COST
06079810205357000,2021,209583,0,209583,COST
06079810205357000,2020,205658,0,205658,COST
06079810205357000,2019,205658,0,205658,COST
06079810206010000,2021,129528,366740,496268,COST
06079810206010000,2020,80394,372440,452834,COST
06079810206010000,2019,80394,372440,452834,COST
06079810206030000,2021,129528,305672,435200,MKT
06079810206030000,2020,80394,305206,385600,MKT
06079810206030000,2019,80394,305206,385600,MKT
06079810206050000,2021,129528,445472,575000,MKT
06079810206050000,2020,80394,406906,487300,MKT
06079810206050000,2019,80394,406906,487300,MKT
06079810206070000,2021,135962,587138,723100,MKT
06079810206070000,2020,88372,513828,602200,MKT
06079810206070000,2019,88372,513828,602200,MKT
06079810206090000,2021,129528,576120,705648,COST
06079810206090000,2020,80394,578180,658574,COST
06079810206090000,2019,80394,557620,638014,COST
06079810206110000,2021,129528,324072,453600,MKT
06079810206110000,2020,80394,325106,405500,OVR
06079810206110000,2019,80394,325106,405500,MKT
06079810206136500,2021,55450,0,55450,COST
06079810206136500,2020,48279,0,48279,COST
06079810206136500,2019,48279,0,48279,COST
06079810206150000,2021,129528,0,129528,COST
06079810206150000,2020,80394,0,80394,COST
06079810206150000,2019,80394,0,80394,COST
06079810206170000,2021,129528,362872,492400,MKT
06079810206170000,2020,80394,342906,423300,MKT
06079810206170000,2019,80394,342906,423300,MKT
06079810206190000,2021,135962,487190,623152,COST
06079810206190000,2020,88372,491240,579612,COST
06079810206190000,2019,88372,491240,579612,COST
06079810206210000,2021,129528,389272,518800,MKT
06079810206210000,2020,80394,366206,446600,MKT
06079810206210000,2019,80394,366206,446600,MKT
06079810206230000,2021,129528,456740,586268,COST
06079810206230000,2020,80394,449680,530074,COST
06079810206230000,2019,80394,449680,530074,COST
06079810206250000,2021,129528,500990,630518,COST
06079810206250000,2020,80394,318906,399300,MKT
06079810206250000,2019,80394,318906,399300,MKT
06079810206270000,2021,129528,0,129528,COST
06079810206270000,2020,80394,0,80394,COST
06079810206270000,2019,80394,0,80394,COST
06079810206290000,2021,135962,505180,641142,COST
06079810206290000,2020,88372,509580,597952,COST
06079810206290000,2019,88372,509580,597952,COST
06079810206310000,2021,129769,296331,426100,MKT
06079810206310000,2020,80685,317315,398000,MKT
06079810206310000,2019,80685,317315,398000,MKT
06079810206330000,2021,144705,428195,572900,MKT
06079810206330000,2020,85883,357717,443600,MKT
06079810206330000,2019,85883,357717,443600,MKT
06079810206350000,2021,139890,583910,723800,MKT
06079810206350000,2020,80394,548706,629100,MKT
06079810206350000,2019,80394,548706,629100,MKT
06079810206370000,2021,139890,510710,650600,MKT
06079810206370000,2020,80394,476906,557300,OVR
06079810206370000,2019,80394,476906,557300,MKT
06079810206390000,2021,139890,518110,658000,MKT
06079810206390000,2020,80394,466406,546800,MKT
06079810206390000,2019,80394,466406,546800,MKT
06079810206410000,2021,129528,481640,611168,COST
06079810206410000,2020,80394,483970,564364,COST
06079810206410000,2019,80394,483970,564364,COST
06079810206430000,2021,129528,381450,510978,COST
06079810206430000,2020,80394,383430,463824,COST
06079810206430000,2019,80394,383430,463824,COST
06079810206450000,2021,135962,451450,587412,COST
06079810206450000,2020,88372,442090,530462,COST
06079810206450000,2019,88372,442090,530462,COST
06079810206470000,2021,129528,502440,631968,COST
06079810206470000,2020,80394,493860,574254,COST
06079810206470000,2019,80394,493860,574254,COST
06079810206490000,2021,129528,451770,581298,COST
06079810206490000,2020,80394,455630,536024,COST
06079810206490000,2019,80394,455630,536024,COST
06079810206510000,2021,135962,433890,569852,COST
06079810206510000,2020,88372,436070,524442,COST
06079810206510000,2019,88372,436070,524442,COST
06079810206530000,2021,129528,478310,607838,COST
06079810206530000,2020,80394,482190,562584,COST
06079810206530000,2019,80394,482190,562584,COST
06079810206550000,2021,129528,426110,555638,COST
06079810206550000,2020,80394,429870,510264,COST
06079810206550000,2019,80394,429870,510264,COST
06079810206570000,2021,129528,474740,604268,COST
06079810206570000,2020,80394,478300,558694,COST
06079810206570000,2019,80394,478300,558694,COST
06079810206590000,2021,129528,406000,535528,COST
06079810206590000,2020,80394,408750,489144,COST
06079810206590000,2019,80394,408750,489144,COST
06079810206610000,2021,135962,463990,599952,COST
06079810206610000,2020,88372,467470,555842,COST
06079810206610000,2019,88372,467470,555842,COST
06079810206630000,2021,129528,297772,427300,MKT
06079810206630000,2020,80394,298406,378800,MKT
06079810206630000,2019,80394,298406,378800,MKT
06079810206650000,2021,129528,439640,569168,COST
06079810206650000,2020,80394,432110,512504,COST
06079810206650000,2019,80394,432110,512504,COST
06079810206670000,2021,129528,492572,622100,MKT
06079810206670000,2020,80394,409506,489900,MKT
06079810206670000,2019,80394,409506,489900,MKT
06079810206690000,2021,129528,338572,468100,MKT
06079810206690000,2020,80394,341706,422100,MKT
06079810206690000,2019,80394,341706,422100,MKT
06079810207010000,2021,125683,373317,499000,MKT
06079810207010000,2020,75801,366399,442200,MKT
06079810207010000,2019,75801,366399,442200,MKT
06079810207030000,2021,133082,398018,531100,MKT
06079810207030000,2020,84754,371246,456000,MKT
06079810207030000,2019,84754,371246,456000,MKT
06079810207050000,2021,132853,456947,589800,MKT
06079810207050000,2020,84470,402030,486500,MKT
06079810207050000,2019,84470,402030,486500,MKT
06079810207070000,2021,132853,485140,617993,COST
06079810207070000,2020,84470,487750,572220,COST
06079810207070000,2019,84470,487750,572220,COST
06079810207090000,2021,132853,476880,609733,COST
06079810207090000,2020,84470,476680,561150,COST
06079810207090000,2019,84470,476680,561150,COST
06079810207110000,2021,132867,0,132867,COST
06079810207110000,2020,84487,0,84487,COST
06079810207110000,2019,84487,0,84487,COST
06079810207136500,2021,60321,0,60321,COST
06079810207136500,2020,56902,0,56902,COST
06079810207136500,2019,56902,0,56902,COST
06079810207136501,2021,107943,0,107943,COST
06079810207136501,2020,177180,0,177180,COST
06079810207136501,2019,177180,0,177180,COST
06079810207150000,2021,146603,639610,786213,COST
06079810207150000,2020,102374,623190,725564,COST
06079810207150000,2019,102374,623190,725564,COST
06079810207170000,2021,147059,484800,631859,COST
06079810207170000,2020,102997,504510,607507,COST
06079810207170000,2019,102997,504510,607507,COST
06079810207190000,2021,153059,0,153059,COST
06079810207190000,2020,111358,0,111358,COST
06079810207190000,2019,111358,0,111358,COST
06079810207210000,2021,160820,574570,735390,COST
06079810207210000,2020,122644,567240,689884,COST
06079810207210000,2019,122644,441656,564300,MKT
06079810207230000,2021,166156,665460,831616,COST
06079810207230000,2020,130712,678230,808942,COST
06079810207230000,2019,130712,678230,808942,COST
06079810207250000,2021,155300,600560,755860,COST
06079810207250000,2020,98584,603320,701904,COST
06079810207250000,2019,98584,603320,701904,COST
06079810207270000,2021,154474,570126,724600,MKT
06079810207270000,2020,97562,496338,593900,MKT
06079810207270000,2019,97562,496338,593900,MKT
06079810207290000,2021,152888,582680,735568,COST
06079810207290000,2020,95616,588410,684026,COST
06079810207290000,2019,95616,588410,684026,COST
06079810207310000,2021,155228,446472,601700,MKT
06079810207310000,2020,98495,393405,491900,MKT
06079810207310000,2019,98495,393405,491900,MKT
06079810207330000,2021,141748,416052,557800,MKT
06079810207330000,2020,82490,383110,465600,MKT
06079810207330000,2019,82490,383110,465600,MKT
06079810207350000,2021,148198,470630,618828,COST
06079810207350000,2020,89975,462760,552735,COST
06079810207350000,2019,89975,366925,456900,MKT
06079810207370000,2021,136412,491888,628300,MKT
06079810207370000,2020,88944,461756,550700,MKT
06079810207370000,2019,88944,461756,550700,MKT
06079810207390000,2021,136412,529588,666000,MKT
06079810207390000,2020,88944,504056,593000,MKT
06079810207390000,2019,88944,504056,593000,MKT
06079810207410000,2021,136710,586070,722780,COST
06079810207410000,2020,89323,579710,669033,COST
06079810207410000,2019,89323,579710,669033,COST
06079810207430000,2021,133008,462692,595700,MKT
06079810207430000,2020,84664,424636,509300,MKT
06079810207430000,2019,84664,424636,509300,MKT
06079810207450000,2021,132857,409620,542477,COST
06079810207450000,2020,84476,411950,496426,COST
06079810207450000,2019,84476,410070,494546,COST
06079810207470000,2021,132853,507247,640100,MKT
06079810207470000,2020,84470,475030,559500,MKT
06079810207470000,2019,84470,475030,559500,MKT
06079810207490000,2021,132853,476240,609093,COST
06079810207490000,2020,84470,469970,554440,COST
06079810207490000,2019,84470,469970,554440,COST
06079810207510000,2021,132853,443280,576133,COST
06079810207510000,2020,84470,437410,521880,COST
06079810207510000,2019,84470,437410,521880,COST
06079810207530000,2021,133082,368518,501600,MKT
06079810207530000,2020,84754,358646,443400,MKT
06079810207530000,2019,84754,358646,443400,MKT
06079810207550000,2021,125683,419790,545473,COST
06079810207550000,2020,75801,420350,496151,COST
06079810207550000,2019,75801,420350,496151,COST
06079810208197000,2021,129528,0,129528,COST
06079810208197000,2020,80394,0,80394,COST
06079810208197000,2019,80394,0,80394,COST
06079810208215001,2021,114311,206889,321200,MKT
06079810208215001,2020,62992,214908,277900,MKT
06079810208215001,2019,62992,214908,277900,MKT
06079810208235002,2021,107726,215074,322800,MKT
06079810208235002,2020,56103,219897,276000,MKT
06079810208235002,2019,56103,219897,276000,MKT
06079810208255003,2021,107726,215474,323200,MKT
06079810208255003,2020,56103,220197,276300,MKT
06079810208255003,2019,56103,220197,276300,MKT
06079810208275004,2021,114311,206889,321200,MKT
06079810208275004,2020,62992,214908,277900,MKT
06079810208275004,2019,62992,214908,277900,MKT
06079810208295001,2021,114311,207689,322000,MKT
06079810208295001,2020,62992,215808,278800,MKT
06079810208295001,2019,62992,215808,278800,MKT
06079810208315002,2021,107726,215874,323600,MKT
06079810208315002,2020,56103,220797,276900,MKT
06079810208315002,2019,56103,220797,276900,MKT
06079810208335003,2021,107726,215874,323600,MKT
06079810208335003,2020,56103,220797,276900,MKT
06079810208335003,2019,56103,220797,276900,MKT
06079810208355004,2021,114311,207689,322000,MKT
06079810208355004,2020,62992,215808,278800,MKT
06079810208355004,2019,62992,215808,278800,MKT
06079810208375001,2021,114311,207689,322000,MKT
06079810208375001,2020,62992,215808,278800,MKT
06079810208375001,2019,62992,215708,278700,MKT
06079810208395002,2021,107726,215774,323500,MKT
06079810208395002,2020,56103,220797,276900,MKT
06079810208395002,2019,56103,220597,276700,MKT
06079810208415003,2021,107726,215474,323200,MKT
06079810208415003,2020,56103,220497,276600,MKT
06079810208415003,2019,56103,220497,276600,MKT
06079810208435004,2021,114311,207689,322000,MKT
06079810208435004,2020,62992,215808,278800,MKT
06079810208435004,2019,62992,215708,278700,MKT
06079810208477000,2021,190306,0,190306,COST
06079810208477000,2020,170355,0,170355,COST
06079810208477000,2019,170355,0,170355,COST
06079810209097000,2021,249512,0,249512,COST
06079810209097000,2020,289046,0,289046,COST
06079810209097000,2019,289046,0,289046,COST
06079810209170000,2021,242437,880863,1123300,INCOME
06079810209170000,2020,137548,882652,1020200,INCOME
06079810209170000,2019,137548,882652,1020200,INCOME
06079810209190000,2021,224905,898395,1123300,INCOME
06079810209190000,2020,128877,891323,1020200,INCOME
06079810209190000,2019,128877,891323,1020200,INCOME
06079810209217000,2021,203936,0,203936,COST
06079810209217000,2020,194980,0,194980,COST
06079810209217000,2019,194980,0,194980,COST
06079810210017000,2021,188749,0,188749,COST
06079810210017000,2020,167645,0,167645,COST
06079810210017000,2019,167645,0,167645,COST
06079810210117000,2021,234557,0,234557,COST
06079810210117000,2020,256198,0,256198,COST
06079810210117000,2019,256198,0,256198,COST
06079810211010000,2021,128135,416210,544345,COST
06079810211010000,2020,78714,415880,494594,COST
06079810211010000,2019,78714,415880,494594,COST
06079810211030000,2021,118443,265157,383600,MKT
06079810211030000,2020,67512,279988,347500,MKT
06079810211030000,2019,67512,279988,347500,MKT
06079810211050000,2021,118443,302657,421100,MKT
06079810211050000,2020,67512,290888,358400,MKT
06079810211050000,2019,67512,286388,353900,MKT
06079810211070000,2021,118443,305657,424100,MKT
06079810211070000,2020,67512,302188,369700,MKT
06079810211070000,2019,67512,302188,369700,MKT
06079810211090000,2021,118443,289957,408400,MKT
06079810211090000,2020,67512,290688,358200,MKT
06079810211090000,2019,67512,290688,358200,MKT
06079810211110000,2021,118443,279957,398400,MKT
06079810211110000,2020,67512,269888,337400,MKT
06079810211110000,2019,67512,269888,337400,MKT
06079810211130000,2021,118443,241257,359700,MKT
06079810211130000,2020,67512,246088,313600,MKT
06079810211130000,2019,67512,243188,310700,MKT
06079810211150000,2021,118443,272257,390700,MKT
06079810211150000,2020,67512,275988,343500,MKT
06079810211150000,2019,67512,275988,343500,MKT
06079810211170000,2021,118443,289857,408300,MKT
06079810211170000,2020,67512,277688,345200,MKT
06079810211170000,2019,67512,277688,345200,MKT
06079810211190000,2021,149655,481090,630745,COST
06079810211190000,2020,91710,483150,574860,COST
06079810211190000,2019,91710,483150,574860,COST
06079810211210000,2021,143446,244354,387800,MKT
06079810211210000,2020,84430,272870,357300,MKT
06079810211210000,2019,84430,272870,357300,MKT
06079810211230000,2021,143446,586690,730136,COST
06079810211230000,2020,84430,698200,782630,COST
06079810211230000,2019,84430,704030,788460,COST
06079810211250000,2021,118443,263657,382100,MKT
06079810211250000,2020,67512,272188,339700,MKT
06079810211250000,2019,67512,272188,339700,MKT
06079810211270000,2021,118443,278957,397400,MKT
06079810211270000,2020,67512,281288,348800,MKT
06079810211270000,2019,67512,281288,348800,MKT
06079810211290000,2021,118443,272357,390800,MKT
06079810211290000,2020,67512,273988,341500,MKT
06079810211290000,2019,67512,272188,339700,MKT
06079810211310000,2021,118443,265157,383600,MKT
06079810211310000,2020,67512,272088,339600,MKT
06079810211310000,2019,67512,271388,338900,MKT
06079810211330000,2021,118443,272157,390600,MKT
06079810211330000,2020,67512,267188,334700,MKT
06079810211330000,2019,67512,267488,335000,MKT
06079810211350000,2021,118443,264957,383400,MKT
06079810211350000,2020,67512,261388,328900,MKT
06079810211350000,2019,67512,261388,328900,MKT
06079810211370000,2021,118443,272057,390500,MKT
06079810211370000,2020,67512,267888,335400,MKT
06079810211370000,2019,67512,267888,335400,MKT
06079810211390000,2021,118443,272857,391300,MKT
06079810211390000,2020,67512,267588,335100,MKT
06079810211390000,2019,67512,267588,335100,MKT
06079810211410000,2021,127213,338020,465233,COST
06079810211410000,2020,77613,344570,422183,COST
06079810211410000,2019,77613,344570,422183,COST
06079810212010000,2021,128579,408221,536800,INCOME
06079810212010000,2020,79247,343053,422300,INCOME
06079810212010000,2019,79247,343053,422300,INCOME
06079810212030000,2021,118443,269357,387800,MKT
06079810212030000,2020,67512,265988,333500,MKT
06079810212030000,2019,67512,265988,333500,MKT
06079810212050000,2021,118443,297557,416000,MKT
06079810212050000,2020,67512,293988,361500,MKT
06079810212050000,2019,67512,293988,361500,MKT
06079810212070000,2021,118443,1870,120313,COST
06079810212070000,2020,67512,1960,69472,COST
06079810212070000,2019,67512,1960,69472,COST
06079810212090000,2021,118443,279657,398100,MKT
06079810212090000,2020,67512,275388,342900,MKT
06079810212090000,2019,67512,275388,342900,MKT
06079810212110000,2021,118443,298857,417300,MKT
06079810212110000,2020,67512,297088,364600,MKT
06079810212110000,2019,67512,297088,364600,MKT
06079810212130000,2021,118443,283357,401800,MKT
06079810212130000,2020,67512,275788,343300,MKT
06079810212130000,2019,67512,275788,343300,MKT
06079810212150000,2021,118443,294657,413100,MKT
06079810212150000,2020,67512,286888,354400,MKT
06079810212150000,2019,67512,286888,354400,MKT
06079810212170000,2021,118443,302757,421200,MKT
06079810212170000,2020,67512,300588,368100,MKT
06079810212170000,2019,67512,290988,358500,MKT
06079810212190000,2021,118443,253157,371600,MKT
06079810212190000,2020,67512,273288,340800,MKT
06079810212190000,2019,67512,273288,340800,MKT
06079810212210000,2021,144807,340393,485200,MKT
06079810212210000,2020,86000,355700,441700,MKT
06079810212210000,2019,86000,355700,441700,MKT
06079810212230000,2021,128941,324659,453600,MKT
06079810212230000,2020,68569,344031,412600,MKT
06079810212230000,2019,68569,344031,412600,MKT
06079810212250000,2021,136295,0,136295,COST
06079810212250000,2020,76410,0,76410,COST
06079810212250000,2019,76410,0,76410,COST
06079810212270000,2021,118443,270657,389100,MKT
06079810212270000,2020,67512,282188,349700,MKT
06079810212270000,2019,67512,282188,349700,MKT
06079810212290000,2021,118443,291757,410200,MKT
06079810212290000,2020,67512,289488,357000,MKT
06079810212290000,2019,67512,289488,357000,MKT
06079810212310000,2021,118443,290657,409100,MKT
06079810212310000,2020,67512,289488,357000,MKT
06079810212310000,2019,67512,289488,357000,MKT
06079810212330000,2021,118443,289257,407700,MKT
06079810212330000,2020,67512,289588,357100,MKT
06079810212330000,2019,67512,289588,357100,MKT
06079810212350000,2021,118443,289357,407800,MKT
06079810212350000,2020,67512,279288,346800,MKT
06079810212350000,2019,67512,279288,346800,MKT
06079810212370000,2021,118443,269357,387800,MKT
06079810212370000,2020,67512,274488,342000,MKT
06079810212370000,2019,67512,274488,342000,MKT
06079810212390000,2021,118443,269557,388000,MKT
06079810212390000,2020,67512,285988,353500,OVR
06079810212390000,2019,67512,285988,353500,MKT
06079810212410000,2021,118443,286257,404700,MKT
06079810212410000,2020,67512,279988,347500,MKT
06079810212410000,2019,67512,279988,347500,MKT
06079810212430000,2021,118443,284657,403100,MKT
06079810212430000,2020,67512,292188,359700,MKT
06079810212430000,2019,67512,292188,359700,MKT
06079810212450000,2021,128332,417268,545600,MKT
06079810212450000,2020,78951,381849,460800,MKT
06079810212450000,2019,78951,381849,460800,MKT
06079810213010000,2021,130642,406158,536800,INCOME
06079810213010000,2020,81748,424952,506700,INCOME
06079810213010000,2019,81748,424952,506700,INCOME
06079810213030000,2021,121471,274229,395700,MKT
06079810213030000,2020,70922,269878,340800,MKT
06079810213030000,2019,70922,269878,340800,MKT
06079810213050000,2021,121471,274229,395700,MKT
06079810213050000,2020,70922,272278,343200,MKT
06079810213050000,2019,70922,272278,343200,MKT
06079810213070000,2021,121471,276129,397600,MKT
06079810213070000,2020,70922,272478,343400,MKT
06079810213070000,2019,70922,272478,343400,MKT
06079810213090000,2021,121816,276084,397900,MKT
06079810213090000,2020,71316,268784,340100,MKT
06079810213090000,2019,71316,268784,340100,MKT
06079810213110000,2021,118950,300550,419500,MKT
06079810213110000,2020,68077,287223,355300,MKT
06079810213110000,2019,68077,287223,355300,MKT
06079810213130000,2021,118556,297544,416100,MKT
06079810213130000,2020,67638,294262,361900,MKT
06079810213130000,2019,67638,294262,361900,MKT
06079810213150000,2021,118443,271157,389600,MKT
06079810213150000,2020,67512,267488,335000,MKT
06079810213150000,2019,67512,267488,335000,MKT
06079810213170000,2021,118443,269657,388100,MKT
06079810213170000,2020,67512,265688,333200,MKT
06079810213170000,2019,67512,265688,333200,MKT
06079810213190000,2021,118443,266057,384500,MKT
06079810213190000,2020,67512,261588,329100,MKT
06079810213190000,2019,67512,261588,329100,MKT
06079810213210000,2021,118443,286257,404700,MKT
06079810213210000,2020,67512,293288,360800,MKT
06079810213210000,2019,67512,293288,360800,MKT
06079810213230000,2021,118443,282857,401300,MKT
06079810213230000,2020,67512,273988,341500,MKT
06079810213230000,2019,67512,273988,341500,MKT
06079810213250000,2021,126373,295927,422300,MKT
06079810213250000,2020,76616,294384,371000,MKT
06079810213250000,2019,76616,294384,371000,MKT
06079810213270000,2021,155200,0,155200,COST
06079810213270000,2020,118744,0,118744,COST
06079810213270000,2019,118744,0,118744,COST
06079810214010000,2021,127998,266102,394100,MKT
06079810214010000,2020,78550,262050,340600,MKT
06079810214010000,2019,78550,262050,340600,MKT
06079810214030000,2021,114311,248189,362500,MKT
06079810214030000,2020,62992,263508,326500,MKT
06079810214030000,2019,62992,263508,326500,MKT
06079810214050000,2021,114311,267489,381800,MKT
06079810214050000,2020,62992,269408,332400,MKT
06079810214050000,2019,62992,269408,332400,MKT
06079810214070000,2021,114311,258989,373300,MKT
06079810214070000,2020,62992,264808,327800,MKT
06079810214070000,2019,62992,264808,327800,MKT
06079810214090000,2021,114311,228989,343300,MKT
06079810214090000,2020,62992,230108,293100,MKT
06079810214090000,2019,62992,230108,293100,MKT
06079810214110000,2021,114311,224289,338600,MKT
06079810214110000,2020,62992,229608,292600,MKT
06079810214110000,2019,62992,229608,292600,MKT
06079810214130000,2021,114311,323089,437400,MKT
06079810214130000,2020,62992,313908,376900,MKT
06079810214130000,2019,62992,256908,319900,MKT
06079810214150000,2021,114311,313489,427800,MKT
06079810214150000,2020,62992,300108,363100,MKT
06079810214150000,2019,62992,300108,363100,MKT
06079810214170000,2021,114311,307789,422100,MKT
06079810214170000,2020,62992,295608,358600,MKT
06079810214170000,2019,62992,295608,358600,MKT
06079810214190000,2021,114311,323689,438000,MKT
06079810214190000,2020,62992,294408,357400,MKT
06079810214190000,2019,62992,294408,357400,MKT
06079810214210000,2021,114311,242589,356900,MKT
06079810214210000,2020,62992,235308,298300,MKT
06079810214210000,2019,62992,235308,298300,MKT
06079810214230000,2021,114311,265989,380300,MKT
06079810214230000,2020,62992,279008,342000,MKT
06079810214230000,2019,62992,279008,342000,MKT
06079810214257000,2021,131048,0,131048,COST
06079810214257000,2020,82245,0,82245,COST
06079810214257000,2019,82245,0,82245,COST
06079810214277000,2021,156650,0,156650,COST
06079810214277000,2020,116514,0,116514,COST
06079810214277000,2019,116514,0,116514,COST
06079810214297000,2021,165534,0,165534,COST
06079810214297000,2020,129759,0,129759,COST
06079810214297000,2019,129759,0,129759,COST
06079810215010000,2021,126657,260843,387500,MKT
06079810215010000,2020,76951,262449,339400,MKT
06079810215010000,2019,76951,262449,339400,MKT
06079810215030000,2021,112384,266416,378800,MKT
06079810215030000,2020,60935,267965,328900,MKT
06079810215030000,2019,60935,267965,328900,MKT
06079810215050000,2021,112435,255165,367600,MKT
06079810215050000,2020,60989,263311,324300,MKT
06079810215050000,2019,60989,263311,324300,MKT
06079810215070000,2021,112486,266414,378900,MKT
06079810215070000,2020,61043,267957,329000,MKT
06079810215070000,2019,61043,267957,329000,MKT
06079810215090000,2021,112537,0,112537,COST
06079810215090000,2020,61097,0,61097,COST
06079810215090000,2019,61097,0,61097,COST
06079810215110000,2021,112587,247313,359900,MKT
06079810215110000,2020,61151,235349,296500,MKT
06079810215110000,2019,61151,235349,296500,MKT
06079810215130000,2021,112638,228162,340800,MKT
06079810215130000,2020,61205,230595,291800,MKT
06079810215130000,2019,61205,230595,291800,MKT
06079810215150000,2021,112689,0,112689,COST
06079810215150000,2020,61258,0,61258,COST
06079810215150000,2019,61258,0,61258,COST
06079810215175001,2021,112746,178454,291200,MKT
06079810215175001,2020,61320,193680,255000,MKT
06079810215175001,2019,61320,193680,255000,MKT
06079810215195002,2021,112797,178503,291300,MKT
06079810215195002,2020,61373,193627,255000,MKT
06079810215195002,2019,61373,193627,255000,MKT
06079810215210000,2021,112847,233253,346100,MKT
06079810215210000,2020,61427,230873,292300,MKT
06079810215210000,2019,61427,230873,292300,MKT
06079810215230000,2021,112898,234302,347200,MKT
06079810215230000,2020,61480,232220,293700,MKT
06079810215230000,2019,61480,232220,293700,MKT
06079810215250000,2021,129504,521296,650800,INCOME
06079810215250000,2020,80364,439736,520100,INCOME
06079810215250000,2019,80364,439736,520100,INCOME
06079810216010000,2021,153815,0,153815,COST
06079810216010000,2020,96752,0,96752,COST
06079810216010000,2019,96752,0,96752,COST
06079810216030000,2021,136160,527040,663200,MKT
06079810216030000,2020,88623,479977,568600,MKT
06079810216030000,2019,88623,479977,568600,MKT
06079810216050000,2021,136228,597190,733418,COST
06079810216050000,2020,88710,595520,684230,COST
06079810216050000,2019,88710,595520,684230,COST
06079810216070000,2021,136203,560130,696333,COST
06079810216070000,2020,88678,561590,650268,COST
06079810216070000,2019,88678,561590,650268,COST
06079810216090000,2021,136228,575080,711308,COST
06079810216090000,2020,88710,567400,656110,COST
06079810216090000,2019,88710,401730,490440,COST
06079810216110000,2021,134303,407297,541600,MKT
06079810216110000,2020,86280,357420,443700,MKT
06079810216110000,2019,86280,357420,443700,MKT
06079810216130000,2021,130738,446610,577348,COST
06079810216130000,2020,81865,448680,530545,OVR
06079810216130000,2019,81865,448680,530545,COST
06079810216150000,2021,130733,446750,577483,COST
06079810216150000,2020,81859,446800,528659,COST
06079810216150000,2019,81859,446800,528659,COST
06079810216170000,2021,134751,454549,589300,MKT
06079810216170000,2020,86842,389558,476400,MKT
06079810216170000,2019,86842,389558,476400,MKT
06079810216190000,2021,135041,493610,628651,COST
06079810216190000,2020,87208,491920,579128,COST
06079810216190000,2019,87208,491920,579128,COST
06079810216210000,2021,134210,553010,687220,COST
06079810216210000,2020,86163,553020,639183,COST
06079810216210000,2019,86163,553020,639183,COST
06079810216230000,2021,135932,545850,681782,COST
06079810216230000,2020,88334,550150,638484,COST
06079810216230000,2019,88334,550150,638484,COST
06079810216250000,2021,135041,521240,656281,COST
06079810216250000,2020,87208,530160,617368,COST
06079810216250000,2019,87208,530160,617368,COST
06079810216270000,2021,135019,577681,712700,MKT
06079810216270000,2020,87180,522320,609500,MKT
06079810216270000,2019,87180,449020,536200,MKT
06079810216290000,2021,153868,522732,676600,MKT
06079810216290000,2020,96817,506683,603500,MKT
06079810216290000,2019,96817,506683,603500,MKT
06079810217010000,2021,154421,702179,856600,MKT
06079810217010000,2020,97497,614703,712200,MKT
06079810217010000,2019,97497,614703,712200,MKT
06079810217030000,2021,154113,622987,777100,MKT
06079810217030000,2020,97118,549282,646400,MKT
06079810217030000,2019,97118,549282,646400,MKT
06079810217050000,2021,143822,618700,762522,COST
06079810217050000,2020,98618,617320,715938,COST
06079810217050000,2019,98618,510682,609300,MKT
06079810217070000,2021,144233,585970,730203,COST
06079810217070000,2020,99169,589890,689059,COST
06079810217070000,2019,99169,589890,689059,COST
06079810217090000,2021,148872,625928,774800,MKT
06079810217090000,2020,105489,564611,670100,MKT
06079810217090000,2019,105489,564611,670100,MKT
06079810217110000,2021,138164,471550,609714,COST
06079810217110000,2020,91186,474420,565606,COST
06079810217110000,2019,91186,474420,565606,COST
06079810217130000,2021,138155,0,138155,COST
06079810217130000,2020,91176,0,91176,COST
06079810217130000,2019,91176,0,91176,COST
06079810217150000,2021,132830,425370,558200,MKT
06079810217150000,2020,84442,387158,471600,MKT
06079810217150000,2019,84442,387158,471600,MKT
06079810217170000,2021,128008,459492,587500,MKT
06079810217170000,2020,78562,407238,485800,MKT
06079810217170000,2019,78562,407238,485800,MKT
06079810218010000,2021,131926,670410,802336,COST
06079810218010000,2020,83324,686180,769504,COST
06079810218010000,2019,83324,594390,677714,COST
06079810218030000,2021,118443,261557,380000,MKT
06079810218030000,2020,67512,256688,324200,MKT
06079810218030000,2019,67512,256688,324200,MKT
06079810218050000,2021,118443,260357,378800,MKT
06079810218050000,2020,67512,255188,322700,MKT
06079810218050000,2019,67512,255188,322700,MKT
06079810218070000,2021,118443,260257,378700,MKT
06079810218070000,2020,67512,255088,322600,MKT
06079810218070000,2019,67512,255088,322600,MKT
06079810218090000,2021,132554,433146,565700,MKT
06079810218090000,2020,84099,363001,447100,MKT
06079810218090000,2019,84099,363001,447100,MKT
06079810218116500,2021,60929,0,60929,COST
06079810218116500,2020,58027,0,58027,COST
06079810218116500,2019,58027,0,58027,COST
06079810218130000,2021,133717,0,133717,COST
06079810218130000,2020,85546,0,85546,COST
06079810218130000,2019,85546,0,85546,COST
06079810218150000,2021,118443,251357,369800,MKT
06079810218150000,2020,67512,270988,338500,MKT
06079810218150000,2019,67512,270988,338500,MKT
06079810218170000,2021,118437,254063,372500,MKT
06079810218170000,2020,67505,252195,319700,MKT
06079810218170000,2019,67505,252195,319700,MKT
06079810218190000,2021,118437,258963,377400,MKT
06079810218190000,2020,67505,255295,322800,MKT
06079810218190000,2019,67505,255295,322800,MKT
06079810218210000,2021,131917,510370,642287,COST
06079810218210000,2020,83313,508990,592303,COST
06079810218210000,2019,83313,508990,592303,COST
06079810218225001,2021,118342,246358,364700,MKT
06079810218225001,2020,67400,260500,327900,MKT
06079810218225001,2019,67400,260500,327900,MKT
06079810218235002,2021,116688,248212,364900,MKT
06079810218235002,2020,65573,260427,326000,MKT
06079810218235002,2019,65573,260427,326000,MKT
06079810218240000,2021,116530,0,116530,COST
06079810218240000,2020,65400,0,65400,COST
06079810218240000,2019,65400,0,65400,COST
06079810218250000,2021,116371,0,116371,COST
06079810218250000,2020,65227,0,65227,COST
06079810218250000,2019,65227,0,65227,COST
06079810218260000,2021,116219,202581,318800,MKT
06079810218260000,2020,65060,194240,259300,MKT
06079810218260000,2019,65060,194240,259300,MKT
06079810218277000,2021,167402,1570,168972,COST
06079810218277000,2020,132633,1850,134483,COST
06079810218277000,2019,132633,1850,134483,COST
06079810218280000,2021,116059,201441,317500,MKT
06079810218280000,2020,64886,191714,256600,MKT
06079810218280000,2019,64886,191714,256600,MKT
06079810218295001,2021,115899,259801,375700,MKT
06079810218295001,2020,64711,269689,334400,MKT
06079810218295001,2019,64711,265489,330200,MKT
06079810218305002,2021,117391,250509,367900,MKT
06079810218305002,2020,66346,265354,331700,MKT
06079810218305002,2019,66346,265354,331700,MKT
06079810218310000,2021,115516,188984,304500,MKT
06079810218310000,2020,64294,175906,240200,MKT
06079810218310000,2019,64294,175906,240200,MKT
06079810218320000,2021,115516,183484,299000,MKT
06079810218320000,2020,64294,176206,240500,MKT
06079810218320000,2019,64294,176206,240500,MKT
06079810218330000,2021,115516,188984,304500,MKT
06079810218330000,2020,64294,175906,240200,MKT
06079810218330000,2019,64294,175906,240200,MKT
06079810218340000,2021,117417,175083,292500,MKT
06079810218340000,2020,66375,166125,232500,MKT
06079810218340000,2019,66375,166125,232500,MKT
06079810219010000,2021,153103,563097,716200,MKT
06079810219010000,2020,95880,493720,589600,MKT
06079810219010000,2019,95880,493720,589600,MKT
06079810219030000,2021,147214,475980,623194,COST
06079810219030000,2020,88814,469960,558774,COST
06079810219030000,2019,88814,469960,558774,COST
06079810219050000,2021,140445,476055,616500,MKT
06079810219050000,2020,94149,443951,538100,MKT
06079810219050000,2019,94149,443951,538100,MKT
06079810219070000,2021,140445,579200,719645,COST
06079810219070000,2020,94149,577670,671819,COST
06079810219070000,2019,94149,577670,671819,COST
06079810219090000,2021,140445,533170,673615,COST
06079810219090000,2020,94149,534280,628429,COST
06079810219090000,2019,94149,534280,628429,COST
06079810219110000,2021,140445,530380,670825,COST
06079810219110000,2020,94149,530340,624489,COST
06079810219110000,2019,94149,530340,624489,COST
06079810219130000,2021,130377,739070,869447,COST
06079810219130000,2020,81425,643500,724925,COST
06079810219130000,2019,81425,316820,398245,COST
06079810219150000,2021,135221,352579,487800,MKT
06079810219150000,2020,87434,366766,454200,MKT
06079810219150000,2019,87434,366766,454200,MKT
06079810219160000,2021,130377,359823,490200,MKT
06079810219160000,2020,81425,356775,438200,MKT
06079810219160000,2019,81425,356775,438200,MKT
06079810219170000,2021,135221,368579,503800,MKT
06079810219170000,2020,87434,378666,466100,MKT
06079810219170000,2019,87434,378666,466100,MKT
06079810219190000,2021,140445,354820,495265,COST
06079810219190000,2020,94149,367000,461149,COST
06079810219190000,2019,94149,367000,461149,COST
06079810219210000,2021,140445,353155,493600,MKT
06079810219210000,2020,94149,340051,434200,MKT
06079810219210000,2019,94149,340051,434200,MKT
06079810219230000,2021,140445,513590,654035,COST
06079810219230000,2020,94149,512250,606399,COST
06079810219230000,2019,94149,512250,606399,COST
06079810219250000,2021,140445,834450,974895,COST
06079810219250000,2020,94149,845750,939899,COST
06079810219250000,2019,94149,845750,939899,COST
06079810219270000,2021,140445,527920,668365,COST
06079810219270000,2020,94149,532320,626469,COST
06079810219270000,2019,94149,532320,626469,COST
06079810219290000,2021,150630,0,150630,COST
06079810219290000,2020,92880,0,92880,COST
06079810219290000,2019,92880,0,92880,COST
06079810219310000,2021,143421,464620,608041,COST
06079810219310000,2020,84402,463970,548372,COST
06079810219310000,2019,84402,463970,548372,COST
06079810220010000,2021,135312,426190,561502,COST
06079810220010000,2020,87550,425250,512800,COST
06079810220010000,2019,87550,425250,512800,COST
06079810220030000,2021,118443,281657,400100,MKT
06079810220030000,2020,67512,281088,348600,MKT
06079810220030000,2019,67512,281088,348600,MKT
06079810220050000,2021,118443,298157,416600,MKT
06079810220050000,2020,67512,285888,353400,MKT
06079810220050000,2019,67512,288488,356000,MKT
06079810220070000,2021,118443,291157,409600,MKT
06079810220070000,2020,67512,287388,354900,MKT
06079810220070000,2019,67512,287388,354900,MKT
06079810220090000,2021,135312,486950,622262,COST
06079810220090000,2020,87550,498400,585950,COST
06079810220090000,2019,87550,498400,585950,COST
06079810220110000,2021,169848,0,169848,COST
06079810220110000,2020,136442,0,136442,COST
06079810220110000,2019,136442,0,136442,COST
06079810220135002,2021,117866,280934,398800,MKT
06079810220135002,2020,66871,308529,375400,MKT
06079810220135002,2019,66871,308529,375400,MKT
06079810220145001,2021,118012,280888,398900,MKT
06079810220145001,2020,67034,308366,375400,MKT
06079810220145001,2019,67034,308366,375400,MKT
06079810220155002,2021,118165,284135,402300,MKT
06079810220155002,2020,67203,302797,370000,MKT
06079810220155002,2019,67203,302797,370000,MKT
06079810220165001,2021,118317,284283,402600,MKT
06079810220165001,2020,67372,302828,370200,MKT
06079810220165001,2019,67372,302828,370200,MKT
06079810221010000,2021,128282,262218,390500,INCOME
06079810221010000,2020,78890,243610,322500,INCOME
06079810221010000,2019,78890,243610,322500,INCOME
06079810221020000,2021,120165,187335,307500,MKT
06079810221020000,2020,69442,174058,243500,MKT
06079810221020000,2019,69442,174058,243500,MKT
06079810221030000,2021,120165,187335,307500,MKT
06079810221030000,2020,69442,174058,243500,MKT
06079810221030000,2019,69442,174058,243500,MKT
06079810221040000,2021,120165,276435,396600,MKT
06079810221040000,2020,69442,276458,345900,MKT
06079810221040000,2019,69442,276458,345900,MKT
06079810221050000,2021,120165,199035,319200,MKT
06079810221050000,2020,69442,183058,252500,MKT
06079810221050000,2019,69442,183058,252500,MKT
06079810221060000,2021,120165,260035,380200,MKT
06079810221060000,2020,69442,274558,344000,MKT
06079810221060000,2019,69442,274558,344000,MKT
06079810221070000,2021,120165,247235,367400,MKT
06079810221070000,2020,69442,255058,324500,MKT
06079810221070000,2019,69442,255058,324500,MKT
06079810221080000,2021,120165,258835,379000,MKT
06079810221080000,2020,69442,267758,337200,MKT
06079810221080000,2019,69442,267758,337200,MKT
06079810221090000,2021,120165,276335,396500,MKT
06079810221090000,2020,69442,276358,345800,MKT
06079810221090000,2019,69442,276358,345800,MKT
06079810221100000,2021,120165,192435,312600,MKT
06079810221100000,2020,69442,174958,244400,MKT
06079810221100000,2019,69442,174958,244400,MKT
06079810221110000,2021,125769,546420,672189,COST
06079810221110000,2020,75902,558260,634162,COST
06079810221110000,2019,75902,538030,613932,COST
06079810221120000,2021,120165,276335,396500,MKT
06079810221120000,2020,69442,276358,345800,MKT
06079810221120000,2019,69442,276358,345800,MKT
06079810221130000,2021,118443,269757,388200,MKT
06079810221130000,2020,67512,268588,336100,MKT
06079810221130000,2019,67512,264888,332400,MKT
06079810221140000,2021,120165,185335,305500,MKT
06079810221140000,2020,69442,173958,243400,MKT
06079810221140000,2019,69442,173958,243400,MKT
06079810221150000,2021,118443,265757,384200,MKT
06079810221150000,2020,67512,264788,332300,MKT
06079810221150000,2019,67512,264788,332300,MKT
06079810221160000,2021,120165,189035,309200,MKT
06079810221160000,2020,69442,175958,245400,MKT
06079810221160000,2019,69442,175958,245400,MKT
06079810221170000,2021,118443,265757,384200,MKT
06079810221170000,2020,67512,264788,332300,MKT
06079810221170000,2019,67512,264788,332300,MKT
06079810221180000,2021,120165,256535,376700,MKT
06079810221180000,2020,69442,272958,342400,MKT
06079810221180000,2019,69442,272958,342400,MKT
06079810221190000,2021,118443,265757,384200,MKT
06079810221190000,2020,67512,264788,332300,MKT
06079810221190000,2019,67512,264788,332300,MKT
06079810221210000,2021,118443,261557,380000,MKT
06079810221210000,2020,67512,257088,324600,MKT
06079810221210000,2019,67512,257088,324600,MKT
06079810221230000,2021,118443,258657,377100,MKT
06079810221230000,2020,67512,264788,332300,MKT
06079810221230000,2019,67512,264788,332300,MKT
06079810221250000,2021,118443,275857,394300,MKT
06079810221250000,2020,67512,268388,335900,MKT
06079810221250000,2019,67512,268388,335900,MKT
06079810221270000,2021,118443,273257,391700,MKT
06079810221270000,2020,67512,268688,336200,MKT
06079810221270000,2019,67512,268688,336200,MKT
06079810221290000,2021,118443,268857,387300,MKT
06079810221290000,2020,67512,265088,332600,MKT
06079810221290000,2019,67512,265088,332600,MKT
06079810221310000,2021,118443,261557,380000,MKT
06079810221310000,2020,67512,258988,326500,MKT
06079810221310000,2019,67512,258988,326500,MKT
06079810221330000,2021,118443,254157,372600,MKT
06079810221330000,2020,67512,251588,319100,MKT
06079810221330000,2019,67512,251588,319100,MKT
06079810221350000,2021,129528,273672,403200,MKT
06079810221350000,2020,80394,256406,336800,MKT
06079810221350000,2019,80394,256406,336800,MKT
06079810222010000,2021,145006,515830,660836,COST
06079810222010000,2020,100209,516310,616519,COST
06079810222010000,2019,100209,516310,616519,COST
06079810222030000,2021,140544,541090,681634,COST
06079810222030000,2020,94278,549160,643438,COST
06079810222030000,2019,94278,549160,643438,COST
06079810222050000,2021,140544,578740,719284,COST
06079810222050000,2020,94278,579430,673708,COST
06079810222050000,2019,94278,579430,673708,COST
06079810222070000,2021,140544,515210,655754,COST
06079810222070000,2020,94278,517390,611668,COST
06079810222070000,2019,94278,517390,611668,COST
06079810222090000,2021,140544,596870,737414,COST
06079810222090000,2020,94278,595690,689968,COST
06079810222090000,2019,94278,595690,689968,COST
06079810222110000,2021,140544,506000,646544,COST
06079810222110000,2020,94278,506630,600908,COST
06079810222110000,2019,94278,506630,600908,COST
06079810222130000,2021,135312,352688,488000,MKT
06079810222130000,2020,87550,372250,459800,MKT
06079810222130000,2019,87550,372250,459800,MKT
06079810222150000,2021,130468,507132,637600,MKT
06079810222150000,2020,81536,434064,515600,MKT
06079810222150000,2019,81536,434064,515600,MKT
06079810222170000,2021,130977,422123,553100,MKT
06079810222170000,2020,82158,379342,461500,MKT
06079810222170000,2019,82158,379342,461500,MKT
06079810222190000,2021,135312,351188,486500,INCOME
06079810222190000,2020,87550,359250,446800,INCOME
06079810222190000,2019,87550,359250,446800,INCOME
06079810222210000,2021,141207,646530,787737,COST
06079810222210000,2020,95148,653970,749118,COST
06079810222210000,2019,95148,653970,749118,COST
06079810222230000,2021,141520,549370,690890,COST
06079810222230000,2020,95560,509440,605000,OVR
06079810222230000,2019,95560,548490,644050,COST
06079810222250000,2021,141831,592680,734511,COST
06079810222250000,2020,95971,591700,687671,COST
06079810222250000,2019,95971,591700,687671,COST
06079810222270000,2021,142137,521800,663937,COST
06079810222270000,2020,96375,533890,630265,COST
06079810222270000,2019,96375,533890,630265,COST
06079810222290000,2021,142444,831370,973814,COST
06079810222290000,2020,96782,629218,726000,OVR
06079810222290000,2019,96782,629218,726000,OVR
06079810222310000,2021,147177,600923,748100,MKT
06079810222310000,2020,103158,550042,653200,MKT
06079810222310000,2019,103158,550042,653200,MKT
06079810222330000,2021,142475,608825,751300,MKT
06079810222330000,2020,96822,539178,636000,OVR
06079810222330000,2019,96822,539178,636000,MKT
06079810222350000,2021,139816,648484,788300,MKT
06079810222350000,2020,93327,518873,612200,MKT
06079810222350000,2019,93327,518873,612200,MKT
06079810223010000,2021,136934,369066,506000,MKT
06079810223010000,2020,92998,383302,476300,MKT
06079810223010000,2019,92998,383302,476300,MKT
06079810223030000,2021,137055,0,137055,COST
06079810223030000,2020,93158,0,93158,COST
06079810223030000,2019,93158,0,93158,COST
06079810223050000,2021,137055,470045,607100,MKT
06079810223050000,2020,93158,416442,509600,MKT
06079810223050000,2019,93158,416442,509600,MKT
06079810223070000,2021,145067,407133,552200,MKT
06079810223070000,2020,104083,397717,501800,MKT
06079810223070000,2019,104083,397717,501800,MKT
06079810223090000,2021,145067,411533,556600,MKT
06079810223090000,2020,104083,459817,563900,MKT
06079810223090000,2019,104083,459817,563900,MKT
06079810223110000,2021,145067,514433,659500,MKT
06079810223110000,2020,104083,463717,567800,MKT
06079810223110000,2019,104083,463717,567800,MKT
06079810223130000,2021,145067,438933,584000,MKT
06079810223130000,2020,104083,401317,505400,MKT
06079810223130000,2019,104083,401317,505400,MKT
06079810223150000,2021,145067,509733,654800,MKT
06079810223150000,2020,104083,513317,617400,MKT
06079810223150000,2019,104083,513317,617400,MKT
06079810223170000,2021,145067,492333,637400,MKT
06079810223170000,2020,104083,448517,552600,MKT
06079810223170000,2019,104083,448517,552600,MKT
06079810223190000,2021,145067,585533,730600,MKT
06079810223190000,2020,104083,518217,622300,MKT
06079810223190000,2019,104083,518217,622300,MKT
06079810223210000,2021,141608,477692,619300,MKT
06079810223210000,2020,99293,420007,519300,MKT
06079810223210000,2019,99293,420007,519300,MKT
06079810223230000,2021,126066,564134,690200,MKT
06079810223230000,2020,89115,526185,615300,MKT
06079810223230000,2019,89115,526185,615300,MKT
06079810223256500,2021,76766,0,76766,COST
06079810223256500,2020,91093,0,91093,COST
06079810223256500,2019,91093,0,91093,COST
06079810224010000,2021,136989,295611,432600,MKT
06079810224010000,2020,89679,331121,420800,MKT
06079810224010000,2019,89679,331121,420800,MKT
06079810224030000,2021,131748,528152,659900,MKT
06079810224030000,2020,83105,562000,645105,COST
06079810224030000,2019,83105,287700,370805,COST
06079810224050000,2021,131753,318947,450700,MKT
06079810224050000,2020,83111,310889,394000,MKT
06079810224050000,2019,83111,310889,394000,MKT
06079810224070000,2021,136993,461307,598300,MKT
06079810224070000,2020,89685,411415,501100,MKT
06079810224070000,2019,89685,411415,501100,MKT
06079810224090000,2021,132591,470209,602800,MKT
06079810224090000,2020,84145,422555,506700,MKT
06079810224090000,2019,84145,422555,506700,MKT
06079810224110000,2021,132591,559909,692500,MKT
06079810224110000,2020,84145,503555,587700,MKT
06079810224110000,2019,84145,503555,587700,MKT
06079810224130000,2021,137287,327113,464400,MKT
06079810224130000,2020,90061,325439,415500,MKT
06079810224130000,2019,90061,325439,415500,MKT
06079810224177000,2021,179745,0,179745,COST
06079810224177000,2020,152389,0,152389,COST
06079810224177000,2019,152389,0,152389,COST
06079810301057000,2021,514322,0,514322,COST
06079810301057000,2020,1186133,0,1186133,COST
06079810301057000,2019,1186133,0,1186133,COST
06079810301100000,2021,1077943,0,1077943,COST
06079810301100000,2020,979460,0,979460,COST
06079810301100000,2019,979460,0,979460,COST
06079810301120000,2021,1248585,0,1248585,COST
06079810301120000,2020,991210,0,991210,COST
06079810301120000,2019,991210,0,991210,COST
06079810301150000,2021,1160133,0,1160133,COST
06079810301150000,2020,960497,0,960497,COST
06079810301150000,2019,960497,0,960497,COST
06079810301170000,2021,1496772,0,1496772,COST
06079810301170000,2020,996846,0,996846,COST
06079810301170000,2019,996846,0,996846,COST
06079810301200000,2021,1717,0,1717,COST
06079810301200000,2020,1598,0,1598,COST
06079810301200000,2019,1598,0,1598,COST
06079810301257000,2021,2996027,213220,3209247,COST
06079810301257000,2020,1197670,204030,1401700,COST
06079810301257000,2019,1197670,0,1197670,COST
06079810301270000,2021,762111,0,762111,COST
06079810301270000,2020,666274,0,666274,COST
06079810301270000,2019,666274,0,666274,COST
06079810301297000,2021,719682,0,719682,COST
06079810301297000,2020,650124,0,650124,COST
06079810301297000,2019,650124,0,650124,COST
06079810301300000,2021,733486,0,733486,COST
06079810301300000,2020,477470,0,477470,COST
06079810301300000,2019,477470,0,477470,COST
06079810301310000,2021,650187,768113,1418300,INCOME
06079810301310000,2020,622449,0,622449,COST
06079810301310000,2019,622449,0,622449,COST
06079810301330000,2021,634525,1168240,1802765,COST
06079810301330000,2020,615981,969219,1585200,INCOME
06079810301330000,2019,615981,969219,1585200,INCOME
06079810301350000,2021,746966,2030434,2777400,INCOME
06079810301350000,2020,660570,1896230,2556800,INCOME
06079810301350000,2019,660570,1896230,2556800,INCOME
06079810301370000,2021,751373,1896127,2647500,INCOME
06079810301370000,2020,662237,1774863,2437100,INCOME
06079810301370000,2019,662237,1774863,2437100,INCOME
06079810301400000,2021,859361,0,859361,COST
06079810301400000,2020,701449,0,701449,COST
06079810301400000,2019,701449,0,701449,COST
06079810301456500,2021,1943008,401700,2344708,COST
06079810301456500,2020,499900,434090,933990,COST
06079810301456500,2019,499900,434090,933990,COST
06079810301506500,2021,155524,0,155524,COST
06079810301526500,2021,60121,0,60121,COST
06079810301540000,2021,1535691,43076009,44611700,INCOME
06079810301800000,2021,373661,0,373661,COST
06079810301800000,2020,635770,0,635770,COST
06079810301800000,2019,635770,0,635770,COST
06079810302010000,2021,542612,4911288,5453900,INCOME
06079810302010000,2020,774263,4379337,5153600,INCOME
06079810302010000,2019,774263,4379337,5153600,INCOME
06079810302026500,2021,36854,0,36854,COST
06079810302026500,2020,21750,0,21750,COST
06079810302026500,2019,21750,0,21750,COST
06079810302030000,2021,588004,5937696,6525700,INCOME
06079810302030000,2020,910651,5385849,6296500,INCOME
06079810302030000,2019,910651,5385849,6296500,INCOME
06079810302057000,2021,301620,0,301620,COST
06079810302057000,2020,418544,0,418544,COST
06079810302057000,2019,418544,0,418544,COST
06079810302100000,2021,699805,691595,1391400,INCOME
06079810302100000,2020,699517,652583,1352100,INCOME
06079810302100000,2019,699517,652583,1352100,INCOME
06079810302150000,2021,1299032,1866068,3165100,INCOME
06079810302150000,2020,1036089,2257911,3294000,INCOME
06079810302150000,2019,1036089,2257911,3294000,INCOME
06079810302200000,2021,2710956,2515844,5226800,INCOME
06079810302200000,2020,1112826,3974730,5087556,COST
06079810302200000,2019,1112826,3974730,5087556,COST
06079810303010000,2021,1169594,1583790,2753384,COST
06079810303010000,2020,963844,1604956,2568800,INCOME
06079810303010000,2019,963844,1604956,2568800,INCOME
06079810303040000,2021,1174591,0,1174591,COST
06079810303040000,2020,965606,0,965606,COST
06079810303040000,2019,965606,0,965606,COST
06079810303077000,2021,1454945,661520,2116465,COST
06079810303077000,2020,984816,496670,1481486,COST
06079810303077000,2019,984816,0,984816,COST
06079810304017000,2021,1257921,21270,1279191,COST
06079810304017000,2020,690057,22890,712947,COST
06079810304017000,2019,690057,22890,712947,COST
06079810304040000,2021,604470,2835430,3439900,INCOME
06079810304040000,2020,675989,2213311,2889300,INCOME
06079810304040000,2019,675989,2213311,2889300,INCOME
06079810304060000,2021,612382,871518,1483900,INCOME
06079810304060000,2020,679766,738834,1418600,INCOME
06079810304060000,2019,679766,738834,1418600,INCOME
06079810304080000,2021,691679,1906470,2598149,COST
06079810304080000,2020,716164,1743020,2459184,COST
06079810304080000,2019,716164,0,716164,COST
06079810305010000,2021,604470,2723530,3328000,INCOME
06079810305010000,2020,675989,0,675989,COST
06079810305010000,2019,675989,0,675989,COST
06079810305030000,2021,612382,0,612382,COST
06079810305030000,2020,679766,0,679766,COST
06079810305030000,2019,679766,0,679766,COST
06079810305050000,2021,691679,0,691679,COST
06079810305050000,2020,716164,0,716164,COST
06079810305050000,2019,716164,0,716164,COST
06079810305080000,2021,1280044,0,1280044,COST
06079810305080000,2020,932240,0,932240,COST
06079810305080000,2019,932240,0,932240,COST
06079810306016500,2021,315128,0,315128,COST
06079810306016500,2020,256961,0,256961,COST
06079810306016500,2019,256961,0,256961,COST
06079810306040000,2021,1160560,0,1160560,COST
06079810306040000,2020,549300,0,549300,COST
06079810306040000,2019,549300,0,549300,COST
06079810306080000,2021,1317254,0,1317254,COST
06079810306080000,2020,678800,0,678800,COST
06079810306080000,2019,678800,0,678800,COST
06079810306120000,2021,1073563,0,1073563,COST
06079810306120000,2020,482200,0,482200,COST
06079810306120000,2019,482200,0,482200,COST
06079810306160000,2021,1271282,0,1271282,COST
06079810306160000,2020,639700,0,639700,COST
06079810306160000,2019,639700,0,639700,COST
06079810401030000,2021,2046930,2318570,4365500,INCOME
06079810401030000,2020,1156867,2632933,3789800,INCOME
06079810401030000,2019,1156867,2632933,3789800,INCOME
06079810402030000,2021,1223186,3102214,4325400,INCOME
06079810402030000,2020,927883,3053917,3981800,INCOME
06079810402030000,2019,927883,3053917,3981800,INCOME
06079810402036500,2021,297685,0,297685,COST
06079810402036500,2020,254504,0,254504,COST
06079810402036500,2019,254504,0,254504,COST
06079810402060000,2021,875478,928222,1803700,INCOME
06079810402060000,2020,804030,647470,1451500,INCOME
06079810402060000,2019,804030,647470,1451500,INCOME
06079810402097000,2021,1357234,154040,1511274,COST
06079810402097000,2020,970152,164810,1134962,COST
06079810402097000,2019,970152,164810,1134962,COST
06079810402120000,2021,990346,0,990346,COST
06079810402120000,2020,847634,0,847634,COST
06079810402120000,2019,847634,0,847634,COST
06079810402150000,2021,797722,2280678,3078400,INCOME
06079810402150000,2020,772624,1743876,2516500,INCOME
06079810402150000,2019,772624,1743876,2516500,INCOME
06079810407016500,2021,98990,0,98990,COST
06079810407016500,2020,172809,0,172809,COST
06079810407016500,2019,172809,0,172809,COST
06079810407037000,2021,904920,32630,937550,COST
06079810407037000,2020,780944,31600,812544,COST
06079810407037000,2019,780944,31600,812544,COST
06079810409017000,2021,639501,21690,661191,COST
06079810409017000,2020,673029,21820,694849,COST
06079810409017000,2019,673029,21820,694849,COST
06079810409047000,2021,1079380,637440,1716820,COST
06079810409047000,2020,957053,620520,1577573,COST
06079810409047000,2019,957053,620520,1577573,COST
06079810410010000,2021,1389840,2829960,4219800,INCOME
06079810410010000,2020,980068,3053832,4033900,INCOME
06079810410010000,2019,980068,3053832,4033900,INCOME
06079810410047000,2021,369490,10610,380100,COST
06079810410047000,2020,286862,11020,297882,COST
06079810410047000,2019,286862,11020,297882,COST
06079810410070000,2021,1394931,0,1394931,COST
06079810410070000,2020,294482,0,294482,COST
06079810410070000,2019,294482,0,294482,COST
06079810410100000,2021,200101,0,200101,COST
06079810410100000,2020,778724,0,778724,COST
06079810410100000,2019,233617,0,233617,COST
06079810413010000,2021,289105,57210,346315,COST
06079810413010000,2020,911679,0,911679,COST
06079810413010000,2019,273503,0,273503,COST
06079810413080000,2021,230908,0,230908,COST
06079810413080000,2020,248396,0,248396,COST
06079810413080000,2019,248396,0,248396,COST
06079810420017000,2021,191779,0,191779,COST
06079810420017000,2020,172937,0,172937,COST
06079810420017000,2019,172937,0,172937,COST
06079810420020000,2021,162039,260661,422700,MKT
06079810420020000,2020,124465,249835,374300,MKT
06079810420020000,2019,124465,249835,374300,MKT
06079810420030000,2021,162039,325161,487200,MKT
06079810420030000,2020,124465,319735,444200,MKT
06079810420030000,2019,124465,319735,444200,MKT
06079810420040000,2021,162039,324561,486600,MKT
06079810420040000,2020,124465,310635,435100,MKT
06079810420040000,2019,124465,310635,435100,MKT
06079810420050000,2021,162039,301261,463300,MKT
06079810420050000,2020,124465,291035,415500,MKT
06079810420050000,2019,124465,291035,415500,MKT
06079810420060000,2021,162039,272261,434300,MKT
06079810420060000,2020,124465,262735,387200,MKT
06079810420060000,2019,124465,262735,387200,MKT
06079810420070000,2021,162039,239961,402000,MKT
06079810420070000,2020,124465,224635,349100,MKT
06079810420070000,2019,124465,224635,349100,MKT
06079810420085001,2021,136391,204609,341000,MKT
06079810420085001,2020,88917,206283,295200,MKT
06079810420085001,2019,88917,206283,295200,MKT
06079810420085002,2021,136391,178709,315100,MKT
06079810420085002,2020,88917,186183,275100,MKT
06079810420085002,2019,88917,186183,275100,MKT
06079810420095001,2021,142885,173115,316000,MKT
06079810420095001,2020,97368,163732,261100,MKT
06079810420095001,2019,97368,163732,261100,MKT
06079810420095002,2021,128282,197618,325900,MKT
06079810420095002,2020,78890,212910,291800,MKT
06079810420095002,2019,78890,210710,289600,MKT
06079810420100000,2021,158626,227374,386000,MKT
06079810420100000,2020,119401,225199,344600,MKT
06079810420100000,2019,119401,225199,344600,MKT
06079810420110000,2021,158626,261674,420300,MKT
06079810420110000,2020,119401,266699,386100,MKT
06079810420110000,2019,119401,266699,386100,MKT
06079810420120000,2021,158626,355974,514600,MKT
06079810420120000,2020,119401,321999,441400,MKT
06079810420120000,2019,119401,321999,441400,MKT
06079810420130000,2021,158977,250523,409500,MKT
06079810420130000,2020,119916,250284,370200,MKT
06079810420130000,2019,119916,250284,370200,MKT
06079810420140000,2021,160497,292203,452700,MKT
06079810420140000,2020,122164,287236,409400,MKT
06079810420140000,2019,122164,287236,409400,MKT
06079810420150000,2021,183864,307430,491294,COST
06079810420150000,2020,159280,257520,416800,MKT
06079810420150000,2019,159280,257520,416800,MKT
06079810420160000,2021,166279,308521,474800,MKT
06079810420160000,2020,130902,318698,449600,MKT
06079810420160000,2019,130902,318698,449600,MKT
06079810420170000,2021,157462,309438,466900,MKT
06079810420170000,2020,117695,286205,403900,MKT
06079810420170000,2019,117695,286205,403900,MKT
06079810420180000,2021,156914,294886,451800,MKT
06079810420180000,2020,116897,309403,426300,MKT
06079810420180000,2019,116897,309403,426300,MKT
06079810420190000,2021,155148,295652,450800,MKT
06079810420190000,2020,114344,318456,432800,MKT
06079810420190000,2019,114344,318456,432800,MKT
06079810420257000,2021,1640051,92210,1732261,COST
06079810420257000,2020,1144894,89260,1234154,COST
06079810420257000,2019,1144894,89260,1234154,COST
06079810420380000,2021,156841,247959,404800,INCOME
06079810420380000,2020,116792,251708,368500,INCOME
06079810420380000,2019,116792,251708,368500,INCOME
06079810420390000,2021,158626,246174,404800,INCOME
06079810420390000,2020,119401,249099,368500,INCOME
06079810420390000,2019,119401,249099,368500,INCOME
06079810420400000,2021,160358,300542,460900,INCOME
06079810420400000,2020,121957,300343,422300,INCOME
06079810420400000,2019,121957,300343,422300,INCOME
06079810420415001,2021,134764,205236,340000,MKT
06079810420415001,2020,86859,240841,327700,MKT
06079810420415001,2019,86859,240841,327700,MKT
06079810420415002,2021,131926,201974,333900,MKT
06079810420415002,2020,83324,224676,308000,MKT
06079810420415002,2019,83324,224676,308000,MKT
06079810420420000,2021,160358,300542,460900,INCOME
06079810420420000,2020,121957,300343,422300,INCOME
06079810420420000,2019,121957,300343,422300,INCOME
06079810421015001,2021,138110,196990,335100,MKT
06079810421015001,2020,91117,201283,292400,MKT
06079810421015001,2019,91117,201283,292400,MKT
06079810421015002,2021,137550,204350,341900,MKT
06079810421015002,2020,90398,204802,295200,MKT
06079810421015002,2019,90398,204802,295200,MKT
06079810421020000,2021,158963,287437,446400,MKT
06079810421020000,2020,119895,266705,386600,MKT
06079810421020000,2019,119895,266705,386600,MKT
06079810421030000,2021,158963,323437,482400,MKT
06079810421030000,2020,119895,320405,440300,MKT
06079810421030000,2019,119895,320405,440300,MKT
06079810421040000,2021,158963,328037,487000,MKT
06079810421040000,2020,119895,299505,419400,MKT
06079810421040000,2019,119895,299505,419400,MKT
06079810421050000,2021,158963,281337,440300,MKT
06079810421050000,2020,119895,288805,408700,MKT
06079810421050000,2019,119895,288805,408700,MKT
06079810421060000,2021,158963,278337,437300,MKT
06079810421060000,2020,119895,280405,400300,MKT
06079810421060000,2019,119895,274405,394300,MKT
06079810421070000,2021,158963,251837,410800,MKT
06079810421070000,2020,119895,239305,359200,MKT
06079810421070000,2019,119895,239305,359200,MKT
06079810421080000,2021,158963,290037,449000,MKT
06079810421080000,2020,119895,284905,404800,MKT
06079810421080000,2019,119895,284905,404800,MKT
06079810440015001,2021,136391,204209,340600,MKT
06079810440015001,2020,88917,214183,303100,MKT
06079810440015001,2019,88917,214183,303100,MKT
06079810440015002,2021,130742,205158,335900,MKT
06079810440015002,2020,81871,221829,303700,MKT
06079810440015002,2019,81871,221829,303700,MKT
06079810440020000,2021,158977,248723,407700,MKT
06079810440020000,2020,119916,236484,356400,MKT
06079810440020000,2019,119916,236484,356400,MKT
06079810440030000,2021,158977,263523,422500,MKT
06079810440030000,2020,119916,254984,374900,MKT
06079810440030000,2019,119916,254984,374900,MKT
06079810440040000,2021,158977,338523,497500,MKT
06079810440040000,2020,119916,318584,438500,MKT
06079810440040000,2019,119916,318584,438500,MKT
06079810440050000,2021,158977,237823,396800,MKT
06079810440050000,2020,119916,237984,357900,MKT
06079810440050000,2019,119916,237984,357900,MKT
06079810440060000,2021,160698,247102,407800,MKT
06079810440060000,2020,122463,246537,369000,MKT
06079810440060000,2019,122463,101880,224343,COST
06079810441015001,2021,136391,209409,345800,MKT
06079810441015001,2020,88917,215983,304900,MKT
06079810441015001,2019,88917,215983,304900,MKT
06079810441015002,2021,130742,197558,328300,MKT
06079810441015002,2020,81871,204329,286200,MKT
06079810441015002,2019,81871,204329,286200,MKT
06079810441020000,2021,156111,266989,423100,MKT
06079810441020000,2020,115733,260767,376500,MKT
06079810441020000,2019,115733,260767,376500,MKT
06079810441030000,2021,156111,226689,382800,MKT
06079810441030000,2020,115733,224967,340700,MKT
06079810441030000,2019,115733,224967,340700,MKT
06079810441040000,2021,156111,251589,407700,MKT
06079810441040000,2020,115733,244867,360600,MKT
06079810441040000,2019,115733,244867,360600,MKT
06079810441050000,2021,156111,285589,441700,MKT
06079810441050000,2020,115733,278967,394700,MKT
06079810441050000,2019,115733,278967,394700,MKT
06079810441060000,2021,163871,355229,519100,MKT
06079810441060000,2020,127227,322573,449800,MKT
06079810441060000,2019,127227,322573,449800,MKT
06079810441070000,2021,160698,262502,423200,MKT
06079810441070000,2020,122463,250637,373100,MKT
06079810441070000,2019,122463,250637,373100,MKT
06079810441080000,2021,158977,330423,489400,MKT
06079810441080000,2020,119916,304184,424100,MKT
06079810441080000,2019,119916,304184,424100,MKT
06079810441090000,2021,158977,332023,491000,MKT
06079810441090000,2020,119916,324684,444600,MKT
06079810441090000,2019,119916,324684,444600,MKT
06079810441100000,2021,158977,220023,379000,MKT
06079810441100000,2020,119916,218484,338400,MKT
06079810441100000,2019,119916,218484,338400,MKT
06079810441110000,2021,158977,298923,457900,MKT
06079810441110000,2020,119916,291384,411300,MKT
06079810441110000,2019,119916,291384,411300,MKT
06079810441125001,2021,135855,199145,335000,MKT
06079810441125001,2020,88236,203364,291600,MKT
06079810441125001,2019,88236,203364,291600,MKT
06079810441125002,2021,131338,205762,337100,MKT
06079810441125002,2020,82601,206599,289200,MKT
06079810441125002,2019,82601,206599,289200,MKT
06079810445015001,2021,126852,191148,318000,MKT
06079810445015001,2020,66418,220182,286600,MKT
06079810445015001,2019,66418,220182,286600,MKT
06079810445035002,2021,106899,182201,289100,MKT
06079810445035002,2020,55265,199935,255200,MKT
06079810445035002,2019,55265,199935,255200,MKT
06079810445055001,2021,106899,176901,283800,MKT
06079810445055001,2020,55265,190335,245600,MKT
06079810445055001,2019,55265,190335,245600,MKT
06079810445075002,2021,106899,176901,283800,MKT
06079810445075002,2020,55265,190335,245600,MKT
06079810445075002,2019,55265,190335,245600,MKT
06079810445095001,2021,106899,183801,290700,MKT
06079810445095001,2020,55265,199335,254600,MKT
06079810445095001,2019,55265,199335,254600,MKT
06079810445115002,2021,106899,178101,285000,MKT
06079810445115002,2020,55265,186835,242100,MKT
06079810445115002,2019,55265,186835,242100,MKT
06079810445135001,2021,106899,178201,285100,MKT
06079810445135001,2020,55265,187035,242300,MKT
06079810445135001,2019,55265,187035,242300,MKT
06079810445155002,2021,106899,183901,290800,MKT
06079810445155002,2020,55265,199535,254800,MKT
06079810445155002,2019,55265,199535,254800,MKT
06079810445175001,2021,106899,177801,284700,MKT
06079810445175001,2020,55265,187035,242300,MKT
06079810445175001,2019,55265,187035,242300,MKT
06079810445195002,2021,116345,174355,290700,MKT
06079810445195002,2020,65198,186702,251900,MKT
06079810445195002,2019,65198,186702,251900,MKT
06079810445215002,2021,125442,175158,300600,MKT
06079810445215002,2020,75518,189482,265000,MKT
06079810445215002,2019,75518,189482,265000,MKT
06079810445235001,2021,106899,176501,283400,MKT
06079810445235001,2020,55265,192035,247300,MKT
06079810445235001,2019,55265,192035,247300,MKT
06079810445255002,2021,106899,167501,274400,MKT
06079810445255002,2020,55265,187535,242800,MKT
06079810445255002,2019,55265,187535,242800,MKT
06079810445275001,2021,106899,168301,275200,MKT
06079810445275001,2020,55265,189035,244300,MKT
06079810445275001,2019,55265,189035,244300,MKT
06079810445295002,2021,106899,172101,279000,MKT
06079810445295002,2020,55265,198135,253400,MKT
06079810445295002,2019,55265,198135,253400,MKT
06079810445315001,2021,106899,170701,277600,MKT
06079810445315001,2020,55265,206735,262000,OVR
06079810445315001,2019,55265,206735,262000,MKT
06079810445335002,2021,106899,156801,263700,MKT
06079810445335002,2020,55265,183335,238600,MKT
06079810445335002,2019,55265,183335,238600,MKT
06079810445355001,2021,106899,156801,263700,MKT
06079810445355001,2020,55265,183335,238600,MKT
06079810445355001,2019,55265,183335,238600,MKT
06079810445375002,2021,106899,178301,285200,MKT
06079810445375002,2020,55265,207135,262400,MKT
06079810445375002,2019,55265,207135,262400,MKT
06079810445395001,2021,106899,178301,285200,MKT
06079810445395001,2020,55265,207135,262400,MKT
06079810445395001,2019,55265,207135,262400,MKT
06079810445415002,2021,106899,171201,278100,MKT
06079810445415002,2020,55265,196335,251600,MKT
06079810445415002,2019,55265,196335,251600,MKT
06079810445435001,2021,117455,165445,282900,MKT
06079810445435001,2020,66418,196282,262700,MKT
06079810445435001,2019,66418,196282,262700,MKT
06079810445455002,2021,103946,150554,254500,MKT
06079810445455002,2020,52324,171376,223700,MKT
06079810445455002,2019,52324,171376,223700,MKT
06079810445475001,2021,103946,151754,255700,MKT
06079810445475001,2020,52324,173376,225700,MKT
06079810445475001,2019,52324,173376,225700,MKT
06079810445495002,2021,103946,152954,256900,MKT
06079810445495002,2020,52324,183476,235800,MKT
06079810445495002,2019,52324,183476,235800,MKT
06079810445515001,2021,103946,153554,257500,MKT
06079810445515001,2020,52324,184676,237000,MKT
06079810445515001,2019,52324,184676,237000,MKT
06079810445535002,2021,102378,154822,257200,MKT
06079810445535002,2020,50795,185805,236600,MKT
06079810445535002,2019,50795,185805,236600,MKT
06079810445555001,2021,115205,155295,270500,MKT
06079810445555001,2020,63956,188544,252500,MKT
06079810445555001,2019,63956,188544,252500,MKT
06079810445606500,2021,547492,0,547492,COST
06079810445606500,2020,330410,0,330410,COST
06079810445606500,2019,330410,0,330410,COST
06079810445657000,2021,258946,0,258946,COST
06079810445657000,2020,310763,0,310763,COST
06079810445657000,2019,310763,0,310763,COST
06079810445757000,2021,240605,0,240605,COST
06079810445757000,2020,763929,0,763929,COST
06079810445757000,2019,763929,0,763929,COST
06079810447010000,2021,126852,273348,400200,INCOME
06079810447010000,2020,66418,306882,373300,INCOME
06079810447010000,2019,66418,306882,373300,INCOME
06079810447035001,2021,106899,158601,265500,MKT
06079810447035001,2020,55265,172035,227300,MKT
06079810447035001,2019,55265,172035,227300,MKT
06079810447055002,2021,106899,182201,289100,MKT
06079810447055002,2020,55265,197135,252400,MKT
06079810447055002,2019,55265,197135,252400,MKT
06079810447075001,2021,106899,181801,288700,MKT
06079810447075001,2020,55265,197035,252300,MKT
06079810447075001,2019,55265,197035,252300,MKT
06079810447095002,2021,106899,174301,281200,MKT
06079810447095002,2020,55265,200335,255600,MKT
06079810447095002,2019,55265,200335,255600,MKT
06079810447115001,2021,106899,169701,276600,MKT
06079810447115001,2020,55265,196335,251600,MKT
06079810447115001,2019,55265,196335,251600,MKT
06079810447135002,2021,106899,182701,289600,MKT
06079810447135002,2020,55265,201835,257100,MKT
06079810447135002,2019,55265,201835,257100,MKT
06079810447155001,2021,106899,182901,289800,MKT
06079810447155001,2020,55265,202235,257500,MKT
06079810447155001,2019,55265,202235,257500,MKT
06079810447175002,2021,106899,196201,303100,MKT
06079810447175002,2020,55265,208135,263400,MKT
06079810447175002,2019,55265,208135,263400,MKT
06079810447195001,2021,116345,227555,343900,MKT
06079810447195001,2020,65198,241502,306700,MKT
06079810447195001,2019,65198,241502,306700,MKT
06079810447215002,2021,125442,231158,356600,MKT
06079810447215002,2020,75518,243482,319000,OVR
06079810447215002,2019,75518,243482,319000,MKT
06079810447235001,2021,106899,184501,291400,MKT
06079810447235001,2020,55265,203135,258400,OVR
06079810447235001,2019,55265,203135,258400,MKT
06079810447255002,2021,106899,187401,294300,MKT
06079810447255002,2020,55265,202935,258200,MKT
06079810447255002,2019,55265,202935,258200,MKT
06079810447275001,2021,106899,187401,294300,MKT
06079810447275001,2020,55265,202935,258200,MKT
06079810447275001,2019,55265,202935,258200,MKT
06079810447295002,2021,106899,183901,290800,MKT
06079810447295002,2020,55265,193735,249000,MKT
06079810447295002,2019,55265,193735,249000,MKT
06079810447315001,2021,106899,183901,290800,MKT
06079810447315001,2020,55265,193735,249000,MKT
06079810447315001,2019,55265,193735,249000,MKT
06079810447335002,2021,106899,182701,289600,MKT
06079810447335002,2020,55265,203035,258300,MKT
06079810447335002,2019,55265,203035,258300,MKT
06079810447355001,2021,106899,182901,289800,MKT
06079810447355001,2020,55265,203035,258300,MKT
06079810447355001,2019,55265,203035,258300,MKT
06079810447375002,2021,106899,177201,284100,MKT
06079810447375002,2020,55265,189735,245000,MKT
06079810447375002,2019,55265,189735,245000,MKT
06079810447395001,2021,106899,177801,284700,MKT
06079810447395001,2020,55265,191035,246300,MKT
06079810447395001,2019,55265,191035,246300,MKT
06079810447415002,2021,106899,183401,290300,MKT
06079810447415002,2020,55265,199235,254500,MKT
06079810447415002,2019,55265,199235,254500,MKT
06079810447435001,2021,117455,185645,303100,MKT
06079810447435001,2020,66418,197882,264300,MKT
06079810447435001,2019,66418,197882,264300,MKT
06079810448015001,2021,118000,154000,272000,MKT
06079810448015001,2020,67020,172080,239100,MKT
06079810448015001,2019,67020,172080,239100,MKT
06079810448035002,2021,108974,154026,263000,MKT
06079810448035002,2020,57379,172021,229400,MKT
06079810448035002,2019,57379,172021,229400,MKT
06079810448055001,2021,107603,181397,289000,MKT
06079810448055001,2020,55978,203122,259100,MKT
06079810448055001,2019,55978,203122,259100,MKT
06079810448075002,2021,107603,180297,287900,MKT
06079810448075002,2020,55978,202222,258200,MKT
06079810448075002,2019,55978,202222,258200,MKT
06079810448115001,2021,129380,235520,364900,MKT
06079810448115001,2020,80214,233286,313500,MKT
06079810448115001,2019,80214,233286,313500,MKT
06079810448155002,2021,129380,235520,364900,MKT
06079810448155002,2020,80214,233286,313500,MKT
06079810448155002,2019,80214,233286,313500,MKT
06079810448175001,2021,107603,183197,290800,MKT
06079810448175001,2020,55978,194422,250400,MKT
06079810448175001,2019,55978,194422,250400,MKT
06079810448195002,2021,107603,180797,288400,MKT
06079810448195002,2020,55978,190622,246600,MKT
06079810448195002,2019,55978,190622,246600,MKT
06079810448215001,2021,108974,171526,280500,MKT
06079810448215001,2020,57379,197521,254900,MKT
06079810448215001,2019,57379,197521,254900,MKT
06079810448235002,2021,120623,176077,296700,MKT
06079810448235002,2020,69959,192241,262200,MKT
06079810448235002,2019,69959,192241,262200,MKT
06079810449015001,2021,114032,176168,290200,MKT
06079810449015001,2020,62692,195508,258200,MKT
06079810449015001,2019,62692,195508,258200,MKT
06079810449035002,2021,106182,182518,288700,MKT
06079810449035002,2020,54544,196856,251400,MKT
06079810449035002,2019,54544,196856,251400,MKT
06079810449055001,2021,106899,186401,293300,MKT
06079810449055001,2020,55265,200835,256100,MKT
06079810449055001,2019,55265,200835,256100,MKT
06079810449075002,2021,106899,186401,293300,MKT
06079810449075002,2020,55265,200835,256100,MKT
06079810449075002,2019,55265,200835,256100,MKT
06079810449095001,2021,106899,186801,293700,MKT
06079810449095001,2020,55265,201435,256700,MKT
06079810449095001,2019,55265,201435,256700,MKT
06079810449115002,2021,106899,188101,295000,MKT
06079810449115002,2020,55265,202835,258100,MKT
06079810449115002,2019,55265,202835,258100,MKT
06079810449135001,2021,106899,172901,279800,MKT
06079810449135001,2020,55265,199535,254800,MKT
06079810449135001,2019,55265,199535,254800,MKT
06079810449155002,2021,106882,173118,280000,MKT
06079810449155002,2020,55248,199852,255100,MKT
06079810449155002,2019,55248,199852,255100,MKT
06079810449175001,2021,125134,227250,352384,COST
06079810449175001,2020,75157,227643,302800,MKT
06079810449175001,2019,75157,227643,302800,MKT
06079810449195002,2021,137752,254820,392572,COST
06079810449195002,2020,78012,290570,368582,COST
06079810449195002,2019,78012,290570,368582,COST
06079810449215001,2021,114731,175369,290100,MKT
06079810449215001,2020,54595,191705,246300,MKT
06079810449215001,2019,54595,191705,246300,MKT
06079810449235002,2021,114731,175469,290200,MKT
06079810449235002,2020,54595,191805,246400,MKT
06079810449235002,2019,54595,191805,246400,MKT
06079810449255001,2021,115106,179694,294800,MKT
06079810449255001,2020,54944,204056,259000,MKT
06079810449255001,2019,54944,204056,259000,MKT
06079810449275002,2021,115106,180194,295300,MKT
06079810449275002,2020,54944,204456,259400,MKT
06079810449275002,2019,54944,204456,259400,MKT
06079810449295001,2021,114353,184247,298600,MKT
06079810449295001,2020,54244,196756,251000,MKT
06079810449295001,2019,54244,196756,251000,MKT
06079810449315002,2021,114353,184247,298600,MKT
06079810449315002,2020,54244,196756,251000,MKT
06079810449315002,2019,54244,196756,251000,MKT
06079810449335001,2021,114722,178978,293700,MKT
06079810449335001,2020,54587,200513,255100,MKT
06079810449335001,2019,54587,200513,255100,MKT
06079810449355002,2021,114722,178978,293700,MKT
06079810449355002,2020,54587,200513,255100,MKT
06079810449355002,2019,54587,200513,255100,MKT
06079810449375001,2021,114722,178278,293000,MKT
06079810449375001,2020,54587,199613,254200,MKT
06079810449375001,2019,54587,199613,254200,MKT
06079810449395002,2021,115088,179312,294400,MKT
06079810449395002,2020,54927,200573,255500,MKT
06079810449395002,2019,54927,200573,255500,MKT
06079810449415001,2021,115088,178112,293200,MKT
06079810449415001,2020,54927,190673,245600,MKT
06079810449415001,2019,54927,190673,245600,MKT
06079810449435002,2021,125258,171242,296500,MKT
06079810449435002,2020,64798,192002,256800,MKT
06079810449435002,2019,64798,192002,256800,MKT
06079810450015001,2021,113603,151797,265400,MKT
06079810450015001,2020,62233,179667,241900,MKT
06079810450015001,2019,62233,179667,241900,MKT
06079810450035002,2021,104926,151874,256800,MKT
06079810450035002,2020,53292,179708,233000,MKT
06079810450035002,2019,53292,179708,233000,MKT
06079810450050000,2021,127840,276960,404800,INCOME
06079810450050000,2020,78361,290139,368500,INCOME
06079810450050000,2019,78361,290139,368500,INCOME
06079810450095001,2021,106580,188220,294800,MKT
06079810450095001,2020,54944,207456,262400,MKT
06079810450095001,2019,54944,207456,262400,MKT
06079810450115002,2021,106580,188220,294800,MKT
06079810450115002,2020,54944,207456,262400,MKT
06079810450115002,2019,54944,207456,262400,MKT
06079810450135001,2021,106580,218120,324700,MKT
06079810450135001,2020,54944,236156,291100,MKT
06079810450135001,2019,54944,236156,291100,MKT
06079810450155002,2021,106233,202067,308300,MKT
06079810450155002,2020,54595,211205,265800,MKT
06079810450155002,2019,54595,211205,265800,MKT
06079810450175001,2021,106233,193167,299400,MKT
06079810450175001,2020,54595,214105,268700,MKT
06079810450175001,2019,54595,214105,268700,MKT
06079810450195002,2021,106233,193167,299400,MKT
06079810450195002,2020,54595,214105,268700,MKT
06079810450195002,2019,54595,214105,268700,MKT
06079810450215001,2021,106233,187767,294000,MKT
06079810450215001,2020,54595,212505,267100,MKT
06079810450215001,2019,54595,212505,267100,MKT
06079810450235002,2021,106233,187767,294000,MKT
06079810450235002,2020,54595,212505,267100,MKT
06079810450235002,2019,54595,212505,267100,MKT
06079810450255001,2021,106233,159667,265900,MKT
06079810450255001,2020,54595,187405,242000,MKT
06079810450255001,2019,54595,187405,242000,MKT
06079810450275002,2021,106233,159667,265900,MKT
06079810450275002,2020,54595,187405,242000,MKT
06079810450275002,2019,54595,187405,242000,MKT
06079810450295001,2021,106916,182584,289500,MKT
06079810450295001,2020,55282,201818,257100,MKT
06079810450295001,2019,55282,201818,257100,MKT
06079810450315002,2021,106563,183837,290400,MKT
06079810450315002,2020,54927,202773,257700,MKT
06079810450315002,2019,54927,202773,257700,MKT
06079810450335001,2021,106563,185437,292000,MKT
06079810450335001,2020,54927,206473,261400,MKT
06079810450335001,2019,54927,206473,261400,MKT
06079810450355002,2021,106916,185484,292400,MKT
06079810450355002,2020,55282,206418,261700,MKT
06079810450355002,2019,55282,206418,261700,MKT
06079810450375001,2021,106916,180284,287200,MKT
06079810450375001,2020,55282,214818,270100,MKT
06079810450375001,2019,55282,214818,270100,MKT
06079810450395002,2021,106916,180284,287200,MKT
06079810450395002,2020,55282,214818,270100,MKT
06079810450395002,2019,55282,214818,270100,MKT
06079810450415001,2021,106916,178384,285300,MKT
06079810450415001,2020,55282,212618,267900,MKT
06079810450415001,2019,55282,212618,267900,MKT
06079810450435002,2021,106916,178384,285300,MKT
06079810450435002,2020,55282,212618,267900,MKT
06079810450435002,2019,55282,212618,267900,MKT
06079810450455001,2021,119586,173914,293500,MKT
06079810450455001,2020,68790,200310,269100,MKT
06079810450455001,2019,68790,200310,269100,MKT
06079810450475002,2021,128614,172786,301400,MKT
06079810450475002,2020,79290,202810,282100,MKT
06079810450475002,2019,79290,202810,282100,MKT
06079810451010000,2021,137459,230941,368400,MKT
06079810451010000,2020,90281,233919,324200,MKT
06079810451010000,2019,90281,233919,324200,MKT
06079810451030000,2021,122470,276530,399000,MKT
06079810451030000,2020,72065,277135,349200,MKT
06079810451030000,2019,72065,277135,349200,MKT
06079810451050000,2021,122470,225930,348400,MKT
06079810451050000,2020,72065,229635,301700,MKT
06079810451050000,2019,72065,229635,301700,MKT
06079810451070000,2021,122470,222430,344900,MKT
06079810451070000,2020,72065,225035,297100,MKT
06079810451070000,2019,72065,225035,297100,MKT
06079810451090000,2021,122470,216430,338900,MKT
06079810451090000,2020,72065,227435,299500,MKT
06079810451090000,2019,72065,227435,299500,MKT
06079810451110000,2021,129759,218641,348400,MKT
06079810451110000,2020,80673,221327,302000,MKT
06079810451110000,2019,80673,221327,302000,MKT
06079810451130000,2021,129759,216341,346100,MKT
06079810451130000,2020,80673,221927,302600,MKT
06079810451130000,2019,80673,221927,302600,MKT
06079810451150000,2021,122470,218530,341000,MKT
06079810451150000,2020,72065,227435,299500,MKT
06079810451150000,2019,72065,227435,299500,MKT
06079810451170000,2021,122470,218030,340500,MKT
06079810451170000,2020,72065,226735,298800,MKT
06079810451170000,2019,72065,226735,298800,MKT
06079810451190000,2021,122470,257230,379700,MKT
06079810451190000,2020,72065,255535,327600,MKT
06079810451190000,2019,72065,255535,327600,MKT
06079810451210000,2021,122470,217930,340400,MKT
06079810451210000,2020,72065,226635,298700,MKT
06079810451210000,2019,72065,226635,298700,MKT
06079810451230000,2021,133150,209050,342200,MKT
06079810451230000,2020,84840,215160,300000,MKT
06079810451230000,2019,84840,215160,300000,MKT
06079810452010000,2021,130886,234814,365700,MKT
06079810452010000,2020,82047,240453,322500,MKT
06079810452010000,2019,82047,240453,322500,MKT
06079810452030000,2021,123883,199617,323500,MKT
06079810452030000,2020,73697,208703,282400,MKT
06079810452030000,2019,73697,208703,282400,MKT
06079810452050000,2021,123883,217717,341600,MKT
06079810452050000,2020,73697,225103,298800,MKT
06079810452050000,2019,73697,225103,298800,MKT
06079810452070000,2021,123883,208417,332300,MKT
06079810452070000,2020,73697,215703,289400,MKT
06079810452070000,2019,73697,215703,289400,MKT
06079810452090000,2021,123883,215917,339800,MKT
06079810452090000,2020,73697,222703,296400,MKT
06079810452090000,2019,73697,222703,296400,MKT
06079810452110000,2021,130886,234214,365100,MKT
06079810452110000,2020,82047,239853,321900,MKT
06079810452110000,2019,82047,239853,321900,MKT
06079810452130000,2021,131319,235781,367100,MKT
06079810452130000,2020,82577,231323,313900,MKT
06079810452130000,2019,82577,231323,313900,MKT
06079810452150000,2021,124293,214307,338600,MKT
06079810452150000,2020,74174,222026,296200,MKT
06079810452150000,2019,74174,222026,296200,MKT
06079810452170000,2021,124293,233107,357400,MKT
06079810452170000,2020,74174,239326,313500,MKT
06079810452170000,2019,74174,239326,313500,MKT
06079810452190000,2021,124293,230607,354900,MKT
06079810452190000,2020,74174,242226,316400,MKT
06079810452190000,2019,74174,242226,316400,MKT
06079810452210000,2021,124293,203807,328100,MKT
06079810452210000,2020,74174,214926,289100,MKT
06079810452210000,2019,74174,214926,289100,MKT
06079810452230000,2021,131319,265581,396900,MKT
06079810452230000,2020,82577,267523,350100,MKT
06079810452230000,2019,82577,267523,350100,MKT
06079810453010000,2021,131319,271481,402800,MKT
06079810453010000,2020,82577,272723,355300,MKT
06079810453010000,2019,82577,272723,355300,MKT
06079810453030000,2021,124293,276807,401100,MKT
06079810453030000,2020,74174,274526,348700,MKT
06079810453030000,2019,74174,274526,348700,MKT
06079810453050000,2021,124293,230407,354700,MKT
06079810453050000,2020,74174,233726,307900,MKT
06079810453050000,2019,74174,233726,307900,MKT
06079810453070000,2021,124293,224707,349000,MKT
06079810453070000,2020,74174,228826,303000,MKT
06079810453070000,2019,74174,228826,303000,MKT
06079810453090000,2021,124293,251607,375900,MKT
06079810453090000,2020,74174,254126,328300,MKT
06079810453090000,2019,74174,254126,328300,MKT
06079810453110000,2021,131319,272781,404100,MKT
06079810453110000,2020,82577,270223,352800,MKT
06079810453110000,2019,82577,270223,352800,MKT
06079810453130000,2021,131319,324281,455600,MKT
06079810453130000,2020,82577,312323,394900,MKT
06079810453130000,2019,82577,312323,394900,MKT
06079810453150000,2021,128201,277099,405300,MKT
06079810453150000,2020,78793,275607,354400,MKT
06079810453150000,2019,78793,271407,350200,MKT
06079810453170000,2021,128201,218899,347100,MKT
06079810453170000,2020,78793,223707,302500,MKT
06079810453170000,2019,78793,223707,302500,MKT
06079810453190000,2021,128201,215599,343800,MKT
06079810453190000,2020,78793,222507,301300,MKT
06079810453190000,2019,78793,222507,301300,MKT
06079810453210000,2021,128201,257699,385900,MKT
06079810453210000,2020,78793,255707,334500,MKT
06079810453210000,2019,78793,255707,334500,MKT
06079810453230000,2021,135447,229553,365000,MKT
06079810453230000,2020,87720,235180,322900,MKT
06079810453230000,2019,87720,235180,322900,MKT
06079810453356500,2021,49136,0,49136,COST
06079810453356500,2020,38131,0,38131,COST
06079810453356500,2019,38131,0,38131,COST
06079810454010000,2021,131319,216481,347800,MKT
06079810454010000,2020,82577,220623,303200,MKT
06079810454010000,2019,82577,220623,303200,MKT
06079810454030000,2021,124293,272307,396600,MKT
06079810454030000,2020,74174,279226,353400,MKT
06079810454030000,2019,74174,275426,349600,MKT
06079810454050000,2021,124293,234707,359000,MKT
06079810454050000,2020,74174,241026,315200,MKT
06079810454050000,2019,74174,241026,315200,MKT
06079810454070000,2021,124293,268607,392900,MKT
06079810454070000,2020,74174,274326,348500,MKT
06079810454070000,2019,74174,274326,348500,MKT
06079810454090000,2021,123883,234717,358600,MKT
06079810454090000,2020,73697,241103,314800,MKT
06079810454090000,2019,73697,241103,314800,MKT
06079810454110000,2021,130886,296814,427700,MKT
06079810454110000,2020,82047,286153,368200,MKT
06079810454110000,2019,82047,286153,368200,MKT
06079810454130000,2021,130886,240914,371800,MKT
06079810454130000,2020,82047,242953,325000,MKT
06079810454130000,2019,82047,242953,325000,MKT
06079810454150000,2021,123883,255617,379500,MKT
06079810454150000,2020,73697,259303,333000,MKT
06079810454150000,2019,73697,259303,333000,MKT
06079810454170000,2021,123883,240717,364600,MKT
06079810454170000,2020,73697,240703,314400,MKT
06079810454170000,2019,73697,240703,314400,MKT
06079810454190000,2021,124293,266707,391000,MKT
06079810454190000,2020,74174,265326,339500,MKT
06079810454190000,2019,74174,265326,339500,MKT
06079810454210000,2021,124293,212207,336500,MKT
06079810454210000,2020,74174,219926,294100,MKT
06079810454210000,2019,74174,216626,290800,MKT
06079810454230000,2021,131319,251881,383200,MKT
06079810454230000,2020,82577,263223,345800,MKT
06079810454230000,2019,82577,263223,345800,MKT
06079810455010000,2021,155084,206716,361800,MKT
06079810455010000,2020,118571,204229,322800,MKT
06079810455010000,2019,118571,204229,322800,MKT
06079810455030000,2021,151708,337192,488900,MKT
06079810455030000,2020,113585,309815,423400,MKT
06079810455030000,2019,113585,309815,423400,MKT
06079810455050000,2021,146012,222388,368400,MKT
06079810455050000,2020,105410,230590,336000,MKT
06079810455050000,2019,105410,230590,336000,MKT
06079810455070000,2021,140814,221086,361900,MKT
06079810455070000,2020,98210,220690,318900,MKT
06079810455070000,2019,98210,220690,318900,MKT
06079810455090000,2021,139472,270428,409900,MKT
06079810455090000,2020,96391,259509,355900,MKT
06079810455090000,2019,96391,259509,355900,MKT
06079810455110000,2021,139472,246128,385600,MKT
06079810455110000,2020,96391,249809,346200,MKT
06079810455110000,2019,96391,249809,346200,MKT
06079810455130000,2021,139472,244628,384100,MKT
06079810455130000,2020,96391,254809,351200,MKT
06079810455130000,2019,96391,254809,351200,MKT
06079810455150000,2021,138981,238619,377600,MKT
06079810455150000,2020,95730,240370,336100,MKT
06079810455150000,2019,95730,240370,336100,MKT
06079810455170000,2021,151214,230686,381900,MKT
06079810455170000,2020,112864,226136,339000,MKT
06079810455170000,2019,112864,226136,339000,MKT
06079810455190000,2021,147163,233137,380300,MKT
06079810455190000,2020,107038,220462,327500,MKT
06079810455190000,2019,107038,220462,327500,MKT
06079810455210000,2021,139472,250928,390400,MKT
06079810455210000,2020,96391,250309,346700,MKT
06079810455210000,2019,96391,250309,346700,MKT
06079810455230000,2021,139472,290928,430400,MKT
06079810455230000,2020,96391,283609,380000,MKT
06079810455230000,2019,96391,283609,380000,MKT
06079810455250000,2021,139472,237928,377400,MKT
06079810455250000,2020,96391,229309,325700,MKT
06079810455250000,2019,96391,229309,325700,MKT
06079810455270000,2021,147163,215737,362900,MKT
06079810455270000,2020,107038,212762,319800,MKT
06079810455270000,2019,107038,212762,319800,MKT
06079810455356500,2021,29708,0,29708,COST
06079810455356500,2020,14280,0,14280,COST
06079810455356500,2019,14280,0,14280,COST
06079810460017000,2021,162039,0,162039,COST
06079810460017000,2020,124465,0,124465,COST
06079810460017000,2019,124465,0,124465,COST
06079810460020000,2021,216053,481347,697400,INCOME
06079810460020000,2020,124465,465035,589500,INCOME
06079810460020000,2019,124465,465035,589500,INCOME
06079810460037000,2021,194833,0,194833,COST
06079810460037000,2020,178354,0,178354,COST
06079810460037000,2019,178354,0,178354,COST
06079810460050000,2021,216053,481347,697400,INCOME
06079810460050000,2020,124465,504835,629300,INCOME
06079810460050000,2019,124465,504835,629300,INCOME
06079810460067000,2021,137733,0,137733,COST
06079810460067000,2020,102061,0,102061,COST
06079810460067000,2019,102061,0,102061,COST
06079810460096500,2021,98072,0,98072,COST
06079810460096500,2020,146932,0,146932,COST
06079810460096500,2019,146932,0,146932,COST
06079810460130000,2021,1631484,10704640,12336124,COST
06079810460130000,2020,718945,10118170,10837115,COST
06079810460130000,2019,718945,10118170,10837115,COST
06079810460207000,2021,432199,0,432199,COST
06079810460207000,2020,844635,0,844635,COST
06079810460207000,2019,844635,0,844635,COST
06079810461017000,2021,137733,0,137733,COST
06079810461017000,2020,102061,0,102061,COST
06079810461017000,2019,102061,0,102061,COST
06079810461020000,2021,216053,351847,567900,INCOME
06079810461020000,2020,124465,373235,497700,INCOME
06079810461020000,2019,124465,373235,497700,INCOME
06079810461030000,2021,216053,443247,659300,INCOME
06079810461030000,2020,124465,499235,623700,INCOME
06079810461030000,2019,124465,499235,623700,INCOME
06079810461040000,2021,216053,331047,547100,INCOME
06079810461040000,2020,124465,336935,461400,INCOME
06079810461040000,2019,124465,336935,461400,INCOME
06079810461057000,2021,162039,0,162039,COST
06079810461057000,2020,124465,0,124465,COST
06079810461057000,2019,124465,0,124465,COST
06079810461067000,2021,162039,0,162039,COST
06079810461067000,2020,124465,0,124465,COST
06079810461067000,2019,124465,0,124465,COST
06079810461075001,2021,103400,179500,282900,MKT
06079810461075001,2020,51789,191211,243000,MKT
06079810461075001,2019,51789,191211,243000,MKT
06079810461075002,2021,103400,168900,272300,MKT
06079810461075002,2020,51789,187311,239100,MKT
06079810461075002,2019,51789,187311,239100,MKT
06079810461075003,2021,103400,168900,272300,MKT
06079810461075003,2020,51789,187311,239100,MKT
06079810461075003,2019,51789,187311,239100,MKT
06079810461075004,2021,112537,179463,292000,MKT
06079810461075004,2020,61097,191003,252100,MKT
06079810461075004,2019,61097,191003,252100,MKT
06079810461076500,2021,31358,0,31358,COST
06079810461076500,2020,15870,0,15870,COST
06079810461076500,2019,15870,0,15870,COST
06079810461080000,2021,216053,593547,809600,INCOME
06079810461080000,2020,124465,612435,736900,INCOME
06079810461080000,2019,124465,612435,736900,INCOME
06079810461095001,2021,120743,178457,299200,MKT
06079810461095001,2020,70094,184206,254300,MKT
06079810461095001,2019,70094,184206,254300,MKT
06079810461095002,2021,101035,180565,281600,MKT
06079810461095002,2020,49503,192197,241700,MKT
06079810461095002,2019,49503,192197,241700,MKT
06079810461095003,2021,101035,180565,281600,MKT
06079810461095003,2020,49503,192197,241700,MKT
06079810461095003,2019,49503,192197,241700,MKT
06079810461095004,2021,120743,184657,305400,MKT
06079810461095004,2020,70094,196006,266100,MKT
06079810461095004,2019,70094,196006,266100,MKT
06079810461100000,2021,216053,408147,624200,INCOME
06079810461100000,2020,124465,446935,571400,INCOME
06079810461100000,2019,124465,446935,571400,INCOME
06079810461110000,2021,216053,593547,809600,INCOME
06079810461110000,2020,124465,612435,736900,INCOME
06079810461110000,2019,124465,612435,736900,INCOME
06079810461120000,2021,216053,295547,511600,INCOME
06079810461120000,2020,102061,315639,417700,INCOME
06079810461120000,2019,102061,315639,417700,INCOME
06079810462010000,2021,216053,481347,697400,INCOME
06079810462010000,2020,102061,487439,589500,INCOME
06079810462010000,2019,102061,487439,589500,INCOME
06079810462027000,2021,162039,0,162039,COST
06079810462027000,2020,124465,0,124465,COST
06079810462027000,2019,124465,0,124465,COST
06079810462037000,2021,162039,0,162039,COST
06079810462037000,2020,124465,0,124465,COST
06079810462037000,2019,124465,0,124465,COST
06079810462040000,2021,216053,340247,556300,INCOME
06079810462040000,2020,124465,340635,465100,INCOME
06079810462040000,2019,124465,340635,465100,INCOME
06079810462050000,2021,216053,291347,507400,INCOME
06079810462050000,2020,124465,289935,414400,INCOME
06079810462050000,2019,124465,289935,414400,INCOME
06079810462060000,2021,216053,291347,507400,INCOME
06079810462060000,2020,124465,289935,414400,INCOME
06079810462060000,2019,124465,289935,414400,INCOME
06079810462070000,2021,216053,291347,507400,INCOME
06079810462070000,2020,124465,289935,414400,INCOME
06079810462070000,2019,124465,289935,414400,INCOME
06079810462087000,2021,162039,0,162039,COST
06079810462087000,2020,124465,0,124465,COST
06079810462087000,2019,124465,0,124465,COST
06079810462097000,2021,162039,0,162039,COST
06079810462097000,2020,124465,0,124465,COST
06079810462097000,2019,124465,0,124465,COST
06079810462107000,2021,162039,0,162039,COST
06079810462107000,2020,124465,0,124465,COST
06079810462107000,2019,124465,0,124465,COST
06079810462110000,2021,216053,291347,507400,INCOME
06079810462110000,2020,124465,289935,414400,INCOME
06079810462110000,2019,124465,289935,414400,INCOME
06079810462127000,2021,137733,0,137733,COST
06079810462127000,2020,102061,0,102061,COST
06079810462127000,2019,102061,0,102061,COST
06079810463015001,2021,106648,189552,296200,MKT
06079810463015001,2020,61950,188150,250100,OVR
06079810463015001,2019,61950,188150,250100,MKT
06079810463015002,2021,101856,185944,287800,MKT
06079810463015002,2020,50291,196609,246900,OVR
06079810463015002,2019,50291,196609,246900,MKT
06079810463015003,2021,101856,182444,284300,MKT
06079810463015003,2020,50291,193109,243400,OVR
06079810463015003,2019,50291,193109,243400,MKT
06079810463015004,2021,125469,188831,314300,MKT
06079810463015004,2020,75549,198951,274500,MKT
06079810463015004,2019,75549,197551,273100,MKT
06079810463027000,2021,158203,0,158203,COST
06079810463027000,2020,118779,0,118779,COST
06079810463027000,2019,118779,0,118779,COST
06079810463030000,2021,204715,302685,507400,INCOME
06079810463030000,2020,118779,295621,414400,INCOME
06079810463030000,2019,118779,295621,414400,INCOME
06079810463047000,2021,174023,0,174023,COST
06079810463047000,2020,148474,0,148474,COST
06079810463047000,2019,148474,0,148474,COST
06079810463057000,2021,174023,0,174023,COST
06079810463057000,2020,148474,0,148474,COST
06079810463057000,2019,148474,0,148474,COST
06079810463060000,2021,204715,363185,567900,INCOME
06079810463060000,2020,148474,349226,497700,INCOME
06079810463060000,2019,148474,349226,497700,INCOME
06079810463070000,2021,210233,449067,659300,INCOME
06079810463070000,2020,121552,502148,623700,INCOME
06079810463070000,2019,121552,502148,623700,INCOME
06079810480017000,2021,210277,350,210627,COST
06079810480017000,2020,206989,350,207339,COST
06079810480017000,2019,206989,350,207339,COST
06079811101010000,2021,124887,233413,358300,MKT
06079811101010000,2020,98394,197506,295900,MKT
06079811101010000,2019,98394,197506,295900,MKT
06079811101020000,2021,126005,261095,387100,MKT
06079811101020000,2020,99384,205616,305000,MKT
06079811101020000,2019,99384,205616,305000,MKT
06079811101030000,2021,126005,225495,351500,MKT
06079811101030000,2020,99384,195616,295000,MKT
06079811101030000,2019,99384,195616,295000,MKT
06079811101040000,2021,126635,264965,391600,MKT
06079811101040000,2020,99942,217258,317200,MKT
06079811101040000,2019,99942,217258,317200,MKT
06079811101050000,2021,126005,259895,385900,MKT
06079811101050000,2020,99384,212016,311400,MKT
06079811101050000,2019,99384,212016,311400,MKT
06079811101060000,2021,126321,268079,394400,MKT
06079811101060000,2020,99663,205937,305600,MKT
06079811101060000,2019,99663,205937,305600,MKT
06079811101070000,2021,126635,246365,373000,MKT
06079811101070000,2020,99942,199958,299900,MKT
06079811101070000,2019,99942,199958,299900,MKT
06079811101080000,2021,126321,282979,409300,MKT
06079811101080000,2020,99663,228237,327900,MKT
06079811101080000,2019,99663,228237,327900,MKT
06079811101090000,2021,126635,240565,367200,MKT
06079811101090000,2020,99942,197258,297200,MKT
06079811101090000,2019,99942,197258,297200,MKT
06079811102010000,2021,107800,210000,317800,MKT
06079811102010000,2020,83414,177086,260500,MKT
06079811102010000,2019,83414,177086,260500,MKT
06079811102020000,2021,126005,187670,313675,COST
06079811102020000,2020,99384,171400,270784,COST
06079811102020000,2019,99384,184260,283644,COST
06079811102030000,2021,126005,202095,328100,MKT
06079811102030000,2020,99384,164016,263400,MKT
06079811102030000,2019,99384,164016,263400,MKT
06079811102040000,2021,126005,225795,351800,MKT
06079811102040000,2020,99384,188116,287500,MKT
06079811102040000,2019,99384,188116,287500,MKT
06079811102050000,2021,126005,275795,401800,MKT
06079811102050000,2020,99384,211516,310900,MKT
06079811102050000,2019,99384,211516,310900,MKT
06079811102060000,2021,126005,242995,369000,MKT
06079811102060000,2020,99384,198616,298000,MKT
06079811102060000,2019,99384,198616,298000,MKT
06079811102070000,2021,126005,250195,376200,MKT
06079811102070000,2020,99384,212616,312000,MKT
06079811102070000,2019,99384,212616,312000,MKT
06079811102080000,2021,126005,227195,353200,MKT
06079811102080000,2020,99384,195616,295000,MKT
06079811102080000,2019,99384,195616,295000,MKT
06079811102090000,2021,126005,258595,384600,MKT
06079811102090000,2020,99384,240116,339500,OVR
06079811102090000,2019,99384,240116,339500,MKT
06079811102150000,2021,142319,206381,348700,INCOME
06079811102150000,2020,96616,198184,294800,INCOME
06079811102150000,2019,96616,198184,294800,INCOME
06079811102175002,2021,117674,182626,300300,MKT
06079811102175002,2020,66659,189241,255900,MKT
06079811102175002,2019,66659,189241,255900,MKT
06079811102195001,2021,115671,199829,315500,MKT
06079811102195001,2020,64463,167440,231903,COST
06079811102195001,2019,64463,167440,231903,COST
06079811102215002,2021,115082,173818,288900,MKT
06079811102215002,2020,63823,180777,244600,MKT
06079811102215002,2019,63823,180777,244600,MKT
06079811102235001,2021,115082,173818,288900,MKT
06079811102235001,2020,63823,180777,244600,MKT
06079811102235001,2019,63823,180777,244600,MKT
06079811102255002,2021,115082,168118,283200,MKT
06079811102255002,2020,63823,179677,243500,MKT
06079811102255002,2019,63823,179677,243500,MKT
06079811102275001,2021,115082,168118,283200,MKT
06079811102275001,2020,63823,179677,243500,MKT
06079811102275001,2019,63823,179677,243500,MKT
06079811102295001,2021,115082,221318,336400,MKT
06079811102295001,2020,63823,230477,294300,OVR
06079811102295001,2019,63823,230477,294300,MKT
06079811102315002,2021,115082,221318,336400,MKT
06079811102315002,2020,63823,230477,294300,OVR
06079811102315002,2019,63823,230477,294300,MKT
06079811102335002,2021,115082,186718,301800,MKT
06079811102335002,2020,63823,208277,272100,MKT
06079811102335002,2019,63823,208277,272100,MKT
06079811102355001,2021,115082,190818,305900,MKT
06079811102355001,2020,63823,202777,266600,MKT
06079811102355001,2019,63823,202777,266600,MKT
06079811102375002,2021,115082,189618,304700,MKT
06079811102375002,2020,63823,202177,266000,MKT
06079811102375002,2019,63823,202177,266000,MKT
06079811102395001,2021,115082,191718,306800,MKT
06079811102395001,2020,63823,204077,267900,MKT
06079811102395001,2019,63823,204077,267900,MKT
06079811102415002,2021,115082,180618,295700,MKT
06079811102415002,2020,63823,191377,255200,MKT
06079811102415002,2019,63823,191377,255200,MKT
06079811102435001,2021,126268,169932,296200,MKT
06079811102435001,2020,76491,191109,267600,MKT
06079811102435001,2019,76491,191109,267600,MKT
06079811103015001,2021,128944,188756,317700,MKT
06079811103015001,2020,79687,199813,279500,MKT
06079811103015001,2019,79687,199813,279500,MKT
06079811103035002,2021,116252,192348,308600,MKT
06079811103035002,2020,65096,208204,273300,MKT
06079811103035002,2019,65096,208204,273300,MKT
06079811103055001,2021,116252,188148,304400,MKT
06079811103055001,2020,65096,209004,274100,MKT
06079811103055001,2019,65096,209004,274100,MKT
06079811103075002,2021,116252,188148,304400,MKT
06079811103075002,2020,65096,209004,274100,MKT
06079811103075002,2019,65096,209004,274100,MKT
06079811103095001,2021,114781,187619,302400,MKT
06079811103095001,2020,63498,208302,271800,MKT
06079811103095001,2019,63498,208302,271800,MKT
06079811103115001,2021,116252,188148,304400,MKT
06079811103115001,2020,65096,209004,274100,MKT
06079811103115001,2019,65096,209004,274100,MKT
06079811103135001,2021,114781,189019,303800,MKT
06079811103135001,2020,63498,209802,273300,MKT
06079811103135001,2019,63498,209802,273300,MKT
06079811103155002,2021,116252,188948,305200,MKT
06079811103155002,2020,65096,209804,274900,MKT
06079811103155002,2019,65096,209804,274900,MKT
06079811103175001,2021,114781,188119,302900,MKT
06079811103175001,2020,63498,209002,272500,MKT
06079811103175001,2019,63498,209002,272500,MKT
06079811103195002,2021,116252,188148,304400,MKT
06079811103195002,2020,65096,209004,274100,MKT
06079811103195002,2019,65096,209004,274100,MKT
06079811103215001,2021,114781,194619,309400,MKT
06079811103215001,2020,63498,210802,274300,MKT
06079811103215001,2019,63498,210802,274300,MKT
06079811103235002,2021,116252,194548,310800,MKT
06079811103235002,2020,65096,210704,275800,MKT
06079811103235002,2019,65096,210704,275800,MKT
06079811103255001,2021,114179,168021,282200,MKT
06079811103255001,2020,62849,179551,242400,MKT
06079811103255001,2019,62849,179551,242400,MKT
06079811103275002,2021,123666,171634,295300,MKT
06079811103275002,2020,73445,179555,253000,MKT
06079811103275002,2019,73445,179555,253000,MKT
06079811103290000,2021,123666,224434,348100,MKT
06079811103290000,2020,73445,227455,300900,MKT
06079811103290000,2019,73445,227455,300900,MKT
06079811103356500,2021,52660,0,52660,COST
06079811103356500,2020,43650,0,43650,COST
06079811103356500,2019,43650,0,43650,COST
06079811105110000,2021,163964,241236,405200,MKT
06079811105110000,2020,114803,233497,348300,OVR
06079811105110000,2019,114803,233497,348300,MKT
06079811106010900,2021,163964,302536,466500,MKT
06079811106010900,2020,127368,274732,402100,MKT
06079811106010900,2019,127368,274732,402100,MKT
06079811106020000,2021,128640,277060,405700,MKT
06079811106020000,2020,101720,241980,343700,MKT
06079811106020000,2019,101720,241980,343700,MKT
06079811106030000,2021,130140,0,130140,COST
06079811106030000,2020,103052,0,103052,COST
06079811106030000,2019,103052,0,103052,COST
06079811106040000,2021,145087,287713,432800,MKT
06079811106040000,2020,116429,238771,355200,MKT
06079811106040000,2019,116429,238771,355200,MKT
06079811109010000,2021,348625,1203930,1552555,COST
06079811109010000,2020,188497,1027103,1215600,INCOME
06079811109010000,2019,188497,1027103,1215600,INCOME
06079811109100000,2021,165937,393700,559637,COST
06079811109100000,2020,98997,376770,475767,COST
06079811109100000,2019,98997,376770,475767,COST
06079811109120000,2021,122430,0,122430,COST
06079811109120000,2020,72019,0,72019,COST
06079811109120000,2019,72019,0,72019,COST
06079811109130000,2021,122430,0,122430,COST
06079811109130000,2020,72019,0,72019,COST
06079811109130000,2019,72019,0,72019,COST
06079811109140000,2021,122430,0,122430,COST
06079811109140000,2020,72019,0,72019,COST
06079811109140000,2019,72019,0,72019,COST
06079811110010000,2021,122464,0,122464,COST
06079811110010000,2020,72058,0,72058,COST
06079811110010000,2019,72058,0,72058,COST
06079811110030000,2021,122464,0,122464,COST
06079811110030000,2020,72058,0,72058,COST
06079811110030000,2019,72058,0,72058,COST
06079811110050000,2021,119849,0,119849,COST
06079811110050000,2020,69086,0,69086,COST
06079811110050000,2019,69086,0,69086,COST
06079811110070000,2021,119849,0,119849,COST
06079811110070000,2020,69086,0,69086,COST
06079811110070000,2019,69086,0,69086,COST
06079811110090000,2021,127177,0,127177,COST
06079811110090000,2020,77570,0,77570,COST
06079811110090000,2019,77570,0,77570,COST
06079811110110000,2021,119849,0,119849,COST
06079811110110000,2020,69086,0,69086,COST
06079811110110000,2019,69086,0,69086,COST
06079811110130000,2021,119849,0,119849,COST
06079811110130000,2020,69086,0,69086,COST
06079811110130000,2019,69086,0,69086,COST
06079811110150000,2021,119849,0,119849,COST
06079811110150000,2020,69086,0,69086,COST
06079811110150000,2019,69086,0,69086,COST
06079811110170000,2021,100966,0,100966,COST
06079811110170000,2020,49437,0,49437,COST
06079811110170000,2019,49437,0,49437,COST
06079811110190000,2021,101462,0,101462,COST
06079811110190000,2020,49912,0,49912,COST
06079811110190000,2019,49912,0,49912,COST
06079811111010000,2021,119849,0,119849,COST
06079811111010000,2020,69086,0,69086,COST
06079811111010000,2019,69086,0,69086,COST
06079811111030000,2021,122430,0,122430,COST
06079811111030000,2020,72019,0,72019,COST
06079811111030000,2019,72019,0,72019,COST
06079811111050000,2021,119849,0,119849,COST
06079811111050000,2020,69086,0,69086,COST
06079811111050000,2019,69086,0,69086,COST
06079811111070000,2021,119849,0,119849,COST
06079811111070000,2020,69086,0,69086,COST
06079811111070000,2019,69086,0,69086,COST
06079811111090000,2021,119849,0,119849,COST
06079811111090000,2020,69086,0,69086,COST
06079811111090000,2019,69086,0,69086,COST
06079811111110000,2021,122430,0,122430,COST
06079811111110000,2020,72019,0,72019,COST
06079811111110000,2019,72019,0,72019,COST
06079811111130000,2021,129380,0,129380,COST
06079811111130000,2020,80214,0,80214,COST
06079811111130000,2019,80214,0,80214,COST
06079811111216500,2021,82444,0,82444,COST
06079811111216500,2020,104706,0,104706,COST
06079811111216500,2019,104706,0,104706,COST
06079811112010000,2021,133495,0,133495,COST
06079811112010000,2020,85270,0,85270,COST
06079811112010000,2019,85270,0,85270,COST
06079811112020000,2021,122430,0,122430,COST
06079811112020000,2020,72019,0,72019,COST
06079811112020000,2019,72019,0,72019,COST
06079811112030000,2021,122430,0,122430,COST
06079811112030000,2020,72019,0,72019,COST
06079811112030000,2019,72019,0,72019,COST
06079811112040000,2021,124863,0,124863,COST
06079811112040000,2020,74839,0,74839,COST
06079811112040000,2019,74839,0,74839,COST
06079811112050000,2021,124863,0,124863,COST
06079811112050000,2020,74839,0,74839,COST
06079811112050000,2019,74839,0,74839,COST
06079811112060000,2021,348625,1191120,1539745,COST
06079811112060000,2020,188497,1027103,1215600,INCOME
06079811112060000,2019,188497,1027103,1215600,INCOME
06079811116180000,2021,269573,103450,373023,COST
06079811116180000,2020,336141,115350,451491,COST
06079811116180000,2019,336141,115350,451491,COST
06079811116257000,2021,367447,612280,979727,COST
06079811116257000,2020,615296,639180,1254476,COST
06079811116257000,2019,615296,639180,1254476,COST
06079811116407000,2021,448863,0,448863,COST
06079811116407000,2020,909363,0,909363,COST
06079811116407000,2019,909363,0,909363,COST
06079811116500000,2021,954920,431720,1386640,COST
06079811116500000,2020,294976,415790,710766,COST
06079811116500000,2019,294976,415790,710766,COST
06079811120010000,2021,128488,259312,387800,MKT
06079811120010000,2020,101585,213615,315200,MKT
06079811120010000,2019,101585,213615,315200,MKT
06079811120050000,2021,128488,265212,393700,MKT
06079811120050000,2020,101585,219515,321100,MKT
06079811120050000,2019,101585,219515,321100,MKT
06079811120100000,2021,136761,268239,405000,MKT
06079811120100000,2020,108956,213544,322500,MKT
06079811120100000,2019,108956,213544,322500,MKT
06079811120150000,2021,151460,236240,387700,MKT
06079811120150000,2020,122186,185214,307400,MKT
06079811120150000,2019,122186,185214,307400,MKT
06079811120200000,2021,111977,0,111977,COST
06079811120200000,2020,87051,0,87051,COST
06079811120200000,2019,87051,0,87051,COST
06079811120250000,2021,151786,342414,494200,MKT
06079811120250000,2020,122481,282919,405400,MKT
06079811120250000,2019,122481,282919,405400,MKT
06079811123010000,2021,1284093,0,1284093,COST
06079811123010000,2020,1030968,0,1030968,COST
06079811123010000,2019,1030968,0,1030968,COST
06079811123100000,2021,2176611,2375689,4552300,INCOME
06079811123100000,2020,1187714,2747386,3935100,INCOME
06079811123100000,2019,1187714,2747386,3935100,INCOME
06079811123200000,2021,656345,124355,780700,INCOME
06079811123200000,2020,420000,180000,600000,OVR
06079811123200000,2019,420000,180000,600000,OVR
06079811124010000,2021,709918,1397730,2107648,COST
06079811124010000,2020,703830,0,703830,COST
06079811124010000,2019,703830,0,703830,COST
06079811124206500,2021,859279,0,859279,COST
06079811124206500,2020,436134,0,436134,COST
06079811124206500,2019,436134,0,436134,COST
06079811125017000,2021,3223493,0,3223493,COST
06079811125017000,2020,1198515,0,1198515,COST
06079811125017000,2019,1198515,0,1198515,COST
06079811125300000,2021,1188673,2274527,3463200,INCOME
06079811125300000,2020,916576,1236610,2153186,COST
06079811125300000,2019,916576,1236610,2153186,COST
06079811125500000,2021,1065823,2477977,3543800,INCOME
06079811125500000,2020,874728,0,874728,COST
06079811125500000,2019,874728,0,874728,COST
06079811125700000,2021,923596,2126004,3049600,INCOME
06079811125700000,2020,822671,1961029,2783700,INCOME
06079811125700000,2019,822671,1961029,2783700,INCOME
06079811131010000,2021,139995,264805,404800,INCOME
06079811131010000,2020,93560,274940,368500,INCOME
06079811131010000,2019,93560,274940,368500,INCOME
06079811131030000,2021,140288,303412,443700,MKT
06079811131030000,2020,93943,315157,409100,MKT
06079811131030000,2019,93943,315157,409100,MKT
06079811131050000,2021,136497,261303,397800,MKT
06079811131050000,2020,89052,253148,342200,MKT
06079811131050000,2019,89052,253148,342200,MKT
06079811131070000,2021,140873,358327,499200,MKT
06079811131070000,2020,94709,330091,424800,MKT
06079811131070000,2019,94709,330091,424800,MKT
06079811131090000,2021,141161,356339,497500,MKT
06079811131090000,2020,95087,353213,448300,MKT
06079811131090000,2019,95087,353213,448300,MKT
06079811131110000,2021,141447,387253,528700,MKT
06079811131110000,2020,95464,367336,462800,MKT
06079811131110000,2019,95464,367336,462800,MKT
06079811131130000,2021,141732,312268,454000,MKT
06079811131130000,2020,95839,316861,412700,MKT
06079811131130000,2019,95839,316861,412700,MKT
06079811131150000,2021,142019,327081,469100,MKT
06079811131150000,2020,96219,317681,413900,MKT
06079811131150000,2019,96219,317681,413900,MKT
06079811131170000,2021,142300,321800,464100,MKT
06079811131170000,2020,96591,326809,423400,MKT
06079811131170000,2019,96591,326809,423400,MKT
06079811131190000,2021,142580,325320,467900,MKT
06079811131190000,2020,96963,314137,411100,MKT
06079811131190000,2019,96963,314137,411100,MKT
06079811131210000,2021,142859,316741,459600,MKT
06079811131210000,2020,97333,315567,412900,MKT
06079811131210000,2019,97333,315567,412900,MKT
06079811131230000,2021,143140,349160,492300,MKT
06079811131230000,2020,97707,342593,440300,MKT
06079811131230000,2019,97707,342593,440300,MKT
06079811131250000,2021,143415,471185,614600,MKT
06079811131250000,2020,98074,457626,555700,MKT
06079811131250000,2019,98074,457626,555700,MKT
06079811131270000,2021,143689,429211,572900,MKT
06079811131270000,2020,98440,378260,476700,MKT
06079811131270000,2019,98440,378260,476700,MKT
06079811131290000,2021,124690,288110,412800,MKT
06079811131290000,2020,84048,287252,371300,MKT
06079811131290000,2019,84048,287252,371300,MKT
06079811132010000,2021,121994,609406,731400,INCOME
06079811132010000,2020,80539,508961,589500,INCOME
06079811132010000,2019,80539,508961,589500,INCOME
06079811132030000,2021,139931,441469,581400,MKT
06079811132030000,2020,93478,393622,487100,MKT
06079811132030000,2019,93478,393622,487100,MKT
06079811132050000,2021,139931,318869,458800,MKT
06079811132050000,2020,93478,301022,394500,MKT
06079811132050000,2019,93478,301022,394500,MKT
06079811132070000,2021,139931,303669,443600,MKT
06079811132070000,2020,93478,311622,405100,MKT
06079811132070000,2019,93478,311622,405100,MKT
06079811132090000,2021,139931,277869,417800,MKT
06079811132090000,2020,93478,295122,388600,MKT
06079811132090000,2019,93478,295122,388600,MKT
06079811132110000,2021,139931,294469,434400,MKT
06079811132110000,2020,93478,303322,396800,MKT
06079811132110000,2019,93478,303322,396800,MKT
06079811132130000,2021,139931,400469,540400,MKT
06079811132130000,2020,93478,361922,455400,OVR
06079811132130000,2019,93478,361922,455400,MKT
06079811132150000,2021,139931,295069,435000,MKT
06079811132150000,2020,93478,301922,395400,MKT
06079811132150000,2019,93478,301922,395400,MKT
06079811132170000,2021,139931,374869,514800,MKT
06079811132170000,2020,93478,337922,431400,MKT
06079811132170000,2019,93478,347222,440700,MKT
06079811132190000,2021,139931,285469,425400,MKT
06079811132190000,2020,93478,296422,389900,MKT
06079811132190000,2019,93478,289422,382900,MKT
06079811132210000,2021,139931,326569,466500,MKT
06079811132210000,2020,93478,337722,431200,MKT
06079811132210000,2019,93478,337722,431200,MKT
06079811132230000,2021,139931,534869,674800,MKT
06079811132230000,2020,93478,499301,592779,MRA
06079811132230000,2019,93478,499301,592779,MRA
06079811132250000,2021,139931,492669,632600,MKT
06079811132250000,2020,93478,437522,531000,MKT
06079811132250000,2019,93478,437522,531000,MKT
06079811132270000,2021,139931,417869,557800,MKT
06079811132270000,2020,93478,387022,480500,MKT
06079811132270000,2019,93478,403122,496600,MKT
06079811132297000,2021,139931,0,139931,COST
06079811132297000,2020,93478,0,93478,COST
06079811132297000,2019,93478,0,93478,COST
06079811133010000,2021,148485,261830,410315,COST
06079811133010000,2020,104955,225240,330195,COST
06079811133010000,2019,104955,225240,330195,COST
06079811133020000,2021,142205,268595,410800,MKT
06079811133020000,2020,96465,256235,352700,MKT
06079811133020000,2019,96465,256235,352700,MKT
06079811133030000,2021,139931,283269,423200,MKT
06079811133030000,2020,93478,274622,368100,MKT
06079811133030000,2019,93478,274622,368100,MKT
06079811133040000,2021,139931,210169,350100,MKT
06079811133040000,2020,93478,218322,311800,MKT
06079811133040000,2019,93478,218322,311800,MKT
06079811133050000,2021,139931,253869,393800,MKT
06079811133050000,2020,93478,249022,342500,MKT
06079811133050000,2019,93478,249022,342500,MKT
06079811133060000,2021,139931,303269,443200,MKT
06079811133060000,2020,93478,286222,379700,MKT
06079811133060000,2019,93478,278622,372100,MKT
06079811133070000,2021,139931,282669,422600,MKT
06079811133070000,2020,93478,269822,363300,MKT
06079811133070000,2019,93478,269822,363300,MKT
06079811133080000,2021,142205,290495,432700,MKT
06079811133080000,2020,96465,286735,383200,MKT
06079811133080000,2019,96465,286735,383200,MKT
06079811133090000,2021,139931,305069,445000,MKT
06079811133090000,2020,93478,292322,385800,MKT
06079811133090000,2019,93478,292322,385800,MKT
06079811133100000,2021,142205,307995,450200,MKT
06079811133100000,2020,96465,287935,384400,MKT
06079811133100000,2019,96465,287935,384400,MKT
06079811133110000,2021,139931,272269,412200,MKT
06079811133110000,2020,93478,269522,363000,MKT
06079811133110000,2019,93478,269522,363000,MKT
06079811133120000,2021,142205,363995,506200,MKT
06079811133120000,2020,96465,322935,419400,MKT
06079811133120000,2019,96465,322935,419400,MKT
06079811133130000,2021,139931,287469,427400,MKT
06079811133130000,2020,93478,278722,372200,MKT
06079811133130000,2019,93478,278722,372200,MKT
06079811133140000,2021,138992,211708,350700,MKT
06079811133140000,2020,92257,214943,307200,MKT
06079811133140000,2019,92257,214943,307200,MKT
06079811133150000,2021,116918,236982,353900,INCOME
06079811133150000,2020,74127,232373,306500,INCOME
06079811133150000,2019,74127,232373,306500,INCOME
06079811134010000,2021,132415,245085,377500,MKT
06079811134010000,2020,83928,240972,324900,MKT
06079811134010000,2019,83928,240972,324900,MKT
06079811134020000,2021,137550,231650,369200,MKT
06079811134020000,2020,90398,225402,315800,MKT
06079811134020000,2019,90398,225402,315800,MKT
06079811134030000,2021,135050,236250,371300,MKT
06079811134030000,2020,87219,233781,321000,MKT
06079811134030000,2019,87219,233781,321000,MKT
06079811134040000,2021,137550,286250,423800,MKT
06079811134040000,2020,90398,276402,366800,MKT
06079811134040000,2019,90398,276402,366800,MKT
06079811134050000,2021,137550,259250,396800,MKT
06079811134050000,2020,90398,247702,338100,MKT
06079811134050000,2019,90398,247702,338100,MKT
06079811134060000,2021,138516,260584,399100,MKT
06079811134060000,2020,91642,258258,349900,MKT
06079811134060000,2019,91642,258258,349900,MKT
06079811134070000,2021,136065,258635,394700,MKT
06079811134070000,2020,88503,260397,348900,MKT
06079811134070000,2019,88503,260397,348900,MKT
06079811134080000,2021,137550,232350,369900,MKT
06079811134080000,2020,90398,230302,320700,MKT
06079811134080000,2019,90398,230302,320700,MKT
06079811134090000,2021,139464,272336,411800,MKT
06079811134090000,2020,92869,263931,356800,MKT
06079811134090000,2019,92869,263931,356800,MKT
06079811134100000,2021,137550,204750,342300,MKT
06079811134100000,2020,90398,214802,305200,MKT
06079811134100000,2019,90398,214802,305200,MKT
06079811134110000,2021,135050,290150,425200,MKT
06079811134110000,2020,87219,288681,375900,MKT
06079811134110000,2019,87219,288681,375900,MKT
06079811134120000,2021,139464,245536,385000,MKT
06079811134120000,2020,92869,232531,325400,MKT
06079811134120000,2019,92869,232531,325400,MKT
06079811134130000,2021,137550,231550,369100,MKT
06079811134130000,2020,90398,236202,326600,MKT
06079811134130000,2019,90398,236202,326600,MKT
06079811134140000,2021,137550,240650,378200,MKT
06079811134140000,2020,90398,244502,334900,MKT
06079811134140000,2019,90398,244502,334900,MKT
06079811134150000,2021,135050,198350,333400,MKT
06079811134150000,2020,87219,205381,292600,MKT
06079811134150000,2019,87219,205381,292600,MKT
06079811134160000,2021,133486,271014,404500,MKT
06079811134160000,2020,85258,240042,325300,MKT
06079811134160000,2019,85258,240042,325300,MKT
06079811134170000,2021,112553,259547,372100,MKT
06079811134170000,2020,68821,251579,320400,MKT
06079811134170000,2019,68821,251579,320400,MKT
06079811134180000,2021,114793,239107,353900,INCOME
06079811134180000,2020,71519,234981,306500,INCOME
06079811134180000,2019,71519,234981,306500,INCOME
06079811134190000,2021,142956,356544,499500,MKT
06079811134190000,2020,97463,334837,432300,MKT
06079811134190000,2019,97463,334837,432300,MKT
06079811134210000,2021,137550,230550,368100,MKT
06079811134210000,2020,90398,229002,319400,MKT
06079811134210000,2019,90398,229002,319400,MKT
06079811134220000,2021,137550,261150,398700,MKT
06079811134220000,2020,90398,254902,345300,MKT
06079811134220000,2019,90398,254902,345300,MKT
06079811134230000,2021,139931,269569,409500,MKT
06079811134230000,2020,93478,260322,353800,MKT
06079811134230000,2019,93478,260322,353800,MKT
06079811134240000,2021,139931,257569,397500,MKT
06079811134240000,2020,93478,258022,351500,MKT
06079811134240000,2019,93478,258022,351500,MKT
06079811134250000,2021,142205,315195,457400,MKT
06079811134250000,2020,96465,299535,396000,MKT
06079811134250000,2019,96465,299535,396000,MKT
06079811134260000,2021,139931,239469,379400,MKT
06079811134260000,2020,93478,236522,330000,MKT
06079811134260000,2019,93478,236522,330000,MKT
06079811134270000,2021,139931,250569,390500,MKT
06079811134270000,2020,93478,231822,325300,MKT
06079811134270000,2019,93478,231822,325300,MKT
06079811134280000,2021,137550,266250,403800,MKT
06079811134280000,2020,90398,252002,342400,MKT
06079811134280000,2019,90398,252002,342400,MKT
06079811134290000,2021,137550,312050,449600,MKT
06079811134290000,2020,90398,270602,361000,MKT
06079811134290000,2019,90398,270602,361000,MKT
06079811134300000,2021,139464,308736,448200,MKT
06079811134300000,2020,92869,290431,383300,MKT
06079811134300000,2019,92869,290431,383300,MKT
06079811134310000,2021,139931,248069,388000,MKT
06079811134310000,2020,93478,245322,338800,MKT
06079811134310000,2019,93478,245322,338800,MKT
06079811134320000,2021,139931,311569,451500,MKT
06079811134320000,2020,93478,304022,397500,MKT
06079811134320000,2019,93478,304022,397500,MKT
06079811134340000,2021,162414,329086,491500,MKT
06079811134340000,2020,125029,301771,426800,MKT
06079811134340000,2019,124981,301819,426800,MKT
06079811135015001,2021,108335,138265,246600,MKT
06079811135015001,2020,56724,169976,226700,MKT
06079811135015001,2019,56724,169976,226700,MKT
06079811135025002,2021,112318,163982,276300,MKT
06079811135025002,2020,60866,184834,245700,MKT
06079811135025002,2019,60866,184834,245700,MKT
06079811135045001,2021,114394,184106,298500,MKT
06079811135045001,2020,63081,210019,273100,MKT
06079811135045001,2019,63081,210019,273100,MKT
06079811135055002,2021,114394,184106,298500,MKT
06079811135055002,2020,63081,210019,273100,MKT
06079811135055002,2019,63081,210019,273100,MKT
06079811135065001,2021,112318,203482,315800,MKT
06079811135065001,2020,60866,212934,273800,MKT
06079811135065001,2019,60866,212934,273800,MKT
06079811135075002,2021,112318,203482,315800,MKT
06079811135075002,2020,60866,212934,273800,MKT
06079811135075002,2019,60866,212934,273800,MKT
06079811135085001,2021,114394,180606,295000,MKT
06079811135085001,2020,63081,197919,261000,MKT
06079811135085001,2019,63081,197919,261000,MKT
06079811135095002,2021,114394,180606,295000,MKT
06079811135095002,2020,63081,197919,261000,MKT
06079811135095002,2019,63081,197919,261000,MKT
06079811135105001,2021,114394,203306,317700,MKT
06079811135105001,2020,63081,221519,284600,MKT
06079811135105001,2019,63081,221519,284600,MKT
06079811135115002,2021,114394,203506,317900,MKT
06079811135115002,2020,63081,214819,277900,MKT
06079811135115002,2019,63081,214819,277900,MKT
06079811135145001,2021,115597,172603,288200,MKT
06079811135145001,2020,64382,190418,254800,MKT
06079811135145001,2019,64382,189318,253700,MKT
06079811135155002,2021,115597,190003,305600,MKT
06079811135155002,2020,64382,304618,369000,OVR
06079811135155002,2019,64382,204618,269000,MKT
06079811135165001,2021,114394,179906,294300,MKT
06079811135165001,2020,63081,202819,265900,MKT
06079811135165001,2019,63081,202819,265900,MKT
06079811135175002,2021,114394,177906,292300,MKT
06079811135175002,2020,63081,197919,261000,MKT
06079811135175002,2019,63081,202719,265800,MKT
06079811135207000,2021,137550,0,137550,COST
06079811135207000,2020,90398,0,90398,COST
06079811135207000,2019,90398,0,90398,COST
06079811135230000,2021,139464,265336,404800,INCOME
06079811135230000,2020,92869,275631,368500,INCOME
06079811135230000,2019,92869,275631,368500,INCOME
06079811135260000,2021,137550,267250,404800,INCOME
06079811135260000,2020,90398,278102,368500,INCOME
06079811135260000,2019,90398,278102,368500,INCOME
06079811135290000,2021,135050,200250,335300,INCOME
06079811135290000,2020,87219,210181,297400,INCOME
06079811135290000,2019,87219,210181,297400,INCOME
06079811135327000,2021,139464,0,139464,COST
06079811135327000,2020,92869,0,92869,COST
06079811135327000,2019,92869,0,92869,COST
06079811135357000,2021,137550,0,137550,COST
06079811135357000,2020,90398,0,90398,COST
06079811135357000,2019,90398,0,90398,COST
06079811135380000,2021,137550,267250,404800,INCOME
06079811135380000,2020,90398,278102,368500,INCOME
06079811135380000,2019,90398,278102,368500,INCOME
06079811135417000,2021,163603,0,163603,COST
06079811135417000,2020,126822,0,126822,COST
06079811135417000,2019,126822,0,126822,COST
06079811135470000,2021,112553,292247,404800,INCOME
06079811135470000,2020,68821,299679,368500,INCOME
06079811135470000,2019,68821,299679,368500,INCOME
06079811135500000,2021,112553,172747,285300,MKT
06079811135500000,2020,68821,181779,250600,MKT
06079811135500000,2019,68821,181779,250600,MKT
06079811135530000,2021,135560,277540,413100,MKT
06079811135530000,2020,87863,273737,361600,MKT
06079811135530000,2019,87863,273737,361600,MKT
06079811135560000,2021,135050,208950,344000,MKT
06079811135560000,2020,87219,208681,295900,MKT
06079811135560000,2019,87219,208681,295900,MKT
06079811135590000,2021,135050,194750,329800,MKT
06079811135590000,2020,87219,194881,282100,MKT
06079811135590000,2019,87219,194881,282100,MKT
06079811135620000,2021,139931,322369,462300,MKT
06079811135620000,2020,93478,309722,403200,MKT
06079811135620000,2019,93478,290522,384000,MKT
06079811135650000,2021,139464,343936,483400,MKT
06079811135650000,2020,92869,309331,402200,MKT
06079811135650000,2019,92869,309331,402200,MKT
06079811135680000,2021,135050,212250,347300,MKT
06079811135680000,2020,87219,212081,299300,MKT
06079811135680000,2019,87219,212081,299300,MKT
06079811135710000,2021,137550,289750,427300,MKT
06079811135710000,2020,90398,220502,310900,MKT
06079811135710000,2019,90398,220502,310900,MKT
06079811135740000,2021,139464,317636,457100,MKT
06079811135740000,2020,92869,315531,408400,OVR
06079811135740000,2019,92869,315531,408400,MKT
06079811135770000,2021,137550,237950,375500,MKT
06079811135770000,2020,90398,229102,319500,MKT
06079811135770000,2019,90398,229102,319500,MKT
06079811135800000,2021,135050,228450,363500,MKT
06079811135800000,2020,87219,229481,316700,MKT
06079811135800000,2019,87219,229481,316700,MKT
06079811135830000,2021,139464,272836,412300,MKT
06079811135830000,2020,92869,263431,356300,MKT
06079811135830000,2019,92869,263431,356300,MKT
06079811135860000,2021,137550,237150,374700,MKT
06079811135860000,2020,90398,225902,316300,MKT
06079811135860000,2019,90398,225902,316300,MKT
06079811135890000,2021,137550,254050,391600,MKT
06079811135890000,2020,90398,239102,329500,MKT
06079811135890000,2019,90398,235002,325400,MKT
06079811135920000,2021,135050,279550,414600,MKT
06079811135920000,2020,87219,266281,353500,MKT
06079811135920000,2019,87219,266281,353500,MKT
06079811135950000,2021,132415,297785,430200,MKT
06079811135950000,2020,83928,293972,377900,OVR
06079811135950000,2019,83928,293972,377900,MKT
06079811135980000,2021,132415,270585,403000,MKT
06079811135980000,2020,83928,262872,346800,MKT
06079811135980000,2019,83928,262872,346800,MKT
06079811139010000,2021,422657,0,422657,COST
06079811139010000,2020,588564,0,588564,COST
06079811139010000,2019,588564,0,588564,COST
06079811139020000,2021,653704,431696,1085400,INCOME
06079811139020000,2020,709457,336650,1046107,COST
06079811139020000,2019,709457,336650,1046107,COST
06079811139030000,2021,921488,0,921488,COST
06079811139030000,2020,700929,0,700929,COST
06079811139030000,2019,700929,0,700929,COST
06079811139040000,2021,1002292,0,1002292,COST
06079811139040000,2020,726628,0,726628,COST
06079811139040000,2019,726628,0,726628,COST
06079811139050000,2021,1264169,477570,1741739,COST
06079811139050000,2020,802597,445900,1248497,COST
06079811139050000,2019,802597,445900,1248497,COST
06079811140010000,2021,129094,245306,374400,MKT
06079811140010000,2020,102123,203977,306100,MKT
06079811140010000,2019,102123,203977,306100,MKT
06079811140020000,2021,129394,228706,358100,MKT
06079811140020000,2020,102390,208310,310700,MKT
06079811140020000,2019,102390,208310,310700,MKT
06079811140030000,2021,129694,246606,376300,MKT
06079811140030000,2020,102656,200044,302700,MKT
06079811140030000,2019,102656,200044,302700,MKT
06079811140040000,2021,135133,229967,365100,MKT
06079811140040000,2020,107501,193799,301300,MKT
06079811140040000,2019,107501,193799,301300,MKT
06079811140050000,2021,157028,283472,440500,MKT
06079811140050000,2020,127240,221460,348700,MKT
06079811140050000,2019,127240,221460,348700,MKT
06079811140070000,2021,128030,223670,351700,MKT
06079811140070000,2020,101178,190722,291900,MKT
06079811140070000,2019,101178,190722,291900,MKT
06079811140080000,2021,130877,235923,366800,MKT
06079811140080000,2020,103708,200892,304600,MKT
06079811140080000,2019,103708,200892,304600,MKT
06079811140090000,2021,131606,232194,363800,MKT
06079811140090000,2020,104356,208744,313100,MKT
06079811140090000,2019,104356,208744,313100,MKT
06079811140100000,2021,131606,263594,395200,MKT
06079811140100000,2020,104356,223544,327900,MKT
06079811140100000,2019,104356,223544,327900,MKT
06079811140110000,2021,131606,257194,388800,MKT
06079811140110000,2020,104356,206344,310700,MKT
06079811140110000,2019,104356,206344,310700,MKT
06079811140167000,2021,248718,0,248718,COST
06079811140167000,2020,287255,0,287255,COST
06079811140167000,2019,287255,0,287255,COST
06079811141010000,2021,128488,278912,407400,MKT
06079811141010000,2020,101585,223915,325500,MKT
06079811141010000,2019,101585,223915,325500,MKT
06079811141020000,2021,128488,268212,396700,MKT
06079811141020000,2020,101585,234515,336100,MKT
06079811141020000,2019,101585,234515,336100,MKT
06079811141030000,2021,128488,209712,338200,MKT
06079811141030000,2020,101585,179215,280800,MKT
06079811141030000,2019,101585,179215,280800,MKT
06079811141040000,2021,125048,296140,421188,COST
06079811141040000,2020,98537,273020,371557,COST
06079811141040000,2019,98537,265170,363707,COST
06079811141050000,2021,116606,241994,358600,MKT
06079811141050000,2020,91101,202899,294000,MKT
06079811141050000,2019,91101,202899,294000,MKT
06079811141060000,2021,145679,235021,380700,MKT
06079811141060000,2020,116963,195437,312400,MKT
06079811141060000,2019,116963,195437,312400,MKT
06079811141070000,2021,134303,220697,355000,MKT
06079811141070000,2020,106760,189440,296200,MKT
06079811141070000,2019,106760,189440,296200,MKT
06079811141080000,2021,126163,211480,337643,COST
06079811141080000,2020,99524,183276,282800,MKT
06079811141080000,2019,99524,183276,282800,MKT
06079811141090000,2021,125847,236653,362500,MKT
06079811141090000,2020,99243,206157,305400,MKT
06079811141090000,2019,99243,206857,306100,MKT
06079811141100000,2021,125847,247953,373800,MKT
06079811141100000,2020,99243,205657,304900,MKT
06079811141100000,2019,99243,205657,304900,MKT
06079811141110000,2021,125847,237953,363800,MKT
06079811141110000,2020,99243,200457,299700,MKT
06079811141110000,2019,99243,200457,299700,MKT
06079811150010000,2021,119382,210318,329700,INCOME
06079811150010000,2020,77206,234694,311900,INCOME
06079811150010000,2019,77206,234694,311900,INCOME
06079811150030000,2021,137550,276650,414200,MKT
06079811150030000,2020,90398,266002,356400,MKT
06079811150030000,2019,90398,266002,356400,MKT
06079811150050000,2021,137550,249050,386600,MKT
06079811150050000,2020,90398,236902,327300,MKT
06079811150050000,2019,90398,236902,327300,MKT
06079811150070000,2021,137550,220050,357600,MKT
06079811150070000,2020,90398,232802,323200,MKT
06079811150070000,2019,90398,232802,323200,MKT
06079811150110000,2021,137550,237650,375200,MKT
06079811150110000,2020,90398,238602,329000,MKT
06079811150110000,2019,90398,238602,329000,MKT
06079811150120000,2021,137550,291250,428800,MKT
06079811150120000,2020,90398,281402,371800,MKT
06079811150120000,2019,90398,281402,371800,MKT
06079811150140000,2021,137550,231750,369300,MKT
06079811150140000,2020,90398,237402,327800,MKT
06079811150140000,2019,90398,237402,327800,MKT
06079811150150000,2021,137550,301550,439100,MKT
06079811150150000,2020,90398,283602,374000,MKT
06079811150150000,2019,90398,283602,374000,MKT
06079811150160000,2021,137550,297750,435300,MKT
06079811150160000,2020,90398,262502,352900,MKT
06079811150160000,2019,90398,262502,352900,MKT
06079811150170000,2021,137550,267450,405000,MKT
06079811150170000,2020,90398,265202,355600,MKT
06079811150170000,2019,90398,265202,355600,MKT
06079811150180000,2021,137550,329550,467100,MKT
06079811150180000,2020,90398,298202,388600,MKT
06079811150180000,2019,90398,298202,388600,MKT
06079811150190000,2021,137550,243050,380600,MKT
06079811150190000,2020,90398,245902,336300,MKT
06079811150190000,2019,90398,245902,336300,MKT
06079811150200000,2021,139931,261469,401400,MKT
06079811150200000,2020,93478,257122,350600,MKT
06079811150200000,2019,93478,257122,350600,MKT
06079811150210000,2021,137550,335150,472700,MKT
06079811150210000,2020,90398,319802,410200,MKT
06079811150210000,2019,90398,313702,404100,MKT
06079811150220000,2021,137550,205850,343400,MKT
06079811150220000,2020,90398,214302,304700,MKT
06079811150220000,2019,90398,214302,304700,MKT
06079811150235002,2021,116365,184635,301000,MKT
06079811150235002,2020,65219,205881,271100,MKT
06079811150235002,2019,65219,205881,271100,MKT
06079811150245001,2021,116365,184635,301000,MKT
06079811150245001,2020,65219,205881,271100,MKT
06079811150245001,2019,65219,205881,271100,MKT
06079811151010000,2021,139931,264869,404800,INCOME
06079811151010000,2020,93478,275022,368500,INCOME
06079811151010000,2019,93478,275022,368500,INCOME
06079811151030000,2021,137550,296050,433600,MKT
06079811151030000,2020,90398,291402,381800,MKT
06079811151030000,2019,90398,288802,379200,MKT
06079811151050000,2021,139931,210469,350400,MKT
06079811151050000,2020,93478,211722,305200,MKT
06079811151050000,2019,93478,211722,305200,MKT
06079811151060000,2021,139931,220469,360400,MKT
06079811151060000,2020,93478,226422,319900,MKT
06079811151060000,2019,93478,226422,319900,MKT
06079811151070000,2021,137550,240450,378000,MKT
06079811151070000,2020,90398,237602,328000,MKT
06079811151070000,2019,90398,237602,328000,MKT
06079811151090000,2021,137550,295050,432600,MKT
06079811151090000,2020,90398,283302,373700,MKT
06079811151090000,2019,90398,283302,373700,MKT
06079811151110000,2021,137550,238750,376300,MKT
06079811151110000,2020,90398,224102,314500,OVR
06079811151110000,2019,90398,224102,314500,MKT
06079811151130000,2021,137550,321350,458900,MKT
06079811151130000,2020,90398,298502,388900,MKT
06079811151130000,2019,90398,298502,388900,MKT
06079811151150000,2021,137550,211250,348800,MKT
06079811151150000,2020,90398,229502,319900,MKT
06079811151150000,2019,90398,229502,319900,MKT
06079811151170000,2021,137550,337850,475400,MKT
06079811151170000,2020,90398,321102,411500,MKT
06079811151170000,2019,90398,321102,411500,MKT
06079811151190000,2021,137550,240150,377700,MKT
06079811151190000,2020,90398,231102,321500,MKT
06079811151190000,2019,90398,231102,321500,MKT
06079811151210000,2021,137550,301850,439400,MKT
06079811151210000,2020,90398,270602,361000,OVR
06079811151210000,2019,90398,270602,361000,MKT
06079811151250000,2021,137550,336050,473600,MKT
06079811151250000,2020,90398,322402,412800,MKT
06079811151250000,2019,90398,322402,412800,MKT
06079811151270000,2021,137550,317950,455500,MKT
06079811151270000,2020,90398,283502,373900,MKT
06079811151270000,2019,90398,283502,373900,MKT
06079811151290000,2021,137550,305250,442800,MKT
06079811151290000,2020,90398,294002,384400,MKT
06079811151290000,2019,90398,270902,361300,MKT
06079811151310000,2021,117916,211784,329700,INCOME
06079811151310000,2020,75367,236533,311900,INCOME
06079811151310000,2019,75367,236533,311900,INCOME
06079811158030000,2021,175912,299888,475800,MKT
06079811158030000,2020,144539,213940,358479,COST
06079811158030000,2019,144539,213940,358479,COST
06079811160010000,2021,119320,100090,219410,COST
06079811160010000,2020,93485,104950,198435,COST
06079811160010000,2019,93485,134480,227965,COST
06079811160040000,2021,142667,248933,391600,MKT
06079811160040000,2020,114252,225448,339700,MKT
06079811160040000,2019,114252,225448,339700,MKT
06079811160060000,2021,119673,249027,368700,MKT
06079811160060000,2020,93795,210405,304200,MKT
06079811160060000,2019,93795,210405,304200,MKT
06079811160080000,2021,102790,143930,246720,COST
06079811160080000,2020,79075,130140,209215,COST
06079811160080000,2019,79075,130140,209215,COST
06079811160100000,2021,109510,212390,321900,MKT
06079811160100000,2020,84901,167599,252500,MKT
06079811160100000,2019,84901,167599,252500,MKT
06079811160120000,2021,94536,213164,307700,MKT
06079811160120000,2020,69014,164286,233300,MKT
06079811160120000,2019,69014,164286,233300,MKT
06079811161010000,2021,123912,235188,359100,MKT
06079811161010000,2020,97533,187467,285000,OVR
06079811161010000,2019,97533,187467,285000,MKT
06079811161020000,2021,124239,204061,328300,MKT
06079811161020000,2020,97821,164279,262100,MKT
06079811161020000,2019,97821,164279,262100,MKT
06079811161030000,2021,123912,208588,332500,MKT
06079811161030000,2020,97533,171967,269500,MKT
06079811161030000,2019,97533,171967,269500,MKT
06079811161040000,2021,123912,281488,405400,MKT
06079811161040000,2020,97533,233667,331200,MKT
06079811161040000,2019,97533,233667,331200,MKT
06079811161050000,2021,123912,195188,319100,MKT
06079811161050000,2020,97533,158867,256400,MKT
06079811161050000,2019,97533,158867,256400,MKT
06079811161060000,2021,119607,138493,258100,MKT
06079811161060000,2020,97533,41720,139253,COST
06079811161060000,2019,97533,41720,139253,COST
06079811161080000,2021,135816,225084,360900,MKT
06079811161080000,2020,103652,189648,293300,MKT
06079811161080000,2019,103652,189648,293300,MKT
06079811162010000,2021,126321,285779,412100,MKT
06079811162010000,2020,99663,223637,323300,MKT
06079811162010000,2019,99663,223637,323300,MKT
06079811162020000,2021,123912,283388,407300,MKT
06079811162020000,2020,97533,227767,325300,MKT
06079811162020000,2019,97533,227767,325300,MKT
06079811162030000,2021,123912,247988,371900,MKT
06079811162030000,2020,97533,204267,301800,MKT
06079811162030000,2019,97533,204267,301800,MKT
06079811162040000,2021,123912,233788,357700,MKT
06079811162040000,2020,97533,200667,298200,MKT
06079811162040000,2019,97533,200667,298200,MKT
06079811162050000,2021,145644,292656,438300,MKT
06079811162050000,2020,101071,283429,384500,MKT
06079811162050000,2019,101071,269529,370600,MKT
06079811162060000,2021,257003,612380,869383,COST
06079811162060000,2020,144689,601500,746189,COST
06079811162060000,2019,144689,601500,746189,COST
06079811163010000,2021,126321,294679,421000,MKT
06079811163010000,2020,99663,241537,341200,MKT
06079811163010000,2019,99663,241537,341200,MKT
06079811163020000,2021,126321,241979,368300,MKT
06079811163020000,2020,99663,203437,303100,MKT
06079811163020000,2019,99663,203437,303100,MKT
06079811163030000,2021,126321,243379,369700,MKT
06079811163030000,2020,99663,185137,284800,MKT
06079811163030000,2019,99663,185437,285100,MKT
06079811163040000,2021,126321,291779,418100,MKT
06079811163040000,2020,99663,225637,325300,MKT
06079811163040000,2019,99663,225637,325300,MKT
06079811163050000,2021,133127,205673,338800,MKT
06079811163050000,2020,95506,204194,299700,MKT
06079811163050000,2019,95506,204194,299700,MKT
06079811163060000,2021,112577,0,112577,COST
06079811163060000,2020,87025,0,87025,COST
06079811163060000,2019,87025,0,87025,COST
06079811163080000,2021,121745,0,121745,COST
06079811163080000,2020,98361,0,98361,COST
06079811163080000,2019,98361,0,98361,COST
06079811163100000,2021,143623,2450,146073,COST
06079811163100000,2020,98351,2090,100441,COST
06079811163100000,2019,98351,2090,100441,COST
06079811201030000,2021,145066,245334,390400,MKT
06079811201030000,2020,132183,203717,335900,MKT
06079811201030000,2019,132183,203717,335900,MKT
06079811201040000,2021,39502,0,39502,COST
06079811201040000,2020,31288,0,31288,COST
06079811201040000,2019,31288,0,31288,COST
06079811201050000,2021,211352,221848,433200,MKT
06079811201050000,2020,238734,214310,453044,COST
06079811201050000,2019,238734,214310,453044,COST
06079811201070000,2021,182725,49390,232115,COST
06079811201070000,2020,186104,53270,239374,COST
06079811201070000,2019,186104,53270,239374,COST
06079811201110000,2021,803427,129373,932800,INCOME
06079811201110000,2020,588170,202130,790300,INCOME
06079811201110000,2019,588170,202130,790300,INCOME
06079811201120000,2021,223983,127817,351800,INCOME
06079811201120000,2020,256267,86033,342300,INCOME
06079811201120000,2019,256267,86033,342300,INCOME
06079811201150000,2021,411933,1608667,2020600,INCOME
06079811201150000,2020,217855,1756745,1974600,INCOME
06079811201150000,2019,217855,1756745,1974600,INCOME
06079811201180000,2021,149918,215682,365600,MKT
06079811201180000,2020,120790,178610,299400,OVR
06079811201180000,2019,120790,178610,299400,MKT
06079811201310000,2021,172964,243836,416800,MKT
06079811201310000,2020,170747,192153,362900,MKT
06079811201310000,2019,170747,192153,362900,MKT
06079811201320000,2021,1763,120340,122103,COST
06079811201320000,2020,2026,121800,123826,COST
06079811201320000,2019,201627,122000,323627,COST
06079811201330000,2021,1866,239920,241786,COST
06079811201330000,2020,2144,240340,242484,COST
06079811201330000,2019,200184,240870,441054,COST
06079811201340000,2021,169002,181598,350600,MKT
06079811201340000,2020,135119,173381,308500,MKT
06079811201340000,2019,135119,173381,308500,MKT
06079811201350000,2021,167487,157413,324900,MKT
06079811201350000,2020,132764,145136,277900,MKT
06079811201350000,2019,132764,145136,277900,MKT
06079811201380000,2021,165658,258642,424300,MKT
06079811201380000,2020,135116,215684,350800,MKT
06079811201380000,2019,135116,215684,350800,MKT
06079811201390000,2021,191259,0,191259,COST
06079811201390000,2020,199961,0,199961,COST
06079811201390000,2019,199961,0,199961,COST
06079811201410000,2021,189128,370150,559278,COST
06079811201410000,2020,196472,369840,566312,COST
06079811201410000,2019,196472,369840,566312,COST
06079811201420000,2021,1132358,367870,1500228,COST
06079811201420000,2020,897715,351080,1248795,COST
06079811201420000,2019,897715,351080,1248795,COST
06079811201430000,2021,1619733,5887767,7507500,INCOME
06079811201430000,2020,1046489,4482111,5528600,INCOME
06079811201430000,2019,1046489,4482111,5528600,INCOME
06079811201440000,2021,606407,385910,992317,COST
06079811201440000,2020,686995,370900,1057895,COST
06079811201440000,2019,686995,370900,1057895,COST
06079811201460000,2021,635686,428840,1064526,COST
06079811201460000,2020,701013,319830,1020843,COST
06079811201460000,2019,701013,319830,1020843,COST
06079811201470000,2021,879053,254847,1133900,INCOME
06079811201470000,2020,805435,146465,951900,INCOME
06079811201470000,2019,805435,146465,951900,INCOME
06079811202610000,2021,339937,961400,1301337,COST
06079811202610000,2020,513414,845610,1359024,COST
06079811202610000,2019,513414,845610,1359024,COST
06079811206010000,2021,260730,328270,589000,INCOME
06079811206010000,2020,146507,372593,519100,INCOME
06079811206010000,2019,146507,372593,519100,INCOME
06079811206020000,2021,156418,237082,393500,MKT
06079811206020000,2020,126684,194716,321400,OVR
06079811206020000,2019,126684,194716,321400,MKT
06079811206030000,2021,156622,296678,453300,MKT
06079811206030000,2020,126870,213730,340600,MKT
06079811206030000,2019,126870,213730,340600,MKT
06079811206040000,2021,156622,214778,371400,MKT
06079811206040000,2020,126870,177530,304400,MKT
06079811206040000,2019,126870,177530,304400,MKT
06079811206050000,2021,156520,222880,379400,MKT
06079811206050000,2020,126777,184223,311000,MKT
06079811206050000,2019,126777,184223,311000,MKT
06079811206060000,2021,155493,240050,395543,COST
06079811206060000,2020,125844,215470,341314,COST
06079811206060000,2019,125844,215470,341314,COST
06079811206070000,2021,406204,0,406204,COST
06079811206070000,2020,369816,0,369816,COST
06079811206070000,2019,369816,0,369816,COST
06079811206200000,2021,199146,232854,432000,MKT
06079811206200000,2020,213067,171533,384600,MKT
06079811206200000,2019,213067,171533,384600,MKT
06079811207010000,2021,169911,261889,431800,MKT
06079811207010000,2020,166037,182163,348200,MKT
06079811207010000,2019,166037,182163,348200,MKT
06079811207020000,2021,194531,212969,407500,MKT
06079811207020000,2020,205360,172890,378250,COST
06079811207020000,2019,205360,172890,378250,COST
06079811207030000,2021,150029,308271,458300,MKT
06079811207030000,2020,120891,219309,340200,MKT
06079811207030000,2019,120891,219309,340200,MKT
06079811207040000,2021,155286,273114,428400,MKT
06079811207040000,2020,125656,247244,372900,MKT
06079811207040000,2019,125656,247244,372900,MKT
06079811207050000,2021,155286,788830,944116,COST
06079811207050000,2020,125656,628844,754500,MKT
06079811207050000,2019,125656,628844,754500,MKT
06079811207060000,2021,155286,219614,374900,MKT
06079811207060000,2020,125656,183144,308800,MKT
06079811207060000,2019,125656,183144,308800,MKT
06079811207070000,2021,155286,158740,314026,COST
06079811207070000,2020,125656,178744,304400,MKT
06079811207070000,2019,125656,179144,304800,MKT
06079811207080000,2021,155286,302614,457900,MKT
06079811207080000,2020,125656,238044,363700,MKT
06079811207080000,2019,125656,238044,363700,MKT
06079811207090000,2021,155286,296114,451400,MKT
06079811207090000,2020,125656,255544,381200,MKT
06079811207090000,2019,125656,255544,381200,MKT
06079811208010000,2021,137792,243708,381500,MKT
06079811208010000,2020,90708,227492,318200,MKT
06079811208010000,2019,90708,227492,318200,MKT
06079811208030000,2021,140288,255012,395300,MKT
06079811208030000,2020,93943,232557,326500,MKT
06079811208030000,2019,93943,232557,326500,MKT
06079811208050000,2021,140315,249985,390300,MKT
06079811208050000,2020,93979,249421,343400,MKT
06079811208050000,2019,93979,249421,343400,MKT
06079811208070000,2021,140873,295527,436400,MKT
06079811208070000,2020,94709,284491,379200,MKT
06079811208070000,2019,94709,284491,379200,MKT
06079811208090000,2021,185954,206146,392100,MKT
06079811208090000,2020,162834,179166,342000,MKT
06079811208090000,2019,162834,179166,342000,MKT
06079811208110000,2021,204819,416081,620900,MKT
06079811208110000,2020,196631,331269,527900,MKT
06079811208110000,2019,196631,393600,590231,COST
06079811209015001,2021,116995,195305,312300,MKT
06079811209015001,2020,65911,206889,272800,MKT
06079811209015001,2019,65911,206889,272800,MKT
06079811209015002,2021,131466,196434,327900,MKT
06079811209015002,2020,82757,207643,290400,MKT
06079811209015002,2019,82757,207643,290400,MKT
06079811209035001,2021,117021,184879,301900,MKT
06079811209035001,2020,65939,204661,270600,MKT
06079811209035001,2019,65939,204661,270600,MKT
06079811209035002,2021,117002,186298,303300,MKT
06079811209035002,2020,65918,205982,271900,MKT
06079811209035002,2019,65918,205982,271900,MKT
06079811209055001,2021,124863,196337,321200,MKT
06079811209055001,2020,74839,207761,282600,MKT
06079811209055001,2019,74839,207761,282600,MKT
06079811209055002,2021,117034,196266,313300,MKT
06079811209055002,2020,65954,207846,273800,MKT
06079811209055002,2019,65954,207846,273800,MKT
06079811210010000,2021,145064,315836,460900,INCOME
06079811210010000,2020,100287,322013,422300,INCOME
06079811210010000,2019,100287,322013,422300,INCOME
06079811210030000,2021,140011,320889,460900,INCOME
06079811210030000,2020,93581,328719,422300,INCOME
06079811210030000,2019,93581,328719,422300,INCOME
06079811210050000,2021,140011,376989,517000,INCOME
06079811210050000,2020,93581,328719,422300,INCOME
06079811210050000,2019,93581,328719,422300,INCOME
06079811210076500,2021,65587,0,65587,COST
06079811210076500,2020,66999,0,66999,COST
06079811210076500,2019,66999,0,66999,COST
06079811210137000,2021,187512,0,187512,COST
06079811210137000,2020,165506,0,165506,COST
06079811210137000,2019,165506,0,165506,COST
06079811210150000,2021,140011,320889,460900,INCOME
06079811210150000,2020,93581,328719,422300,INCOME
06079811210150000,2019,93581,328719,422300,INCOME
06079811210170000,2021,140011,320889,460900,INCOME
06079811210170000,2020,93581,328719,422300,INCOME
06079811210170000,2019,93581,328719,422300,INCOME
06079811210190000,2021,145064,315836,460900,INCOME
06079811210190000,2020,100287,322013,422300,INCOME
06079811210190000,2019,100287,322013,422300,INCOME
06079811210215001,2021,115550,188050,303600,MKT
06079811210215001,2020,64331,206569,270900,MKT
06079811210215001,2019,64331,206569,270900,MKT
06079811210215002,2021,123750,196350,320100,MKT
06079811210215002,2020,73542,206358,279900,MKT
06079811210215002,2019,73542,206358,279900,MKT
06079811210235001,2021,118038,176862,294900,MKT
06079811210235001,2020,67062,193038,260100,MKT
06079811210235001,2019,67062,193038,260100,MKT
06079811210235002,2021,116583,176917,293500,MKT
06079811210235002,2020,65458,203242,268700,MKT
06079811210235002,2019,65458,203242,268700,MKT
06079811210255001,2021,116806,185594,302400,MKT
06079811210255001,2020,65702,205498,271200,MKT
06079811210255001,2019,65702,205498,271200,MKT
06079811210255002,2021,116622,192878,309500,MKT
06079811210255002,2020,65501,205799,271300,MKT
06079811210255002,2019,65501,205799,271300,MKT
06079811210275001,2021,116444,190956,307400,MKT
06079811210275001,2020,65306,202994,268300,MKT
06079811210275001,2019,65306,202994,268300,MKT
06079811210275002,2021,115899,191801,307700,MKT
06079811210275002,2020,64711,203789,268500,MKT
06079811210275002,2019,64711,203789,268500,MKT
06079811210295001,2021,116444,190756,307200,MKT
06079811210295001,2020,65306,212294,277600,MKT
06079811210295001,2019,65306,212294,277600,MKT
06079811210295002,2021,116444,196156,312600,MKT
06079811210295002,2020,65306,226294,291600,MKT
06079811210295002,2019,65306,226294,291600,MKT
06079811210315001,2021,116444,196356,312800,MKT
06079811210315001,2020,65306,219194,284500,MKT
06079811210315001,2019,65306,219194,284500,MKT
06079811210315002,2021,116444,190456,306900,MKT
06079811210315002,2020,65306,211194,276500,MKT
06079811210315002,2019,65306,211194,276500,MKT
06079811210335001,2021,116444,190756,307200,MKT
06079811210335001,2020,65306,212294,277600,MKT
06079811210335001,2019,65306,212294,277600,MKT
06079811210335002,2021,116444,196156,312600,MKT
06079811210335002,2020,65306,226294,291600,MKT
06079811210335002,2019,65306,226294,291600,MKT
06079811210355001,2021,116444,196556,313000,MKT
06079811210355001,2020,65306,226194,291500,MKT
06079811210355001,2019,65306,226194,291500,MKT
06079811210355002,2021,116444,192156,308600,MKT
06079811210355002,2020,65306,214194,279500,MKT
06079811210355002,2019,65306,214194,279500,MKT
06079811210375001,2021,116444,191756,308200,MKT
06079811210375001,2020,65306,212994,278300,MKT
06079811210375001,2019,65306,212994,278300,MKT
06079811210375002,2021,116444,196756,313200,MKT
06079811210375002,2020,65306,226394,291700,MKT
06079811210375002,2019,65306,226394,291700,MKT
06079811210395001,2021,124491,199009,323500,MKT
06079811210395001,2020,74405,232395,306800,MKT
06079811210395001,2019,74405,232395,306800,MKT
06079811210395002,2021,116444,196956,313400,MKT
06079811210395002,2020,65306,212494,277800,MKT
06079811210395002,2019,65306,212494,277800,MKT
06079811211010000,2021,140532,350168,490700,MKT
06079811211010000,2020,94262,328038,422300,MKT
06079811211010000,2019,94262,328038,422300,MKT
06079811211030000,2021,140035,300965,441000,MKT
06079811211030000,2020,93612,304488,398100,MKT
06079811211030000,2019,93612,304488,398100,MKT
06079811211050000,2021,140062,251838,391900,MKT
06079811211050000,2020,93648,248152,341800,MKT
06079811211050000,2019,93648,248152,341800,MKT
06079811211070000,2021,140090,247810,387900,MKT
06079811211070000,2020,93685,236415,330100,MKT
06079811211070000,2019,93685,236415,330100,MKT
06079811211090000,2021,140118,270882,411000,MKT
06079811211090000,2020,93721,272479,366200,MKT
06079811211090000,2019,93721,272479,366200,MKT
06079811211110000,2021,140146,233154,373300,MKT
06079811211110000,2020,93757,249543,343300,MKT
06079811211110000,2019,93757,249543,343300,MKT
06079811211130000,2021,140173,248427,388600,MKT
06079811211130000,2020,93793,230807,324600,MKT
06079811211130000,2019,93793,230807,324600,MKT
06079811211150000,2021,146736,244064,390800,MKT
06079811211150000,2020,102555,237145,339700,MKT
06079811211150000,2019,102555,226945,329500,MKT
06079811212010000,2021,141153,319747,460900,INCOME
06079811212010000,2020,95077,327223,422300,INCOME
06079811212010000,2019,95077,327223,422300,INCOME
06079811212030000,2021,141153,319747,460900,INCOME
06079811212030000,2020,95077,327223,422300,INCOME
06079811212030000,2019,95077,327223,422300,INCOME
06079811212050000,2021,141153,319747,460900,INCOME
06079811212050000,2020,95077,327223,422300,INCOME
06079811212050000,2019,95077,327223,422300,INCOME
06079811212070000,2021,141153,319747,460900,INCOME
06079811212070000,2020,95077,327223,422300,INCOME
06079811212070000,2019,95077,327223,422300,INCOME
06079811212090000,2021,141153,319747,460900,INCOME
06079811212090000,2020,95077,327223,422300,INCOME
06079811212090000,2019,95077,327223,422300,INCOME
06079811212110000,2021,147104,313796,460900,INCOME
06079811212110000,2020,103058,319242,422300,INCOME
06079811212110000,2019,103058,319242,422300,INCOME
06079811213017000,2021,191810,0,191810,COST
06079811213017000,2020,172993,0,172993,COST
06079811213017000,2019,172993,0,172993,COST
06079811213070000,2021,141900,319000,460900,INCOME
06079811213070000,2020,96062,326238,422300,INCOME
06079811213070000,2019,96062,326238,422300,INCOME
06079811213090000,2021,161345,299555,460900,INCOME
06079811213090000,2020,123428,298872,422300,INCOME
06079811213090000,2019,123428,298872,422300,INCOME
06079811213110000,2021,151870,309030,460900,INCOME
06079811213110000,2020,109675,312625,422300,INCOME
06079811213110000,2019,109675,312625,422300,INCOME
06079811213137000,2021,160535,0,160535,COST
06079811213137000,2020,122220,0,122220,COST
06079811213137000,2019,122220,0,122220,COST
06079811213175001,2021,111849,200551,312400,MKT
06079811213175001,2020,60370,220930,281300,MKT
06079811213175001,2019,60370,227130,287500,MKT
06079811213175002,2021,111842,199358,311200,MKT
06079811213175002,2020,60363,213537,273900,MKT
06079811213175002,2019,60363,213537,273900,MKT
06079811213195001,2021,119611,191689,311300,MKT
06079811213195001,2020,68818,219382,288200,MKT
06079811213195001,2019,68818,219382,288200,MKT
06079811213195002,2021,111864,202436,314300,MKT
06079811213195002,2020,60386,231714,292100,MKT
06079811213195002,2019,60386,231714,292100,MKT
06079811214015001,2021,128282,176318,304600,MKT
06079811214015001,2020,78890,192910,271800,MKT
06079811214015001,2019,78890,192910,271800,MKT
06079811214035002,2021,106689,182611,289300,MKT
06079811214035002,2020,55054,192246,247300,MKT
06079811214035002,2019,55054,192246,247300,MKT
06079811214045003,2021,106689,181011,287700,MKT
06079811214045003,2020,55054,189246,244300,MKT
06079811214045003,2019,55054,189246,244300,MKT
06079811214055004,2021,106689,177811,284500,MKT
06079811214055004,2020,55054,199046,254100,MKT
06079811214055004,2019,55054,199046,254100,MKT
06079811214065001,2021,114863,182037,296900,MKT
06079811214065001,2020,63587,190913,254500,MKT
06079811214065001,2019,63587,190913,254500,MKT
06079811214075002,2021,106689,181111,287800,MKT
06079811214075002,2020,55054,189246,244300,MKT
06079811214075002,2019,55054,189246,244300,MKT
06079811214085003,2021,106689,181111,287800,MKT
06079811214085003,2020,55054,189246,244300,MKT
06079811214085003,2019,55054,189246,244300,MKT
06079811214095004,2021,114863,185237,300100,MKT
06079811214095004,2020,63587,195813,259400,MKT
06079811214095004,2019,63587,195813,259400,MKT
06079811214105001,2021,114863,182537,297400,MKT
06079811214105001,2020,63587,191213,254800,MKT
06079811214105001,2019,63587,191213,254800,MKT
06079811214115002,2021,106689,182611,289300,MKT
06079811214115002,2020,55054,192246,247300,MKT
06079811214115002,2019,55054,192246,247300,MKT
06079811214125003,2021,106689,181211,287900,MKT
06079811214125003,2020,55054,189546,244600,MKT
06079811214125003,2019,55054,189546,244600,MKT
06079811214135004,2021,114863,182537,297400,MKT
06079811214135004,2020,63587,189913,253500,MKT
06079811214135004,2019,63587,189913,253500,MKT
06079811214156500,2021,47794,0,47794,COST
06079811214156500,2020,36124,0,36124,COST
06079811214156500,2019,36124,0,36124,COST
06079811214207000,2021,247669,0,247669,COST
06079811214207000,2020,284895,0,284895,COST
06079811214207000,2019,284895,0,284895,COST
06079811214227000,2021,244256,0,244256,COST
06079811214227000,2020,277283,0,277283,COST
06079811214227000,2019,277283,0,277283,COST
06079811214240000,2021,194429,405871,600300,INCOME
06079811214240000,2020,113585,425715,539300,INCOME
06079811214240000,2019,113585,425715,539300,INCOME
06079811214260000,2021,207915,392385,600300,INCOME
06079811214260000,2020,120388,418912,539300,INCOME
06079811214260000,2019,120388,418912,539300,INCOME
06079811214337000,2021,232907,0,232907,COST
06079811214337000,2020,252692,0,252692,COST
06079811214337000,2019,252692,0,252692,COST
06079811214377000,2021,241347,0,241347,COST
06079811214377000,2020,270872,0,270872,COST
06079811214377000,2019,270872,0,270872,COST
06079811216010000,2021,213353,321147,534500,INCOME
06079811216010000,2020,123115,374585,497700,INCOME
06079811216010000,2019,123115,374585,497700,INCOME
06079811216050000,2021,194224,340276,534500,INCOME
06079811216050000,2020,113481,384219,497700,INCOME
06079811216050000,2019,113481,384219,497700,INCOME
06079811216090000,2021,194224,340276,534500,INCOME
06079811216090000,2020,113481,384219,497700,INCOME
06079811216090000,2019,113481,384219,497700,INCOME
06079811216130000,2021,194224,340276,534500,INCOME
06079811216130000,2020,113481,384219,497700,INCOME
06079811216130000,2019,113481,384219,497700,INCOME
06079811216177000,2021,154547,0,154547,COST
06079811216177000,2020,113481,0,113481,COST
06079811216177000,2019,113481,0,113481,COST
06079811216217000,2021,154547,0,154547,COST
06079811216217000,2020,113481,0,113481,COST
06079811216217000,2019,113481,0,113481,COST
06079811216255001,2021,115089,182411,297500,MKT
06079811216255001,2020,63831,190869,254700,MKT
06079811216255001,2019,63831,190869,254700,MKT
06079811216265002,2021,106899,182401,289300,MKT
06079811216265002,2020,55265,191835,247100,MKT
06079811216265002,2019,55265,191835,247100,MKT
06079811216275003,2021,106899,181101,288000,MKT
06079811216275003,2020,55265,189235,244500,MKT
06079811216275003,2019,55265,189235,244500,MKT
06079811216285004,2021,128534,173866,302400,MKT
06079811216285004,2020,79193,188707,267900,MKT
06079811216285004,2019,79193,188707,267900,MKT
06079811217010000,2021,138471,319529,458000,MKT
06079811217010000,2020,91583,279117,370700,MKT
06079811217010000,2019,91583,279117,370700,MKT
06079811217040000,2021,138471,266329,404800,INCOME
06079811217040000,2020,91583,276917,368500,INCOME
06079811217040000,2019,91583,276917,368500,INCOME
06079811217070000,2021,140477,234923,375400,INCOME
06079811217070000,2020,94190,263210,357400,INCOME
06079811217070000,2019,94190,263210,357400,INCOME
06079811217100000,2021,140477,262820,403297,COST
06079811217100000,2020,94190,229870,324060,COST
06079811217100000,2019,94190,229870,324060,COST
06079811217130000,2021,140477,257323,397800,MKT
06079811217130000,2020,94190,266110,360300,MKT
06079811217130000,2019,94190,266110,360300,MKT
06079811217160000,2021,140477,234923,375400,INCOME
06079811217160000,2020,94190,263210,357400,INCOME
06079811217160000,2019,94190,263210,357400,INCOME
06079811217190000,2021,140477,204823,345300,MKT
06079811217190000,2020,94190,132260,226450,COST
06079811217190000,2019,94190,132260,226450,COST
06079811217220000,2021,140477,204823,345300,MKT
06079811217220000,2020,94190,152320,246510,COST
06079811217220000,2019,94190,152320,246510,COST
06079811217300000,2021,229343,520580,749923,COST
06079811217300000,2020,131080,447070,578150,COST
06079811217300000,2019,131080,447070,578150,COST
06079811217340000,2021,199096,335404,534500,INCOME
06079811217340000,2020,115946,381754,497700,INCOME
06079811217340000,2019,115946,381754,497700,INCOME
06079811217380000,2021,199096,335404,534500,INCOME
06079811217380000,2020,115946,381754,497700,INCOME
06079811217380000,2019,115946,381754,497700,INCOME
06079811217420000,2021,199096,335404,534500,INCOME
06079811217420000,2020,115946,381754,497700,INCOME
06079811217420000,2019,115946,381754,497700,INCOME
06079811217460000,2021,199096,335404,534500,INCOME
06079811217460000,2020,115946,381754,497700,INCOME
06079811217460000,2019,115946,381754,497700,INCOME
06079811217500000,2021,199096,335404,534500,INCOME
06079811217500000,2020,115946,381754,497700,INCOME
06079811217500000,2019,115946,381754,497700,INCOME
06079811217540000,2021,149983,149017,299000,MKT
06079811217540000,2020,107031,144969,252000,MKT
06079811217540000,2019,107031,144969,252000,MKT
06079811218010000,2021,134201,467999,602200,INCOME
06079811218010000,2020,86151,336149,422300,INCOME
06079811218010000,2019,86151,336149,422300,INCOME
06079811218040000,2021,134201,195499,329700,INCOME
06079811218040000,2020,86151,225749,311900,INCOME
06079811218040000,2019,86151,225749,311900,INCOME
06079811218070000,2021,134201,195499,329700,INCOME
06079811218070000,2020,86151,225749,311900,INCOME
06079811218070000,2019,86151,225749,311900,INCOME
06079811218100000,2021,135090,269710,404800,INCOME
06079811218100000,2020,87268,281232,368500,INCOME
06079811218100000,2019,87268,281232,368500,INCOME
06079811218130000,2021,145010,259790,404800,INCOME
06079811218130000,2020,100214,268286,368500,INCOME
06079811218130000,2019,100214,268286,368500,INCOME
06079811218160000,2021,164693,442507,607200,INCOME
06079811218160000,2020,128476,424224,552700,INCOME
06079811218160000,2019,128476,424224,552700,INCOME
06079811218180000,2021,132015,223385,355400,MKT
06079811218180000,2020,83434,229166,312600,MKT
06079811218180000,2019,83434,229166,312600,MKT
06079811218186500,2021,42015,0,42015,COST
06079811218186500,2020,28090,0,28090,COST
06079811218186500,2019,28090,0,28090,COST
06079811218200000,2021,134044,216456,350500,MKT
06079811218200000,2020,85956,219644,305600,MKT
06079811218200000,2019,85956,219644,305600,MKT
06079811218220000,2021,132706,219994,352700,MKT
06079811218220000,2020,84288,224812,309100,MKT
06079811218220000,2019,84288,224812,309100,MKT
06079811218240000,2021,130690,207610,338300,MKT
06079811218240000,2020,81807,213993,295800,MKT
06079811218240000,2019,81807,213993,295800,MKT
06079811218260000,2021,129720,208380,338100,MKT
06079811218260000,2020,80626,212974,293600,MKT
06079811218260000,2019,80626,212974,293600,MKT
06079811218280000,2021,129548,213052,342600,MKT
06079811218280000,2020,80417,228783,309200,MKT
06079811218280000,2019,80417,228783,309200,MKT
06079811218300000,2021,129548,207552,337100,MKT
06079811218300000,2020,80417,213683,294100,MKT
06079811218300000,2019,80417,213683,294100,MKT
06079811218320000,2021,137467,227233,364700,MKT
06079811218320000,2020,90291,231709,322000,MKT
06079811218320000,2019,90291,231709,322000,MKT
06079811218340000,2021,199272,401028,600300,INCOME
06079811218340000,2020,116035,423265,539300,INCOME
06079811218340000,2019,116035,423265,539300,INCOME
06079811218360000,2021,197622,561078,758700,INCOME
06079811218360000,2020,115201,559799,675000,INCOME
06079811218360000,2019,115201,559799,675000,INCOME
06079811218380000,2021,192622,448378,641000,INCOME
06079811218380000,2020,112668,476832,589500,INCOME
06079811218380000,2019,112668,476832,589500,INCOME
06079811218400000,2021,194949,453451,648400,INCOME
06079811218400000,2020,113848,452152,566000,INCOME
06079811218400000,2019,113848,452152,566000,INCOME
06079811218420000,2021,187848,412452,600300,INCOME
06079811218420000,2020,110242,429058,539300,INCOME
06079811218420000,2019,110242,429058,539300,INCOME
06079811218440000,2021,199684,400616,600300,INCOME
06079811218440000,2020,116243,423057,539300,INCOME
06079811218440000,2019,116243,423057,539300,INCOME
06079811218467000,2021,163035,0,163035,COST
06079811218467000,2020,125963,0,125963,COST
06079811218467000,2019,125963,0,125963,COST
06079811218505001,2021,114863,170937,285800,MKT
06079811218505001,2020,63587,184613,248200,MKT
06079811218505001,2019,63587,184613,248200,MKT
06079811218515002,2021,106689,162611,269300,MKT
06079811218515002,2020,55054,180746,235800,MKT
06079811218515002,2019,55054,180746,235800,MKT
06079811218525003,2021,106689,174611,281300,MKT
06079811218525003,2020,55054,180946,236000,MKT
06079811218525003,2019,55054,180946,236000,MKT
06079811218535004,2021,114863,170937,285800,MKT
06079811218535004,2020,63587,184613,248200,MKT
06079811218535004,2019,63587,184613,248200,MKT
06079811218545001,2021,114863,170937,285800,MKT
06079811218545001,2020,63587,184613,248200,MKT
06079811218545001,2019,63587,184613,248200,MKT
06079811218555002,2021,106689,164611,271300,MKT
06079811218555002,2020,55054,184746,239800,MKT
06079811218555002,2019,55054,184746,239800,MKT
06079811218565003,2021,106689,162611,269300,MKT
06079811218565003,2020,55054,180746,235800,MKT
06079811218565003,2019,55054,180746,235800,MKT
06079811218575004,2021,114863,170937,285800,MKT
06079811218575004,2020,63587,184613,248200,MKT
06079811218575004,2019,63587,184613,248200,MKT
06079811218585001,2021,114863,182437,297300,MKT
06079811218585001,2020,63587,190913,254500,MKT
06079811218585001,2019,63587,190913,254500,MKT
06079811218595002,2021,106689,181011,287700,MKT
06079811218595002,2020,55054,189246,244300,MKT
06079811218595002,2019,55054,189246,244300,MKT
06079811218605003,2021,106689,181011,287700,MKT
06079811218605003,2020,55054,189246,244300,MKT
06079811218605003,2019,55054,189246,244300,MKT
06079811218615004,2021,114863,171537,286400,MKT
06079811218615004,2020,63587,185713,249300,MKT
06079811218615004,2019,63587,185713,249300,MKT
06079811218625001,2021,114863,182637,297500,MKT
06079811218625001,2020,63587,191413,255000,MKT
06079811218625001,2019,63587,191413,255000,MKT
06079811218635002,2021,106689,183111,289800,MKT
06079811218635002,2020,55054,193246,248300,MKT
06079811218635002,2019,55054,189646,244700,MKT
06079811218645003,2021,106689,182111,288800,MKT
06079811218645003,2020,55054,189646,244700,OVR
06079811218645003,2019,55054,189646,244700,MKT
06079811218655004,2021,128282,176818,305100,MKT
06079811218655004,2020,78890,189210,268100,OVR
06079811218655004,2019,78890,189210,268100,MKT
06079811219010000,2021,146983,333817,480800,INCOME
06079811219010000,2020,102892,339308,442200,INCOME
06079811219010000,2019,102892,339308,442200,INCOME
06079811219047000,2021,134428,2650,137078,COST
06079811219047000,2020,86436,2610,89046,COST
06079811219047000,2019,86436,2610,89046,COST
06079811219055001,2021,107570,162630,270200,MKT
06079811219055001,2020,55945,190355,246300,MKT
06079811219055001,2019,55945,190355,246300,MKT
06079811219065002,2021,103400,154900,258300,MKT
06079811219065002,2020,51789,176711,228500,MKT
06079811219065002,2019,51789,176711,228500,MKT
06079811219075003,2021,113334,163766,277100,MKT
06079811219075003,2020,61945,190355,252300,MKT
06079811219075003,2019,61945,190355,252300,MKT
06079811219085001,2021,109141,148559,257700,MKT
06079811219085001,2020,57550,173050,230600,MKT
06079811219085001,2019,57550,173050,230600,MKT
06079811219095002,2021,104403,148497,252900,MKT
06079811219095002,2020,52775,172925,225700,MKT
06079811219095002,2019,52775,172925,225700,MKT
06079811219105001,2021,106105,162595,268700,MKT
06079811219105001,2020,54467,188433,242900,MKT
06079811219105001,2019,54467,188433,242900,MKT
06079811219115002,2021,120509,157191,277700,MKT
06079811219115002,2020,69830,182470,252300,MKT
06079811219115002,2019,69830,182470,252300,MKT
06079811219140000,2021,125394,230006,355400,INCOME
06079811219140000,2020,75461,251939,327400,INCOME
06079811219140000,2019,75461,251939,327400,INCOME
06079811219170000,2021,136663,324237,460900,INCOME
06079811219170000,2020,89264,333036,422300,INCOME
06079811219170000,2019,89264,333036,422300,INCOME
06079811219200000,2021,135971,176129,312100,INCOME
06079811219200000,2020,88383,197317,285700,INCOME
06079811219200000,2019,88383,197317,285700,INCOME
06079811219247000,2021,250053,0,250053,COST
06079811219247000,2020,290271,0,290271,COST
06079811219247000,2019,290271,0,290271,COST
06079811220010000,2021,135962,176138,312100,INCOME
06079811220010000,2020,88372,197328,285700,INCOME
06079811220010000,2019,88372,197328,285700,INCOME
06079811220040000,2021,139608,201892,341500,MKT
06079811220040000,2020,93057,162870,255927,COST
06079811220040000,2019,93057,162870,255927,COST
06079811220070000,2021,209129,325371,534500,INCOME
06079811220070000,2020,120998,376702,497700,INCOME
06079811220070000,2019,120998,376702,497700,INCOME
06079811220100000,2021,195554,338946,534500,INCOME
06079811220100000,2020,114154,383546,497700,INCOME
06079811220100000,2019,114154,383546,497700,INCOME
06079811220130000,2021,150006,225394,375400,INCOME
06079811220130000,2020,107063,250337,357400,INCOME
06079811220130000,2019,107063,250337,357400,INCOME
06079811220160000,2021,145857,229543,375400,INCOME
06079811220160000,2020,101360,256040,357400,INCOME
06079811220160000,2019,101360,256040,357400,INCOME
06079811220190000,2021,141751,197149,338900,MKT
06079811220190000,2020,95865,121790,217655,COST
06079811220190000,2019,95865,121790,217655,COST
06079811220220000,2021,137262,238138,375400,INCOME
06079811220220000,2020,90029,267371,357400,INCOME
06079811220220000,2019,90029,267371,357400,INCOME
06079811220250000,2021,136816,204084,340900,MKT
06079811220250000,2020,89458,134670,224128,COST
06079811220250000,2019,89458,134670,224128,COST
06079811221016500,2021,60360,0,60360,COST
06079811221016500,2020,56973,0,56973,COST
06079811221016500,2019,56973,0,56973,COST
06079811230707000,2021,62500,0,62500,COST
06079811230707000,2020,60982,0,60982,COST
06079811230707000,2019,60982,0,60982,COST
06079811250010000,2021,152542,281158,433700,MKT
06079811250010000,2020,123166,208134,331300,MKT
06079811250010000,2019,123166,208134,331300,MKT
06079811250020000,2021,152542,292158,444700,MKT
06079811250020000,2020,123166,242734,365900,MKT
06079811250020000,2019,123166,242734,365900,MKT
06079811250030000,2021,154661,278539,433200,MKT
06079811250030000,2020,125089,238611,363700,MKT
06079811250030000,2019,125089,238611,363700,MKT
06079811250040000,2021,154661,233639,388300,MKT
06079811250040000,2020,125089,201011,326100,MKT
06079811250040000,2019,125089,201011,326100,MKT
06079811250050000,2021,151569,275850,427419,COST
06079811250050000,2020,122284,256416,378700,MKT
06079811250050000,2019,122284,256416,378700,MKT
06079811250060000,2021,176089,252811,428900,MKT
06079811250060000,2020,127055,214645,341700,MKT
06079811250060000,2019,127055,214645,341700,MKT
06079811250070000,2021,154661,323239,477900,MKT
06079811250070000,2020,125089,264411,389500,MKT
06079811250070000,2019,125089,264411,389500,MKT
06079811250080000,2021,133824,274476,408300,MKT
06079811250080000,2020,101947,215153,317100,MKT
06079811250080000,2019,101947,215153,317100,MKT
06079811251010000,2021,187261,548739,736000,MKT
06079811251010000,2020,200703,537515,738218,MRA
06079811251010000,2019,200703,537515,738218,MRA
06079811251026500,2021,53418,0,53418,COST
06079811251026500,2020,44886,0,44886,COST
06079811251026500,2019,44886,0,44886,COST
06079811251036500,2021,44443,0,44443,COST
06079811251036500,2020,31346,0,31346,COST
06079811251036500,2019,31346,0,31346,COST
06079811251080000,2021,123234,324466,447700,MKT
06079811251080000,2020,88688,327212,415900,MKT
06079811251080000,2019,88688,327212,415900,MKT
06079811251100000,2021,195037,105270,300307,COST
06079811251100000,2020,155600,145800,301400,MKT
06079811251100000,2019,155600,145800,301400,MKT
06079811251110000,2021,187076,140660,327736,COST
06079811251110000,2020,135216,127480,262696,COST
06079811251110000,2019,135216,127480,262696,COST
06079811251120000,2021,122459,337041,459500,MKT
06079811251120000,2020,87603,325497,413100,MKT
06079811251120000,2019,87603,325497,413100,MKT
06079811251140000,2021,122298,451602,573900,MKT
06079811251140000,2020,87378,377122,464500,MKT
06079811251140000,2019,87378,327622,415000,MKT
06079811251160000,2021,122250,336950,459200,MKT
06079811251160000,2020,87312,325788,413100,MKT
06079811251160000,2019,87312,325788,413100,MKT
06079811251180000,2021,122202,325398,447600,MKT
06079811251180000,2020,87245,301755,389000,MKT
06079811251180000,2019,87245,301755,389000,MKT
06079811251206500,2021,46264,0,46264,COST
06079811251206500,2020,41218,0,41218,COST
06079811251206500,2019,41218,0,41218,COST
06079811252020000,2021,128368,354900,483268,COST
06079811252020000,2020,96044,356040,452084,COST
06079811252020000,2019,96044,356040,452084,COST
06079811252040000,2021,121935,273865,395800,MKT
06079811252040000,2020,86873,266527,353400,MKT
06079811252040000,2019,86873,266527,353400,MKT
06079811252060000,2021,121887,249710,371597,COST
06079811252060000,2020,86806,0,86806,COST
06079811252060000,2019,86806,0,86806,COST
06079811252080000,2021,121844,243956,365800,MKT
06079811252080000,2020,86746,234154,320900,MKT
06079811252080000,2019,86746,234154,320900,MKT
06079811252100000,2021,121796,240904,362700,MKT
06079811252100000,2020,86679,232621,319300,MKT
06079811252100000,2019,86679,232621,319300,MKT
06079811252120000,2021,121747,257953,379700,MKT
06079811252120000,2020,86612,246888,333500,MKT
06079811252120000,2019,86612,246888,333500,MKT
06079811252140000,2021,121704,367496,489200,MKT
06079811252140000,2020,86552,0,86552,COST
06079811252140000,2019,86552,0,86552,COST
06079811252160000,2021,121656,271944,393600,MKT
06079811252160000,2020,86485,260715,347200,MKT
06079811252160000,2019,86485,260715,347200,MKT
06079811252180000,2021,121608,277692,399300,MKT
06079811252180000,2020,86418,271782,358200,MKT
06079811252180000,2019,86418,271782,358200,MKT
06079811252200000,2021,121564,309136,430700,MKT
06079811252200000,2020,86358,322642,409000,MKT
06079811252200000,2019,86358,322642,409000,MKT
06079811252220000,2021,120044,347256,467300,MKT
06079811252220000,2020,84263,335337,419600,MKT
06079811252220000,2019,84263,119910,204173,COST
06079811252240000,2021,118996,272304,391300,MKT
06079811252240000,2020,82833,279067,361900,MKT
06079811252240000,2019,82833,279067,361900,MKT
06079811252266500,2021,33054,0,33054,COST
06079811252266500,2020,21384,0,21384,COST
06079811252266500,2019,21384,0,21384,COST
06079811253020000,2021,104676,0,104676,COST
06079811253020000,2020,59734,0,59734,COST
06079811253020000,2019,59734,0,59734,COST
06079811253040000,2021,107578,0,107578,COST
06079811253040000,2020,55953,0,55953,COST
06079811253040000,2019,55953,0,55953,COST
06079811253060000,2021,107545,0,107545,COST
06079811253060000,2020,55920,0,55920,COST
06079811253060000,2019,55920,0,55920,COST
06079811253080000,2021,107496,0,107496,COST
06079811253080000,2020,55870,0,55870,COST
06079811253080000,2019,55870,0,55870,COST
06079811253100000,2021,106622,0,106622,COST
06079811253100000,2020,54986,0,54986,COST
06079811253100000,2019,54986,0,54986,COST
06079811253120000,2021,103151,0,103151,COST
06079811253120000,2020,51547,0,51547,COST
06079811253120000,2019,51547,0,51547,COST
06079811253140000,2021,120611,0,120611,COST
06079811253140000,2020,69945,0,69945,COST
06079811253140000,2019,69945,0,69945,COST
06079811254185002,2021,114353,243947,358300,MKT
06079811254185002,2020,63036,0,63036,COST
06079811254185002,2019,63036,0,63036,COST
06079811254205001,2021,122905,245495,368400,MKT
06079811254205001,2020,72565,0,72565,COST
06079811254205001,2019,72565,0,72565,COST
06079811255020000,2021,108262,0,108262,COST
06079811255020000,2020,56650,0,56650,COST
06079811255020000,2019,56650,0,56650,COST
06079811255040000,2021,102179,0,102179,COST
06079811255040000,2020,50603,0,50603,COST
06079811255040000,2019,50603,0,50603,COST
06079811255060000,2021,103290,0,103290,COST
06079811255060000,2020,51682,0,51682,COST
06079811255060000,2019,51682,0,51682,COST
06079811255080000,2021,113020,0,113020,COST
06079811255080000,2020,61610,0,61610,COST
06079811255080000,2019,61610,0,61610,COST
06079811255100000,2021,113020,0,113020,COST
06079811255100000,2020,61610,0,61610,COST
06079811255100000,2019,61610,0,61610,COST
06079811255120000,2021,103519,0,103519,COST
06079811255120000,2020,51906,0,51906,COST
06079811255120000,2019,51906,0,51906,COST
06079811255140000,2021,103519,0,103519,COST
06079811255140000,2020,51906,0,51906,COST
06079811255140000,2019,51906,0,51906,COST
06079811255160000,2021,113020,0,113020,COST
06079811255160000,2020,61610,0,61610,COST
06079811255160000,2019,61610,0,61610,COST
06079811256025001,2021,121501,270599,392100,MKT
06079811256025001,2020,70956,286044,357000,MKT
06079811256025001,2019,70956,286044,357000,MKT
06079811256045002,2021,108028,271072,379100,MKT
06079811256045002,2020,56410,293390,349800,MKT
06079811256045002,2019,56410,293390,349800,MKT
06079811256065003,2021,108028,271072,379100,MKT
06079811256065003,2020,56410,293390,349800,MKT
06079811256065003,2019,56410,293390,349800,MKT
06079811256085004,2021,113020,271580,384600,MKT
06079811256085004,2020,61610,286290,347900,MKT
06079811256085004,2019,61610,286290,347900,MKT
06079811256105001,2021,113020,265080,378100,MKT
06079811256105001,2020,61610,267290,328900,OVR
06079811256105001,2019,61610,267290,328900,MKT
06079811256125002,2021,103519,182981,286500,MKT
06079811256125002,2020,51906,191294,243200,MKT
06079811256125002,2019,51906,191294,243200,MKT
06079811256145003,2021,103519,182981,286500,MKT
06079811256145003,2020,51906,191294,243200,MKT
06079811256145003,2019,51906,191294,243200,MKT
06079811256165004,2021,113020,255180,368200,MKT
06079811256165004,2020,61610,267290,328900,MKT
06079811256165004,2019,61610,267290,328900,MKT
06079811256185001,2021,113020,255180,368200,MKT
06079811256185001,2020,61610,267290,328900,MKT
06079811256185001,2019,61610,267290,328900,MKT
06079811256205002,2021,103519,182981,286500,MKT
06079811256205002,2020,51906,191294,243200,MKT
06079811256205002,2019,51906,191294,243200,MKT
06079811256225003,2021,103519,182981,286500,MKT
06079811256225003,2020,51906,191294,243200,MKT
06079811256225003,2019,51906,191294,243200,MKT
06079811256245004,2021,113020,255180,368200,MKT
06079811256245004,2020,61610,267290,328900,MKT
06079811256245004,2019,61610,267290,328900,MKT
06079811256265001,2021,113020,255380,368400,MKT
06079811256265001,2020,61610,267390,329000,MKT
06079811256265001,2019,61610,267390,329000,MKT
06079811256285002,2021,103519,183181,286700,MKT
06079811256285002,2020,51906,191594,243500,MKT
06079811256285002,2019,51906,191594,243500,MKT
06079811256305003,2021,103519,183181,286700,MKT
06079811256305003,2020,51906,191594,243500,MKT
06079811256305003,2019,51906,191594,243500,MKT
06079811256325004,2021,113020,255180,368200,MKT
06079811256325004,2020,61610,267290,328900,MKT
06079811256325004,2019,61610,267290,328900,MKT
06079811256345001,2021,113320,255280,368600,MKT
06079811256345001,2020,61930,267370,329300,MKT
06079811256345001,2019,61930,267370,329300,MKT
06079811256365002,2021,104829,183071,287900,MKT
06079811256365002,2020,53196,188104,241300,MKT
06079811256365002,2019,53196,188104,241300,MKT
06079811256385003,2021,106011,183389,289400,MKT
06079811256385003,2020,54373,188427,242800,MKT
06079811256385003,2019,54373,188427,242800,MKT
06079811256405004,2021,123844,256556,380400,MKT
06079811256405004,2020,73652,268648,342300,MKT
06079811256405004,2019,73652,268648,342300,MKT
06079811257020000,2021,114235,0,114235,COST
06079811257020000,2020,62909,0,62909,COST
06079811257020000,2019,62909,0,62909,COST
06079811257040000,2021,109180,0,109180,COST
06079811257040000,2020,57591,0,57591,COST
06079811257040000,2019,57591,0,57591,COST
06079811257060000,2021,114214,0,114214,COST
06079811257060000,2020,62887,0,62887,COST
06079811257060000,2019,62887,0,62887,COST
06079811257080000,2021,114200,0,114200,COST
06079811257080000,2020,62872,0,62872,COST
06079811257080000,2019,62872,0,62872,COST
06079811257100000,2021,114186,0,114186,COST
06079811257100000,2020,62857,0,62857,COST
06079811257100000,2019,62857,0,62857,COST
06079811257120000,2021,114179,0,114179,COST
06079811257120000,2020,62849,0,62849,COST
06079811257120000,2019,62849,0,62849,COST
06079811257140000,2021,114165,0,114165,COST
06079811257140000,2020,62834,0,62834,COST
06079811257140000,2019,62834,0,62834,COST
06079811257160000,2021,114151,0,114151,COST
06079811257160000,2020,62820,0,62820,COST
06079811257160000,2019,62820,0,62820,COST
06079811257180000,2021,114137,0,114137,COST
06079811257180000,2020,62805,0,62805,COST
06079811257180000,2019,62805,0,62805,COST
06079811257200000,2021,113850,0,113850,COST
06079811257200000,2020,62497,0,62497,COST
06079811257200000,2019,62497,0,62497,COST
06079811257220000,2021,112275,0,112275,COST
06079811257220000,2020,60820,0,60820,COST
06079811257220000,2019,60820,0,60820,COST
06079811257240000,2021,110300,0,110300,COST
06079811257240000,2020,58749,0,58749,COST
06079811257240000,2019,58749,0,58749,COST
06079811257260000,2021,107488,0,107488,COST
06079811257260000,2020,55861,0,55861,COST
06079811257260000,2019,55861,0,55861,COST
06079811260016500,2021,38570,0,38570,COST
06079811260016500,2020,23771,0,23771,COST
06079811260016500,2019,23771,0,23771,COST
06079811260020000,2021,124803,292797,417600,MKT
06079811260020000,2020,74769,270831,345600,OVR
06079811260020000,2019,74769,270831,345600,MKT
06079811260040000,2021,123492,277108,400600,MKT
06079811260040000,2020,73243,248557,321800,MKT
06079811260040000,2019,73243,248557,321800,MKT
06079811260060000,2021,123492,276208,399700,MKT
06079811260060000,2020,73243,255357,328600,MKT
06079811260060000,2019,73243,255357,328600,MKT
06079811260080000,2021,127068,233232,360300,MKT
06079811260080000,2020,77440,240660,318100,MKT
06079811260080000,2019,77440,240660,318100,MKT
06079811260100000,2021,127032,265968,393000,MKT
06079811260100000,2020,77397,253803,331200,MKT
06079811260100000,2019,77397,253803,331200,MKT
06079811260120000,2021,123346,267754,391100,MKT
06079811260120000,2020,73074,258626,331700,MKT
06079811260120000,2019,73074,258626,331700,MKT
06079811260140000,2021,123492,265608,389100,MKT
06079811260140000,2020,73243,257357,330600,MKT
06079811260140000,2019,73243,257357,330600,MKT
06079811260160000,2021,123492,269608,393100,MKT
06079811260160000,2020,73243,257357,330600,MKT
06079811260160000,2019,73243,257357,330600,MKT
06079811260180000,2021,127363,278237,405600,MKT
06079811260180000,2020,77791,287509,365300,MKT
06079811260180000,2019,77791,287509,365300,MKT
06079811260200000,2021,127327,316273,443600,MKT
06079811260200000,2020,77748,306352,384100,MKT
06079811260200000,2019,77748,306352,384100,MKT
06079811260220000,2021,121448,362052,483500,MKT
06079811260220000,2020,70895,349205,420100,MKT
06079811260220000,2019,70895,349205,420100,MKT
06079811260240000,2021,123872,343128,467000,MKT
06079811260240000,2020,73684,323516,397200,MKT
06079811260240000,2019,73684,323516,397200,MKT
06079811260260000,2021,124983,279017,404000,MKT
06079811260260000,2020,74979,283721,358700,MKT
06079811260260000,2019,74979,283721,358700,MKT
06079811260280000,2021,124983,293017,418000,MKT
06079811260280000,2020,74979,292421,367400,MKT
06079811260280000,2019,74979,292421,367400,MKT
06079811260300000,2021,121259,265741,387000,MKT
06079811260300000,2020,70681,264719,335400,MKT
06079811260300000,2019,70681,264719,335400,MKT
06079811260320000,2021,118443,244657,363100,MKT
06079811260320000,2020,67512,256388,323900,MKT
06079811260320000,2019,67512,256388,323900,MKT
06079811260340000,2021,118443,270757,389200,MKT
06079811260340000,2020,67512,263288,330800,MKT
06079811260340000,2019,67512,263288,330800,MKT
06079811260360000,2021,125598,280402,406000,MKT
06079811260360000,2020,75701,273699,349400,MKT
06079811260360000,2019,75701,273699,349400,MKT
06079811260387000,2021,198725,0,198725,COST
06079811260387000,2020,185375,0,185375,COST
06079811260387000,2019,185375,0,185375,COST
06079811260400000,2021,133973,446827,580800,MKT
06079811260400000,2020,85866,415634,501500,MKT
06079811260400000,2019,85866,415634,501500,MKT
06079811260420000,2021,133816,304484,438300,MKT
06079811260420000,2020,85669,287631,373300,MKT
06079811260420000,2019,85669,287631,373300,MKT
06079811260440000,2021,133072,334528,467600,MKT
06079811260440000,2020,84743,341357,426100,MKT
06079811260440000,2019,84743,341357,426100,MKT
06079811260460000,2021,132318,353182,485500,MKT
06079811260460000,2020,83807,353193,437000,MKT
06079811260460000,2019,83807,353193,437000,MKT
06079811260480000,2021,128764,328636,457400,MKT
06079811260480000,2020,79471,311429,390900,MKT
06079811260480000,2019,79471,311429,390900,MKT
06079811260500000,2021,128473,329827,458300,MKT
06079811260500000,2020,79121,326679,405800,MKT
06079811260500000,2019,79121,326679,405800,MKT
06079811260520000,2021,127748,305952,433700,MKT
06079811260520000,2020,78251,301449,379700,MKT
06079811260520000,2019,78251,301449,379700,MKT
06079811260540000,2021,127011,387089,514100,MKT
06079811260540000,2020,77372,359128,436500,MKT
06079811260540000,2019,77372,359128,436500,MKT
06079811260560000,2021,126262,440138,566400,MKT
06079811260560000,2020,76485,398215,474700,MKT
06079811260560000,2019,76485,398215,474700,MKT
06079811260580000,2021,125496,289504,415000,MKT
06079811260580000,2020,75581,281719,357300,MKT
06079811260580000,2019,75581,281719,357300,MKT
06079811260600000,2021,127001,291699,418700,MKT
06079811260600000,2020,77360,285740,363100,MKT
06079811260600000,2019,77360,285740,363100,MKT
06079811260620000,2021,126918,262482,389400,MKT
06079811260620000,2020,77261,264339,341600,MKT
06079811260620000,2019,77261,264339,341600,MKT
06079811260640000,2021,118443,268557,387000,MKT
06079811260640000,2020,67512,254888,322400,MKT
06079811260640000,2019,67512,254888,322400,MKT
06079811260660000,2021,124519,299681,424200,MKT
06079811260660000,2020,74437,302663,377100,MKT
06079811260660000,2019,74437,302663,377100,MKT
06079811260680000,2021,118443,304157,422600,MKT
06079811260680000,2020,67512,302788,370300,MKT
06079811260680000,2019,67512,302788,370300,MKT
06079811260700000,2021,130159,0,130159,COST
06079811260700000,2020,81159,0,81159,COST
06079811260700000,2019,81159,0,81159,COST
06079811261020000,2021,127886,413314,541200,MKT
06079811261020000,2020,78416,370984,449400,MKT
06079811261020000,2019,78416,370984,449400,MKT
06079811261040000,2021,125544,298756,424300,MKT
06079811261040000,2020,75638,288962,364600,MKT
06079811261040000,2019,75638,288962,364600,MKT
06079811261060000,2021,123492,263908,387400,MKT
06079811261060000,2020,73243,241457,314700,MKT
06079811261060000,2019,73243,241457,314700,MKT
06079811261080000,2021,123492,0,123492,COST
06079811261080000,2020,73243,0,73243,COST
06079811261080000,2019,73243,0,73243,COST
06079811261100000,2021,123492,281108,404600,MKT
06079811261100000,2020,73243,279457,352700,MKT
06079811261100000,2019,73243,279457,352700,MKT
06079811261120000,2021,136138,306262,442400,MKT
06079811261120000,2020,88596,294704,383300,MKT
06079811261120000,2019,88596,294704,383300,MKT
06079811261130000,2021,123576,0,123576,COST
06079811261130000,2020,73341,0,73341,COST
06079811261130000,2019,73341,0,73341,COST
06079811261140000,2021,124343,0,124343,COST
06079811261140000,2020,74231,0,74231,COST
06079811261140000,2019,74231,0,74231,COST
06079811261160000,2021,121950,287650,409600,MKT
06079811261160000,2020,71469,284831,356300,MKT
06079811261160000,2019,71469,284831,356300,MKT
06079811261180000,2021,118443,263257,381700,MKT
06079811261180000,2020,67512,261888,329400,MKT
06079811261180000,2019,67512,261888,329400,MKT
06079811261200000,2021,118443,267557,386000,MKT
06079811261200000,2020,67512,261788,329300,MKT
06079811261200000,2019,67512,261788,329300,MKT
06079811261220000,2021,121665,315435,437100,MKT
06079811261220000,2020,71143,326157,397300,MKT
06079811261220000,2019,71143,326157,397300,MKT
06079811261240000,2021,124672,449428,574100,MKT
06079811261240000,2020,74616,412384,487000,MKT
06079811261240000,2019,74616,412384,487000,MKT
06079811261260000,2021,118443,261157,379600,MKT
06079811261260000,2020,67512,264588,332100,MKT
06079811261260000,2019,67512,264588,332100,MKT
06079811261280000,2021,128074,323226,451300,MKT
06079811261280000,2020,78641,319959,398600,OVR
06079811261280000,2019,78641,319959,398600,MKT
06079811275237000,2021,303780,0,303780,COST
06079811275237000,2020,424415,0,424415,COST
06079811275237000,2019,424415,0,424415,COST
06079811275276500,2021,63464,0,63464,COST
06079811275276500,2020,62832,0,62832,COST
06079811275276500,2019,62832,0,62832,COST
06079811275310000,2021,482877,577210,1060087,COST
06079811275310000,2020,250052,561380,811432,COST
06079811275310000,2019,250052,613360,863412,COST
06079811275360000,2021,482872,338370,821242,COST
06079811275360000,2020,250050,321350,571400,COST
06079811275360000,2019,250050,321350,571400,COST
06079811280010000,2021,132697,214303,347000,MKT
06079811280010000,2020,84276,218924,303200,MKT
06079811280010000,2019,84276,215624,299900,MKT
06079811280030000,2021,134795,264805,399600,MKT
06079811280030000,2020,86898,264502,351400,MKT
06079811280030000,2019,86898,244702,331600,MKT
06079811280050000,2021,137609,281891,419500,MKT
06079811280050000,2020,90473,267327,357800,MKT
06079811280050000,2019,90473,267327,357800,MKT
06079811280070000,2021,135002,271798,406800,MKT
06079811280070000,2020,87158,272942,360100,MKT
06079811280070000,2019,87158,272942,360100,MKT
06079811282010000,2021,132206,237594,369800,MKT
06079811282010000,2020,83670,240330,324000,MKT
06079811282010000,2019,83670,238030,321700,MKT
06079811282030000,2021,125501,216199,341700,MKT
06079811282030000,2020,75587,227713,303300,MKT
06079811282030000,2019,75587,227713,303300,MKT
06079811282050000,2021,125501,229099,354600,MKT
06079811282050000,2020,75587,234113,309700,MKT
06079811282050000,2019,75587,234113,309700,MKT
06079811282070000,2021,125501,269299,394800,MKT
06079811282070000,2020,75587,260913,336500,MKT
06079811282070000,2019,75587,260913,336500,MKT
06079811282090000,2021,125501,279699,405200,MKT
06079811282090000,2020,75587,274913,350500,MKT
06079811282090000,2019,75587,274913,350500,MKT
06079811282110000,2021,124111,241189,365300,MKT
06079811282110000,2020,73961,251939,325900,MKT
06079811282110000,2019,73961,251939,325900,MKT
06079811282130000,2021,139396,232804,372200,MKT
06079811282130000,2020,92781,235519,328300,MKT
06079811282130000,2019,92781,235519,328300,MKT
06079811282150000,2021,131607,262693,394300,MKT
06079811282150000,2020,82931,254869,337800,MKT
06079811282150000,2019,82931,254869,337800,MKT
06079811282170000,2021,125501,269699,395200,MKT
06079811282170000,2020,75587,264313,339900,MKT
06079811282170000,2019,75587,264313,339900,MKT
06079811282190000,2021,125849,249051,374900,MKT
06079811282190000,2020,75996,244504,320500,MKT
06079811282190000,2019,75996,244504,320500,MKT
06079811282210000,2021,125539,259561,385100,MKT
06079811282210000,2020,75631,258069,333700,MKT
06079811282210000,2019,75631,258069,333700,MKT
06079811282230000,2021,162210,264190,426400,MKT
06079811282230000,2020,103550,270050,373600,MKT
06079811282230000,2019,103550,270050,373600,MKT
06079811282250000,2021,143933,202567,346500,MKT
06079811282250000,2020,82000,234100,316100,MKT
06079811282250000,2019,82000,234100,316100,MKT
06079811282270000,2021,142193,219407,361600,MKT
06079811282270000,2020,80077,229023,309100,MKT
06079811282270000,2019,80077,229023,309100,MKT
06079811282300000,2021,140999,256401,397400,MKT
06079811282300000,2020,78769,257031,335800,MKT
06079811282300000,2019,78769,257031,335800,MKT
06079811282320000,2021,146350,207050,353400,MKT
06079811282320000,2020,84709,234491,319200,MKT
06079811282320000,2019,84709,234491,319200,MKT
06079811282340000,2021,131584,264316,395900,MKT
06079811282340000,2020,82902,266698,349600,MKT
06079811282340000,2019,82902,266698,349600,MKT
06079811282360000,2021,126389,206211,332600,MKT
06079811282360000,2020,76634,214066,290700,MKT
06079811282360000,2019,76634,214066,290700,MKT
06079811282380000,2021,132623,229277,361900,MKT
06079811282380000,2020,84185,233915,318100,MKT
06079811282380000,2019,84185,233915,318100,MKT
06079811282400000,2021,132623,235577,368200,MKT
06079811282400000,2020,84185,249215,333400,MKT
06079811282400000,2019,84185,249215,333400,MKT
06079811282420000,2021,126347,211253,337600,MKT
06079811282420000,2020,76584,218416,295000,MKT
06079811282420000,2019,76584,218416,295000,MKT
06079811282440000,2021,150822,231478,382300,MKT
06079811282440000,2020,89835,229765,319600,MKT
06079811282440000,2019,89835,229765,319600,MKT
06079811282470000,2021,139472,231428,370900,MKT
06079811282470000,2020,77113,252587,329700,MKT
06079811282470000,2019,77113,252587,329700,MKT
06079811282490000,2021,133784,282116,415900,MKT
06079811282490000,2020,85630,271270,356900,MKT
06079811282490000,2019,85630,271270,356900,MKT
06079811282510000,2021,143658,228842,372500,MKT
06079811282510000,2020,81695,240805,322500,MKT
06079811282510000,2019,81695,240805,322500,MKT
06079811282530000,2021,143658,223042,366700,MKT
06079811282530000,2020,81695,229705,311400,MKT
06079811282530000,2019,81695,229705,311400,MKT
06079811282550000,2021,144378,228422,372800,MKT
06079811282550000,2020,103120,214880,318000,MKT
06079811282550000,2019,103120,214880,318000,MKT
06079811282570000,2021,144352,203448,347800,MKT
06079811282570000,2020,82467,215333,297800,MKT
06079811282570000,2019,82467,215333,297800,MKT
06079811282590000,2021,143558,206442,350000,MKT
06079811282590000,2020,81583,218017,299600,MKT
06079811282590000,2019,81583,218017,299600,MKT
06079811285015001,2021,122441,203659,326100,MKT
06079811285015001,2020,72032,221068,293100,MKT
06079811285015001,2019,72032,203668,275700,MKT
06079811285035002,2021,113969,203831,317800,MKT
06079811285035002,2020,62624,206476,269100,OVR
06079811285035002,2019,62624,206476,269100,MKT
06079811285055001,2021,112500,166400,278900,MKT
06079811285055001,2020,61059,186841,247900,MKT
06079811285055001,2019,61059,186841,247900,MKT
06079811285075002,2021,112500,166000,278500,MKT
06079811285075002,2020,61059,185841,246900,MKT
06079811285075002,2019,61059,185841,246900,MKT
06079811285095001,2021,112500,142900,255400,MKT
06079811285095001,2020,61059,158341,219400,MKT
06079811285095001,2019,61059,158341,219400,MKT
06079811285115002,2021,112500,155400,267900,MKT
06079811285115002,2020,61059,163241,224300,MKT
06079811285115002,2019,61059,163241,224300,MKT
06079811285135001,2021,112500,149000,261500,MKT
06079811285135001,2020,61059,160341,221400,MKT
06079811285135001,2019,61059,160341,221400,MKT
06079811285155002,2021,112500,144200,256700,MKT
06079811285155002,2020,61059,158041,219100,MKT
06079811285155002,2019,61059,158041,219100,MKT
06079811285175001,2021,112500,143400,255900,MKT
06079811285175001,2020,61059,157541,218600,MKT
06079811285175001,2019,61059,157541,218600,MKT
06079811285195002,2021,112500,148200,260700,MKT
06079811285195002,2020,61059,159841,220900,MKT
06079811285195002,2019,61059,159841,220900,MKT
06079811285215001,2021,112500,146900,259400,MKT
06079811285215001,2020,61059,158241,219300,MKT
06079811285215001,2019,61059,158241,219300,MKT
06079811285235002,2021,112500,143800,256300,MKT
06079811285235002,2020,61059,157641,218700,MKT
06079811285235002,2019,61059,157641,218700,MKT
06079811285255001,2021,112500,192800,305300,MKT
06079811285255001,2020,61059,208641,269700,MKT
06079811285255001,2019,61059,208641,269700,MKT
06079811285275002,2021,112500,192900,305400,MKT
06079811285275002,2020,61059,208741,269800,MKT
06079811285275002,2019,61059,208741,269800,MKT
06079811285346500,2021,40687,0,40687,COST
06079811285346500,2020,26384,0,26384,COST
06079811285346500,2019,26384,0,26384,COST
06079811285350000,2021,197622,402678,600300,INCOME
06079811285350000,2020,115201,424099,539300,INCOME
06079811285350000,2019,115201,424099,539300,INCOME
06079811285370000,2021,197622,402678,600300,INCOME
06079811285370000,2020,115201,424099,539300,INCOME
06079811285370000,2019,115201,424099,539300,INCOME
06079811285390000,2021,197622,402678,600300,INCOME
06079811285390000,2020,115201,424099,539300,INCOME
06079811285390000,2019,115201,424099,539300,INCOME
06079811285410000,2021,197622,402678,600300,INCOME
06079811285410000,2020,115201,424099,539300,INCOME
06079811285410000,2019,115201,424099,539300,INCOME
06079811285430000,2021,197622,402678,600300,INCOME
06079811285430000,2020,115201,424099,539300,INCOME
06079811285430000,2019,115201,424099,539300,INCOME
06079811285450000,2021,207613,392687,600300,INCOME
06079811285450000,2020,120237,419063,539300,INCOME
06079811285450000,2019,120237,419063,539300,INCOME
06079811287010000,2021,113636,202664,316300,MKT
06079811287010000,2020,70120,213280,283400,MKT
06079811287010000,2019,70120,213280,283400,MKT
06079811287030000,2021,114200,208900,323100,MKT
06079811287030000,2020,70800,204500,275300,MKT
06079811287030000,2019,70800,204500,275300,MKT
06079811287050000,2021,124890,216510,341400,MKT
06079811287050000,2020,85365,221335,306700,MKT
06079811287050000,2019,85365,221335,306700,MKT
06079811287070000,2021,148362,203338,351700,MKT
06079811287070000,2020,86997,214403,301400,MKT
06079811287070000,2019,86997,214403,301400,MKT
06079811287090000,2021,142616,292384,435000,MKT
06079811287090000,2020,80542,278558,359100,MKT
06079811287090000,2019,80542,278558,359100,MKT
06079811287110000,2021,128468,234732,363200,MKT
06079811287110000,2020,79114,233286,312400,MKT
06079811287110000,2019,79114,233286,312400,MKT
06079811287130000,2021,135716,216684,352400,MKT
06079811287130000,2020,110076,201324,311400,MKT
06079811287130000,2019,110076,201324,311400,MKT
06079811287160000,2021,135962,224838,360800,MKT
06079811287160000,2020,88372,218228,306600,MKT
06079811287160000,2019,88372,218228,306600,MKT
06079811287180000,2021,130027,237873,367900,MKT
06079811287180000,2020,80999,243301,324300,MKT
06079811287180000,2019,80999,243301,324300,MKT
06079811287200000,2021,138539,245261,383800,MKT
06079811287200000,2020,76109,248791,324900,MKT
06079811287200000,2019,76109,247091,323200,MKT
06079811287220000,2021,140500,231600,372100,MKT
06079811287220000,2020,78227,246473,324700,MKT
06079811287220000,2019,78227,246473,324700,MKT
06079811287240000,2021,142573,236227,378800,MKT
06079811287240000,2020,80495,235405,315900,MKT
06079811287240000,2019,80495,235405,315900,MKT
06079811287260000,2021,130168,236632,366800,MKT
06079811287260000,2020,81171,239729,320900,MKT
06079811287260000,2019,81171,239729,320900,MKT
06079811287280000,2021,136412,212188,348600,MKT
06079811287280000,2020,88944,218656,307600,MKT
06079811287280000,2019,88944,218656,307600,MKT
06079811287300000,2021,132692,227308,360000,MKT
06079811287300000,2020,84271,229129,313400,MKT
06079811287300000,2019,84271,229129,313400,MKT
06079811287320000,2021,129182,222818,352000,MKT
06079811287320000,2020,79975,230425,310400,MKT
06079811287320000,2019,79975,230425,310400,MKT
06079811287340000,2021,150655,288945,439600,MKT
06079811287340000,2020,89641,279159,368800,MKT
06079811287340000,2019,89641,279159,368800,MKT
06079811287356500,2021,81767,0,81767,COST
06079811287356500,2020,103035,0,103035,COST
06079811287356500,2019,103035,0,103035,COST
06079811287370000,2021,145646,212154,357800,MKT
06079811287370000,2020,83916,227784,311700,MKT
06079811287370000,2019,83916,227784,311700,MKT
06079811287390000,2021,141866,211534,353400,MKT
06079811287390000,2020,79717,222583,302300,MKT
06079811287390000,2019,79717,222583,302300,MKT
06079811287415001,2021,118184,152216,270400,MKT
06079811287415001,2020,67224,166976,234200,MKT
06079811287415001,2019,67224,166976,234200,MKT
06079811287435002,2021,107339,152261,259600,MKT
06079811287435002,2020,55711,166989,222700,MKT
06079811287435002,2019,55711,166989,222700,MKT
06079811287455001,2021,131491,192309,323800,MKT
06079811287455001,2020,68735,209065,277800,MKT
06079811287455001,2019,68735,209065,277800,MKT
06079811287475002,2021,129016,192184,321200,MKT
06079811287475002,2020,66232,213868,280100,MKT
06079811287475002,2019,66232,213868,280100,MKT
06079811287495001,2021,126342,188458,314800,MKT
06079811287495001,2020,63579,206721,270300,OVR
06079811287495001,2019,63579,206721,270300,MKT
06079811287515002,2021,123622,188478,312100,MKT
06079811287515002,2020,60935,207865,268800,MKT
06079811287515002,2019,60935,207865,268800,MKT
06079811287535001,2021,124282,188318,312600,MKT
06079811287535001,2020,61572,207728,269300,MKT
06079811287535001,2019,61572,207728,269300,MKT
06079811287555002,2021,123430,188370,311800,MKT
06079811287555002,2020,60750,207750,268500,MKT
06079811287555002,2019,60750,207750,268500,MKT
06079811287575001,2021,118499,208801,327300,MKT
06079811287575001,2020,56103,229697,285800,MKT
06079811287575001,2019,56103,229697,285800,MKT
06079811287585002,2021,113730,210170,323900,MKT
06079811287585002,2020,51780,228120,279900,MKT
06079811287585002,2019,51780,228120,279900,MKT
06079811287595003,2021,118490,210910,329400,MKT
06079811287595003,2020,56095,226105,282200,MKT
06079811287595003,2019,56095,226105,282200,MKT
06079811287600000,2021,161345,247355,408700,INCOME
06079811287600000,2020,96616,268684,365300,INCOME
06079811287600000,2019,96616,268684,365300,INCOME
06079811289015001,2021,110382,160418,270800,MKT
06079811289015001,2020,66254,171746,238000,MKT
06079811289015001,2019,66254,171746,238000,MKT
06079811289035002,2021,117680,158920,276600,MKT
06079811289035002,2020,66666,169734,236400,MKT
06079811289035002,2019,66666,169734,236400,MKT
06079811289055001,2021,116891,186409,303300,MKT
06079811289055001,2020,65796,207604,273400,MKT
06079811289055001,2019,65796,207604,273400,MKT
06079811289075002,2021,116891,186509,303400,MKT
06079811289075002,2020,65796,207704,273500,MKT
06079811289075002,2019,65796,207704,273500,MKT
06079811289095001,2021,117164,178736,295900,MKT
06079811289095001,2020,66097,198503,264600,MKT
06079811289095001,2019,66097,198503,264600,MKT
06079811289115002,2021,117164,178736,295900,MKT
06079811289115002,2020,66097,198503,264600,MKT
06079811289115002,2019,66097,198503,264600,MKT
06079811289135001,2021,117164,180236,297400,MKT
06079811289135001,2020,66097,200103,266200,MKT
06079811289135001,2019,66097,200103,266200,MKT
06079811289155002,2021,117164,180236,297400,MKT
06079811289155002,2020,66097,200103,266200,MKT
06079811289155002,2019,66097,200103,266200,MKT
06079811289175001,2021,116006,171294,287300,MKT
06079811289175001,2020,64828,185172,250000,MKT
06079811289175001,2019,64828,185172,250000,MKT
06079811289195002,2021,115906,182494,298400,MKT
06079811289195002,2020,64718,203482,268200,MKT
06079811289195002,2019,64718,203482,268200,MKT
06079811289215001,2021,113885,152015,265900,MKT
06079811289215001,2020,62534,166866,229400,MKT
06079811289215001,2019,62534,166866,229400,MKT
06079811289235002,2021,111856,152044,263900,MKT
06079811289235002,2020,60378,166822,227200,MKT
06079811289235002,2019,60378,166822,227200,MKT
06079811289255001,2021,109728,152072,261800,MKT
06079811289255001,2020,58156,169444,227600,MKT
06079811289255001,2019,58156,169444,227600,MKT
06079811289275002,2021,107628,152072,259700,MKT
06079811289275002,2020,56003,169497,225500,MKT
06079811289275002,2019,56003,169497,225500,MKT
06079811289295001,2021,106798,188602,295400,MKT
06079811289295001,2020,55164,207236,262400,OVR
06079811289295001,2019,55164,207236,262400,MKT
06079811289315002,2021,117067,188433,305500,MKT
06079811289315002,2020,65989,201611,267600,MKT
06079811289315002,2019,65989,201611,267600,MKT
06079811301230000,2021,148082,339418,487500,MKT
06079811301230000,2020,104400,316900,421300,OVR
06079811301230000,2019,104400,316900,421300,MKT
06079811301247000,2021,193815,2710,196525,COST
06079811301247000,2020,176540,3200,179740,COST
06079811301247000,2019,176540,3200,179740,COST
06079811301250000,2021,131170,210830,342000,MKT
06079811301250000,2020,103968,180332,284300,MKT
06079811301250000,2019,103968,180332,284300,MKT
06079811301260000,2021,271536,229264,500800,MKT
06079811301260000,2020,340936,145130,486066,COST
06079811301260000,2019,340936,145130,486066,COST
