id,year,land,building,total,method
06079918101200000,2021,424508,569410,993918,COST
06079918101200000,2020,303959,544360,848319,COST
06079918101200000,2019,303959,544360,848319,COST
06079918101250000,2021,322665,0,322665,COST
06079918101250000,2020,231935,0,231935,COST
06079918101250000,2019,231935,0,231935,COST
06079918101300000,2021,4609,515080,519689,COST
06079918101300000,2020,4988,499020,504008,COST
06079918101300000,2019,4988,499020,504008,COST
06079918101350000,2021,226710,149340,376050,COST
06079918101350000,2020,163777,144220,307997,COST
06079918101350000,2019,163777,144220,307997,COST
06079918101400000,2021,932775,1547025,2479800,INCOME
06079918101400000,2020,687890,1712510,2400400,INCOME
06079918101400000,2019,672728,1727672,2400400,INCOME
06079918101450000,2021,1413039,334880,1747919,COST
06079918101450000,2020,1033447,327850,1361297,COST
06079918101450000,2019,1031550,327850,1359400,COST
06079918101500000,2021,413129,0,413129,COST
06079918101500000,2020,295926,0,295926,COST
06079918101500000,2019,295926,0,295926,COST
06079918101550000,2021,303058,41030,344088,COST
06079918101550000,2020,218034,40030,258064,COST
06079918101550000,2019,218034,42160,260194,COST
06079918101600000,2021,914485,0,914485,COST
06079918101600000,2020,390279,0,390279,COST
06079918101600000,2019,390279,0,390279,COST
06079918103010000,2021,221355,0,221355,COST
06079918103010000,2020,157262,0,157262,COST
06079918103010000,2019,157262,0,157262,COST
06079918120050000,2021,131674,318826,450500,MKT
06079918120050000,2020,99338,272262,371600,MKT
06079918120050000,2019,99338,272262,371600,MKT
06079918120107000,2021,229592,0,229592,COST
06079918120107000,2020,171852,0,171852,COST
06079918120107000,2019,171852,0,171852,COST
06079918120150000,2021,290523,106977,397500,MKT
06079918120150000,2020,216737,86970,303707,COST
06079918120150000,2019,216737,86970,303707,COST
06079918120250000,2021,229592,221508,451100,MKT
06079918120250000,2020,171852,220348,392200,MKT
06079918120250000,2019,171852,186148,358000,MKT
06079918120300000,2021,248696,0,248696,COST
06079918120300000,2020,185942,0,185942,COST
06079918120300000,2019,185942,0,185942,COST
06079918120350000,2021,229592,294600,524192,COST
06079918120350000,2020,171852,290480,462332,COST
06079918120350000,2019,171852,290480,462332,COST
06079918120400000,2021,104696,341304,446000,MKT
06079918120400000,2020,79241,271259,350500,MKT
06079918120400000,2019,79241,271259,350500,MKT
06079918120450000,2021,245217,336583,581800,INCOME
06079918120450000,2020,169348,363252,532600,INCOME
06079918120450000,2019,169348,363252,532600,INCOME
06079918131016500,2021,74789,0,74789,COST
06079918131016500,2020,53956,0,53956,COST
06079918131016500,2019,53956,0,53956,COST
06079918140010000,2021,4104770,32328660,36433430,COST
06079918140010000,2020,1696758,31071790,32768548,COST
06079918140010000,2019,1696758,31071790,32768548,COST
06079918140036500,2021,35361,0,35361,COST
06079918140036500,2020,25783,0,25783,COST
06079918140036500,2019,25783,0,25783,COST
06079918141010000,2021,132428,490272,622700,MKT
06079918141010000,2020,99898,451002,550900,MKT
06079918141010000,2019,99898,451002,550900,MKT
06079918141030000,2021,127703,492197,619900,MKT
06079918141030000,2020,96383,451017,547400,MKT
06079918141030000,2019,96383,451017,547400,MKT
06079918141050000,2021,127379,587021,714400,MKT
06079918141050000,2020,96142,599358,695500,MKT
06079918141050000,2019,96142,599358,695500,MKT
06079918141070000,2021,127703,549997,677700,MKT
06079918141070000,2020,96383,501917,598300,MKT
06079918141070000,2019,96383,0,96383,COST
06079918141090000,2021,124959,421241,546200,MKT
06079918141090000,2020,94341,397259,491600,MKT
06079918141090000,2019,94341,397259,491600,MKT
06079918141110000,2021,122399,596201,718600,MKT
06079918141110000,2020,92436,528864,621300,MKT
06079918141110000,2019,92436,528864,621300,MKT
06079918141130000,2021,122399,552701,675100,MKT
06079918141130000,2020,92436,498264,590700,MKT
06079918141130000,2019,92436,498264,590700,MKT
06079918141150000,2021,122399,494001,616400,MKT
06079918141150000,2020,92436,453664,546100,MKT
06079918141150000,2019,92436,453664,546100,MKT
06079918141170000,2021,122399,562701,685100,MKT
06079918141170000,2020,92436,498164,590600,MKT
06079918141170000,2019,92436,498164,590600,MKT
06079918141190000,2021,122399,572801,695200,MKT
06079918141190000,2020,92436,514364,606800,MKT
06079918141190000,2019,92436,514364,606800,MKT
06079918141210000,2021,122399,500001,622400,MKT
06079918141210000,2020,92436,459964,552400,MKT
06079918141210000,2019,92436,459964,552400,MKT
06079918141230000,2021,122399,481501,603900,MKT
06079918141230000,2020,92436,450964,543400,MKT
06079918141230000,2019,92436,450964,543400,MKT
06079918141250000,2021,122399,558201,680600,MKT
06079918141250000,2020,92436,506664,599100,MKT
06079918141250000,2019,92436,506664,599100,MKT
06079918141270000,2021,122399,555701,678100,MKT
06079918141270000,2020,92436,512464,604900,MKT
06079918141270000,2019,92436,512464,604900,MKT
06079918141290000,2021,131960,503740,635700,MKT
06079918141290000,2020,99550,459450,559000,MKT
06079918141290000,2019,99550,459450,559000,MKT
06079918141316500,2021,181532,0,181532,COST
06079918141316500,2020,129332,0,129332,COST
06079918141316500,2019,129332,0,129332,COST
06079918142016500,2021,125810,0,125810,COST
06079918142016500,2020,90099,0,90099,COST
06079918142016500,2019,90099,0,90099,COST
06079918142030000,2021,120070,530030,650100,MKT
06079918142030000,2020,87522,468478,556000,MKT
06079918142030000,2019,87522,468478,556000,MKT
06079918142050000,2021,103728,495872,599600,MKT
06079918142050000,2020,75767,456433,532200,MKT
06079918142050000,2019,75767,456433,532200,MKT
06079918142070000,2021,103728,467172,570900,MKT
06079918142070000,2020,75767,428533,504300,MKT
06079918142070000,2019,75767,331860,407627,COST
06079918142090000,2021,103728,477572,581300,MKT
06079918142090000,2020,75767,438833,514600,MKT
06079918142090000,2019,75767,438833,514600,MKT
06079918142110000,2021,111830,481570,593400,MKT
06079918142110000,2020,81598,448802,530400,MKT
06079918142110000,2019,81598,448802,530400,MKT
06079918142130000,2021,103728,508872,612600,MKT
06079918142130000,2020,75767,468433,544200,MKT
06079918142130000,2019,75767,468433,544200,MKT
06079918142150000,2021,103728,409072,512800,MKT
06079918142150000,2020,75767,391933,467700,MKT
06079918142150000,2019,75767,391933,467700,MKT
06079918142170000,2021,103728,413272,517000,MKT
06079918142170000,2020,75767,393433,469200,MKT
06079918142170000,2019,75767,393433,469200,MKT
06079918142190000,2021,111830,535570,647400,MKT
06079918142190000,2020,81598,478802,560400,MKT
06079918142190000,2019,81598,478802,560400,MKT
06079918142210000,2021,103770,502930,606700,MKT
06079918142210000,2020,75797,462603,538400,MKT
06079918142210000,2019,75797,462603,538400,MKT
06079918142230000,2021,106760,555340,662100,MKT
06079918142230000,2020,77950,491150,569100,MKT
06079918142230000,2019,77950,491150,569100,MKT
06079918142250000,2021,108223,554077,662300,MKT
06079918142250000,2020,79003,486597,565600,MKT
06079918142250000,2019,79003,486597,565600,MKT
06079918142270000,2021,111830,613170,725000,MKT
06079918142270000,2020,81598,526902,608500,MKT
06079918142270000,2019,81598,526902,608500,MKT
06079918142290000,2021,103728,582072,685800,MKT
06079918142290000,2020,75767,531730,607497,COST
06079918142290000,2019,75767,531730,607497,COST
06079918142310000,2021,103728,0,103728,COST
06079918142310000,2020,75767,0,75767,COST
06079918142310000,2019,75767,0,75767,COST
06079918142330000,2021,103728,542672,646400,MKT
06079918142330000,2020,75767,499833,575600,MKT
06079918142330000,2019,75767,304380,380147,COST
06079918142350000,2021,103728,576272,680000,MKT
06079918142350000,2020,75767,505633,581400,MKT
06079918142350000,2019,75767,504633,580400,MKT
06079918142370000,2021,111830,506570,618400,MKT
06079918142370000,2020,81598,457402,539000,MKT
06079918142370000,2019,81598,457402,539000,MKT
06079918143010000,2021,115659,421841,537500,MKT
06079918143010000,2020,84352,400448,484800,MKT
06079918143010000,2019,84352,400448,484800,MKT
06079918143030000,2021,107177,538223,645400,MKT
06079918143030000,2020,78250,478950,557200,MKT
06079918143030000,2019,78250,478950,557200,MKT
06079918143050000,2021,107754,532846,640600,MKT
06079918143050000,2020,78665,471235,549900,MKT
06079918143050000,2019,78665,471235,549900,MKT
06079918143070000,2021,106219,664281,770500,MKT
06079918143070000,2020,77560,247540,325100,COST
06079918143070000,2019,77560,0,77560,COST
06079918143090000,2021,99417,590583,690000,MKT
06079918143090000,2020,72661,336510,409171,COST
06079918143090000,2019,72661,0,72661,COST
06079918143110000,2021,103728,590472,694200,MKT
06079918143110000,2020,75767,276260,352027,COST
06079918143110000,2019,75767,0,75767,COST
06079918143130000,2021,115696,686004,801700,MKT
06079918143130000,2020,84379,693780,778159,COST
06079918143130000,2019,84379,0,84379,COST
06079918144010000,2021,288030,0,288030,COST
06079918144010000,2020,207372,0,207372,COST
06079918144010000,2019,207372,0,207372,COST
06079918144100000,2021,233418,0,233418,COST
06079918144100000,2020,168553,0,168553,COST
06079918144100000,2019,168553,0,168553,COST
06079918144150000,2021,553812,0,553812,COST
06079918144150000,2020,395056,0,395056,COST
06079918144150000,2019,395056,0,395056,COST
06079918145010000,2021,114143,615957,730100,MKT
06079918145010000,2020,83262,608738,692000,MKT
06079918145010000,2019,83262,608738,692000,MKT
06079918145030000,2021,103305,490695,594000,MKT
06079918145030000,2020,75463,456037,531500,MKT
06079918145030000,2019,75463,456037,531500,MKT
06079918145050000,2021,103305,489095,592400,MKT
06079918145050000,2020,75463,452837,528300,MKT
06079918145050000,2019,75463,452837,528300,MKT
06079918145070000,2021,121522,556478,678000,MKT
06079918145070000,2020,88566,488534,577100,MKT
06079918145070000,2019,88566,394770,483336,COST
06079918145090000,2021,121522,886080,1007602,COST
06079918145090000,2020,88566,862340,950906,COST
06079918145090000,2019,88566,708710,797276,COST
06079918145110000,2021,94899,421201,516100,MKT
06079918145110000,2020,69405,378395,447800,MKT
06079918145110000,2019,69405,378395,447800,MKT
06079918145130000,2021,101164,465536,566700,MKT
06079918145130000,2020,73921,420979,494900,MKT
06079918145130000,2019,73921,420979,494900,MKT
06079918145150000,2021,94899,423901,518800,MKT
06079918145150000,2020,69405,381895,451300,MKT
06079918145150000,2019,69405,381895,451300,MKT
06079918145170000,2021,94899,419301,514200,MKT
06079918145170000,2020,69405,393695,463100,MKT
06079918145170000,2019,69405,393695,463100,MKT
06079918145190000,2021,101078,475522,576600,MKT
06079918145190000,2020,73858,428842,502700,MKT
06079918145190000,2019,73858,428842,502700,MKT
06079918145210000,2021,94899,426201,521100,MKT
06079918145210000,2020,69405,382395,451800,MKT
06079918145210000,2019,69405,382395,451800,MKT
06079918145230000,2021,103728,487772,591500,MKT
06079918145230000,2020,75767,449033,524800,MKT
06079918145230000,2019,75767,449033,524800,MKT
06079918145250000,2021,94899,430101,525000,MKT
06079918145250000,2020,69405,387695,457100,MKT
06079918145250000,2019,69405,387695,457100,MKT
06079918145270000,2021,94899,422301,517200,MKT
06079918145270000,2020,69405,378495,447900,MKT
06079918145270000,2019,69405,378495,447900,MKT
06079918145290000,2021,94899,422301,517200,MKT
06079918145290000,2020,69405,378595,448000,MKT
06079918145290000,2019,69405,378595,448000,MKT
06079918145310000,2021,103728,478772,582500,MKT
06079918145310000,2020,75767,453133,528900,MKT
06079918145310000,2019,75767,453133,528900,MKT
06079918145330000,2021,117079,617121,734200,MKT
06079918145330000,2020,85373,568327,653700,MKT
06079918145330000,2019,85373,568327,653700,MKT
06079918145350000,2021,117893,544607,662500,MKT
06079918145350000,2020,85958,479542,565500,MKT
06079918145350000,2019,85958,479542,565500,MKT
06079918145370000,2021,103305,475795,579100,MKT
06079918145370000,2020,75463,439937,515400,MKT
06079918145370000,2019,75463,439937,515400,MKT
06079918145390000,2021,103305,491295,594600,MKT
06079918145390000,2020,75463,453037,528500,MKT
06079918145390000,2019,75463,453037,528500,MKT
06079918145410000,2021,114143,804950,919093,COST
06079918145410000,2020,83262,794500,877762,COST
06079918145410000,2019,83262,794500,877762,COST
06079918145430000,2021,119884,444616,564500,MKT
06079918145430000,2020,90563,417237,507800,MKT
06079918145430000,2019,90563,417237,507800,MKT
06079918145450000,2021,111981,432419,544400,MKT
06079918145450000,2020,84675,406625,491300,MKT
06079918145450000,2019,84675,406625,491300,MKT
06079918145470000,2021,111981,433819,545800,MKT
06079918145470000,2020,84675,391925,476600,MKT
06079918145470000,2019,84675,391925,476600,MKT
06079918145490000,2021,111981,435019,547000,MKT
06079918145490000,2020,84675,393525,478200,MKT
06079918145490000,2019,84675,393525,478200,MKT
06079918145510000,2021,124861,493639,618500,MKT
06079918145510000,2020,94269,452131,546400,MKT
06079918145510000,2019,94269,452131,546400,MKT
06079918145530000,2021,111981,593619,705600,MKT
06079918145530000,2020,84675,546525,631200,MKT
06079918145530000,2019,84675,546525,631200,MKT
06079918145550000,2021,111981,587219,699200,MKT
06079918145550000,2020,84675,540525,625200,MKT
06079918145550000,2019,84675,540525,625200,MKT
06079918145570000,2021,111981,601219,713200,MKT
06079918145570000,2020,84675,519025,603700,MKT
06079918145570000,2019,84675,519025,603700,MKT
06079918145590000,2021,111981,596119,708100,MKT
06079918145590000,2020,84675,568150,652825,COST
06079918145590000,2019,84675,540925,625600,MKT
06079918145610000,2021,111981,577819,689800,MKT
06079918145610000,2020,84675,541030,625705,COST
06079918145610000,2019,84675,541030,625705,COST
06079918145630000,2021,124861,539439,664300,MKT
06079918145630000,2020,94269,470431,564700,MKT
06079918145630000,2019,94269,470431,564700,MKT
06079918145650000,2021,111981,419819,531800,MKT
06079918145650000,2020,84675,397525,482200,MKT
06079918145650000,2019,84675,397525,482200,MKT
06079918145670000,2021,111981,405819,517800,MKT
06079918145670000,2020,84675,384825,469500,MKT
06079918145670000,2019,84675,384825,469500,MKT
06079918145690000,2021,111981,425219,537200,MKT
06079918145690000,2020,84675,382925,467600,MKT
06079918145690000,2019,84675,382925,467600,MKT
06079918145710000,2021,119884,422816,542700,MKT
06079918145710000,2020,90563,398337,488900,MKT
06079918145710000,2019,90563,398337,488900,MKT
06079918158020000,2021,930226,0,930226,COST
06079918158020000,2020,658718,0,658718,COST
06079918158020000,2019,658718,0,658718,COST
06079918190010000,2021,165850,242850,408700,MKT
06079918190010000,2020,120342,223558,343900,MKT
06079918190010000,2019,120342,223558,343900,MKT
06079918190030000,2021,186810,224190,411000,MKT
06079918190030000,2020,135323,224477,359800,MKT
06079918190030000,2019,135323,224477,359800,MKT
06079918190050000,2021,167985,235515,403500,MKT
06079918190050000,2020,121869,240131,362000,MKT
06079918190050000,2019,121869,240131,362000,MKT
06079918190060000,2021,218826,243274,462100,MKT
06079918190060000,2020,158160,253540,411700,MKT
06079918190060000,2019,158160,253540,411700,MKT
06079918190070000,2021,131788,0,131788,COST
06079918190070000,2020,95938,0,95938,COST
06079918190070000,2019,95938,0,95938,COST
06079918190090000,2021,156497,327303,483800,MKT
06079918190090000,2020,113649,297151,410800,MKT
06079918190090000,2019,113649,297151,410800,MKT
06079918190110000,2021,160449,277051,437500,MKT
06079918190110000,2020,116478,269622,386100,MKT
06079918190110000,2019,116478,269622,386100,MKT
06079918190120000,2021,294587,42410,336997,COST
06079918190120000,2020,212025,41600,253625,COST
06079918190120000,2019,212025,41600,253625,COST
06079918190130000,2021,279438,210140,489578,COST
06079918190130000,2020,201272,203790,405062,COST
06079918190130000,2019,201272,203790,405062,COST
06079918190130900,2021,397298,2770,400068,COST
06079918190130900,2020,279238,2730,281968,COST
06079918190130900,2019,279238,2730,281968,COST
06079918190180000,2021,353243,268360,621603,COST
06079918190180000,2020,248687,259940,508627,COST
06079918190180000,2019,248687,259940,508627,COST
06079918201010000,2021,488525,368120,856645,COST
06079918201010000,2020,335159,292890,628049,COST
06079918201010000,2019,335159,292890,628049,COST
06079918201040000,2021,309654,0,309654,COST
06079918201040000,2020,266681,0,266681,COST
06079918201040000,2019,266681,0,266681,COST
06079918201080000,2021,309654,185046,494700,MKT
06079918201080000,2020,266681,182119,448800,MKT
06079918201080000,2019,266681,182119,448800,MKT
06079918201120000,2021,452544,278070,730614,COST
06079918201120000,2020,322549,226351,548900,MKT
06079918201120000,2019,322549,120300,442849,COST
06079918201140000,2021,285116,199984,485100,MKT
06079918201140000,2020,255870,146830,402700,OVR
06079918201140000,2019,255870,146830,402700,MKT
06079918201160000,2021,332680,248120,580800,MKT
06079918201160000,2020,276444,197356,473800,MKT
06079918201160000,2019,276444,197356,473800,MKT
06079918201170000,2021,256152,270848,527000,MKT
06079918201170000,2020,242492,206208,448700,MKT
06079918201170000,2019,242492,206208,448700,MKT
06079918201190000,2021,301700,302500,604200,COST
06079918201190000,2020,263225,283775,547000,MKT
06079918201190000,2019,263225,273675,536900,MKT
06079918201230000,2021,469962,160438,630400,MKT
06079918201230000,2020,328713,165587,494300,MKT
06079918201230000,2019,328713,165587,494300,MKT
06079918201240000,2021,224022,0,224022,COST
06079918201240000,2020,226736,0,226736,COST
06079918201240000,2019,226736,0,226736,COST
06079918201270000,2021,386607,181693,568300,MKT
06079918201270000,2020,298066,201234,499300,MKT
06079918201270000,2019,298066,201234,499300,MKT
06079918201290000,2021,338795,300105,638900,MKT
06079918201290000,2020,278980,238820,517800,MKT
06079918201290000,2019,278980,238820,517800,MKT
06079918201320000,2021,457502,79398,536900,INCOME
06079918201320000,2020,322232,133768,456000,INCOME
06079918201320000,2019,322232,133768,456000,INCOME
06079918202010000,2021,482477,314723,797200,INCOME
06079918202010000,2020,330184,414516,744700,INCOME
06079918202010000,2019,319508,356992,676500,INCOME
06079918202050000,2021,78156,0,78156,COST
06079918202050000,2020,24339,0,24339,COST
06079918202050000,2019,24339,0,24339,COST
06079918202080000,2021,443624,168176,611800,MKT
06079918202080000,2020,319346,175454,494800,MKT
06079918202080000,2019,319346,175454,494800,MKT
06079918202120000,2021,448614,326986,775600,INCOME
06079918202120000,2020,319346,433554,752900,INCOME
06079918202120000,2019,319346,433554,752900,INCOME
06079918202140000,2021,303551,249349,552900,MKT
06079918202140000,2020,264033,190267,454300,OVR
06079918202140000,2019,264033,190267,454300,MKT
06079918202160000,2021,303551,283149,586700,MKT
06079918202160000,2020,264033,205267,469300,MKT
06079918202160000,2019,264033,205267,469300,MKT
06079918202170000,2021,284597,167003,451600,MKT
06079918202170000,2020,255636,138664,394300,MKT
06079918202170000,2019,255636,138664,394300,MKT
06079918202200000,2021,321573,250327,571900,MKT
06079918202200000,2020,271778,202822,474600,MKT
06079918202200000,2019,271778,202822,474600,MKT
06079918202240000,2021,443624,248440,692064,COST
06079918202240000,2020,319346,200154,519500,MKT
06079918202240000,2019,319346,200154,519500,MKT
06079918202270000,2021,344488,225512,570000,MKT
06079918202270000,2020,281320,164480,445800,MKT
06079918202270000,2019,281320,164480,445800,MKT
06079918202290000,2021,344488,225712,570200,MKT
06079918202290000,2020,281320,194780,476100,OVR
06079918202290000,2019,281320,194780,476100,MKT
06079918202320000,2021,311731,237869,549600,MKT
06079918202320000,2020,267577,195423,463000,MKT
06079918202320000,2019,267577,195423,463000,MKT
06079918202350000,2021,257565,354235,611800,MKT
06079918202350000,2020,243162,285938,529100,MKT
06079918202350000,2019,243162,260838,504000,MKT
06079918203010000,2021,371862,203938,575800,MKT
06079918203010000,2020,292312,152288,444600,MKT
06079918203010000,2019,292312,152288,444600,MKT
06079918203030000,2021,285738,321070,606808,COST
06079918203030000,2020,256149,274451,530600,OVR
06079918203030000,2019,256149,274451,530600,MKT
06079918203030100,2021,51437,0,51437,COST
06079918203030100,2020,150536,0,150536,COST
06079918203030100,2019,150536,0,150536,COST
06079918204050000,2021,593896,218200,812096,COST
06079918204050000,2020,347667,174633,522300,MKT
06079918204050000,2019,347667,174633,522300,MKT
06079918204150000,2021,450976,149624,600600,INCOME
06079918204150000,2020,320116,261284,581400,INCOME
06079918204150000,2019,320116,261284,581400,INCOME
06079918204160000,2021,156442,0,156442,COST
06079918204160000,2020,189238,0,189238,COST
06079918204160000,2019,189238,0,189238,COST
06079918205010000,2021,119358,294242,413600,MKT
06079918205010000,2020,87011,264089,351100,MKT
06079918205010000,2019,87011,264089,351100,MKT
06079918205020000,2021,227145,297255,524400,MKT
06079918205020000,2020,170047,251853,421900,MKT
06079918205020000,2019,170047,251853,421900,MKT
06079918205030000,2021,182265,293235,475500,MKT
06079918205030000,2020,136874,260626,397500,MKT
06079918205030000,2019,136874,260626,397500,MKT
06079918205060000,2021,204902,345598,550500,MKT
06079918205060000,2020,153619,294081,447700,MKT
06079918205060000,2019,153619,294081,447700,MKT
06079918206030000,2021,127781,422919,550700,MKT
06079918206030000,2020,93062,333538,426600,MKT
06079918206030000,2019,93062,333538,426600,MKT
06079918206040000,2021,197519,292981,490500,MKT
06079918206040000,2020,148160,246540,394700,MKT
06079918206040000,2019,148160,246540,394700,MKT
06079918206050000,2021,197519,328681,526200,MKT
06079918206050000,2020,148160,292440,440600,MKT
06079918206050000,2019,148160,292440,440600,MKT
06079918206060000,2021,197519,328981,526500,MKT
06079918206060000,2020,148160,280840,429000,MKT
06079918206060000,2019,148160,280840,429000,MKT
06079918206070000,2021,194482,254618,449100,MKT
06079918206070000,2020,145915,271185,417100,MKT
06079918206070000,2019,145915,271185,417100,MKT
06079918206080000,2021,200506,486694,687200,MKT
06079918206080000,2020,150369,386531,536900,MKT
06079918206080000,2019,150369,386531,536900,MKT
06079918206090000,2021,197519,285581,483100,MKT
06079918206090000,2020,148160,265540,413700,MKT
06079918206090000,2019,148160,265540,413700,MKT
06079918206100000,2021,197519,273181,470700,MKT
06079918206100000,2020,148160,231340,379500,MKT
06079918206100000,2019,148160,231340,379500,MKT
06079918206110000,2021,197519,334681,532200,MKT
06079918206110000,2020,148160,305140,453300,MKT
06079918206110000,2019,148160,305140,453300,MKT
06079918206120000,2021,119358,319242,438600,MKT
06079918206120000,2020,87011,255589,342600,MKT
06079918206120000,2019,87011,255589,342600,MKT
06079918206130000,2021,119358,316342,435700,MKT
06079918206130000,2020,87011,302489,389500,MKT
06079918206130000,2019,87011,302489,389500,MKT
06079918206150000,2021,180685,346015,526700,MKT
06079918206150000,2020,135704,283196,418900,MKT
06079918206150000,2019,135704,283196,418900,MKT
06079918206240000,2021,148363,347837,496200,MKT
06079918206240000,2020,111739,328561,440300,MKT
06079918206240000,2019,111739,328561,440300,MKT
06079918207010000,2021,164372,286928,451300,MKT
06079918207010000,2020,123617,272783,396400,MKT
06079918207010000,2019,123617,272783,396400,MKT
06079918207020000,2021,165681,297219,462900,MKT
06079918207020000,2020,124588,303012,427600,MKT
06079918207020000,2019,124588,303012,427600,MKT
06079918207030000,2021,166332,346768,513100,MKT
06079918207030000,2020,125070,293830,418900,MKT
06079918207030000,2019,125070,293830,418900,MKT
06079918207040000,2021,166980,412620,579600,MKT
06079918207040000,2020,125550,376850,502400,MKT
06079918207040000,2019,125550,376850,502400,MKT
06079918207050000,2021,167625,413575,581200,MKT
06079918207050000,2020,126029,382371,508400,MKT
06079918207050000,2019,126029,382371,508400,MKT
06079918207060000,2021,168268,357432,525700,MKT
06079918207060000,2020,126505,303095,429600,OVR
06079918207060000,2019,126505,303095,429600,MKT
06079918207070000,2021,168908,387392,556300,MKT
06079918207070000,2020,126979,329721,456700,MKT
06079918207070000,2019,126979,329721,456700,MKT
06079918207080000,2021,168908,321792,490700,MKT
06079918207080000,2020,126979,281621,408600,MKT
06079918207080000,2019,126979,281621,408600,MKT
06079918210010000,2021,256152,232248,488400,MKT
06079918210010000,2020,242492,173208,415700,MKT
06079918210010000,2019,242492,173208,415700,MKT
06079918210040000,2021,284597,243203,527800,MKT
06079918210040000,2020,255636,226464,482100,MKT
06079918210040000,2019,255636,226464,482100,MKT
06079918210050000,2021,298594,247806,546400,MKT
06079918210050000,2020,261863,192137,454000,OVR
06079918210050000,2019,261863,192137,454000,MKT
06079918210080000,2021,386607,352910,739517,COST
06079918210080000,2020,298066,293650,591716,COST
06079918210080000,2019,298066,293650,591716,COST
06079918210100000,2021,309654,353146,662800,MKT
06079918210100000,2020,266681,257819,524500,MKT
06079918210100000,2019,266681,257819,524500,MKT
06079918210120000,2021,309654,255846,565500,MKT
06079918210120000,2020,266681,182119,448800,MKT
06079918210120000,2019,266681,182119,448800,MKT
06079918210150000,2021,294200,211500,505700,MKT
06079918210150000,2020,259925,147975,407900,MKT
06079918210150000,2019,259925,147975,407900,MKT
06079918210160000,2021,264536,426364,690900,MKT
06079918210160000,2020,246439,311961,558400,OVR
06079918210160000,2019,246439,311961,558400,MKT
06079918210180000,2021,408758,183042,591800,MKT
06079918210180000,2020,306508,148092,454600,MKT
06079918210180000,2019,306508,140792,447300,MKT
06079918210220000,2021,478474,321470,799944,COST
06079918210220000,2020,331684,260270,591954,COST
06079918210220000,2019,331684,260270,591954,COST
06079918210240000,2021,327397,288403,615800,MKT
06079918210240000,2020,274235,224765,499000,OVR
06079918210240000,2019,274235,224765,499000,MKT
06079918211010000,2021,303551,287149,590700,MKT
06079918211010000,2020,264033,195967,460000,OVR
06079918211010000,2019,264033,195967,460000,MKT
06079918211040000,2021,303551,121349,424900,MKT
06079918211040000,2020,264033,101567,365600,MKT
06079918211040000,2019,264033,101667,365700,MKT
06079918211060000,2021,303551,273749,577300,MKT
06079918211060000,2020,264033,228867,492900,MKT
06079918211060000,2019,264033,228867,492900,MKT
06079918211080000,2021,303551,264949,568500,MKT
06079918211080000,2020,264033,190167,454200,OVR
06079918211080000,2019,264033,190167,454200,MKT
06079918211100000,2021,303551,244649,548200,MKT
06079918211100000,2020,264033,232767,496800,MKT
06079918211100000,2019,264033,232767,496800,MKT
06079918211120000,2021,303551,531370,834921,COST
06079918211120000,2020,264033,427600,691633,COST
06079918211120000,2019,264033,427600,691633,COST
06079918211150000,2021,378986,295414,674400,MKT
06079918211150000,2020,295106,254394,549500,MKT
06079918211150000,2019,295106,254394,549500,MKT
06079918211180000,2021,378986,35460,414446,COST
06079918211180000,2020,295106,209394,504500,OVR
06079918211180000,2019,295106,209394,504500,MKT
06079918211200000,2021,303551,248849,552400,MKT
06079918211200000,2020,264033,186867,450900,OVR
06079918211200000,2019,264033,186867,450900,MKT
06079918211220000,2021,321573,59409,380982,OVR
06079918211220000,2020,271778,53022,324800,MKT
06079918211220000,2019,271778,59322,331100,MKT
06079918211240000,2021,284597,272403,557000,MKT
06079918211240000,2020,255636,218064,473700,MKT
06079918211240000,2019,255636,218064,473700,MKT
06079918212010000,2021,417251,253149,670400,MKT
06079918212010000,2020,309684,225116,534800,OVR
06079918212010000,2019,309684,225116,534800,MKT
06079918212050000,2021,328030,236270,564300,INCOME
06079918212050000,2020,276634,259466,536100,INCOME
06079918212050000,2019,276634,259466,536100,INCOME
06079918212070000,2021,333136,239964,573100,MKT
06079918212070000,2020,276634,171366,448000,MKT
06079918212070000,2019,276634,171366,448000,MKT
06079918212100000,2021,415924,186476,602400,MKT
06079918212100000,2020,309190,191410,500600,OVR
06079918212100000,2019,309190,191410,500600,MKT
06079918212120000,2021,309654,189646,499300,MKT
06079918212120000,2020,266681,123319,390000,MKT
06079918212120000,2019,266681,128619,395300,MKT
06079918213016500,2021,199377,0,199377,COST
06079918213016500,2020,141857,0,141857,COST
06079918213016500,2019,141857,0,141857,COST
06079918213207000,2021,430343,0,430343,COST
06079918213207000,2020,308078,0,308078,COST
06079918213207000,2019,308078,0,308078,COST
06079918214010000,2021,126418,352682,479100,MKT
06079918214010000,2020,92083,290017,382100,MKT
06079918214010000,2019,92083,290017,382100,MKT
06079918214020000,2021,126418,359982,486400,MKT
06079918214020000,2020,92083,282017,374100,MKT
06079918214020000,2019,92083,282017,374100,MKT
06079918214030000,2021,119358,367242,486600,MKT
06079918214030000,2020,87011,342089,429100,MKT
06079918214030000,2019,87011,342089,429100,MKT
06079918214040000,2021,119358,286742,406100,MKT
06079918214040000,2020,87011,263889,350900,OVR
06079918214040000,2019,87011,263889,350900,MKT
06079918214050000,2021,119358,354642,474000,MKT
06079918214050000,2020,87011,273989,361000,OVR
06079918214050000,2019,87011,273989,361000,MKT
06079918214060000,2021,119358,385642,505000,MKT
06079918214060000,2020,87011,333389,420400,OVR
06079918214060000,2019,87011,333389,420400,MKT
06079918214070000,2021,119358,354342,473700,MKT
06079918214070000,2020,87011,322089,409100,MKT
06079918214070000,2019,87011,329089,416100,MKT
06079918214080000,2021,119358,338442,457800,MKT
06079918214080000,2020,87011,286789,373800,OVR
06079918214080000,2019,87011,286789,373800,MKT
06079918214090000,2021,119358,339642,459000,MKT
06079918214090000,2020,87011,296189,383200,OVR
06079918214090000,2019,87011,296189,383200,MKT
06079918214100000,2021,119358,351342,470700,MKT
06079918214100000,2020,87011,350589,437600,OVR
06079918214100000,2019,87011,350589,437600,MKT
06079918214110000,2021,119358,340342,459700,MKT
06079918214110000,2020,87011,285389,372400,OVR
06079918214110000,2019,87011,285389,372400,MKT
06079918214120000,2021,126418,308882,435300,MKT
06079918214120000,2020,92083,263917,356000,OVR
06079918214120000,2019,92083,263917,356000,MKT
06079918214130000,2021,126418,376282,502700,MKT
06079918214130000,2020,92083,339717,431800,MKT
06079918214130000,2019,92083,311617,403700,MKT
06079918214140000,2021,119358,296142,415500,MKT
06079918214140000,2020,87011,243189,330200,OVR
06079918214140000,2019,87011,243189,330200,MKT
06079918214150000,2021,119358,321842,441200,MKT
06079918214150000,2020,87011,279589,366600,OVR
06079918214150000,2019,87011,279589,366600,MKT
06079918214160000,2021,119358,393242,512600,MKT
06079918214160000,2020,87011,337289,424300,OVR
06079918214160000,2019,87011,337289,424300,MKT
06079918214180000,2021,145468,355532,501000,MKT
06079918214180000,2020,105749,326951,432700,OVR
06079918214180000,2019,105749,326951,432700,MKT
06079918214190000,2021,145468,365732,511200,MKT
06079918214190000,2020,105749,302451,408200,MKT
06079918214190000,2019,105749,302451,408200,MKT
06079918214200000,2021,119358,377142,496500,MKT
06079918214200000,2020,87011,349389,436400,MKT
06079918214200000,2019,87011,278389,365400,MKT
06079918214210000,2021,119358,347142,466500,MKT
06079918214210000,2020,87011,334489,421500,OVR
06079918214210000,2019,87011,334489,421500,MKT
06079918214220000,2021,119358,366242,485600,MKT
06079918214220000,2020,87011,318189,405200,OVR
06079918214220000,2019,87011,318189,405200,MKT
06079918214230000,2021,126418,356882,483300,MKT
06079918214230000,2020,92083,310717,402800,MKT
06079918214230000,2019,92083,310717,402800,MKT
06079918214240000,2021,126418,329782,456200,MKT
06079918214240000,2020,92083,348817,440900,OVR
06079918214240000,2019,92083,348817,440900,MKT
06079918215010000,2021,126418,411382,537800,MKT
06079918215010000,2020,92083,382617,474700,MKT
06079918215010000,2019,92083,382117,474200,MKT
06079918215020000,2021,119358,386342,505700,MKT
06079918215020000,2020,87011,331389,418400,MKT
06079918215020000,2019,87011,331389,418400,MKT
06079918215030000,2021,119358,317942,437300,MKT
06079918215030000,2020,87011,275689,362700,OVR
06079918215030000,2019,87011,275689,362700,MKT
06079918215040000,2021,119358,327542,446900,MKT
06079918215040000,2020,87011,327289,414300,OVR
06079918215040000,2019,87011,327289,414300,MKT
06079918215050000,2021,119358,367542,486900,MKT
06079918215050000,2020,87011,316589,403600,MKT
06079918215050000,2019,87011,316589,403600,MKT
06079918215060000,2021,119358,354342,473700,MKT
06079918215060000,2020,87011,368189,455200,OVR
06079918215060000,2019,87011,368189,455200,MKT
06079918215070000,2021,119358,322442,441800,MKT
06079918215070000,2020,87011,263489,350500,OVR
06079918215070000,2019,87011,263489,350500,MKT
06079918215080000,2021,119358,330242,449600,MKT
06079918215080000,2020,87011,276889,363900,OVR
06079918215080000,2019,87011,276889,363900,MKT
06079918215090000,2021,119358,335542,454900,MKT
06079918215090000,2020,87011,296189,383200,OVR
06079918215090000,2019,87011,296189,383200,MKT
06079918215100000,2021,126418,334982,461400,MKT
06079918215100000,2020,92083,344217,436300,MKT
06079918215100000,2019,92083,344217,436300,MKT
06079918215110000,2021,119358,331542,450900,MKT
06079918215110000,2020,87011,320689,407700,OVR
06079918215110000,2019,87011,320689,407700,MKT
06079918215120000,2021,126418,363882,490300,MKT
06079918215120000,2020,92083,354917,447000,OVR
06079918215120000,2019,92083,354917,447000,MKT
06079918215130000,2021,126418,326982,453400,MKT
06079918215130000,2020,92083,268717,360800,OVR
06079918215130000,2019,92083,268717,360800,MKT
06079918215140000,2021,119358,327342,446700,MKT
06079918215140000,2020,87011,314589,401600,MKT
06079918215140000,2019,87011,272489,359500,MKT
06079918215150000,2021,119358,347242,466600,MKT
06079918215150000,2020,87011,305789,392800,OVR
06079918215150000,2019,87011,305789,392800,MKT
06079918215160000,2021,119358,313542,432900,MKT
06079918215160000,2020,87011,306789,393800,OVR
06079918215160000,2019,87011,306789,393800,MKT
06079918215170000,2021,119358,320742,440100,MKT
06079918215170000,2020,87011,276689,363700,MKT
06079918215170000,2019,87011,276689,363700,MKT
06079918215190000,2021,126418,369282,495700,MKT
06079918215190000,2020,92083,307917,400000,MKT
06079918215190000,2019,92083,307917,400000,MKT
06079918215200000,2021,111830,375170,487000,MKT
06079918215200000,2020,81598,322402,404000,MKT
06079918215200000,2019,81598,322402,404000,MKT
06079918215210000,2021,111830,341570,453400,MKT
06079918215210000,2020,81598,299502,381100,OVR
06079918215210000,2019,81598,299502,381100,MKT
06079918215220000,2021,119358,346742,466100,MKT
06079918215220000,2020,87011,353489,440500,OVR
06079918215220000,2019,87011,353489,440500,MKT
06079918215230000,2021,126418,343582,470000,MKT
06079918215230000,2020,92083,288317,380400,OVR
06079918215230000,2019,92083,288317,380400,MKT
06079918215240000,2021,119358,331042,450400,MKT
06079918215240000,2020,87011,312989,400000,MKT
06079918215240000,2019,87011,312989,400000,MKT
06079918215250000,2021,126418,384182,510600,MKT
06079918215250000,2020,92083,317417,409500,OVR
06079918215250000,2019,92083,317417,409500,MKT
06079918216010000,2021,126418,311582,438000,MKT
06079918216010000,2020,92083,291017,383100,MKT
06079918216010000,2019,92083,291017,383100,MKT
06079918216020000,2021,114904,337596,452500,MKT
06079918216020000,2020,83809,296991,380800,MKT
06079918216020000,2019,83809,296991,380800,MKT
06079918216030000,2021,119358,346142,465500,MKT
06079918216030000,2020,87011,317589,404600,MKT
06079918216030000,2019,87011,317589,404600,MKT
06079918216040000,2021,119358,324242,443600,MKT
06079918216040000,2020,87011,282489,369500,MKT
06079918216040000,2019,87011,282489,369500,MKT
06079918216050000,2021,119358,336442,455800,MKT
06079918216050000,2020,87011,286889,373900,MKT
06079918216050000,2019,87011,286889,373900,MKT
06079918216060000,2021,119358,361542,480900,MKT
06079918216060000,2020,87011,350989,438000,MKT
06079918216060000,2019,87011,350989,438000,MKT
06079918216070000,2021,115659,332541,448200,MKT
06079918216070000,2020,84352,280748,365100,MKT
06079918216070000,2019,84352,280748,365100,MKT
06079918216080000,2021,119358,359342,478700,MKT
06079918216080000,2020,87011,342589,429600,MKT
06079918216080000,2019,87011,342589,429600,MKT
06079918216090000,2021,119358,414942,534300,MKT
06079918216090000,2020,87011,329889,416900,MKT
06079918216090000,2019,87011,329889,416900,MKT
06079918216100000,2021,126418,328482,454900,MKT
06079918216100000,2020,92083,311017,403100,MKT
06079918216100000,2019,92083,311017,403100,MKT
06079918216110000,2021,126418,313282,439700,MKT
06079918216110000,2020,92083,278117,370200,MKT
06079918216110000,2019,92083,278117,370200,MKT
06079918216120000,2021,126418,307782,434200,MKT
06079918216120000,2020,92083,283617,375700,MKT
06079918216120000,2019,92083,283617,375700,MKT
06079918216130000,2021,126418,466182,592600,MKT
06079918216130000,2020,92083,380917,473000,MKT
06079918216130000,2019,92083,380917,473000,MKT
06079918216140000,2021,115659,351041,466700,MKT
06079918216140000,2020,84352,310948,395300,MKT
06079918216140000,2019,84352,310948,395300,MKT
06079918216150000,2021,114904,335896,450800,MKT
06079918216150000,2020,83809,308191,392000,MKT
06079918216150000,2019,83809,308191,392000,MKT
06079918216160000,2021,119358,348242,467600,MKT
06079918216160000,2020,87011,298989,386000,MKT
06079918216160000,2019,87011,298989,386000,MKT
06079918216170000,2021,119358,321042,440400,MKT
06079918216170000,2020,87011,283089,370100,MKT
06079918216170000,2019,87011,283089,370100,MKT
06079918216180000,2021,119358,369542,488900,MKT
06079918216180000,2020,87011,282189,369200,MKT
06079918216180000,2019,87011,282189,369200,MKT
06079918216190000,2021,119358,334142,453500,MKT
06079918216190000,2020,87011,268989,356000,MKT
06079918216190000,2019,87011,268989,356000,MKT
06079918216200000,2021,119358,325642,445000,MKT
06079918216200000,2020,87011,268289,355300,MKT
06079918216200000,2019,87011,268289,355300,MKT
06079918216210000,2021,119358,332742,452100,MKT
06079918216210000,2020,87011,274989,362000,MKT
06079918216210000,2019,87011,274989,362000,MKT
06079918216220000,2021,126418,356382,482800,MKT
06079918216220000,2020,92083,292017,384100,MKT
06079918216220000,2019,92083,292017,384100,MKT
06079918216230000,2021,126418,351382,477800,MKT
06079918216230000,2020,92083,288917,381000,MKT
06079918216230000,2019,92083,288917,381000,MKT
06079918216240000,2021,126418,367182,493600,MKT
06079918216240000,2020,92083,324217,416300,MKT
06079918216240000,2019,92083,324217,416300,MKT
06079918217010000,2021,136409,360291,496700,MKT
06079918217010000,2020,97335,365265,462600,MKT
06079918217010000,2019,97335,365265,462600,MKT
06079918217020000,2021,127102,415298,542400,MKT
06079918217020000,2020,92574,361126,453700,MKT
06079918217020000,2019,92574,361126,453700,MKT
06079918217030000,2021,126418,347982,474400,MKT
06079918217030000,2020,92083,325417,417500,MKT
06079918217030000,2019,92083,325417,417500,MKT
06079918217040000,2021,126418,321982,448400,MKT
06079918217040000,2020,92083,293417,385500,MKT
06079918217040000,2019,92083,293417,385500,MKT
06079918217050000,2021,126418,325482,451900,MKT
06079918217050000,2020,92083,261217,353300,MKT
06079918217050000,2019,92083,261217,353300,MKT
06079918217060000,2021,471052,305710,776762,COST
06079918217060000,2020,336790,299260,636050,COST
06079918217060000,2019,336790,299260,636050,COST
06079918217070000,2021,119358,313942,433300,MKT
06079918217070000,2020,87011,281689,368700,MKT
06079918217070000,2019,87011,281689,368700,MKT
06079918217080000,2021,119358,343642,463000,MKT
06079918217080000,2020,87011,285289,372300,MKT
06079918217080000,2019,87011,285289,372300,MKT
06079918217090000,2021,115659,280241,395900,MKT
06079918217090000,2020,84352,285148,369500,MKT
06079918217090000,2019,84352,285148,369500,MKT
06079918217100000,2021,119358,328442,447800,MKT
06079918217100000,2020,87011,272889,359900,MKT
06079918217100000,2019,87011,272889,359900,MKT
06079918217110000,2021,119358,350642,470000,MKT
06079918217110000,2020,87011,266560,353571,COST
06079918217110000,2019,87011,266560,353571,COST
06079918217120000,2021,115659,369341,485000,MKT
06079918217120000,2020,84352,343448,427800,MKT
06079918217120000,2019,84352,343448,427800,MKT
06079918217130000,2021,126418,302982,429400,MKT
06079918217130000,2020,92083,279517,371600,MKT
06079918217130000,2019,92083,279517,371600,MKT
06079918217140000,2021,126418,367082,493500,MKT
06079918217140000,2020,92083,332317,424400,MKT
06079918217140000,2019,92083,332317,424400,MKT
06079918219010000,2021,309654,134846,444500,MKT
06079918219010000,2020,266681,127919,394600,MKT
06079918219010000,2019,266681,127919,394600,MKT
06079918219040000,2021,309654,252546,562200,MKT
06079918219040000,2020,266681,182219,448900,MKT
06079918219040000,2019,266681,182219,448900,MKT
06079918219060000,2021,309654,292646,602300,MKT
06079918219060000,2020,266681,246919,513600,MKT
06079918219060000,2019,266681,246919,513600,MKT
06079918219080000,2021,309654,215546,525200,MKT
06079918219080000,2020,266681,129019,395700,MKT
06079918219080000,2019,266681,129019,395700,MKT
06079918219100000,2021,309654,18746,328400,INCOME
06079918219100000,2020,266681,46619,313300,INCOME
06079918219100000,2019,266681,46619,313300,INCOME
06079918219120000,2021,309654,386910,696564,COST
06079918219120000,2020,266681,335630,602311,OVR
06079918219120000,2019,266681,335630,602311,COST
06079918219150000,2021,326633,393667,720300,MKT
06079918219150000,2020,273914,389886,663800,MKT
06079918219150000,2019,273914,389886,663800,MKT
06079918219180000,2021,479385,309630,789015,COST
06079918219180000,2020,332001,250120,582121,COST
06079918219180000,2019,332001,250120,582121,COST
06079918219220000,2021,478474,307310,785784,COST
06079918219220000,2020,331684,253116,584800,MKT
06079918219220000,2019,331684,253116,584800,MKT
06079918219240000,2021,327397,247103,574500,MKT
06079918219240000,2020,274235,171965,446200,MKT
06079918219240000,2019,274235,171965,446200,MKT
06079918220010000,2021,303551,247449,551000,MKT
06079918220010000,2020,264033,167467,431500,MKT
06079918220010000,2019,264033,167467,431500,MKT
06079918220040000,2021,303551,232149,535700,MKT
06079918220040000,2020,264033,165967,430000,OVR
06079918220040000,2019,264033,165967,430000,MKT
06079918220060000,2021,303551,245349,548900,MKT
06079918220060000,2020,264033,182767,446800,MKT
06079918220060000,2019,264033,182767,446800,MKT
06079918220080000,2021,296324,313576,609900,INCOME
06079918220080000,2020,264033,317367,581400,INCOME
06079918220080000,2019,264033,317367,581400,INCOME
06079918220100000,2021,303551,289020,592571,COST
06079918220100000,2020,264033,243820,507853,OVR
06079918220100000,2019,264033,243820,507853,COST
06079918220120000,2021,303551,435049,738600,MKT
06079918220120000,2020,264033,432070,696103,COST
06079918220120000,2019,264033,432070,696103,COST
06079918220140000,2021,293441,274059,567500,MKT
06079918220140000,2020,259588,194012,453600,OVR
06079918220140000,2019,259588,194012,453600,MKT
06079918220160000,2021,300246,219354,519600,INCOME
06079918220160000,2020,265631,242969,508600,INCOME
06079918220160000,2019,265631,242969,508600,INCOME
06079918220180000,2021,303551,88749,392300,MKT
06079918220180000,2020,264033,73267,337300,MKT
06079918220180000,2019,264033,73267,337300,MKT
06079918220200000,2021,303551,268149,571700,MKT
06079918220200000,2020,264033,200467,464500,MKT
06079918220200000,2019,264033,186667,450700,MKT
06079918220220000,2021,303551,188949,492500,MKT
06079918220220000,2020,264033,126467,390500,MKT
06079918220220000,2019,264033,126467,390500,MKT
06079918220240000,2021,303551,266949,570500,MKT
06079918220240000,2020,264033,185267,449300,MKT
06079918220240000,2019,264033,185267,449300,MKT
06079918221120000,2021,660516,354100,1014616,COST
06079918221120000,2020,389867,283050,672917,COST
06079918221120000,2019,389867,283050,672917,COST
06079918221140000,2021,333136,214564,547700,MKT
06079918221140000,2020,276634,153466,430100,MKT
06079918221140000,2019,276634,153466,430100,MKT
06079918221170000,2021,415924,108776,524700,MKT
06079918221170000,2020,309190,142410,451600,MKT
06079918221170000,2019,309190,142410,451600,MKT
06079918221190000,2021,333136,219264,552400,MKT
06079918221190000,2020,276634,154766,431400,MKT
06079918221190000,2019,276634,154766,431400,MKT
06079918221210000,2021,333136,77964,411100,MKT
06079918221210000,2020,276634,71966,348600,MKT
06079918221210000,2019,276634,71966,348600,MKT
06079918221240000,2021,415924,193376,609300,MKT
06079918221240000,2020,309190,184610,493800,MKT
06079918221240000,2019,309190,184610,493800,MKT
06079918228010000,2021,309654,183546,493200,MKT
06079918228010000,2020,266681,154319,421000,MKT
06079918228010000,2019,266681,154319,421000,MKT
06079918228040000,2021,309654,248646,558300,MKT
06079918228040000,2020,266681,164919,431600,MKT
06079918228040000,2019,266681,164919,431600,MKT
06079918228060000,2021,309654,226046,535700,MKT
06079918228060000,2020,266681,153119,419800,MKT
06079918228060000,2019,266681,153119,419800,MKT
06079918228080000,2021,309654,174546,484200,MKT
06079918228080000,2020,266681,142619,409300,MKT
06079918228080000,2019,266681,142619,409300,MKT
06079918228100000,2021,309654,303646,613300,MKT
06079918228100000,2020,266681,235019,501700,OVR
06079918228100000,2019,266681,235019,501700,MKT
06079918228120000,2021,309654,125746,435400,MKT
06079918228120000,2020,266681,140619,407300,MKT
06079918228120000,2019,266681,140619,407300,MKT
06079918228140000,2021,327397,316360,643757,COST
06079918228140000,2020,274235,257060,531295,COST
06079918228140000,2019,274235,257060,531295,COST
06079918228160000,2021,327397,250503,577900,MKT
06079918228160000,2020,274235,224565,498800,MKT
06079918228160000,2019,274235,224565,498800,MKT
06079918228180000,2021,327397,313003,640400,MKT
06079918228180000,2020,274235,237465,511700,MKT
06079918228180000,2019,274235,237465,511700,MKT
06079918228200000,2021,327397,359603,687000,MKT
06079918228200000,2020,274235,259165,533400,MKT
06079918228200000,2019,274235,259165,533400,MKT
06079918228220000,2021,327397,261903,589300,MKT
06079918228220000,2020,274235,211065,485300,MKT
06079918228220000,2019,274235,211065,485300,MKT
06079918228240000,2021,327397,147003,474400,MKT
06079918228240000,2020,274235,139265,413500,MKT
06079918228240000,2019,274235,139265,413500,MKT
06079918229010000,2021,378986,124714,503700,MKT
06079918229010000,2020,295106,145394,440500,MKT
06079918229010000,2019,295106,145394,440500,MKT
06079918229050000,2021,303551,305349,608900,MKT
06079918229050000,2020,264033,293067,557100,MKT
06079918229050000,2019,264033,293067,557100,MKT
06079918229070000,2021,303821,255779,559600,INCOME
06079918229070000,2020,264151,281749,545900,INCOME
06079918229070000,2019,264151,281749,545900,INCOME
06079918229090000,2021,303551,227849,531400,MKT
06079918229090000,2020,264033,200367,464400,MKT
06079918229090000,2019,264033,159467,423500,MKT
06079918229120000,2021,363352,352948,716300,MKT
06079918229120000,2020,288939,336561,625500,OVR
06079918229120000,2019,288939,336561,625500,OVR
06079918229140000,2021,303551,224949,528500,MKT
06079918229140000,2020,264033,150567,414600,MKT
06079918229140000,2019,264033,150567,414600,MKT
06079918229160000,2021,303551,319149,622700,MKT
06079918229160000,2020,264033,257067,521100,MKT
06079918229160000,2019,264033,257067,521100,MKT
06079918229180000,2021,303551,196949,500500,MKT
06079918229180000,2020,264033,133367,397400,MKT
06079918229180000,2019,264033,133367,397400,MKT
06079918229200000,2021,303551,231670,535221,COST
06079918229200000,2020,264033,187870,451903,COST
06079918229200000,2019,264033,187870,451903,COST
06079918229220000,2021,303551,313640,617191,COST
06079918229220000,2020,264033,272867,536900,MKT
06079918229220000,2019,264033,272867,536900,MKT
06079918229240000,2021,303551,226649,530200,MKT
06079918229240000,2020,264033,149467,413500,MKT
06079918229240000,2019,264033,149467,413500,MKT
06079918230010000,2021,517135,470850,987985,COST
06079918230010000,2020,344859,373870,718729,COST
06079918230010000,2019,344859,373870,718729,COST
06079918230040000,2021,513081,1003530,1516611,COST
06079918230040000,2020,343501,814800,1158301,COST
06079918230040000,2019,343501,814800,1158301,COST
06079918230050000,2021,355323,268177,623500,MKT
06079918230050000,2020,285721,252279,538000,MKT
06079918230050000,2019,285721,252279,538000,MKT
06079918230060000,2021,355323,294877,650200,MKT
06079918230060000,2020,285721,292279,578000,MKT
06079918230060000,2019,285721,292279,578000,MKT
06079918230070000,2021,355323,90777,446100,MKT
06079918230070000,2020,285721,89379,375100,MKT
06079918230070000,2019,285721,89379,375100,MKT
06079918230080000,2021,355323,357877,713200,MKT
06079918230080000,2020,285721,332879,618600,OVR
06079918230080000,2019,285721,332879,618600,MKT
06079918230090000,2021,355323,230177,585500,MKT
06079918230090000,2020,285721,158879,444600,MKT
06079918230090000,2019,285721,158879,444600,MKT
06079918230100000,2021,401487,410340,811827,COST
06079918230100000,2020,303763,331200,634963,COST
06079918230100000,2019,303763,331200,634963,COST
06079918230130000,2021,415924,427760,843684,COST
06079918230130000,2020,309190,347060,656250,COST
06079918230130000,2019,309190,347060,656250,COST
06079918230150000,2021,286668,147032,433700,MKT
06079918230150000,2020,256567,134033,390600,MKT
06079918230150000,2019,256567,134033,390600,MKT
06079918230170000,2021,286668,212232,498900,MKT
06079918230170000,2020,256567,146133,402700,MKT
06079918230170000,2019,256567,146133,402700,MKT
06079918230200000,2021,415981,1122130,1538111,COST
06079918230200000,2020,309211,905470,1214681,COST
06079918230200000,2019,309211,905470,1214681,COST
06079918230220000,2021,333136,206764,539900,MKT
06079918230220000,2020,276634,140766,417400,MKT
06079918230220000,2019,276634,140766,417400,MKT
06079918230240000,2021,350978,289022,640000,MKT
06079918230240000,2020,283964,268636,552600,MKT
06079918230240000,2019,283964,268636,552600,MKT
06079918230250000,2021,350978,193022,544000,MKT
06079918230250000,2020,283964,147336,431300,MKT
06079918230250000,2019,283964,147336,431300,MKT
06079918230280000,2021,418089,198811,616900,INCOME
06079918230280000,2020,309190,289410,598600,INCOME
06079918230280000,2019,309190,289410,598600,INCOME
06079918230300000,2021,333136,260464,593600,MKT
06079918230300000,2020,276634,190666,467300,MKT
06079918230300000,2019,276634,190666,467300,MKT
06079918230320000,2021,333136,534550,867686,COST
06079918230320000,2020,276634,432930,709564,COST
06079918230320000,2019,276634,171140,447774,COST
06079918230340000,2021,333136,254664,587800,MKT
06079918230340000,2020,276634,183466,460100,MKT
06079918230340000,2019,276634,183466,460100,MKT
06079918230360000,2021,333136,180964,514100,MKT
06079918230360000,2020,276634,129566,406200,MKT
06079918230360000,2019,276634,129566,406200,MKT
06079918232010000,2021,159460,344340,503800,MKT
06079918232010000,2020,119974,327926,447900,MKT
06079918232010000,2019,119974,327926,447900,MKT
06079918232030000,2021,121820,256080,377900,MKT
06079918232030000,2020,92005,234795,326800,MKT
06079918232030000,2019,92005,234795,326800,MKT
06079918233010000,2021,248982,371518,620500,INCOME
06079918233010000,2020,137132,360568,497700,INCOME
06079918233010000,2019,137132,360568,497700,INCOME
06079918233030100,2021,35500,0,35500,COST
06079918233030100,2020,25883,0,25883,COST
06079918233030100,2019,25883,0,25883,COST
06079918233037000,2021,152393,0,152393,COST
06079918233037000,2020,110710,0,110710,COST
06079918233037000,2019,110710,0,110710,COST
06079918233047000,2021,200244,0,200244,COST
06079918233047000,2020,144912,0,144912,COST
06079918233047000,2019,144912,0,144912,COST
06079918233070000,2021,172141,175659,347800,INCOME
06079918233070000,2020,124841,195559,320400,INCOME
06079918233070000,2019,124841,195559,320400,INCOME
06079918233080000,2021,306351,234249,540600,INCOME
06079918233080000,2020,146610,372490,519100,INCOME
06079918233080000,2019,146610,372490,519100,INCOME
06079918233090000,2021,348933,211367,560300,INCOME
06079918233090000,2020,162782,356318,519100,INCOME
06079918233090000,2019,162782,356318,519100,INCOME
06079918233110000,2021,207589,336611,544200,INCOME
06079918233110000,2020,118483,383317,501800,INCOME
06079918233110000,2019,118483,383317,501800,INCOME
06079918233120000,2021,117598,279002,396600,MKT
06079918233120000,2020,85746,244054,329800,MKT
06079918233120000,2019,85746,244054,329800,MKT
06079918233130000,2021,118188,328712,446900,MKT
06079918233130000,2020,86170,279930,366100,MKT
06079918233130000,2019,86170,279930,366100,MKT
06079918233140000,2021,117598,243802,361400,MKT
06079918233140000,2020,85746,233254,319000,MKT
06079918233140000,2019,85746,233254,319000,MKT
06079918233150000,2021,118775,240725,359500,MKT
06079918233150000,2020,86592,222208,308800,MKT
06079918233150000,2019,86592,222208,308800,MKT
06079918233177000,2021,143322,0,143322,COST
06079918233177000,2020,104211,0,104211,COST
06079918233177000,2019,104211,0,104211,COST
06079918233190000,2021,168187,372413,540600,INCOME
06079918233190000,2020,100038,419062,519100,INCOME
06079918233190000,2019,100038,419062,519100,INCOME
06079918233210000,2021,200897,776103,977000,INCOME
06079918233210000,2020,104435,762765,867200,INCOME
06079918233210000,2019,104435,762765,867200,INCOME
06079918234017000,2021,591038,223980,815018,COST
06079918234017000,2020,421223,201190,622413,COST
06079918234017000,2019,421223,201190,622413,COST
06079918234070000,2021,205506,351794,557300,INCOME
06079918234070000,2020,117527,418573,536100,INCOME
06079918234070000,2019,117527,418573,536100,INCOME
06079918234140000,2021,107046,295054,402100,MKT
06079918234140000,2020,78156,255144,333300,MKT
06079918234140000,2019,78156,255144,333300,MKT
06079918234150000,2021,116408,284692,401100,MKT
06079918234150000,2020,84891,251609,336500,MKT
06079918234150000,2019,84891,251609,336500,MKT
06079918234160000,2021,141392,330008,471400,INCOME
06079918234160000,2020,87011,380789,467800,INCOME
06079918234160000,2019,87011,380789,467800,INCOME
06079918235010000,2021,141392,350708,492100,INCOME
06079918235010000,2020,87011,327389,414400,INCOME
06079918235010000,2019,87011,327389,414400,INCOME
06079918235020000,2021,130535,361565,492100,INCOME
06079918235020000,2020,81598,332802,414400,INCOME
06079918235020000,2019,81598,332802,414400,INCOME
06079918235130000,2021,130535,218665,349200,INCOME
06079918235130000,2020,81598,250802,332400,INCOME
06079918235130000,2019,81598,250802,332400,INCOME
06079918235140000,2021,141392,399208,540600,INCOME
06079918235140000,2020,87011,432089,519100,INCOME
06079918235140000,2019,87011,432089,519100,INCOME
06079918237010000,2021,309654,184746,494400,MKT
06079918237010000,2020,266681,126519,393200,MKT
06079918237010000,2019,266681,126519,393200,MKT
06079918237050000,2021,315605,350795,666400,INCOME
06079918237050000,2020,271778,361022,632800,INCOME
06079918237050000,2019,271778,361022,632800,INCOME
06079918237070000,2021,309654,232246,541900,MKT
06079918237070000,2020,266681,176719,443400,MKT
06079918237070000,2019,266681,176719,443400,MKT
06079918237090000,2021,309654,344646,654300,MKT
06079918237090000,2020,266681,290319,557000,MKT
06079918237090000,2019,266681,290319,557000,MKT
06079918237120000,2021,386607,329493,716100,MKT
06079918237120000,2020,298066,273834,571900,MKT
06079918237120000,2019,298066,273834,571900,MKT
06079918237160000,2021,478474,551550,1030024,COST
06079918237160000,2020,331684,496380,828064,COST
06079918237160000,2019,331684,496380,828064,COST
06079918237180000,2021,327397,222803,550200,MKT
06079918237180000,2020,274235,152265,426500,MKT
06079918237180000,2019,274235,152265,426500,MKT
06079918237200000,2021,327397,772670,1100067,COST
06079918237200000,2020,274235,621660,895895,COST
06079918237200000,2019,274235,621660,895895,COST
06079918237220000,2021,327397,333140,660537,COST
06079918237220000,2020,274235,308065,582300,MKT
06079918237220000,2019,274235,308065,582300,MKT
06079918237240000,2021,327397,393790,721187,COST
06079918237240000,2020,274235,343490,617725,COST
06079918237240000,2019,274235,343490,617725,COST
06079918238010000,2021,303551,289949,593500,MKT
06079918238010000,2020,264033,215067,479100,OVR
06079918238010000,2019,264033,215067,479100,MKT
06079918238040000,2021,303551,275049,578600,MKT
06079918238040000,2020,264033,176867,440900,MKT
06079918238040000,2019,264033,176867,440900,MKT
06079918238060000,2021,303551,265849,569400,MKT
06079918238060000,2020,264033,180767,444800,MKT
06079918238060000,2019,264033,193167,457200,MKT
06079918238080000,2021,303600,332000,635600,MKT
06079918238080000,2020,264055,270945,535000,MKT
06079918238080000,2019,264055,270945,535000,MKT
06079918238120000,2021,443624,554910,998534,COST
06079918238120000,2020,319346,444920,764266,COST
06079918238120000,2019,319346,444920,764266,COST
06079918238150000,2021,378986,775250,1154236,COST
06079918238150000,2020,295106,625510,920616,COST
06079918238150000,2019,295106,625510,920616,COST
06079918238180000,2021,378986,266914,645900,MKT
06079918238180000,2020,295106,253194,548300,MKT
06079918238180000,2019,295106,253194,548300,MKT
06079918238200000,2021,303551,119749,423300,MKT
06079918238200000,2020,264033,84167,348200,MKT
06079918238200000,2019,264033,84167,348200,MKT
06079918238240000,2021,448614,331886,780500,INCOME
06079918238240000,2020,319346,445354,764700,INCOME
06079918238240000,2019,319346,445354,764700,INCOME
06079918239010000,2021,238162,506138,744300,MKT
06079918239010000,2020,178175,464325,642500,MKT
06079918239010000,2019,178175,464325,642500,MKT
06079918239030000,2021,161120,357480,518600,MKT
06079918239030000,2020,116958,340642,457600,MKT
06079918239030000,2019,116958,340642,457600,MKT
06079918239040000,2021,154612,239988,394600,MKT
06079918239040000,2020,112299,248401,360700,MKT
06079918239040000,2019,112299,248401,360700,MKT
06079918239050000,2021,129557,288343,417900,MKT
06079918239050000,2020,94337,261163,355500,MKT
06079918239050000,2019,94337,261163,355500,MKT
06079918239060000,2021,114600,267000,381600,MKT
06079918239060000,2020,83591,246909,330500,MKT
06079918239060000,2019,83591,246909,330500,MKT
06079918239070000,2021,180211,360389,540600,INCOME
06079918239070000,2020,105749,413351,519100,INCOME
06079918239070000,2019,105749,413351,519100,INCOME
06079918239080000,2021,344024,1190276,1534300,INCOME
06079918239080000,2020,177840,1295460,1473300,INCOME
06079918239080000,2019,177840,1295460,1473300,INCOME
06079918239110000,2021,178986,558514,737500,INCOME
06079918239110000,2020,308224,399876,708100,INCOME
06079918239110000,2019,308224,399876,708100,INCOME
06079918239120000,2021,351851,332349,684200,INCOME
06079918239120000,2020,284318,314282,598600,INCOME
06079918239120000,2019,284318,314282,598600,INCOME
06079918239130000,2021,360265,99235,459500,INCOME
06079918239130000,2020,287706,164594,452300,INCOME
06079918239130000,2019,287706,164594,452300,INCOME
06079918239140000,2021,413871,383980,797851,COST
06079918239140000,2020,308424,320680,629104,COST
06079918239140000,2019,308424,320680,629104,COST
06079918239160000,2021,779565,171360,950925,COST
06079918239160000,2020,183661,173739,357400,MKT
06079918239160000,2019,183661,173739,357400,MKT
06079918239187000,2021,478566,15610,494176,COST
06079918239187000,2020,354511,19110,373621,COST
06079918239187000,2019,354511,19110,373621,COST
06079918239206500,2021,45494,0,45494,COST
06079918239206500,2020,33053,0,33053,COST
06079918239206500,2019,33053,0,33053,COST
06079918240010000,2021,175958,308942,484900,MKT
06079918240010000,2020,132203,274897,407100,MKT
06079918240010000,2019,132203,272897,405100,MKT
06079918240030000,2021,171632,237068,408700,MKT
06079918240030000,2020,128998,248302,377300,MKT
06079918240030000,2019,128998,248302,377300,MKT
06079918240040000,2021,160054,283946,444000,MKT
06079918240040000,2020,120415,269085,389500,MKT
06079918240040000,2019,120415,269085,389500,MKT
06079918240050000,2021,108118,252682,360800,MKT
06079918240050000,2020,78927,234873,313800,MKT
06079918240050000,2019,78927,234873,313800,MKT
06079918240060000,2021,104835,270665,375500,MKT
06079918240060000,2020,76564,235836,312400,MKT
06079918240060000,2019,76564,235836,312400,MKT
06079918240070000,2021,133768,308232,442000,MKT
06079918240070000,2020,100895,274905,375800,OVR
06079918240070000,2019,100895,274905,375800,MKT
06079918240080000,2021,155997,248803,404800,MKT
06079918240080000,2020,117406,232394,349800,MKT
06079918240080000,2019,117406,232394,349800,MKT
06079918240090000,2021,113362,312638,426000,MKT
06079918240090000,2020,82701,277799,360500,MKT
06079918240090000,2019,82701,277799,360500,MKT
06079918240100000,2021,108118,307082,415200,MKT
06079918240100000,2020,78927,266773,345700,MKT
06079918240100000,2019,78927,266773,345700,MKT
06079918240110000,2021,111299,323501,434800,MKT
06079918240110000,2020,81216,278284,359500,MKT
06079918240110000,2019,81216,278284,359500,MKT
06079918240120000,2021,115395,414505,529900,MKT
06079918240120000,2020,84162,356438,440600,MKT
06079918240120000,2019,84162,356438,440600,MKT
06079918240130000,2021,172557,328143,500700,MKT
06079918240130000,2020,129684,263416,393100,MKT
06079918240130000,2019,129684,263416,393100,MKT
06079918240140000,2021,178019,321181,499200,MKT
06079918240140000,2020,133730,292070,425800,MKT
06079918240140000,2019,133730,292070,425800,MKT
06079918240150000,2021,136211,280489,416700,MKT
06079918240150000,2020,99111,252089,351200,MKT
06079918240150000,2019,99111,252089,351200,MKT
06079918240160000,2021,111299,302901,414200,MKT
06079918240160000,2020,81216,263284,344500,MKT
06079918240160000,2019,81216,263284,344500,MKT
06079918240177000,2021,264033,0,264033,COST
06079918240177000,2020,197242,0,197242,COST
06079918240177000,2019,197242,0,197242,COST
06079918246010000,2021,538527,659530,1198057,COST
06079918246010000,2020,487049,476751,963800,MKT
06079918246010000,2019,487049,476751,963800,MKT
06079918246060000,2021,368489,172011,540500,MKT
06079918246060000,2020,402689,111511,514200,MKT
06079918246060000,2019,402689,111511,514200,MKT
06079918246080000,2021,368489,146211,514700,MKT
06079918246080000,2020,402689,79911,482600,MKT
06079918246080000,2019,402689,79911,482600,MKT
06079918246100000,2021,368489,332811,701300,MKT
06079918246100000,2020,402689,235770,638459,COST
06079918246100000,2019,402689,235770,638459,COST
06079918246120000,2021,368489,262911,631400,MKT
06079918246120000,2020,402689,117311,520000,MKT
06079918246120000,2019,402689,117311,520000,MKT
06079918246160000,2021,678506,149694,828200,MKT
06079918246160000,2020,478999,297870,776869,COST
06079918246160000,2019,478999,297870,776869,COST
06079918246180000,2021,585839,188461,774300,MKT
06079918246180000,2020,445005,186795,631800,OVR
06079918246180000,2019,445005,186795,631800,MKT
06079918246210000,2021,633575,487860,1121435,COST
06079918246210000,2020,462827,390690,853517,COST
06079918246210000,2019,462827,390690,853517,COST
06079918246240000,2021,633575,396900,1030475,COST
06079918246240000,2020,462827,306373,769200,MKT
06079918246240000,2019,462827,306373,769200,MKT
06079918247010000,2021,527913,525300,1053213,COST
06079918247010000,2020,482213,442087,924300,MKT
06079918247010000,2019,482213,442087,924300,MKT
06079918247080000,2021,527913,554090,1082003,COST
06079918247080000,2020,482213,423387,905600,MKT
06079918247080000,2019,482213,423387,905600,MKT
06079918247120000,2021,527913,440430,968343,COST
06079918247120000,2020,482213,349910,832123,COST
06079918247120000,2019,482213,349910,832123,COST
06079918247150000,2021,384344,165556,549900,MKT
06079918247150000,2020,411284,110216,521500,MKT
06079918247150000,2019,411284,110216,521500,MKT
06079918247160000,2021,430872,96428,527300,MKT
06079918247160000,2020,435531,41669,477200,MKT
06079918247160000,2019,435531,41669,477200,MKT
06079918247180000,2021,450994,590970,1041964,COST
06079918247180000,2020,445610,442990,888600,OVR
06079918247180000,2019,445610,442990,888600,MKT
06079918247220000,2021,382671,392829,775500,MKT
06079918247220000,2020,410385,293115,703500,MKT
06079918247220000,2019,410385,293115,703500,MKT
06079918247240000,2021,338670,348630,687300,MKT
06079918247240000,2020,386011,282689,668700,MKT
06079918247240000,2019,386011,282689,668700,MKT
06079918248010000,2021,321573,347427,669000,MKT
06079918248010000,2020,271778,277522,549300,MKT
06079918248010000,2019,271778,277522,549300,MKT
06079918248050000,2021,469962,315480,785442,COST
06079918248050000,2020,328713,254587,583300,MKT
06079918248050000,2019,328713,254587,583300,MKT
06079918248120000,2021,586753,382247,969000,MKT
06079918248120000,2020,367398,372250,739648,COST
06079918248120000,2019,367398,372250,739648,COST
06079918248140000,2021,361225,266575,627800,MKT
06079918248140000,2020,398690,172310,571000,MKT
06079918248140000,2019,398690,172310,571000,MKT
06079918248150000,2021,274718,195482,470200,MKT
06079918248150000,2020,251149,173351,424500,MKT
06079918248150000,2019,251149,173351,424500,MKT
06079918248170000,2021,396432,330610,727042,COST
06079918248170000,2020,417718,286582,704300,MKT
06079918248170000,2019,417718,286582,704300,MKT
06079918248190000,2021,396432,275368,671800,MKT
06079918248190000,2020,417718,160282,578000,MKT
06079918248190000,2019,417718,157382,575100,MKT
06079918248220000,2021,449895,441740,891635,COST
06079918248220000,2020,445066,358570,803636,COST
06079918248220000,2019,445066,358570,803636,COST
06079918248240000,2021,449895,420805,870700,MKT
06079918248240000,2020,445066,356580,801646,COST
06079918248240000,2019,445066,356580,801646,COST
06079918250010000,2021,969083,2791017,3760100,INCOME
06079918250010000,2020,692177,2383823,3076000,INCOME
06079918250010000,2019,692177,2383823,3076000,INCOME
06079918250020000,2021,115659,332241,447900,MKT
06079918250020000,2020,84352,338248,422600,MKT
06079918250020000,2019,84352,338248,422600,MKT
06079918256010000,2021,479964,141236,621200,MKT
06079918256010000,2020,402689,102311,505000,MKT
06079918256010000,2019,402689,102311,505000,MKT
06079918256040000,2021,701443,360650,1062093,COST
06079918256040000,2020,487049,286870,773919,COST
06079918256040000,2019,487049,286870,773919,COST
06079918256080000,2021,479964,156950,636914,COST
06079918256080000,2020,402689,75111,477800,MKT
06079918256080000,2019,402689,75111,477800,MKT
06079918256100000,2021,479964,165320,645284,COST
06079918256100000,2020,402689,78111,480800,OVR
06079918256100000,2019,402689,78111,480800,MKT
06079918256130000,2021,620789,153611,774400,MKT
06079918256130000,2020,458121,177379,635500,MKT
06079918256130000,2019,458121,177379,635500,MKT
06079918256150000,2021,534643,318500,853143,COST
06079918256150000,2020,425067,223033,648100,MKT
06079918256150000,2019,425067,223033,648100,MKT
06079918256170000,2021,507465,216435,723900,MKT
06079918256170000,2020,414094,174006,588100,MKT
06079918256170000,2019,414094,174006,588100,MKT
06079918256200000,2021,633575,113025,746600,MKT
06079918256200000,2020,462827,133373,596200,MKT
06079918256200000,2019,462827,133373,596200,MKT
06079918256220000,2021,507465,283635,791100,MKT
06079918256220000,2020,414094,285106,699200,MKT
06079918256220000,2019,414094,285106,699200,MKT
06079918256240000,2021,507465,133235,640700,MKT
06079918256240000,2020,414094,121906,536000,MKT
06079918256240000,2019,414094,121906,536000,MKT
06079918256260000,2021,507465,362035,869500,MKT
06079918256260000,2020,414094,358906,773000,MKT
06079918256260000,2019,414094,358906,773000,MKT
06079918257010000,2021,1438811,1719510,3158321,COST
06079918257010000,2020,671893,1520270,2192163,COST
06079918257010000,2019,671893,1520270,2192163,COST
06079918257100000,2021,1332709,0,1332709,COST
06079918257100000,2020,671893,0,671893,COST
06079918257100000,2019,671893,0,671893,COST
06079918258010000,2021,321573,232627,554200,MKT
06079918258010000,2020,271778,212622,484400,MKT
06079918258010000,2019,271778,212622,484400,MKT
06079918258040000,2021,321573,307027,628600,MKT
06079918258040000,2020,271778,264422,536200,MKT
06079918258040000,2019,271778,264422,536200,MKT
06079918258070000,2021,364940,207860,572800,MKT
06079918258070000,2020,289572,148528,438100,MKT
06079918258070000,2019,289572,148528,438100,MKT
06079918258090000,2021,321573,230527,552100,MKT
06079918258090000,2020,271778,159322,431100,MKT
06079918258090000,2019,271778,159322,431100,MKT
06079918258110000,2021,364940,240460,605400,MKT
06079918258110000,2020,289572,218628,508200,MKT
06079918258110000,2019,289572,218628,508200,MKT
06079918258130000,2021,338795,173105,511900,MKT
06079918258130000,2020,278980,199120,478100,MKT
06079918258130000,2019,278980,199120,478100,MKT
06079918258160000,2021,667865,1389730,2057595,COST
06079918258160000,2020,475219,496660,971879,COST
06079918258160000,2019,475219,217520,692739,COST
06079918258190000,2021,644683,618350,1263033,COST
06079918258190000,2020,466877,494810,961687,COST
06079918258190000,2019,466877,494810,961687,COST
06079918258220000,2021,644683,291300,935983,COST
06079918258220000,2020,466877,260923,727800,MKT
06079918258220000,2019,466877,260923,727800,MKT
06079918258260000,2021,754636,471870,1226506,COST
06079918258260000,2020,505226,375910,881136,COST
06079918258260000,2019,505226,375910,881136,COST
06079918259060000,2021,341037,248263,589300,MKT
06079918259060000,2020,279904,201796,481700,MKT
06079918259060000,2019,279904,201796,481700,MKT
06079918259090000,2021,341037,326363,667400,MKT
06079918259090000,2020,279904,252596,532500,MKT
06079918259090000,2019,279904,252596,532500,MKT
06079918259110000,2021,341037,273863,614900,MKT
06079918259110000,2020,279904,247596,527500,MKT
06079918259110000,2019,279904,247596,527500,MKT
06079918259130000,2021,321924,203876,525800,MKT
06079918259130000,2020,271927,137673,409600,MKT
06079918259130000,2019,271927,137673,409600,MKT
06079918259150000,2021,321924,366676,688600,MKT
06079918259150000,2020,271927,293973,565900,MKT
06079918259150000,2019,271927,293973,565900,MKT
06079918259160000,2021,301823,176377,478200,MKT
06079918259160000,2020,263279,181121,444400,MKT
06079918259160000,2019,263279,181121,444400,MKT
06079918259180000,2021,341037,183263,524300,MKT
06079918259180000,2020,279904,122096,402000,MKT
06079918259180000,2019,279904,122096,402000,MKT
06079918261010000,2021,157784,303416,461200,MKT
06079918261010000,2020,114570,242430,357000,MKT
06079918261010000,2019,114570,242430,357000,MKT
06079918261030000,2021,140776,257524,398300,MKT
06079918261030000,2020,102385,231115,333500,MKT
06079918261030000,2019,102385,231115,333500,MKT
06079918261050000,2021,140776,334624,475400,MKT
06079918261050000,2020,102385,263115,365500,MKT
06079918261050000,2019,102385,263115,365500,MKT
06079918261070000,2021,173108,176092,349200,INCOME
06079918261070000,2020,102385,230015,332400,INCOME
06079918261070000,2019,102385,230015,332400,INCOME
06079918261090000,2021,111635,240465,352100,MKT
06079918261090000,2020,81458,233042,314500,MKT
06079918261090000,2019,81458,233042,314500,MKT
06079918261100000,2021,111635,293565,405200,MKT
06079918261100000,2020,81458,255242,336700,MKT
06079918261100000,2019,81458,255242,336700,MKT
06079918296010000,2021,393246,0,393246,COST
06079918296010000,2020,281880,0,281880,COST
06079918296010000,2019,281880,0,281880,COST
06079918296020000,2021,242015,0,242015,COST
06079918296020000,2020,174672,0,174672,COST
06079918296020000,2019,174672,0,174672,COST
06079918297250000,2021,170182,230018,400200,MKT
06079918297250000,2020,123440,241560,365000,MKT
06079918297250000,2019,123440,241560,365000,MKT
06079918297300000,2021,1226836,2546464,3773300,INCOME
06079918297300000,2020,917015,2397285,3314300,INCOME
06079918297300000,2019,917015,2397285,3314300,INCOME
06079918297350000,2021,83357,0,83357,COST
06079918297350000,2020,61076,0,61076,COST
06079918297350000,2019,61076,0,61076,COST
06079918299010000,2021,319408,0,319408,COST
06079918299010000,2020,229627,0,229627,COST
06079918299010000,2019,229627,0,229627,COST
06079918299030000,2021,88287,0,88287,COST
06079918299030000,2020,64635,0,64635,COST
06079918299030000,2019,64635,0,64635,COST
06079918299040000,2021,272867,0,272867,COST
06079918299040000,2020,196605,0,196605,COST
06079918299040000,2019,196605,0,196605,COST
06079918301010000,2021,190516,346484,537000,MKT
06079918301010000,2020,142980,333820,476800,MKT
06079918301010000,2019,142980,333820,476800,MKT
06079918301020000,2021,191390,348910,540300,MKT
06079918301020000,2020,143627,379773,523400,MKT
06079918301020000,2019,143627,379773,523400,MKT
06079918301030000,2021,187100,483800,670900,MKT
06079918301030000,2020,140452,481270,621722,COST
06079918301030000,2019,140452,481270,621722,COST
06079918301040000,2021,158110,646890,805000,MKT
06079918301040000,2020,114803,670880,785683,COST
06079918301040000,2019,114803,670880,785683,COST
06079918301050000,2021,157142,342358,499500,MKT
06079918301050000,2020,118255,341245,459500,MKT
06079918301050000,2019,118255,341245,459500,MKT
06079918301060000,2021,157723,353577,511300,MKT
06079918301060000,2020,118686,314114,432800,MKT
06079918301060000,2019,118686,314114,432800,MKT
06079918301076500,2021,105499,0,105499,COST
06079918301076500,2020,75742,0,75742,COST
06079918301076500,2019,75742,0,75742,COST
06079918301080000,2021,695077,1213840,1908917,COST
06079918301080000,2020,313033,1175590,1488623,COST
06079918301080000,2019,313033,1175590,1488623,COST
06079918303010000,2021,168188,275912,444100,MKT
06079918303010000,2020,122014,279786,401800,MKT
06079918303010000,2019,122014,279786,401800,MKT
06079918303020000,2021,161130,350870,512000,MKT
06079918303020000,2020,116965,366435,483400,MKT
06079918303020000,2019,116965,366435,483400,MKT
06079918303030000,2021,162727,357173,519900,MKT
06079918303030000,2020,118107,369093,487200,MKT
06079918303030000,2019,118107,369093,487200,MKT
06079918303040000,2021,168000,405200,573200,MKT
06079918303040000,2020,121880,342720,464600,MKT
06079918303040000,2019,121880,342720,464600,MKT
06079918303050000,2021,167077,385223,552300,MKT
06079918303050000,2020,121220,334580,455800,MKT
06079918303050000,2019,121220,335380,456600,MKT
06079918303060000,2021,169089,491511,660600,MKT
06079918303060000,2020,122659,402241,524900,MKT
06079918303060000,2019,122659,392041,514700,MKT
06079918303070000,2021,169089,273911,443000,MKT
06079918303070000,2020,122659,285541,408200,MKT
06079918303070000,2019,122659,285541,408200,MKT
06079918303080000,2021,147948,311152,459100,MKT
06079918303080000,2020,107526,281674,389200,MKT
06079918303080000,2019,107526,281674,389200,MKT
06079918303090000,2021,143292,334108,477400,MKT
06079918303090000,2020,104189,261111,365300,MKT
06079918303090000,2019,104189,261111,365300,MKT
06079918303100000,2021,155657,360943,516600,MKT
06079918303100000,2020,113047,354153,467200,MKT
06079918303100000,2019,113047,354153,467200,MKT
06079918303110000,2021,160219,340581,500800,MKT
06079918303110000,2020,116313,345387,461700,MKT
06079918303110000,2019,116313,345387,461700,MKT
06079918303120000,2021,154512,347088,501600,MKT
06079918303120000,2020,112227,351173,463400,MKT
06079918303120000,2019,112227,351173,463400,MKT
06079918303130000,2021,162621,374279,536900,MKT
06079918303130000,2020,118032,379568,497600,MKT
06079918303130000,2019,118032,379568,497600,MKT
06079918303140000,2021,158581,368019,526600,MKT
06079918303140000,2020,115140,340360,455500,MKT
06079918303140000,2019,115140,340360,455500,MKT
06079918303150000,2021,151534,413666,565200,MKT
06079918303150000,2020,110095,375205,485300,MKT
06079918303150000,2019,110095,375205,485300,MKT
06079918304030000,2021,52256,0,52256,COST
06079918304030000,2020,37891,0,37891,COST
06079918304030000,2019,37891,0,37891,COST
06079918304110000,2021,282151,478749,760900,MKT
06079918304110000,2020,203198,393302,596500,MKT
06079918304110000,2019,203198,393302,596500,MKT
06079918304120000,2021,280203,346497,626700,MKT
06079918304120000,2020,201815,398385,600200,MKT
06079918304120000,2019,201815,398385,600200,MKT
06079918304130000,2021,258103,303197,561300,MKT
06079918304130000,2020,186113,300187,486300,MKT
06079918304130000,2019,186113,300187,486300,MKT
06079918304140000,2021,282652,357148,639800,MKT
06079918304140000,2020,203554,477330,680884,COST
06079918304140000,2019,203554,477330,680884,COST
06079918304150000,2021,282652,2150840,2433492,COST
06079918304150000,2020,203554,2101940,2305494,COST
06079918304150000,2019,203554,2101940,2305494,COST
06079918304160000,2021,282652,0,282652,COST
06079918304160000,2020,203554,0,203554,COST
06079918304160000,2019,203554,0,203554,COST
06079918304170000,2021,282652,536248,818900,MKT
06079918304170000,2020,203554,581170,784724,COST
06079918304170000,2019,203554,581170,784724,COST
06079918304180000,2021,225481,468220,693701,COST
06079918304180000,2020,162902,451960,614862,COST
06079918304180000,2019,162902,451960,614862,COST
06079918304200000,2021,321098,0,321098,COST
06079918304200000,2020,230824,0,230824,COST
06079918304200000,2019,230824,0,230824,COST
06079918304220000,2021,424340,680900,1105240,COST
06079918304220000,2020,303841,662770,966611,COST
06079918304220000,2019,303841,662770,966611,COST
06079918304250000,2021,218799,386801,605600,MKT
06079918304250000,2020,158141,330359,488500,MKT
06079918304250000,2019,158141,314759,472900,MKT
06079918304260000,2021,196766,313734,510500,MKT
06079918304260000,2020,142430,291070,433500,OVR
06079918304260000,2019,142430,291070,433500,MKT
06079918304280000,2021,169694,346006,515700,MKT
06079918304280000,2020,123092,346908,470000,MKT
06079918304280000,2019,123092,346908,470000,MKT
06079918304290000,2021,539026,375274,914300,INCOME
06079918304290000,2020,625510,268490,894000,INCOME
06079918304290000,2019,625510,268490,894000,INCOME
06079918304300000,2021,179044,339556,518600,MKT
06079918304300000,2020,129775,340125,469900,MKT
06079918304300000,2019,129775,340125,469900,MKT
06079918304327000,2021,374405,0,374405,COST
06079918304327000,2020,268560,0,268560,COST
06079918304327000,2019,268560,0,268560,COST
06079918304347000,2021,355010,0,355010,COST
06079918304347000,2020,254840,0,254840,COST
06079918304347000,2019,254840,0,254840,COST
06079918305010000,2021,1052083,1372417,2424500,INCOME
06079918305010000,2020,946608,1388392,2335000,INCOME
06079918305010000,2019,946608,1388392,2335000,INCOME
06079918305020000,2021,1043676,1580520,2624196,COST
06079918305020000,2020,237983,1533550,1771533,COST
06079918305020000,2019,237983,1533550,1771533,COST
06079918305037000,2021,382524,0,382524,COST
06079918305037000,2020,299272,0,299272,COST
06079918305037000,2019,299272,0,299272,COST
06079918305046500,2021,92337,0,92337,COST
06079918305046500,2020,59396,0,59396,COST
06079918305046500,2019,59396,0,59396,COST
06079918309010000,2021,155304,437396,592700,MKT
06079918309010000,2020,112794,407806,520600,MKT
06079918309010000,2019,112794,407806,520600,MKT
06079918309020000,2021,153487,396413,549900,MKT
06079918309020000,2020,111493,320807,432300,MKT
06079918309020000,2019,111493,320807,432300,MKT
06079918309030000,2021,151228,452072,603300,MKT
06079918309030000,2020,109875,447625,557500,MKT
06079918309030000,2019,109875,447625,557500,MKT
06079918309040000,2021,136553,373847,510400,MKT
06079918309040000,2020,99356,335644,435000,MKT
06079918309040000,2019,99356,335644,435000,MKT
06079918309050000,2021,133152,384848,518000,MKT
06079918309050000,2020,96917,351983,448900,MKT
06079918309050000,2019,96917,350183,447100,MKT
06079918309060000,2021,133152,341248,474400,MKT
06079918309060000,2020,96917,338883,435800,MKT
06079918309060000,2019,96917,338883,435800,MKT
06079918309070000,2021,133152,389048,522200,MKT
06079918309070000,2020,96917,337783,434700,MKT
06079918309070000,2019,96917,337783,434700,MKT
06079918309080000,2021,133152,507448,640600,MKT
06079918309080000,2020,96917,485583,582500,OVR
06079918309080000,2019,96917,485583,582500,MKT
06079918309090000,2021,136337,316263,452600,MKT
06079918309090000,2020,99202,280198,379400,MKT
06079918309090000,2019,99202,280198,379400,MKT
06079918309100000,2021,136052,349848,485900,MKT
06079918309100000,2020,98997,329003,428000,MKT
06079918309100000,2019,98997,329003,428000,MKT
06079918309110000,2021,136052,386248,522300,MKT
06079918309110000,2020,98997,340203,439200,MKT
06079918309110000,2019,98997,340203,439200,MKT
06079918309120000,2021,201815,396585,598400,MKT
06079918309120000,2020,146033,447867,593900,MKT
06079918309120000,2019,146033,447867,593900,MKT
06079918309247000,2021,1662693,126850,1789543,COST
06079918309247000,2020,1151639,131350,1282989,COST
06079918309247000,2019,1151639,131350,1282989,COST
06079918310010000,2021,133223,437177,570400,MKT
06079918310010000,2020,96968,393432,490400,MKT
06079918310010000,2019,96968,393432,490400,MKT
06079918310020000,2021,155778,404822,560600,MKT
06079918310020000,2020,113134,360166,473300,MKT
06079918310020000,2019,113134,360166,473300,MKT
06079918310030000,2021,151074,383626,534700,MKT
06079918310030000,2020,109765,318135,427900,OVR
06079918310030000,2019,109765,318135,427900,MKT
06079918310040000,2021,140818,376682,517500,MKT
06079918310040000,2020,102416,359584,462000,MKT
06079918310040000,2019,102416,359584,462000,MKT
06079918310050000,2021,157806,348594,506400,MKT
06079918310050000,2020,114586,349514,464100,MKT
06079918310050000,2019,114586,349514,464100,MKT
06079918310060000,2021,157246,350354,507600,MKT
06079918310060000,2020,114185,329215,443400,MKT
06079918310060000,2019,114185,329215,443400,MKT
06079918310070000,2021,180837,366163,547000,MKT
06079918310070000,2020,131056,343744,474800,MKT
06079918310070000,2019,131056,343744,474800,MKT
06079918310080000,2021,182789,375111,557900,MKT
06079918310080000,2020,132451,324949,457400,MKT
06079918310080000,2019,132451,340949,473400,MKT
06079918310090000,2021,154290,332010,486300,MKT
06079918310090000,2020,112068,309532,421600,MKT
06079918310090000,2019,112068,309532,421600,MKT
06079918310100000,2021,149577,479523,629100,MKT
06079918310100000,2020,108693,421907,530600,MKT
06079918310100000,2019,108693,421907,530600,MKT
06079918310110000,2021,140328,318472,458800,MKT
06079918310110000,2020,102064,292136,394200,MKT
06079918310110000,2019,102064,292136,394200,MKT
06079918310120000,2021,135537,461263,596800,MKT
06079918310120000,2020,98628,389872,488500,MKT
06079918310120000,2019,98628,389872,488500,MKT
06079918310130000,2021,133087,392713,525800,MKT
06079918310130000,2020,96870,375030,471900,MKT
06079918310130000,2019,96870,375030,471900,MKT
06079918310140000,2021,133087,415713,548800,MKT
06079918310140000,2020,96870,351930,448800,MKT
06079918310140000,2019,96870,351930,448800,MKT
06079918310150000,2021,133087,383013,516100,MKT
06079918310150000,2020,96870,335230,432100,MKT
06079918310150000,2019,96870,335230,432100,MKT
06079918310160000,2021,133941,318459,452400,MKT
06079918310160000,2020,97483,316817,414300,MKT
06079918310160000,2019,97483,316817,414300,MKT
06079918310170000,2021,137973,357227,495200,MKT
06079918310170000,2020,100375,294125,394500,MKT
06079918310170000,2019,100375,294125,394500,MKT
06079918310180000,2021,139725,445075,584800,MKT
06079918310180000,2020,101631,392769,494400,MKT
06079918310180000,2019,101631,392769,494400,MKT
06079918310190000,2021,140039,306561,446600,MKT
06079918310190000,2020,101857,295843,397700,MKT
06079918310190000,2019,101857,295843,397700,MKT
06079918310200000,2021,134674,421326,556000,MKT
06079918310200000,2020,98009,396891,494900,MKT
06079918310200000,2019,98009,396891,494900,MKT
06079918310210000,2021,137961,334339,472300,MKT
06079918310210000,2020,100366,302534,402900,MKT
06079918310210000,2019,100366,302534,402900,MKT
06079918310220000,2021,140180,385220,525400,MKT
06079918310220000,2020,101958,343842,445800,MKT
06079918310220000,2019,101958,343842,445800,MKT
06079918310230000,2021,138566,349034,487600,MKT
06079918310230000,2020,100800,339300,440100,MKT
06079918310230000,2019,100800,339300,440100,MKT
06079918317010000,2021,435596,429804,865400,INCOME
06079918317010000,2020,144831,675369,820200,INCOME
06079918317010000,2019,144831,675369,820200,INCOME
06079918317035001,2021,100460,215840,316300,MKT
06079918317035001,2020,73413,267287,340700,MKT
06079918317035001,2019,73413,267287,340700,MKT
06079918317045002,2021,108834,211266,320100,MKT
06079918317045002,2020,79443,269357,348800,MKT
06079918317045002,2019,79443,269357,348800,MKT
06079918317090000,2021,219529,254971,474500,INCOME
06079918317090000,2020,158662,293038,451700,INCOME
06079918317090000,2019,158662,293038,451700,INCOME
06079918317107000,2021,336050,0,336050,COST
06079918317107000,2020,241418,0,241418,COST
06079918317107000,2019,241418,0,241418,COST
06079918317157000,2021,169195,0,169195,COST
06079918317157000,2020,122735,0,122735,COST
06079918317157000,2019,122735,0,122735,COST
06079918317160000,2021,151080,282320,433400,MKT
06079918317160000,2020,109769,279331,389100,MKT
06079918317160000,2019,109769,279331,389100,MKT
06079918317170000,2021,119358,269142,388500,MKT
06079918317170000,2020,87011,228289,315300,MKT
06079918317170000,2019,87011,228289,315300,MKT
06079918317180000,2021,119358,313242,432600,MKT
06079918317180000,2020,87011,284689,371700,MKT
06079918317180000,2019,87011,281189,368200,MKT
06079918317190000,2021,119358,249942,369300,MKT
06079918317190000,2020,87011,248589,335600,MKT
06079918317190000,2019,87011,248589,335600,MKT
06079918317200000,2021,119358,310042,429400,MKT
06079918317200000,2020,87011,278689,365700,MKT
06079918317200000,2019,87011,278689,365700,MKT
06079918317210000,2021,119358,364642,484000,MKT
06079918317210000,2020,87011,318489,405500,OVR
06079918317210000,2019,87011,318489,405500,MKT
06079918317220000,2021,119358,347042,466400,MKT
06079918317220000,2020,87011,281089,368100,MKT
06079918317220000,2019,87011,281089,368100,MKT
06079918317230000,2021,119358,329642,449000,MKT
06079918317230000,2020,87011,308289,395300,OVR
06079918317230000,2019,87011,308289,395300,MKT
06079918317240000,2021,119939,276361,396300,INCOME
06079918317240000,2020,87429,286371,373800,INCOME
06079918317240000,2019,87429,286371,373800,INCOME
06079918317250000,2021,119358,296842,416200,MKT
06079918317250000,2020,87011,248089,335100,MKT
06079918317250000,2019,87011,248089,335100,MKT
06079918317260000,2021,119358,375742,495100,MKT
06079918317260000,2020,87011,327589,414600,MKT
06079918317260000,2019,87011,327589,414600,MKT
06079918317270000,2021,119358,345642,465000,MKT
06079918317270000,2020,87011,327389,414400,MKT
06079918317270000,2019,87011,327389,414400,MKT
06079918317280000,2021,119358,341942,461300,MKT
06079918317280000,2020,87011,328189,415200,MKT
06079918317280000,2019,87011,336689,423700,MKT
06079918317290000,2021,119358,317142,436500,MKT
06079918317290000,2020,87011,308789,395800,MKT
06079918317290000,2019,87011,308789,395800,MKT
06079918317300000,2021,119358,390542,509900,MKT
06079918317300000,2020,87011,313589,400600,MKT
06079918317300000,2019,87011,290089,377100,MKT
06079918317310000,2021,119358,405242,524600,MKT
06079918317310000,2020,87011,358190,445201,COST
06079918317310000,2019,87011,310889,397900,MKT
06079918317320000,2021,121746,354754,476500,MKT
06079918317320000,2020,87011,348189,435200,MKT
06079918317320000,2019,87011,348189,435200,MKT
06079918317330000,2021,121746,328054,449800,MKT
06079918317330000,2020,87011,278189,365200,MKT
06079918317330000,2019,87011,278189,365200,MKT
06079918317340000,2021,121746,310554,432300,MKT
06079918317340000,2020,87011,279289,366300,MKT
06079918317340000,2019,87011,279289,366300,MKT
06079918317350000,2021,121746,278554,400300,MKT
06079918317350000,2020,87011,260889,347900,MKT
06079918317350000,2019,87011,260889,347900,MKT
06079918317360000,2021,121404,346896,468300,MKT
06079918317360000,2020,86770,292230,379000,MKT
06079918317360000,2019,86770,292230,379000,MKT
06079918324010000,2021,305251,271649,576900,INCOME
06079918324010000,2020,108820,437980,546800,INCOME
06079918324010000,2019,108820,437980,546800,INCOME
06079918324030000,2021,146529,430371,576900,INCOME
06079918324030000,2020,106509,440291,546800,INCOME
06079918324030000,2019,106509,440291,546800,INCOME
06079918324050000,2021,449354,668146,1117500,INCOME
06079918324050000,2020,578606,487294,1065900,INCOME
06079918324050000,2019,578606,487294,1065900,INCOME
06079918324077000,2021,295077,0,295077,COST
06079918324077000,2020,212373,0,212373,COST
06079918324077000,2019,212373,0,212373,COST
06079918324097000,2021,177116,0,177116,COST
06079918324097000,2020,128398,0,128398,COST
06079918324097000,2019,128398,0,128398,COST
06079918324100000,2021,294924,286876,581800,INCOME
06079918324100000,2020,105850,426750,532600,INCOME
06079918324100000,2019,105850,426750,532600,INCOME
06079918324110000,2021,143262,283238,426500,INCOME
06079918324110000,2020,104168,286332,390500,INCOME
06079918324110000,2019,104168,286332,390500,INCOME
06079918324130000,2021,143004,317496,460500,INCOME
06079918324130000,2020,103982,314318,418300,INCOME
06079918324130000,2019,103982,314318,418300,INCOME
06079918324157000,2021,161194,0,161194,COST
06079918324157000,2020,117011,0,117011,COST
06079918324157000,2019,117011,0,117011,COST
06079918324170000,2021,135167,367833,503000,MKT
06079918324170000,2020,98363,336237,434600,MKT
06079918324170000,2019,98363,336237,434600,MKT
06079918324230000,2021,294586,265714,560300,INCOME
06079918324230000,2020,105753,413347,519100,INCOME
06079918324230000,2019,105753,413347,519100,INCOME
06079918324255001,2021,80494,215806,296300,MKT
06079918324255001,2020,59007,248393,307400,MKT
06079918324255001,2019,59007,248393,307400,MKT
06079918324255002,2021,79452,215848,295300,MKT
06079918324255002,2020,58254,248346,306600,MKT
06079918324255002,2019,58254,248346,306600,MKT
06079918324270000,2021,118188,236912,355100,INCOME
06079918324270000,2020,86170,240330,326500,INCOME
06079918324270000,2019,86170,240330,326500,INCOME
06079918325017000,2021,144203,0,144203,COST
06079918325017000,2020,104842,0,104842,COST
06079918325017000,2019,104842,0,104842,COST
06079918325020000,2021,116251,408449,524700,MKT
06079918325020000,2020,84778,357422,442200,MKT
06079918325020000,2019,84778,357422,442200,MKT
06079918325030000,2021,123547,302953,426500,INCOME
06079918325030000,2020,90021,300479,390500,INCOME
06079918325030000,2019,90021,300479,390500,INCOME
06079918325040000,2021,130297,348603,478900,INCOME
06079918325040000,2020,94867,353133,448000,INCOME
06079918325040000,2019,94867,353133,448000,INCOME
06079918325050000,2021,136698,340902,477600,MKT
06079918325050000,2020,99461,293539,393000,MKT
06079918325050000,2019,99461,293539,393000,MKT
06079918325060000,2021,139836,339064,478900,INCOME
06079918325060000,2020,101711,346289,448000,INCOME
06079918325060000,2019,101711,346289,448000,INCOME
06079918325070000,2021,185037,517363,702400,INCOME
06079918325070000,2020,108020,578680,686700,INCOME
06079918325070000,2019,108020,578680,686700,INCOME
06079918325080000,2021,193634,405666,599300,INCOME
06079918325080000,2020,112036,458364,570400,INCOME
06079918325080000,2019,112036,458364,570400,INCOME
06079918325097000,2021,133074,0,133074,COST
06079918325097000,2020,96861,0,96861,COST
06079918325097000,2019,96861,0,96861,COST
06079918325100000,2021,160657,205743,366400,INCOME
06079918325100000,2020,96422,258378,354800,INCOME
06079918325100000,2019,96422,258378,354800,INCOME
06079918325117000,2021,132521,0,132521,COST
06079918325117000,2020,96464,0,96464,COST
06079918325117000,2019,96464,0,96464,COST
06079918325127000,2021,133003,0,133003,COST
06079918325127000,2020,96809,0,96809,COST
06079918325127000,2019,96809,0,96809,COST
06079918325130000,2021,193634,383266,576900,INCOME
06079918325130000,2020,112036,434764,546800,INCOME
06079918325130000,2019,112036,434764,546800,INCOME
06079918325147000,2021,148638,0,148638,COST
06079918325147000,2020,108020,0,108020,COST
06079918325147000,2019,108020,0,108020,COST
06079918325150000,2021,180552,465448,646000,INCOME
06079918325150000,2020,105910,526390,632300,INCOME
06079918325150000,2019,105910,526390,632300,INCOME
06079918325167000,2021,136698,0,136698,COST
06079918325167000,2020,99461,0,99461,COST
06079918325167000,2019,99461,0,99461,COST
06079918325175001,2021,76027,192773,268800,MKT
06079918325175001,2020,55778,242522,298300,MKT
06079918325175001,2019,55778,242522,298300,MKT
06079918325175002,2021,74109,183491,257600,MKT
06079918325175002,2020,54390,231010,285400,MKT
06079918325175002,2019,54390,231010,285400,MKT
06079918325175003,2021,78498,188902,267400,MKT
06079918325175003,2020,57564,232836,290400,MKT
06079918325175003,2019,57564,232836,290400,MKT
06079918325180000,2021,123547,244853,368400,INCOME
06079918325180000,2020,90021,266379,356400,INCOME
06079918325180000,2019,90021,266379,356400,INCOME
06079918325190000,2021,116079,256021,372100,INCOME
06079918325190000,2020,84654,283846,368500,INCOME
06079918325190000,2019,84654,283846,368500,INCOME
06079918328010000,2021,205290,0,205290,COST
06079918328010000,2020,148512,0,148512,COST
06079918328010000,2019,148512,0,148512,COST
06079918328020000,2021,163471,334429,497900,MKT
06079918328020000,2020,118640,331960,450600,OVR
06079918328020000,2019,118640,331960,450600,MKT
06079918328030000,2021,154073,367127,521200,MKT
06079918328030000,2020,111913,340987,452900,OVR
06079918328030000,2019,111913,340987,452900,MKT
06079918328040000,2021,154073,361327,515400,MKT
06079918328040000,2020,111913,336087,448000,MKT
06079918328040000,2019,111913,336087,448000,MKT
06079918328050000,2021,154073,338027,492100,MKT
06079918328050000,2020,111913,269187,381100,MKT
06079918328050000,2019,111913,269187,381100,MKT
06079918328060000,2021,154073,404927,559000,MKT
06079918328060000,2020,111913,391887,503800,MKT
06079918328060000,2019,111913,391887,503800,MKT
06079918328070000,2021,154073,349227,503300,MKT
06079918328070000,2020,111913,362487,474400,MKT
06079918328070000,2019,111913,362487,474400,MKT
06079918328080000,2021,153235,378065,531300,MKT
06079918328080000,2020,111313,362487,473800,MKT
06079918328080000,2019,111313,362487,473800,MKT
06079918328090000,2021,149709,372191,521900,MKT
06079918328090000,2020,108787,346813,455600,MKT
06079918328090000,2019,108787,335913,444700,MKT
06079918328100000,2021,146716,385484,532200,MKT
06079918328100000,2020,106643,340557,447200,MKT
06079918328100000,2019,106643,340557,447200,MKT
06079918328110000,2021,156420,375680,532100,MKT
06079918328110000,2020,113594,325106,438700,MKT
06079918328110000,2019,113594,325106,438700,MKT
06079918328120000,2021,149088,432612,581700,MKT
06079918328120000,2020,108342,367258,475600,MKT
06079918328120000,2019,108342,367258,475600,MKT
06079918328130000,2021,169699,371201,540900,MKT
06079918328130000,2020,123095,329405,452500,MKT
06079918328130000,2019,123095,329405,452500,MKT
06079918329010000,2021,373682,407618,781300,INCOME
06079918329010000,2020,534657,246643,781300,INCOME
06079918329010000,2019,534657,246643,781300,INCOME
06079918329030000,2021,465281,583619,1048900,INCOME
06079918329030000,2020,587304,377896,965200,INCOME
06079918329030000,2019,587304,377896,965200,INCOME
06079918329050000,2021,953597,605703,1559300,INCOME
06079918329050000,2020,733423,707377,1440800,INCOME
06079918329050000,2019,733423,707377,1440800,INCOME
06079918329070000,2021,494416,240584,735000,INCOME
06079918329070000,2020,553541,149059,702600,INCOME
06079918329070000,2019,553541,149059,702600,INCOME
06079918329096500,2021,590721,57720,648441,COST
06079918329096500,2020,300173,55880,356053,COST
06079918329096500,2019,300173,55880,356053,COST
06079918329110000,2021,459944,302956,762900,INCOME
06079918329110000,2020,536666,124934,661600,INCOME
06079918329110000,2019,536666,124934,661600,INCOME
06079918329130000,2021,791158,326530,1117688,COST
06079918329130000,2020,677037,294980,972017,COST
06079918329130000,2019,677037,294980,972017,COST
06079918329150000,2021,778343,136457,914800,INCOME
06079918329150000,2020,672317,107783,780100,INCOME
06079918329150000,2019,672317,107783,780100,INCOME
06079918329170000,2021,656011,254489,910500,INCOME
06079918329170000,2020,624831,250469,875300,INCOME
06079918329170000,2019,624831,250469,875300,INCOME
06079918329190000,2021,559083,112217,671300,INCOME
06079918329190000,2020,583469,58231,641700,INCOME
06079918329190000,2019,583469,58231,641700,INCOME
06079918329210000,2021,181806,384194,566000,MKT
06079918329210000,2020,136534,396766,533300,MKT
06079918329210000,2019,136534,396766,533300,MKT
06079918329220000,2021,181806,331694,513500,MKT
06079918329220000,2020,136534,282666,419200,MKT
06079918329220000,2019,136534,282666,419200,MKT
06079918329236500,2021,296147,0,296147,COST
06079918329236500,2020,223311,0,223311,COST
06079918329236500,2019,223311,0,223311,COST
06079918329270000,2021,118114,373386,491500,MKT
06079918329270000,2020,86117,344883,431000,MKT
06079918329270000,2019,86117,344883,431000,MKT
06079918329290000,2021,129798,415502,545300,MKT
06079918329290000,2020,94509,355191,449700,OVR
06079918329290000,2019,94509,355191,449700,MKT
06079918333017000,2021,167720,0,167720,COST
06079918333017000,2020,121680,0,121680,COST
06079918333017000,2019,121680,0,121680,COST
06079918333025000,2021,25928,0,25928,COST
06079918333025000,2020,18988,0,18988,COST
06079918333025000,2019,18988,0,18988,COST
06079918333025001,2021,71453,197047,268500,MKT
06079918333025001,2020,52520,255980,308500,MKT
06079918333025001,2019,52520,255980,308500,MKT
06079918333025002,2021,70425,212575,283000,MKT
06079918333025002,2020,51774,255326,307100,MKT
06079918333025002,2019,51774,255326,307100,MKT
06079918333025003,2021,70788,195112,265900,MKT
06079918333025003,2020,52038,255362,307400,MKT
06079918333025003,2019,52038,255362,307400,MKT
06079918333025004,2021,70243,197057,267300,MKT
06079918333025004,2020,51642,255958,307600,MKT
06079918333025004,2019,51642,255958,307600,MKT
06079918333030000,2021,148684,304316,453000,MKT
06079918333030000,2020,108053,264747,372800,MKT
06079918333030000,2019,108053,264747,372800,MKT
06079918333040000,2021,147599,339401,487000,MKT
06079918333040000,2020,107276,302624,409900,MKT
06079918333040000,2019,107276,302624,409900,MKT
06079918333050000,2021,147056,709480,856536,COST
06079918333050000,2020,106887,649800,756687,COST
06079918333050000,2019,106887,649800,756687,COST
06079918333060000,2021,146000,254200,400200,INCOME
06079918333060000,2020,106130,267170,373300,INCOME
06079918333060000,2019,106130,267170,373300,INCOME
06079918333070000,2021,146000,229400,375400,INCOME
06079918333070000,2020,106130,251270,357400,INCOME
06079918333070000,2019,106130,251270,357400,INCOME
06079918333080000,2021,146000,250800,396800,INCOME
06079918333080000,2020,106130,280670,386800,INCOME
06079918333080000,2019,106130,280670,386800,INCOME
06079918333097000,2021,146053,0,146053,COST
06079918333097000,2020,106168,0,106168,COST
06079918333097000,2019,106168,0,106168,COST
06079918337010000,2021,125910,368290,494200,MKT
06079918337010000,2020,91718,333482,425200,MKT
06079918337010000,2019,91718,333482,425200,MKT
06079918337020000,2021,141685,374415,516100,MKT
06079918337020000,2020,103037,330463,433500,MKT
06079918337020000,2019,103037,330463,433500,MKT
06079918337030000,2021,172453,334747,507200,MKT
06079918337030000,2020,125064,341836,466900,MKT
06079918337030000,2019,125064,341836,466900,MKT
06079918337040000,2021,133119,364781,497900,MKT
06079918337040000,2020,96893,361607,458500,OVR
06079918337040000,2019,96893,361607,458500,MKT
06079918337050000,2021,142648,343252,485900,MKT
06079918337050000,2020,103727,332273,436000,MKT
06079918337050000,2019,103727,332273,436000,MKT
06079918337060000,2021,142648,379352,522000,MKT
06079918337060000,2020,103727,323673,427400,MKT
06079918337060000,2019,103727,323673,427400,MKT
06079918337070000,2021,191572,321028,512600,MKT
06079918337070000,2020,138723,294477,433200,MKT
06079918337070000,2019,138723,294477,433200,MKT
06079918337080000,2021,166677,377423,544100,MKT
06079918337080000,2020,120934,383266,504200,MKT
06079918337080000,2019,120934,383266,504200,MKT
06079918337090000,2021,164743,348357,513100,MKT
06079918337090000,2020,119550,276050,395600,MKT
06079918337090000,2019,119550,276050,395600,MKT
06079918337100000,2021,126418,362382,488800,MKT
06079918337100000,2020,92083,350317,442400,MKT
06079918337100000,2019,92083,350317,442400,MKT
06079918337110000,2021,126418,345282,471700,MKT
06079918337110000,2020,92083,359017,451100,MKT
06079918337110000,2019,92083,359017,451100,MKT
06079918337120000,2021,126418,349082,475500,MKT
06079918337120000,2020,92083,295317,387400,MKT
06079918337120000,2019,92083,295317,387400,MKT
06079918337130000,2021,46533,0,46533,COST
06079918337130000,2020,33797,0,33797,COST
06079918337130000,2019,33797,0,33797,COST
06079918339010000,2021,183766,336934,520700,MKT
06079918339010000,2020,137985,296615,434600,MKT
06079918339010000,2019,137985,296615,434600,MKT
06079918339020000,2021,186665,298335,485000,MKT
06079918339020000,2020,140131,292869,433000,MKT
06079918339020000,2019,140131,292869,433000,MKT
06079918339030000,2021,186665,295135,481800,MKT
06079918339030000,2020,140131,270669,410800,MKT
06079918339030000,2019,140131,270669,410800,MKT
06079918339040000,2021,185704,383696,569400,MKT
06079918339040000,2020,139420,398780,538200,MKT
06079918339040000,2019,139420,398780,538200,MKT
06079918339050000,2021,208520,353580,562100,MKT
06079918339050000,2020,156292,330208,486500,MKT
06079918339050000,2019,156292,330208,486500,MKT
06079918340010000,2021,116610,292090,408700,MKT
06079918340010000,2020,85036,269464,354500,MKT
06079918340010000,2019,85036,269464,354500,MKT
06079918340025001,2021,95967,246733,342700,MKT
06079918340025001,2020,70175,247025,317200,MKT
06079918340025001,2019,70175,247025,317200,MKT
06079918340025002,2021,94193,247207,341400,MKT
06079918340025002,2020,68896,247504,316400,MKT
06079918340025002,2019,68896,247504,316400,MKT
06079918340025003,2021,95453,247447,342900,MKT
06079918340025003,2020,69805,248195,318000,MKT
06079918340025003,2019,69805,248195,318000,MKT
06079918340025004,2021,74277,303223,377500,MKT
06079918340025004,2020,54511,296989,351500,MKT
06079918340025004,2019,54511,296989,351500,MKT
06079918340025005,2021,74920,327480,402400,MKT
06079918340025005,2020,54977,338423,393400,MKT
06079918340025005,2019,54977,338423,393400,MKT
06079918340025006,2021,94239,246861,341100,MKT
06079918340025006,2020,68930,247070,316000,MKT
06079918340025006,2019,68930,247070,316000,MKT
06079918340025007,2021,92839,246861,339700,MKT
06079918340025007,2020,67919,261981,329900,MKT
06079918340025007,2019,67919,261981,329900,MKT
06079918340025008,2021,66037,244663,310700,MKT
06079918340025008,2020,48545,261255,309800,MKT
06079918340025008,2019,48545,261255,309800,MKT
06079918340025009,2021,66037,242863,308900,MKT
06079918340025009,2020,48545,259955,308500,OVR
06079918340025009,2019,48545,259955,308500,MKT
06079918340025010,2021,90349,248751,339100,MKT
06079918340025010,2020,66124,246676,312800,MKT
06079918340025010,2019,66124,246676,312800,MKT
06079918340025017,2021,86917,276683,363600,MKT
06079918340025017,2020,63647,297053,360700,MKT
06079918340025017,2019,63647,297053,360700,MKT
06079918340025018,2021,67616,310484,378100,MKT
06079918340025018,2020,49689,303711,353400,MKT
06079918340025018,2019,49689,303711,353400,MKT
06079918340025019,2021,68639,322661,391300,MKT
06079918340025019,2020,50430,311870,362300,MKT
06079918340025019,2019,50430,311870,362300,MKT
06079918340025020,2021,67272,320928,388200,MKT
06079918340025020,2020,49440,312760,362200,MKT
06079918340025020,2019,49440,312760,362200,MKT
06079918340025021,2021,86917,273383,360300,MKT
06079918340025021,2020,63647,292453,356100,MKT
06079918340025021,2019,63647,292453,356100,MKT
06079918340025022,2021,85576,289824,375400,MKT
06079918340025022,2020,62678,298622,361300,MKT
06079918340025022,2019,62678,298622,361300,MKT
06079918340025023,2021,66577,321523,388100,MKT
06079918340025023,2020,48936,314164,363100,MKT
06079918340025023,2019,48936,314164,363100,MKT
06079918340025024,2021,85576,274624,360200,MKT
06079918340025024,2020,62678,292722,355400,MKT
06079918340025024,2019,62678,292722,355400,MKT
06079918340025025,2021,88496,374550,463046,COST
06079918340025025,2020,64787,419260,484047,COST
06079918340025025,2019,64787,419260,484047,COST
06079918340025026,2021,75910,369890,445800,MKT
06079918340025026,2020,55693,368907,424600,MKT
06079918340025026,2019,55693,372007,427700,MKT
06079918340025027,2021,75910,365690,441600,MKT
06079918340025027,2020,55693,373607,429300,MKT
06079918340025027,2019,55693,373607,429300,MKT
06079918340025028,2021,85627,383473,469100,MKT
06079918340025028,2020,62716,394784,457500,MKT
06079918340025028,2019,62716,394784,457500,MKT
06079918340025029,2021,86602,349198,435800,MKT
06079918340025029,2020,63419,353181,416600,MKT
06079918340025029,2019,63419,353181,416600,MKT
06079918340025030,2021,69927,333873,403800,MKT
06079918340025030,2020,51363,342537,393900,MKT
06079918340025030,2019,51363,342537,393900,MKT
06079918340025031,2021,70991,319009,390000,MKT
06079918340025031,2020,52133,312667,364800,MKT
06079918340025031,2019,52133,312667,364800,MKT
06079918340025032,2021,87494,401906,489400,MKT
06079918340025032,2020,64063,404337,468400,MKT
06079918340025032,2019,64063,404337,468400,MKT
06079918340025043,2021,79908,261292,341200,MKT
06079918340025043,2020,58584,258016,316600,MKT
06079918340025043,2019,58584,258016,316600,MKT
06079918340025044,2021,65875,320225,386100,MKT
06079918340025044,2020,48427,329573,378000,MKT
06079918340025044,2019,48427,329573,378000,MKT
06079918340025045,2021,65875,341725,407600,MKT
06079918340025045,2020,48427,307073,355500,MKT
06079918340025045,2019,48427,307073,355500,MKT
06079918340025046,2021,65875,335625,401500,MKT
06079918340025046,2020,48427,333473,381900,MKT
06079918340025046,2019,48427,333473,381900,MKT
06079918340025047,2021,79908,253492,333400,MKT
06079918340025047,2020,58584,252316,310900,MKT
06079918340025047,2019,58584,251316,309900,MKT
06079918340025048,2021,75441,279459,354900,MKT
06079918340025048,2020,55354,299420,354774,COST
06079918340025048,2019,55354,299420,354774,COST
06079918340025049,2021,75441,260080,335521,COST
06079918340025049,2020,55354,286420,341774,COST
06079918340025049,2019,55354,286420,341774,COST
06079918340025050,2021,80791,252209,333000,MKT
06079918340025050,2020,59222,249878,309100,MKT
06079918340025050,2019,59222,249878,309100,MKT
06079918340025051,2021,66577,340523,407100,MKT
06079918340025051,2020,48936,351064,400000,MKT
06079918340025051,2019,48936,351064,400000,MKT
06079918340025052,2021,80791,255709,336500,MKT
06079918340025052,2020,59222,253378,312600,MKT
06079918340025052,2019,59222,253378,312600,MKT
06079918340025053,2021,84223,269477,353700,MKT
06079918340025053,2020,61701,270499,332200,MKT
06079918340025053,2019,61701,270499,332200,MKT
06079918340025054,2021,66577,323723,390300,MKT
06079918340025054,2020,48936,317664,366600,MKT
06079918340025054,2019,48936,317664,366600,MKT
06079918340025055,2021,83960,237140,321100,MKT
06079918340025055,2020,61511,232789,294300,MKT
06079918340025055,2019,61511,232789,294300,MKT
06079918340025056,2021,92668,343032,435700,MKT
06079918340025056,2020,67796,351104,418900,MKT
06079918340025056,2019,67796,351104,418900,MKT
06079918340025057,2021,73578,352622,426200,MKT
06079918340025057,2020,54006,356194,410200,MKT
06079918340025057,2019,54006,356194,410200,MKT
06079918340025058,2021,73578,356122,429700,MKT
06079918340025058,2020,54006,353794,407800,MKT
06079918340025058,2019,54006,353794,407800,MKT
06079918340025059,2021,73578,355422,429000,MKT
06079918340025059,2020,54006,359394,413400,MKT
06079918340025059,2019,54006,359394,413400,MKT
06079918340025060,2021,92668,327732,420400,MKT
06079918340025060,2020,67796,335304,403100,MKT
06079918340025060,2019,67796,335304,403100,MKT
06079918340025061,2021,80052,363948,444000,MKT
06079918340025061,2020,58688,361212,419900,MKT
06079918340025061,2019,58688,361212,419900,MKT
06079918340025062,2021,72555,345245,417800,MKT
06079918340025062,2020,53266,358134,411400,MKT
06079918340025062,2019,53266,358134,411400,MKT
06079918340025063,2021,80052,346948,427000,MKT
06079918340025063,2020,58688,352912,411600,MKT
06079918340025063,2019,58688,352912,411600,MKT
06079918340025071,2021,79908,254692,334600,MKT
06079918340025071,2020,58584,254916,313500,MKT
06079918340025071,2019,58584,254916,313500,MKT
06079918340025072,2021,65875,315825,381700,MKT
06079918340025072,2020,48427,310273,358700,MKT
06079918340025072,2019,48427,310273,358700,MKT
06079918340025073,2021,65164,318536,383700,MKT
06079918340025073,2020,47912,326388,374300,MKT
06079918340025073,2019,47912,326388,374300,MKT
06079918340025074,2021,65164,312036,377200,MKT
06079918340025074,2020,47912,305688,353600,MKT
06079918340025074,2019,47912,305688,353600,MKT
06079918340025075,2021,79908,262592,342500,MKT
06079918340025075,2020,58584,260416,319000,MKT
06079918340025075,2019,58584,261416,320000,MKT
06079918340025080,2021,79475,263525,343000,MKT
06079918340025080,2020,58270,265830,324100,MKT
06079918340025080,2019,58270,265830,324100,MKT
06079918340025081,2021,71864,348036,419900,MKT
06079918340025081,2020,52766,351634,404400,MKT
06079918340025081,2019,52766,351634,404400,MKT
06079918340025082,2021,65875,341125,407000,MKT
06079918340025082,2020,48427,345273,393700,MKT
06079918340025082,2019,48427,345273,393700,MKT
06079918340025083,2021,71864,347936,419800,MKT
06079918340025083,2020,52766,351634,404400,MKT
06079918340025083,2019,52766,351634,404400,MKT
06079918340025084,2021,82311,264589,346900,MKT
06079918340025084,2020,60320,265780,326100,MKT
06079918340025084,2019,60320,265780,326100,MKT
06079918340025091,2021,65711,291789,357500,MKT
06079918340025091,2020,48309,282691,331000,OVR
06079918340025091,2019,48309,282691,331000,MKT
06079918340025092,2021,65109,298291,363400,MKT
06079918340025092,2020,47873,290727,338600,MKT
06079918340025092,2019,47873,290727,338600,MKT
06079918340025093,2021,65711,292889,358600,MKT
06079918340025093,2020,48309,285291,333600,MKT
06079918340025093,2019,48309,285291,333600,MKT
06079918340025102,2021,69351,301649,371000,MKT
06079918340025102,2020,50946,293854,344800,MKT
06079918340025102,2019,50946,293854,344800,MKT
06079918340025103,2021,68704,310196,378900,MKT
06079918340025103,2020,50477,304223,354700,MKT
06079918340025103,2019,50477,304223,354700,MKT
06079918340025104,2021,68691,310209,378900,MKT
06079918340025104,2020,50468,303332,353800,MKT
06079918340025104,2019,50468,303332,353800,MKT
06079918340025105,2021,69325,301675,371000,MKT
06079918340025105,2020,50927,292873,343800,MKT
06079918340025105,2019,50927,292873,343800,MKT
06079918340025106,2021,71864,346736,418600,MKT
06079918340025106,2020,52766,352234,405000,MKT
06079918340025106,2019,52766,352534,405300,MKT
06079918340025107,2021,71864,350636,422500,MKT
06079918340025107,2020,52766,356934,409700,MKT
06079918340025107,2019,52766,356934,409700,MKT
06079918340025108,2021,71864,316236,388100,MKT
06079918340025108,2020,52766,325434,378200,MKT
06079918340025108,2019,52766,325434,378200,MKT
06079918340025109,2021,71864,342636,414500,MKT
06079918340025109,2020,52766,341534,394300,MKT
06079918340025109,2019,52766,341534,394300,MKT
06079918340025110,2021,93170,271330,364500,MKT
06079918340025110,2020,68158,275542,343700,OVR
06079918340025110,2019,68158,275542,343700,OVR
06079918340025111,2021,118672,245828,364500,MKT
06079918340025111,2020,86518,254982,341500,MKT
06079918340025111,2019,86518,254982,341500,MKT
06079918340025112,2021,106350,247650,354000,MKT
06079918340025112,2020,77655,247645,325300,MKT
06079918340025112,2019,77655,247645,325300,MKT
06079918340036500,2021,80019,0,80019,COST
06079918340036500,2020,57674,0,57674,COST
06079918340036500,2019,57674,0,57674,COST
06079918340056500,2021,91111,0,91111,COST
06079918340056500,2020,65548,0,65548,COST
06079918340056500,2019,65548,0,65548,COST
06079918340096500,2021,67881,0,67881,COST
06079918340096500,2020,49039,0,49039,COST
06079918340096500,2019,49039,0,49039,COST
06079918340116500,2021,78230,0,78230,COST
06079918340116500,2020,56402,0,56402,COST
06079918340116500,2019,56402,0,56402,COST
06079918340156500,2021,62984,0,62984,COST
06079918340156500,2020,45550,0,45550,COST
06079918340156500,2019,45550,0,45550,COST
06079918340176500,2021,35735,0,35735,COST
06079918340176500,2020,26052,0,26052,COST
06079918340176500,2019,26052,0,26052,COST
06079918340196500,2021,54204,0,54204,COST
06079918340196500,2020,39284,0,39284,COST
06079918340196500,2019,39284,0,39284,COST
06079918341010000,2021,147453,343447,490900,MKT
06079918341010000,2020,107171,289329,396500,MKT
06079918341010000,2019,107171,289329,396500,MKT
06079918341030000,2021,146646,398254,544900,INCOME
06079918341030000,2020,106593,419707,526300,INCOME
06079918341030000,2019,106593,419707,526300,INCOME
06079918341040000,2021,162700,382200,544900,INCOME
06079918341040000,2020,118089,408211,526300,INCOME
06079918341040000,2019,118089,408211,526300,INCOME
06079918341080000,2021,146646,184854,331500,INCOME
06079918341080000,2020,106593,202107,308700,INCOME
06079918341080000,2019,106593,202107,308700,INCOME
06079918341100000,2021,145533,277067,422600,INCOME
06079918341100000,2020,105795,300005,405800,INCOME
06079918341100000,2019,105795,300005,405800,INCOME
06079918341120000,2021,148408,300492,448900,INCOME
06079918341120000,2020,105770,318830,424600,INCOME
06079918341120000,2019,105770,318830,424600,INCOME
06079918341140000,2021,148571,351429,500000,INCOME
06079918341140000,2020,105884,342116,448000,INCOME
06079918341140000,2019,105884,342116,448000,INCOME
06079918341160000,2021,148571,335229,483800,INCOME
06079918341160000,2020,105884,332316,438200,INCOME
06079918341160000,2019,105884,332316,438200,INCOME
06079918341180000,2021,141540,298060,439600,MKT
06079918341180000,2020,100943,267457,368400,MKT
06079918341180000,2019,100943,267457,368400,MKT
06079918341200000,2021,155452,429148,584600,MKT
06079918341200000,2020,110718,385682,496400,MKT
06079918341200000,2019,110718,385682,496400,MKT
06079918341220000,2021,149878,346922,496800,MKT
06079918341220000,2020,106803,336097,442900,MKT
06079918341220000,2019,106803,336097,442900,MKT
06079918345016500,2021,168845,0,168845,COST
06079918345016500,2020,335066,0,335066,COST
06079918345016500,2019,335066,0,335066,COST
06079918346010000,2021,132729,330971,463700,MKT
06079918346010000,2020,96613,264287,360900,MKT
06079918346010000,2019,96613,264287,360900,MKT
06079918346020000,2021,130681,335819,466500,MKT
06079918346020000,2020,95143,333157,428300,MKT
06079918346020000,2019,95143,335557,430700,MKT
06079918346030000,2021,141118,339782,480900,MKT
06079918346030000,2020,102630,317970,420600,MKT
06079918346030000,2019,102630,317970,420600,MKT
06079918346040000,2021,161904,365096,527000,MKT
06079918346040000,2020,117519,289481,407000,MKT
06079918346040000,2019,117519,289481,407000,MKT
06079918346050000,2021,155513,471587,627100,MKT
06079918346050000,2020,112944,377356,490300,MKT
06079918346050000,2019,112944,377356,490300,MKT
06079918346060000,2021,155513,361387,516900,MKT
06079918346060000,2020,112944,323856,436800,OVR
06079918346060000,2019,112944,323856,436800,MKT
06079918346070000,2021,155513,327887,483400,MKT
06079918346070000,2020,112944,313356,426300,MKT
06079918346070000,2019,112944,313356,426300,MKT
06079918346080000,2021,147249,417751,565000,MKT
06079918346080000,2020,107025,354275,461300,MKT
06079918346080000,2019,107025,354275,461300,MKT
06079918346090000,2021,129176,346324,475500,MKT
06079918346090000,2020,94063,276437,370500,MKT
06079918346090000,2019,94063,276437,370500,MKT
06079918348020000,2021,226306,470694,697000,MKT
06079918348020000,2020,169428,422072,591500,MKT
06079918348020000,2019,169428,422072,591500,MKT
06079918348030000,2021,237433,308067,545500,MKT
06079918348030000,2020,177637,272163,449800,MKT
06079918348030000,2019,177637,272163,449800,MKT
06079918349016500,2021,108454,0,108454,COST
06079918349016500,2020,265548,0,265548,COST
06079918349016500,2019,265548,0,265548,COST
06079918350010000,2021,175250,365350,540600,INCOME
06079918350010000,2020,103402,415698,519100,INCOME
06079918350010000,2019,103402,415698,519100,INCOME
06079918350020000,2021,195452,446948,642400,INCOME
06079918350020000,2020,112881,515119,628000,INCOME
06079918350020000,2019,112881,515119,628000,INCOME
06079918350037000,2021,182527,0,182527,COST
06079918350037000,2020,137068,0,137068,COST
06079918350037000,2019,137068,0,137068,COST
06079918350040000,2021,169856,370744,540600,INCOME
06079918350040000,2020,127682,391418,519100,INCOME
06079918350040000,2019,127682,391418,519100,INCOME
06079918350050000,2021,144733,395867,540600,INCOME
06079918350050000,2020,105222,413878,519100,INCOME
06079918350050000,2019,105222,413878,519100,INCOME
06079918351010000,2021,685277,0,685277,COST
06079918351010000,2020,487365,0,487365,COST
06079918351010000,2019,487365,0,487365,COST
06079918401030000,2021,171873,172027,343900,MKT
06079918401030000,2020,122495,93890,216385,COST
06079918401030000,2019,122495,93890,216385,COST
06079918401040000,2021,261554,0,261554,COST
06079918401040000,2020,198770,0,198770,COST
06079918401040000,2019,198770,0,198770,COST
06079918401050000,2021,354020,584090,938110,COST
06079918401050000,2020,281782,450162,731944,MRA
06079918401050000,2019,281782,450162,731944,MRA
06079918401080000,2021,277059,444210,721269,COST
06079918401080000,2020,212415,430540,642955,COST
06079918401080000,2019,212415,430540,642955,COST
06079918401180000,2021,278726,268220,546946,COST
06079918401180000,2020,213889,263610,477499,COST
06079918401180000,2019,213889,263610,477499,COST
06079918401200000,2021,376,0,376,COST
06079918401200000,2020,350,0,350,COST
06079918401200000,2019,350,0,350,COST
06079918401260000,2021,180571,198429,379000,MKT
06079918401260000,2020,129670,163430,293100,MKT
06079918401260000,2019,129670,163430,293100,MKT
06079918402180000,2021,233131,411950,645081,COST
06079918402180000,2020,212145,206730,418875,COST
06079918402180000,2019,212145,206730,418875,COST
06079918403040000,2021,192921,202179,395100,MKT
06079918403040000,2020,144760,212640,357400,MKT
06079918403040000,2019,144760,212640,357400,MKT
06079918404020000,2021,150869,0,150869,COST
06079918404020000,2020,109619,0,109619,COST
06079918404020000,2019,109619,0,109619,COST
06079918404040000,2021,148308,0,148308,COST
06079918404040000,2020,107783,0,107783,COST
06079918404040000,2019,107783,0,107783,COST
06079918404060000,2021,149852,461448,611300,MKT
06079918404060000,2020,108890,434810,543700,MKT
06079918404060000,2019,108890,434810,543700,MKT
06079918404080000,2021,163414,0,163414,COST
06079918404080000,2020,118599,0,118599,COST
06079918404080000,2019,118599,0,118599,COST
06079918404100000,2021,228843,235657,464500,MKT
06079918404100000,2020,255592,246210,501802,COST
06079918404100000,2019,255592,246210,501802,COST
06079918404110000,2021,162824,0,162824,COST
06079918404110000,2020,115091,0,115091,COST
06079918404110000,2019,115091,0,115091,COST
06079918404120000,2021,219716,795490,1015206,COST
06079918404120000,2020,162601,765460,928061,COST
06079918404120000,2019,162601,765460,928061,COST
06079918404136500,2021,11805,0,11805,COST
06079918404136500,2020,8742,0,8742,COST
06079918404136500,2019,8742,0,8742,COST
06079918404140000,2021,302773,0,302773,COST
06079918404140000,2020,217832,0,217832,COST
06079918404140000,2019,217832,0,217832,COST
06079918404160000,2021,224073,1569390,1793463,COST
06079918404160000,2020,166307,1522240,1688547,COST
06079918404160000,2019,166307,1522240,1688547,COST
06079918404180000,2021,97171,0,97171,COST
06079918404180000,2020,63473,0,63473,COST
06079918404180000,2019,63473,0,63473,COST
06079918404200000,2021,660,0,660,COST
06079918404200000,2020,614,0,614,COST
06079918404200000,2019,614,0,614,COST
06079918404240000,2021,267791,0,267791,COST
06079918404240000,2020,204244,0,204244,COST
06079918404240000,2019,204244,0,204244,COST
06079918406040000,2021,245686,350214,595900,MKT
06079918406040000,2020,184933,295360,480293,COST
06079918406040000,2019,184933,295360,480293,COST
06079918406060000,2021,283668,0,283668,COST
06079918406060000,2020,218267,0,218267,COST
06079918406060000,2019,218267,0,218267,COST
06079918406210000,2021,163,0,163,COST
06079918406210000,2020,152,0,152,COST
06079918406210000,2019,152,0,152,COST
06079918407010000,2021,420265,816150,1236415,COST
06079918407010000,2020,349426,644092,993518,MRA
06079918407010000,2019,349426,644092,993518,MRA
06079918407020000,2021,417050,727946,1144996,MRA
06079918407020000,2020,346791,605352,952143,MRA
06079918407020000,2019,346791,605352,952143,MRA
06079918407030000,2021,477216,0,477216,COST
06079918407030000,2020,324452,0,324452,COST
06079918407030000,2019,324452,0,324452,COST
06079918407040000,2021,384797,314503,699300,MKT
06079918407040000,2020,262416,424158,686574,MRA
06079918407040000,2019,262416,424158,686574,MRA
06079918407050000,2021,406297,0,406297,COST
06079918407050000,2020,276864,0,276864,COST
06079918407050000,2019,276864,0,276864,COST
06079918407060000,2021,437619,0,437619,COST
06079918407060000,2020,548194,0,548194,COST
06079918407060000,2019,548194,0,548194,COST
06079918407070000,2021,395333,0,395333,COST
06079918407070000,2020,519697,0,519697,COST
06079918407070000,2019,519697,0,519697,COST
06079918407080000,2021,406203,0,406203,COST
06079918407080000,2020,527155,0,527155,COST
06079918407080000,2019,527155,0,527155,COST
06079918407090000,2021,380691,0,380691,COST
06079918407090000,2020,509495,0,509495,COST
06079918407090000,2019,509495,0,509495,COST
06079918407100000,2021,375354,0,375354,COST
06079918407100000,2020,505731,0,505731,COST
06079918407100000,2019,505731,0,505731,COST
06079918407110000,2021,361771,0,361771,COST
06079918407110000,2020,496033,0,496033,COST
06079918407110000,2019,496033,0,496033,COST
06079918407170000,2021,440914,440833,881747,MRA
06079918407170000,2020,300106,404659,704765,MRA
06079918407170000,2019,300106,404659,704765,MRA
06079918407180000,2021,425638,324062,749700,MKT
06079918407180000,2020,289853,440024,729877,MRA
06079918407180000,2019,289853,440024,729877,MRA
06079918407190000,2021,418280,399320,817600,MKT
06079918407190000,2020,284913,471032,755945,MRA
06079918407190000,2019,284913,471032,755945,MRA
06079918407200000,2021,406719,642572,1049291,MRA
06079918407200000,2020,277148,589538,866686,MRA
06079918407200000,2019,277148,589538,866686,MRA
06079918407210000,2021,361201,271899,633100,MKT
06079918407210000,2020,246544,429932,676476,MRA
06079918407210000,2019,246544,429932,676476,MRA
06079918407220000,2021,332249,0,332249,COST
06079918407220000,2020,474340,0,474340,COST
06079918407220000,2019,474340,0,474340,COST
06079918407230000,2021,340962,0,340962,COST
06079918407230000,2020,480834,0,480834,COST
06079918407230000,2019,480834,0,480834,COST
06079918407240000,2021,427576,0,427576,COST
06079918407240000,2020,541548,0,541548,COST
06079918407240000,2019,541548,0,541548,COST
06079918407250000,2021,441387,0,441387,COST
06079918407250000,2020,550668,0,550668,COST
06079918407250000,2019,550668,0,550668,COST
06079918407260000,2021,524346,869570,1393916,MRA
06079918407260000,2020,357234,746972,1104206,MRA
06079918407260000,2019,357234,746972,1104206,MRA
06079918407270000,2021,597774,854166,1451940,MRA
06079918407270000,2020,406506,759254,1165760,MRA
06079918407270000,2019,406506,759254,1165760,MRA
06079918411010000,2021,135816,0,135816,COST
06079918411010000,2020,505731,0,505731,COST
06079918411010000,2019,505731,0,505731,COST
06079918411020000,2021,165757,0,165757,COST
06079918411020000,2020,120276,0,120276,COST
06079918411020000,2019,120276,0,120276,COST
06079918411040000,2021,268052,331148,599200,MKT
06079918411040000,2020,193184,351616,544800,OVR
06079918411040000,2019,193184,351616,544800,MKT
06079918411050000,2021,234746,341354,576100,MKT
06079918411050000,2020,169499,299901,469400,MKT
06079918411050000,2019,169499,299901,469400,MKT
06079918411070000,2021,165465,0,165465,COST
06079918411070000,2020,117246,0,117246,COST
06079918411070000,2019,117246,0,117246,COST
06079918411090000,2021,187431,249869,437300,INCOME
06079918411090000,2020,135365,257535,392900,INCOME
06079918411090000,2019,135365,257535,392900,INCOME
06079918412010000,2021,416708,677006,1093714,MRA
06079918412010000,2020,283857,438787,722644,OVR
06079918412010000,2019,283857,438787,722644,OVR
06079918412030000,2021,371692,0,371692,COST
06079918412030000,2020,253603,0,253603,COST
06079918412030000,2019,253603,0,253603,COST
06079918412040000,2021,410425,425875,836300,MKT
06079918412040000,2020,279637,493225,772862,MRA
06079918412040000,2019,279637,493225,772862,MRA
06079918412050000,2021,382244,505670,887914,COST
06079918412050000,2020,260699,474421,735120,MRA
06079918412050000,2019,260699,474421,735120,MRA
06079918412060000,2021,404946,723343,1128289,MRA
06079918412060000,2020,275957,638645,914602,MRA
06079918412060000,2019,275957,638645,914602,MRA
06079918412070000,2021,318862,677321,996183,MRA
06079918412070000,2020,218029,452889,670918,OVR
06079918412070000,2019,218029,452889,670918,OVR
06079918412090000,2021,308573,0,308573,COST
06079918412090000,2020,211092,0,211092,COST
06079918412090000,2019,211092,0,211092,COST
06079918412100000,2021,346952,0,346952,COST
06079918412100000,2020,236953,0,236953,COST
06079918412100000,2019,236953,0,236953,COST
06079918413010000,2021,329091,513650,842741,COST
06079918413010000,2020,224923,463172,688095,MRA
06079918413010000,2019,224923,463172,688095,MRA
06079918413020000,2021,348498,604262,952760,MRA
06079918413020000,2020,237994,395406,633400,MKT
06079918413020000,2019,237994,395406,633400,MKT
06079918413030000,2021,295104,502280,797384,COST
06079918413030000,2020,202005,362395,564400,MKT
06079918413030000,2019,202005,362395,564400,MKT
06079918413040000,2021,295285,454325,749610,MRA
06079918413040000,2020,202127,384173,586300,MKT
06079918413040000,2019,202127,0,202127,COST
06079918413050000,2021,295449,0,295449,COST
06079918413050000,2020,202238,0,202238,COST
06079918413050000,2019,202238,0,202238,COST
06079918414010000,2021,295645,320055,615700,MKT
06079918414010000,2020,202370,306932,509302,MRA
06079918414010000,2019,202370,306932,509302,MRA
06079918414020000,2021,295792,425240,721032,COST
06079918414020000,2020,202470,391124,593594,MRA
06079918414020000,2019,202470,391124,593594,MRA
06079918414030000,2021,295792,596379,892171,MRA
06079918414030000,2020,202470,531063,733533,MRA
06079918414030000,2019,202470,531063,733533,MRA
06079918414040000,2021,358284,622761,981045,MRA
06079918414040000,2020,244581,554270,798851,MRA
06079918414040000,2019,244581,554270,798851,MRA
06079918414060000,2021,362683,599909,962592,MRA
06079918414060000,2020,247542,533445,780987,MRA
06079918414060000,2019,247542,533445,780987,MRA
06079918414070000,2021,313585,649282,962867,MRA
06079918414070000,2020,214471,573911,788382,MRA
06079918414070000,2019,214471,573911,788382,MRA
06079918415010000,2021,490230,631929,1122159,MRA
06079918415010000,2020,334309,558893,893202,MRA
06079918415010000,2019,334309,558893,893202,MRA
06079918415020000,2021,511701,503412,1015113,MRA
06079918415020000,2020,348739,390261,739000,MKT
06079918415020000,2019,348739,390261,739000,MKT
06079918415030000,2021,549826,643849,1193675,MRA
06079918415030000,2020,374342,469358,843700,MKT
06079918415030000,2019,374342,469358,843700,MKT
06079918415040000,2021,511466,783262,1294728,MRA
06079918415040000,2020,348581,725966,1074547,MRA
06079918415040000,2019,348581,725966,1074547,MRA
06079918415050000,2021,475529,755233,1230762,MRA
06079918415050000,2020,324423,671349,995772,MRA
06079918415050000,2019,324423,671349,995772,MRA
06079918415060000,2021,461909,422680,884589,MRA
06079918415060000,2020,315261,383474,698735,MRA
06079918415060000,2019,315261,383474,698735,MRA
06079918415070000,2021,451529,389204,840733,MRA
06079918415070000,2020,308275,365948,674223,MRA
06079918415070000,2019,308275,365948,674223,MRA
06079918416240000,2021,407491,0,407491,COST
06079918416240000,2020,277666,0,277666,COST
06079918416240000,2019,277666,0,277666,COST
06079918416250000,2021,398097,731540,1129637,COST
06079918416250000,2020,271355,480945,752300,MKT
06079918416250000,2019,271355,480945,752300,MKT
06079918416260000,2021,420005,0,420005,COST
06079918416260000,2020,286071,0,286071,COST
06079918416260000,2019,286071,0,286071,COST
06079918416270000,2021,517256,1007287,1524543,MRA
06079918416270000,2020,351274,828985,1180259,MRA
06079918416270000,2019,351274,828985,1180259,MRA
06079918416290000,2021,432260,0,432260,COST
06079918416290000,2020,294299,0,294299,COST
06079918416290000,2019,294299,0,294299,COST
06079918416300000,2021,392790,465620,858410,COST
06079918416300000,2020,267789,431153,698942,MRA
06079918416300000,2019,267789,431153,698942,MRA
06079918416310000,2021,412484,700568,1113052,MRA
06079918416310000,2020,281021,663036,944057,MRA
06079918416310000,2019,281021,663036,944057,MRA
06079918424010000,2021,311887,549260,861147,COST
06079918424010000,2020,213327,498382,711709,MRA
06079918424010000,2019,213327,498382,711709,MRA
06079918424020000,2021,426786,357950,784736,COST
06079918424020000,2020,290624,350440,641064,COST
06079918424020000,2019,290624,350440,641064,COST
06079918424040000,2021,327419,293640,621059,COST
06079918424040000,2020,223797,294451,518248,MRA
06079918424040000,2019,223797,294451,518248,MRA
06079918424050000,2021,305790,287720,593510,COST
06079918424050000,2020,209215,263333,472548,MRA
06079918424050000,2019,209215,263333,472548,MRA
06079918424060000,2021,407935,0,407935,COST
06079918424060000,2020,277965,0,277965,COST
06079918424060000,2019,277965,0,277965,COST
06079918424070000,2021,410865,1095750,1506615,COST
06079918424070000,2020,279933,1052290,1332223,COST
06079918424070000,2019,279933,1052290,1332223,COST
06079918424080000,2021,355260,500980,856240,COST
06079918424080000,2020,242546,480059,722605,MRA
06079918424080000,2019,242546,480059,722605,MRA
06079918424090000,2021,308792,601369,910161,MRA
06079918424090000,2020,211239,564637,775876,MRA
06079918424090000,2019,211239,564637,775876,MRA
06079918425010000,2021,282009,247970,529979,COST
06079918425010000,2020,193165,218378,411543,MRA
06079918425010000,2019,193165,218378,411543,MRA
06079918425020000,2021,282009,281880,563889,COST
06079918425020000,2020,193165,266876,460041,MRA
06079918425020000,2019,193165,266876,460041,MRA
06079918425030000,2021,281957,548580,830537,COST
06079918425030000,2020,193130,427270,620400,MKT
06079918425030000,2019,193130,427270,620400,MKT
06079918425030900,2021,295580,241790,537370,COST
06079918425030900,2020,202326,222874,425200,MKT
06079918425030900,2019,202326,222874,425200,MKT
06079918425040000,2021,295514,444120,739634,COST
06079918425040000,2020,202282,329118,531400,MKT
06079918425040000,2019,202282,329118,531400,MKT
06079918425050000,2021,282009,262810,544819,COST
06079918425050000,2020,193165,269120,462285,MRA
06079918425050000,2019,193165,269120,462285,MRA
06079918425060000,2021,282009,223500,505509,COST
06079918425060000,2020,193165,245853,439018,MRA
06079918425060000,2019,193165,245853,439018,MRA
06079918425070000,2021,282009,242330,524339,COST
06079918425070000,2020,193165,284355,477520,OVR
06079918425070000,2019,193165,284355,477520,MRA
06079918426010000,2021,295432,288708,584140,MRA
06079918426010000,2020,202227,251541,453768,MRA
06079918426010000,2019,202227,251541,453768,MRA
06079918426020000,2021,295432,246930,542362,COST
06079918426020000,2020,202227,240490,442717,COST
06079918426020000,2019,202227,240490,442717,COST
06079918426030000,2021,280352,298948,579300,MKT
06079918426030000,2020,192047,315970,508017,COST
06079918426030000,2019,192047,315970,508017,COST
06079918426040000,2021,323185,368340,691525,COST
06079918426040000,2020,220943,344364,565307,MRA
06079918426040000,2019,220943,344364,565307,MRA
06079918434010000,2021,450109,404890,854999,COST
06079918434010000,2020,306276,390960,697236,OVR
06079918434010000,2019,306276,390960,697236,COST
06079918434020000,2021,370428,369460,739888,COST
06079918434020000,2020,252753,331563,584316,MRA
06079918434020000,2019,252753,331563,584316,MRA
06079918434030000,2021,353392,530987,884379,MRA
06079918434030000,2020,241289,495443,736732,MRA
06079918434030000,2019,241289,495443,736732,MRA
06079918434040000,2021,356500,398300,754800,MKT
06079918434040000,2020,243380,465628,709008,MRA
06079918434040000,2019,243380,465628,709008,MRA
06079918434050000,2021,388944,146770,535714,COST
06079918434050000,2020,265203,145910,411113,COST
06079918434050000,2019,265203,145910,411113,COST
06079918434060000,2021,318756,275630,594386,COST
06079918434060000,2020,217958,312809,530767,MRA
06079918434060000,2019,217958,312809,530767,MRA
06079918434070000,2021,321855,246060,567915,COST
06079918434070000,2020,220047,249214,469261,MRA
06079918434070000,2019,220047,249214,469261,MRA
06079918434080000,2021,316646,327830,644476,COST
06079918434080000,2020,216535,303871,520406,MRA
06079918434080000,2019,216535,303871,520406,MRA
06079918434090000,2021,312907,254180,567087,COST
06079918434090000,2020,214014,217286,431300,MKT
06079918434090000,2019,214014,217286,431300,MKT
06079918434100000,2021,312907,209650,522557,COST
06079918434100000,2020,214014,246976,460990,MRA
06079918434100000,2019,214014,246976,460990,MRA
06079918442010000,2021,353012,0,353012,COST
06079918442010000,2020,241033,0,241033,COST
06079918442010000,2019,241033,0,241033,COST
06079918442020000,2021,438540,364160,802700,MKT
06079918442020000,2020,298513,462790,761303,OVR
06079918442020000,2019,298513,462790,761303,MRA
06079918442040000,2021,528455,752845,1281300,MKT
06079918442040000,2020,359994,830550,1190544,COST
06079918442040000,2019,359994,830550,1190544,COST
06079918442050000,2021,408553,259247,667800,MKT
06079918442050000,2020,278380,312420,590800,MKT
06079918442050000,2019,278380,312420,590800,MKT
06079918442060000,2021,409205,551435,960640,MRA
06079918442060000,2020,278818,496212,775030,MRA
06079918442060000,2019,278818,496212,775030,MRA
06079918442070000,2021,500060,471640,971700,MKT
06079918442070000,2020,339758,426042,765800,MKT
06079918442070000,2019,339758,426042,765800,MKT
06079918442080000,2020,263855,0,263855,COST
06079918442080000,2019,263855,0,263855,COST
06079918442090000,2021,530304,495870,1026174,COST
06079918442090000,2020,263647,472157,735804,MRA
06079918442090000,2019,263647,472157,735804,MRA
06079918442100000,2021,448738,415061,863799,MRA
06079918442100000,2020,305356,383567,688923,MRA
06079918442100000,2019,305356,383567,688923,MRA
06079918442111001,2021,56934,0,56934,COST
06079918442111001,2020,56261,0,56261,COST
06079918442111001,2019,56261,0,56261,COST
06079918442111002,2021,626661,935960,1562621,COST
06079918442111002,2020,424419,927840,1352259,COST
06079918442111002,2019,424419,927840,1352259,COST
06079918442120000,2021,413901,966530,1380431,COST
06079918442120000,2020,281972,945520,1227492,COST
06079918442120000,2019,281972,945520,1227492,COST
06079918442130000,2021,403532,452280,855812,COST
06079918442130000,2020,275007,413348,688355,MRA
06079918442130000,2019,275007,413348,688355,MRA
06079918442701001,2021,268383,644940,913323,COST
06079918442701001,2020,239562,615060,854622,COST
06079918442701001,2019,239562,615060,854622,COST
06079918442701002,2021,53734,0,53734,COST
06079918442701002,2020,34250,0,34250,COST
06079918442701002,2019,34250,0,34250,COST
06079918442761001,2021,44864,0,44864,COST
06079918442761001,2020,39782,0,39782,COST
06079918442761001,2019,39782,0,39782,COST
06079918442761002,2021,160385,0,160385,COST
06079918442761002,2020,114466,0,114466,COST
06079918442761002,2019,114466,0,114466,COST
06079918443010000,2021,344396,415340,759736,COST
06079918443010000,2020,235232,372630,607862,MRA
06079918443010000,2019,235232,372630,607862,MRA
06079918443020000,2021,457510,389890,847400,COST
06079918443020000,2020,311240,350969,662209,MRA
06079918443020000,2019,311240,350969,662209,MRA
06079918443030000,2021,383703,277150,660853,COST
06079918443030000,2020,261680,276670,538350,COST
06079918443030000,2019,261680,276670,538350,COST
06079918443040000,2021,361757,242843,604600,MKT
06079918443040000,2020,246919,293169,540088,OVR
06079918443040000,2019,246919,293169,540088,OVR
06079918443050000,2021,309916,196484,506400,MKT
06079918443050000,2020,211997,344429,556426,MRA
06079918443050000,2019,211997,344429,556426,MRA
06079918443060000,2021,295219,199100,494319,COST
06079918443060000,2020,202083,233151,435234,MRA
06079918443060000,2019,202083,233151,435234,MRA
06079918443060900,2021,295022,207430,502452,COST
06079918443060900,2020,201950,201500,403450,COST
06079918443060900,2019,201950,201500,403450,COST
06079918443070000,2021,304285,270750,575035,COST
06079918443070000,2020,208200,268880,477080,COST
06079918443070000,2019,208200,268880,477080,COST
06079918443070900,2021,295481,318400,613881,COST
06079918443070900,2020,202260,341680,543940,MRA
06079918443070900,2019,202260,341680,543940,MRA
06079918443080000,2021,274331,236180,510511,COST
06079918443080000,2020,187980,243375,431355,MRA
06079918443080000,2019,187980,243375,431355,MRA
06079918443080900,2021,306563,481710,788273,COST
06079918443080900,2020,209736,324664,534400,MKT
06079918443080900,2019,209736,324664,534400,MKT
06079918443090000,2021,298236,377730,675966,COST
06079918443090000,2020,204118,377420,581538,COST
06079918443090000,2019,204118,377420,581538,COST
06079918443100000,2021,282146,248600,530746,COST
06079918443100000,2020,193258,224414,417672,OVR
06079918443100000,2019,193258,224414,417672,OVR
06079918445010000,2021,450625,687153,1137778,MRA
06079918445010000,2020,306621,641531,948152,MRA
06079918445010000,2019,306621,641531,948152,MRA
06079918445030000,2021,421316,937130,1358446,COST
06079918445030000,2020,286952,757286,1044238,MRA
06079918445030000,2019,286952,757286,1044238,MRA
06079918445050000,2021,435259,0,435259,COST
06079918445050000,2020,296312,0,296312,COST
06079918445050000,2019,296312,0,296312,COST
06079918445070000,2021,418644,0,418644,COST
06079918445070000,2020,285157,0,285157,COST
06079918445070000,2019,285157,0,285157,COST
06079918447010000,2021,175439,529661,705100,MKT
06079918447010000,2020,127199,120640,247839,COST
06079918447010000,2019,127199,0,127199,COST
06079918447030000,2021,164987,518313,683300,MKT
06079918447030000,2020,119725,428470,548195,COST
06079918447030000,2019,119725,298520,418245,COST
06079918447050000,2021,171202,507998,679200,MKT
06079918447050000,2020,124170,433530,557700,MKT
06079918447050000,2019,124170,425830,550000,MKT
06079918447070000,2021,138373,393427,531800,MKT
06079918447070000,2020,100662,414138,514800,OVR
06079918447070000,2019,100662,414138,514800,MKT
06079918447090000,2021,139224,330976,470200,MKT
06079918447090000,2020,101272,316228,417500,MKT
06079918447090000,2019,101272,316228,417500,MKT
06079918449016500,2021,391940,0,391940,COST
06079918449016500,2020,262705,0,262705,COST
06079918449016500,2019,262705,0,262705,COST
06079918450017000,2021,1860576,0,1860576,COST
06079918450017000,2020,1242269,0,1242269,COST
06079918450017000,2019,1242269,0,1242269,COST
06079918453560100,2021,74551,0,74551,COST
06079918453560100,2020,54710,0,54710,COST
06079918453560100,2019,54710,0,54710,COST
06079919101010000,2021,1989321,3472210,5461531,COST
06079919101010000,2020,1139912,2590090,3730002,COST
06079919101010000,2019,1139912,2590090,3730002,COST
06079919108010000,2021,219578,484860,704438,COST
06079919108010000,2020,162466,476660,639126,COST
06079919108010000,2019,162466,413550,576016,COST
06079919108030000,2021,411450,406560,818010,COST
06079919108030000,2020,335107,395160,730267,COST
06079919108030000,2019,335107,395160,730267,COST
06079919108050000,2021,285409,465691,751100,MKT
06079919108050000,2020,219812,438588,658400,MKT
06079919108050000,2019,219812,438588,658400,MKT
06079919108060000,2021,231267,555733,787000,MKT
06079919108060000,2020,172477,548023,720500,OVR
06079919108060000,2019,172477,548023,720500,MKT
06079919108070000,2021,300626,358390,659016,COST
06079919108070000,2020,233378,350060,583438,COST
06079919108070000,2019,233378,350060,583438,COST
06079919108080000,2021,235230,568370,803600,MKT
06079919108080000,2020,175889,275330,451219,COST
06079919108080000,2019,175889,0,175889,COST
06079919108090000,2021,235503,624220,859723,COST
06079919108090000,2020,176125,641310,817435,OVR
06079919108090000,2019,176125,641310,817435,COST
06079919108100000,2021,248440,254560,503000,MKT
06079919108100000,2020,187325,241375,428700,MKT
06079919108100000,2019,187325,241375,428700,MKT
06079919108110000,2021,262061,298339,560400,MKT
06079919108110000,2020,199214,309686,508900,MKT
06079919108110000,2019,199214,309686,508900,MKT
06079919108120000,2021,263181,465319,728500,MKT
06079919108120000,2020,200196,420480,620676,COST
06079919108120000,2019,200196,420480,620676,COST
06079919108130000,2021,238542,133258,371800,MKT
06079919108130000,2020,178747,105190,283937,COST
06079919108130000,2019,178747,105190,283937,COST
06079919108130900,2021,238475,1257510,1495985,COST
06079919108130900,2020,178689,1218340,1397029,COST
06079919108130900,2019,178689,1218340,1397029,COST
06079919108140000,2021,239870,212430,452300,MKT
06079919108140000,2020,179895,217905,397800,MKT
06079919108140000,2019,179895,217905,397800,MKT
06079919108140900,2021,238542,0,238542,COST
06079919108140900,2020,178747,0,178747,COST
06079919108140900,2019,178747,0,178747,COST
06079919108150000,2021,240200,180000,420200,MKT
06079919108150000,2020,180180,185220,365400,MKT
06079919108150000,2019,180180,185220,365400,MKT
06079919108160000,2021,240200,222300,462500,MKT
06079919108160000,2020,180180,229520,409700,MKT
06079919108160000,2019,180180,229520,409700,MKT
06079919108180000,2021,215551,382749,598300,MKT
06079919108180000,2020,159037,346963,506000,MKT
06079919108180000,2019,159037,346963,506000,MKT
06079919108190000,2021,247195,190,247385,COST
06079919108190000,2020,186243,200,186443,COST
06079919108190000,2019,186243,200,186443,COST
06079919108200000,2021,253965,247135,501100,MKT
06079919108200000,2020,192136,211464,403600,OVR
06079919108200000,2019,192136,211464,403600,MKT
06079919108210000,2021,237537,747063,984600,MKT
06079919108210000,2020,177879,766390,944269,COST
06079919108210000,2019,177879,766390,944269,COST
06079919108220000,2021,208091,233409,441500,MKT
06079919108220000,2020,152708,257792,410500,MKT
06079919108220000,2019,154859,255641,410500,MKT
06079919108230000,2021,188462,254238,442700,MKT
06079919108230000,2020,136224,286076,422300,MKT
06079919108230000,2019,136224,281676,417900,MKT
06079919108250000,2021,265943,240357,506300,MKT
06079919108250000,2020,202620,197980,400600,MKT
06079919108250000,2019,202620,197980,400600,MKT
06079919108270000,2021,272366,254534,526900,MKT
06079919108270000,2020,208272,236428,444700,MKT
06079919108270000,2019,208272,236428,444700,MKT
06079919108297000,2021,358229,0,358229,COST
06079919108297000,2020,257118,0,257118,COST
06079919108297000,2019,257118,0,257118,COST
06079919108300000,2021,219500,173100,392600,MKT
06079919108300000,2020,162400,190400,352800,MKT
06079919108300000,2019,162400,190400,352800,MKT
06079919108310000,2021,276500,209930,486430,COST
06079919108310000,2020,211920,203520,415440,COST
06079919108310000,2019,211920,203520,415440,COST
06079919108320000,2021,240857,209543,450400,MKT
06079919108320000,2020,180749,183390,364139,COST
06079919108320000,2019,180749,184610,365359,COST
06079919108330000,2021,239539,158430,397969,COST
06079919108330000,2020,179609,155770,335379,COST
06079919108330000,2019,179609,155770,335379,COST
06079919108360000,2021,228482,183718,412200,MKT
06079919108360000,2020,170085,180615,350700,MKT
06079919108360000,2019,170085,180615,350700,MKT
06079919108370000,2021,235503,386197,621700,MKT
06079919108370000,2020,176125,375775,551900,MKT
06079919108370000,2019,176125,375775,551900,MKT
06079919108380000,2021,234818,1029470,1264288,COST
06079919108380000,2020,175534,1019350,1194884,COST
06079919108380000,2019,175534,1019350,1194884,COST
06079919108390000,2021,241511,142589,384100,MKT
06079919108390000,2020,181315,130180,311495,COST
06079919108390000,2019,181315,130180,311495,COST
06079919108410000,2021,222568,598432,821000,MKT
06079919108410000,2020,165020,508080,673100,MKT
06079919108410000,2019,165020,508080,673100,MKT
06079919150040000,2021,373491,481380,854871,COST
06079919150040000,2020,320877,443080,763957,OVR
06079919150040000,2019,320877,443080,763957,COST
06079919150240000,2021,261498,295902,557400,MKT
06079919150240000,2020,198720,280480,479200,COST
06079919150240000,2019,198720,280480,479200,COST
06079919150340000,2021,590769,0,590769,COST
06079919150340000,2020,544400,0,544400,COST
06079919150340000,2019,544400,0,544400,COST
06079919201010000,2021,584545,1316660,1901205,COST
06079919201010000,2020,272346,1310850,1583196,COST
06079919201010000,2019,272346,1310850,1583196,COST
06079919201020000,2021,153738,308262,462000,MKT
06079919201020000,2020,111673,282427,394100,MKT
06079919201020000,2019,111673,282427,394100,MKT
06079919201030000,2021,153738,323062,476800,MKT
06079919201030000,2020,111673,278527,390200,MKT
06079919201030000,2019,111673,278527,390200,MKT
06079919201040000,2021,153738,326762,480500,MKT
06079919201040000,2020,111673,286627,398300,MKT
06079919201040000,2019,111673,286627,398300,MKT
06079919201050000,2021,153738,321462,475200,MKT
06079919201050000,2020,111673,301427,413100,OVR
06079919201050000,2019,111673,301427,413100,MKT
06079919201060000,2021,153738,381062,534800,MKT
06079919201060000,2020,111673,313227,424900,MKT
06079919201060000,2019,111673,313227,424900,MKT
06079919201076500,2021,94251,0,94251,COST
06079919201076500,2020,67774,0,67774,COST
06079919201076500,2019,67774,0,67774,COST
06079919201087000,2021,242369,0,242369,COST
06079919201087000,2020,174923,0,174923,COST
06079919201087000,2019,174923,0,174923,COST
06079919201110000,2021,242482,514618,757100,MKT
06079919201110000,2020,218406,334394,552800,MKT
06079919201110000,2019,218406,334394,552800,MKT
06079919201120000,2021,240249,462751,703000,MKT
06079919201120000,2020,216422,359278,575700,MKT
06079919201120000,2019,216422,359278,575700,MKT
06079919201130000,2021,230799,427701,658500,MKT
06079919201130000,2020,208028,337972,546000,MKT
06079919201130000,2019,208028,337972,546000,MKT
06079919201140000,2021,243317,308383,551700,MKT
06079919201140000,2020,219147,262553,481700,OVR
06079919201140000,2019,219147,262553,481700,MKT
06079919201150000,2021,253503,336497,590000,MKT
06079919201150000,2020,228189,281311,509500,MKT
06079919201150000,2019,228189,281311,509500,MKT
06079919201160000,2021,225375,590125,815500,MKT
06079919201160000,2020,203208,421492,624700,MKT
06079919201160000,2019,203208,421492,624700,MKT
06079919201170000,2021,233998,250202,484200,MKT
06079919201170000,2020,210870,205730,416600,MKT
06079919201170000,2019,210870,205730,416600,MKT
06079919201180000,2021,244433,382867,627300,MKT
06079919201180000,2020,220138,310462,530600,OVR
06079919201180000,2019,220138,310462,530600,MKT
06079919201190000,2021,228544,570456,799000,MKT
06079919201190000,2020,206024,481176,687200,MKT
06079919201190000,2019,206024,481176,687200,MKT
06079919201200000,2021,244784,347016,591800,MKT
06079919201200000,2020,220450,304750,525200,MKT
06079919201200000,2019,220450,304750,525200,MKT
06079919201210000,2021,231741,0,231741,COST
06079919201210000,2020,220198,0,220198,COST
06079919201210000,2019,220198,0,220198,COST
06079919201220000,2021,223000,311300,534300,MKT
06079919201220000,2020,212008,280792,492800,MKT
06079919201220000,2019,212008,280792,492800,MKT
06079919201230000,2021,214270,0,214270,COST
06079919201230000,2020,203823,0,203823,COST
06079919201230000,2019,203823,0,203823,COST
06079919201240000,2021,214503,368797,583300,MKT
06079919201240000,2020,204042,330358,534400,MKT
06079919201240000,2019,204042,330358,534400,MKT
06079919201250000,2021,234724,1472499,1707223,OVR
06079919201250000,2020,222992,1171690,1394682,COST
06079919201250000,2019,222992,876020,1099012,COST
06079919201270000,2021,301686,979680,1281366,COST
06079919201270000,2020,285592,544208,829800,MKT
06079919201270000,2019,285592,608600,894192,MRA
06079919201280000,2021,235530,445370,680900,MKT
06079919201280000,2020,223747,403353,627100,MKT
06079919201280000,2019,223747,403353,627100,MKT
06079919201290000,2021,224830,402070,626900,MKT
06079919201290000,2020,213723,344677,558400,MKT
06079919201290000,2019,213723,344677,558400,MKT
06079919201300000,2021,277617,403983,681600,MKT
06079919201300000,2020,263115,334785,597900,MKT
06079919201300000,2019,263115,334785,597900,MKT
06079919201310000,2021,254613,413387,668000,MKT
06079919201310000,2020,241609,306391,548000,MKT
06079919201310000,2019,241609,306391,548000,MKT
06079919201320000,2021,270632,394968,665600,MKT
06079919201320000,2020,256588,331312,587900,MKT
06079919201320000,2019,256588,331312,587900,MKT
06079919201330000,2021,339566,741834,1081400,MKT
06079919201330000,2020,320914,645250,966164,COST
06079919201330000,2019,320914,645250,966164,COST
06079919201340000,2021,431755,359145,790900,MKT
06079919201340000,2020,294291,290909,585200,MKT
06079919201340000,2019,294291,290909,585200,MKT
06079919201416500,2021,215300,0,215300,COST
06079919201416500,2020,90690,0,90690,COST
06079919201416500,2019,90690,0,90690,COST
06079919205076500,2021,299287,0,299287,COST
06079919205076500,2020,211724,0,211724,COST
06079919205076500,2019,211724,0,211724,COST
06079919208010000,2021,143844,456356,600200,MKT
06079919208010000,2020,104585,373315,477900,MKT
06079919208010000,2019,104585,373315,477900,MKT
06079919208020000,2021,145539,398961,544500,MKT
06079919208020000,2020,105800,334800,440600,MKT
06079919208020000,2019,105800,334800,440600,MKT
06079919208030000,2021,145539,456261,601800,MKT
06079919208030000,2020,105800,420500,526300,MKT
06079919208030000,2019,105800,420500,526300,MKT
06079919208040000,2021,145539,408661,554200,MKT
06079919208040000,2020,105800,340900,446700,MKT
06079919208040000,2019,105800,340900,446700,MKT
06079919208050000,2021,146300,362700,509000,MKT
06079919208050000,2020,106345,326655,433000,MKT
06079919208050000,2019,106345,326655,433000,MKT
06079919208060000,2021,163036,375864,538900,MKT
06079919208060000,2020,118329,342171,460500,MKT
06079919208060000,2019,118329,342171,460500,MKT
06079919208070000,2021,163147,437853,601000,MKT
06079919208070000,2020,118408,390992,509400,OVR
06079919208070000,2019,118408,390992,509400,MKT
06079919208080000,2021,147395,572205,719600,MKT
06079919208080000,2020,107129,513971,621100,MKT
06079919208080000,2019,107129,513971,621100,MKT
06079919208090000,2021,183142,11710,194852,COST
06079919208090000,2020,107129,11340,118469,COST
06079919208090000,2019,107129,11340,118469,COST
06079919208100000,2021,183142,8270,191412,COST
06079919208100000,2020,107129,8000,115129,COST
06079919208100000,2019,107129,8000,115129,COST
06079919208110000,2021,183142,8270,191412,COST
06079919208110000,2020,107129,8000,115129,COST
06079919208110000,2019,107129,8000,115129,COST
06079919208120000,2021,180749,4970,185719,COST
06079919208120000,2020,106003,4810,110813,COST
06079919208120000,2019,106003,4810,110813,COST
06079919208200000,2021,729761,2467820,3197581,COST
06079919208200000,2020,325530,2352360,2677890,COST
06079919208200000,2019,325530,2352360,2677890,COST
06079919210047000,2021,183351,0,183351,COST
06079919210047000,2020,132852,0,132852,COST
06079919210047000,2019,132852,0,132852,COST
06079919211010000,2021,157213,456187,613400,MKT
06079919211010000,2020,114161,385739,499900,MKT
06079919211010000,2019,114161,385739,499900,MKT
06079919211020000,2021,151250,467450,618700,MKT
06079919211020000,2020,109891,381109,491000,MKT
06079919211020000,2019,109891,371209,481100,MKT
06079919211030000,2021,151250,353150,504400,MKT
06079919211030000,2020,109891,334009,443900,MKT
06079919211030000,2019,109891,334009,443900,MKT
06079919211040000,2021,151250,407050,558300,MKT
06079919211040000,2020,109891,366709,476600,MKT
06079919211040000,2019,109891,366709,476600,MKT
06079919211050000,2021,151250,331150,482400,MKT
06079919211050000,2020,109891,338909,448800,MKT
06079919211050000,2019,109891,338909,448800,MKT
06079919211060000,2021,147033,385767,532800,MKT
06079919211060000,2020,106870,310630,417500,MKT
06079919211060000,2019,106870,310630,417500,MKT
06079919211070000,2021,151250,353550,504800,MKT
06079919211070000,2020,109891,326609,436500,MKT
06079919211070000,2019,109891,326609,436500,MKT
06079919211080000,2021,151250,366550,517800,MKT
06079919211080000,2020,109891,352009,461900,MKT
06079919211080000,2019,109891,352009,461900,MKT
06079919211090000,2021,151250,455950,607200,MKT
06079919211090000,2020,109891,409409,519300,MKT
06079919211090000,2019,109891,409409,519300,MKT
06079919211100000,2021,151250,415050,566300,MKT
06079919211100000,2020,109891,364309,474200,MKT
06079919211100000,2019,109891,364309,474200,MKT
06079919218010000,2021,221907,693493,915400,MKT
06079919218010000,2020,166180,747780,913960,COST
06079919218010000,2019,166180,747780,913960,COST
06079919218020000,2021,208104,457096,665200,MKT
06079919218020000,2020,155985,473515,629500,MKT
06079919218020000,2019,155985,473515,629500,MKT
06079919218030000,2021,208520,457680,666200,MKT
06079919218030000,2020,156292,459408,615700,MKT
06079919218030000,2019,156292,459408,615700,MKT
06079919218040000,2021,208929,444571,653500,MKT
06079919218040000,2020,156595,385005,541600,MKT
06079919218040000,2019,156595,385005,541600,MKT
06079919218050000,2021,227582,471118,698700,MKT
06079919218050000,2020,170369,360231,530600,MKT
06079919218050000,2019,170369,360231,530600,MKT
06079919218060000,2021,201783,332417,534200,MKT
06079919218060000,2020,151313,287887,439200,MKT
06079919218060000,2019,151313,287887,439200,MKT
06079919218070000,2021,202277,454423,656700,MKT
06079919218070000,2020,151678,453722,605400,MKT
06079919218070000,2019,151678,453722,605400,MKT
06079919218080000,2021,202277,745369,947646,OVR
06079919218080000,2020,151678,712490,864168,COST
06079919218080000,2019,151678,712490,864168,COST
06079919218090000,2021,202277,355023,557300,MKT
06079919218090000,2020,151678,348622,500300,MKT
06079919218090000,2019,151678,348622,500300,MKT
06079919218100000,2021,196474,588226,784700,MKT
06079919218100000,2020,147387,602030,749417,COST
06079919218100000,2019,147387,602030,749417,COST
06079919218110000,2021,217609,398491,616100,MKT
06079919218110000,2020,163007,438993,602000,MKT
06079919218110000,2019,163007,438993,602000,MKT
06079919218120000,2021,258219,471881,730100,MKT
06079919218120000,2020,192959,497841,690800,MKT
06079919218120000,2019,192959,497841,690800,MKT
06079919218130000,2021,215497,568503,784000,MKT
06079919218130000,2020,155788,596100,751888,COST
06079919218130000,2019,155788,596100,751888,COST
06079919218140000,2021,152522,311478,464000,MKT
06079919218140000,2020,110802,338698,449500,MKT
06079919218140000,2019,110802,338698,449500,MKT
06079919218150000,2021,166236,372664,538900,MKT
06079919218150000,2020,120618,366182,486800,MKT
06079919218150000,2019,120618,366182,486800,MKT
06079919218160000,2021,150898,0,150898,COST
06079919218160000,2020,109639,0,109639,COST
06079919218160000,2019,109639,0,109639,COST
06079919218170000,2021,154517,312283,466800,MKT
06079919218170000,2020,112231,278769,391000,MKT
06079919218170000,2019,112231,278769,391000,MKT
06079919218180000,2021,154517,310183,464700,MKT
06079919218180000,2020,112231,293669,405900,MKT
06079919218180000,2019,112231,293669,405900,MKT
06079919218190000,2021,154517,396583,551100,MKT
06079919218190000,2020,112231,337669,449900,MKT
06079919218190000,2019,112231,337669,449900,MKT
06079919218200000,2021,156831,324169,481000,MKT
06079919218200000,2020,113888,279412,393300,OVR
06079919218200000,2019,113888,279412,393300,MKT
06079919219010000,2021,145646,429354,575000,MKT
06079919219010000,2020,105876,371724,477600,MKT
06079919219010000,2019,105876,371724,477600,MKT
06079919219020000,2021,142194,335506,477700,MKT
06079919219020000,2020,103402,314198,417600,MKT
06079919219020000,2019,103402,314198,417600,MKT
06079919219030000,2021,142291,450409,592700,MKT
06079919219030000,2020,103472,379028,482500,MKT
06079919219030000,2019,103472,379028,482500,MKT
06079919219040000,2021,142394,391906,534300,MKT
06079919219040000,2020,103545,358955,462500,MKT
06079919219040000,2019,103545,358955,462500,MKT
06079919219050000,2021,144852,393448,538300,MKT
06079919219050000,2020,105307,329893,435200,MKT
06079919219050000,2019,105307,329893,435200,MKT
06079919219060000,2021,148076,438724,586800,MKT
06079919219060000,2020,107617,420783,528400,MKT
06079919219060000,2019,107617,420783,528400,MKT
06079919219070000,2021,176258,456642,632900,MKT
06079919219070000,2020,127784,350516,478300,MKT
06079919219070000,2019,127784,350516,478300,MKT
06079919219080000,2021,353429,731840,1085269,COST
06079919219080000,2020,262937,702520,965457,COST
06079919219080000,2019,262937,702520,965457,COST
06079919219120000,2021,274744,370556,645300,MKT
06079919219120000,2020,205128,415423,620551,MRA
06079919219120000,2019,205128,415423,620551,MRA
06079919219140000,2021,275535,343465,619000,MKT
06079919219140000,2020,205710,309990,515700,MKT
06079919219140000,2019,205710,309990,515700,MKT
06079919219150000,2021,274680,635420,910100,MKT
06079919219150000,2020,205081,716810,921891,COST
06079919219150000,2019,205081,716810,921891,COST
06079919219160000,2021,280374,647660,928034,COST
06079919219160000,2020,209271,623940,833211,COST
06079919219160000,2019,209271,623940,833211,COST
06079919219170000,2021,236127,624873,861000,MKT
06079919219170000,2020,170482,458118,628600,MKT
06079919219170000,2019,170482,458118,628600,MKT
06079919219200000,2021,254381,567719,822100,MKT
06079919219200000,2020,183467,566540,750007,COST
06079919219200000,2019,183467,566540,750007,COST
06079919219211001,2021,32094,0,32094,COST
06079919219211001,2020,23057,0,23057,COST
06079919219211001,2019,23057,0,23057,COST
06079919219211002,2021,201282,641560,842842,COST
06079919219211002,2020,145652,623480,769132,COST
06079919219211002,2019,145652,623480,769132,COST
06079919219220000,2021,237891,466109,704000,MKT
06079919219220000,2020,171738,549590,721328,COST
06079919219220000,2019,171738,549590,721328,COST
06079919219230000,2021,231730,639470,871200,MKT
06079919219230000,2020,167352,467448,634800,MKT
06079919219230000,2019,167352,467448,634800,MKT
06079919219316500,2021,87636,0,87636,COST
06079919219316500,2020,63082,0,63082,COST
06079919219316500,2019,63082,0,63082,COST
06079919220017000,2021,246883,0,246883,COST
06079919220017000,2020,178135,0,178135,COST
06079919220017000,2019,178135,0,178135,COST
06079919220037000,2021,257249,0,257249,COST
06079919220037000,2020,185507,0,185507,COST
06079919220037000,2019,185507,0,185507,COST
06079919220050000,2021,418251,118260,536511,COST
06079919220050000,2020,300007,121150,421157,COST
06079919220050000,2019,300007,121150,421157,COST
06079919220076500,2021,110223,0,110223,COST
06079919220076500,2020,79084,0,79084,COST
06079919220076500,2019,79084,0,79084,COST
06079919220090000,2021,253359,337041,590400,MKT
06079919220090000,2020,198294,308706,507000,MKT
06079919220090000,2019,198294,308706,507000,MKT
06079919220096500,2021,44596,0,44596,COST
06079919220096500,2020,32410,0,32410,COST
06079919220096500,2019,32410,0,32410,COST
06079919220147000,2021,734422,0,734422,COST
06079919220147000,2020,540758,0,540758,COST
06079919220147000,2019,540758,0,540758,COST
06079919229010000,2021,146011,335789,481800,MKT
06079919229010000,2020,106138,314362,420500,MKT
06079919229010000,2019,106138,314362,420500,MKT
06079919229020000,2021,136540,335760,472300,MKT
06079919229020000,2020,99347,308153,407500,MKT
06079919229020000,2019,99347,308153,407500,MKT
06079919229030000,2021,133935,333565,467500,MKT
06079919229030000,2020,97478,350822,448300,MKT
06079919229030000,2019,97478,350822,448300,MKT
06079919229040000,2021,165628,388672,554300,MKT
06079919229040000,2020,120183,367817,488000,MKT
06079919229040000,2019,120183,367817,488000,MKT
06079919229050000,2021,198002,326398,524400,MKT
06079919229050000,2020,143313,283587,426900,MKT
06079919229050000,2019,143313,283587,426900,MKT
06079919229060000,2021,200151,358849,559000,MKT
06079919229060000,2020,144846,418454,563300,MKT
06079919229060000,2019,144846,418454,563300,MKT
06079919229070000,2021,164067,317033,481100,MKT
06079919229070000,2020,119066,314634,433700,MKT
06079919229070000,2019,119066,314634,433700,MKT
06079919229080000,2021,156563,353437,510000,MKT
06079919229080000,2020,113696,326204,439900,MKT
06079919229080000,2019,113696,326204,439900,MKT
06079919229090000,2021,156185,383415,539600,MKT
06079919229090000,2020,113425,358075,471500,MKT
06079919229090000,2019,113425,358075,471500,MKT
06079919229100000,2021,148400,362900,511300,MKT
06079919229100000,2020,107850,323250,431100,MKT
06079919229100000,2019,107850,323250,431100,MKT
06079919229110000,2021,144780,336520,481300,MKT
06079919229110000,2020,105256,304344,409600,MKT
06079919229110000,2019,105256,304344,409600,MKT
06079919229120000,2021,162490,339610,502100,MKT
06079919229120000,2020,117938,321362,439300,MKT
06079919229120000,2019,117938,321362,439300,MKT
06079919229130000,2021,172374,308226,480600,MKT
06079919229130000,2020,125008,340392,465400,MKT
06079919229130000,2019,125008,340392,465400,MKT
06079919229140000,2021,153319,355881,509200,MKT
06079919229140000,2020,111373,336127,447500,MKT
06079919229140000,2019,111373,336127,447500,MKT
06079919229150000,2021,153487,290013,443500,MKT
06079919229150000,2020,111493,270207,381700,MKT
06079919229150000,2019,111493,270207,381700,MKT
06079919229160000,2021,158456,374244,532700,MKT
06079919229160000,2020,115051,354849,469900,MKT
06079919229160000,2019,115051,357849,472900,MKT
06079919229170000,2021,142479,319421,461900,MKT
06079919229170000,2020,103606,266394,370000,MKT
06079919229170000,2019,103606,266394,370000,MKT
06079919229180000,2021,148441,396659,545100,MKT
06079919229180000,2020,107879,333921,441800,MKT
06079919229180000,2019,107879,333921,441800,MKT
06079919229190000,2021,148487,342313,490800,MKT
06079919229190000,2020,107912,292788,400700,MKT
06079919229190000,2019,107912,292788,400700,MKT
06079919229200000,2021,152758,409142,561900,MKT
06079919229200000,2020,110972,387428,498400,MKT
06079919229200000,2019,110972,387428,498400,MKT
06079919229210000,2021,157703,373597,531300,MKT
06079919229210000,2020,114512,381288,495800,MKT
06079919229210000,2019,114512,381288,495800,MKT
06079919230010000,2021,151057,415443,566500,MKT
06079919230010000,2020,109753,376847,486600,MKT
06079919230010000,2019,109753,366447,476200,MKT
06079919230020000,2021,199621,508679,708300,MKT
06079919230020000,2020,149715,505160,654875,COST
06079919230020000,2019,149715,505160,654875,COST
06079919230030000,2021,200156,342044,542200,MKT
06079919230030000,2020,150110,360590,510700,MKT
06079919230030000,2019,150110,360590,510700,MKT
06079919230040000,2021,180007,494493,674500,MKT
06079919230040000,2020,130463,419237,549700,MKT
06079919230040000,2019,130463,419237,549700,MKT
06079919230050000,2021,205879,652421,858300,MKT
06079919230050000,2020,154341,596610,750951,COST
06079919230050000,2019,154341,596610,750951,COST
06079919230060000,2021,198844,378756,577600,MKT
06079919230060000,2020,143913,370287,514200,MKT
06079919230060000,2019,143913,370287,514200,MKT
06079919230090000,2021,208121,517779,725900,MKT
06079919230090000,2020,155998,470302,626300,MKT
06079919230090000,2019,155998,470302,626300,MKT
06079919230100000,2021,178750,352350,531100,MKT
06079919230100000,2020,134271,320129,454400,MKT
06079919230100000,2019,134271,320129,454400,MKT
06079919230110000,2021,154360,376940,531300,MKT
06079919230110000,2020,116191,332709,448900,MKT
06079919230110000,2019,116191,332709,448900,MKT
06079919230120000,2021,173574,380526,554100,MKT
06079919230120000,2020,130438,357962,488400,MKT
06079919230120000,2019,130438,357962,488400,MKT
06079919230130000,2021,184647,325253,509900,MKT
06079919230130000,2020,138637,272763,411400,MKT
06079919230130000,2019,138637,270163,408800,MKT
06079919230216500,2021,83753,0,83753,COST
06079919230216500,2020,60326,0,60326,COST
06079919230216500,2019,60326,0,60326,COST
06079919255010000,2021,152668,334932,487600,MKT
06079919255010000,2020,110907,287693,398600,MKT
06079919255010000,2019,110907,287693,398600,MKT
06079919255020000,2021,152893,317007,469900,MKT
06079919255020000,2020,111068,326632,437700,MKT
06079919255020000,2019,111068,317432,428500,MKT
06079919255040000,2021,148163,315537,463700,MKT
06079919255040000,2020,107680,251120,358800,MKT
06079919255040000,2019,107680,251120,358800,MKT
06079919255060000,2021,191209,366491,557700,MKT
06079919255060000,2020,143493,368507,512000,MKT
06079919255060000,2019,143493,368507,512000,MKT
06079919255080000,2021,171888,350112,522000,MKT
06079919255080000,2020,124660,359640,484300,MKT
06079919255080000,2019,124660,359640,484300,MKT
06079919255100000,2021,191396,392404,583800,MKT
06079919255100000,2020,143631,348269,491900,MKT
06079919255100000,2019,143631,348269,491900,MKT
06079919255110000,2021,191396,375504,566900,MKT
06079919255110000,2020,143631,383669,527300,MKT
06079919255110000,2019,143631,383669,527300,MKT
06079919255220000,2021,228847,447610,676457,COST
06079919255220000,2020,179642,412820,592462,COST
06079919255220000,2019,179642,412820,592462,COST
06079919255220200,2021,109087,0,109087,COST
06079919255220200,2020,78815,0,78815,COST
06079919255220200,2019,78815,0,78815,COST
06079919255316500,2021,67134,0,67134,COST
06079919255316500,2020,48507,0,48507,COST
06079919255316500,2019,48507,0,48507,COST
06079919257010000,2021,189124,496276,685400,MKT
06079919257010000,2020,136975,440425,577400,MKT
06079919257010000,2019,136975,440425,577400,MKT
06079919257020000,2021,179884,364716,544600,MKT
06079919257020000,2020,130375,346225,476600,MKT
06079919257020000,2019,130375,346225,476600,MKT
06079919257030000,2021,179884,551110,730994,COST
06079919257030000,2020,130375,166190,296565,COST
06079919257030000,2019,130375,351725,482100,MKT
06079919257040000,2021,176577,401623,578200,MKT
06079919257040000,2020,128012,334988,463000,MKT
06079919257040000,2019,128012,334988,463000,MKT
06079919257050000,2021,177049,348851,525900,MKT
06079919257050000,2020,128350,359650,488000,MKT
06079919257050000,2019,128350,359650,488000,MKT
06079919257060000,2021,171685,378515,550200,MKT
06079919257060000,2020,124515,304285,428800,MKT
06079919257060000,2019,124515,304285,428800,MKT
06079919301010000,2021,344256,224660,568916,COST
06079919301010000,2020,267215,214185,481400,MKT
06079919301010000,2019,267215,214185,481400,MKT
06079919301010900,2021,261726,347874,609600,MKT
06079919301010900,2020,198420,276080,474500,MKT
06079919301010900,2019,198420,276080,474500,MKT
06079919301040000,2021,433927,357860,791787,COST
06079919301040000,2020,348951,342830,691781,COST
06079919301040000,2019,348951,342830,691781,COST
06079919301050000,2021,261726,315750,577476,COST
06079919301050000,2020,198420,311280,509700,MKT
06079919301050000,2019,198420,311280,509700,MKT
06079919301070000,2021,434002,855670,1289672,COST
06079919301070000,2020,349020,855380,1204400,COST
06079919301070000,2019,349020,855380,1204400,COST
06079919301100000,2021,548793,881690,1430483,COST
06079919301100000,2020,457453,851140,1308593,COST
06079919301100000,2019,457453,1194010,1651463,COST
06079919302010000,2021,377049,589170,966219,COST
06079919302010000,2020,296768,571850,868618,COST
06079919302010000,2019,296768,571850,868618,COST
06079919302040000,2021,397681,701570,1099251,COST
06079919302040000,2020,315567,696560,1012127,COST
06079919302040000,2019,315567,696560,1012127,COST
06079919302070000,2021,424031,312580,736611,COST
06079919302070000,2020,339792,303790,643582,COST
06079919302070000,2019,339792,303790,643582,COST
06079919303010000,2021,231714,193786,425500,MKT
06079919303010000,2020,172427,228573,401000,MKT
06079919303010000,2019,172427,228573,401000,MKT
06079919303050000,2021,237371,424540,661911,COST
06079919303050000,2020,177290,385310,562600,MKT
06079919303050000,2019,177290,385310,562600,MKT
06079919304020000,2021,294384,259316,553700,MKT
06079919304020000,2020,227227,259973,487200,MKT
06079919304020000,2019,227227,259973,487200,MKT
06079919304030000,2021,231714,364786,596500,MKT
06079919304030000,2020,172427,389773,562200,MKT
06079919304030000,2019,172427,389773,562200,MKT
06079919304040000,2021,237045,321555,558600,MKT
06079919304040000,2020,177009,319991,497000,MKT
06079919304040000,2019,177009,319991,497000,MKT
06079919304050000,2021,229136,255064,484200,MKT
06079919304050000,2020,170217,225483,395700,MKT
06079919304050000,2019,170217,225483,395700,MKT
06079919305010000,2021,371517,1222670,1594187,COST
06079919305010000,2020,268101,1167610,1435711,COST
06079919305010000,2019,268101,1167610,1435711,COST
06079919305010900,2021,420585,311150,731735,COST
06079919305010900,2020,336610,302630,639240,COST
06079919305010900,2019,336610,302630,639240,COST
06079919305030000,2021,385082,553970,939052,COST
06079919305030000,2020,304069,538370,842439,COST
06079919305030000,2019,304069,538370,842439,COST
06079919305040900,2021,266416,292284,558700,MKT
06079919305040900,2020,202525,221575,424100,MKT
06079919305040900,2019,202525,221575,424100,MKT
06079919305050000,2021,253308,230492,483800,MKT
06079919305050000,2020,191081,227019,418100,MKT
06079919305050000,2019,191081,227019,418100,MKT
06079919305060000,2021,235733,241167,476900,MKT
06079919305060000,2020,175880,239020,414900,MKT
06079919305060000,2019,175880,239020,414900,MKT
06079919305080000,2021,235568,316832,552400,MKT
06079919305080000,2020,175738,289762,465500,MKT
06079919305080000,2019,175738,289762,465500,MKT
06079919305090000,2021,173391,385609,559000,MKT
06079919305090000,2020,191116,331584,522700,MKT
06079919305090000,2019,191116,331584,522700,MKT
06079919305100000,2021,242573,333927,576500,MKT
06079919305100000,2020,176109,292491,468600,MKT
06079919305100000,2019,176109,292491,468600,MKT
06079919305130000,2021,482150,412650,894800,MKT
06079919305130000,2020,358397,397430,755827,COST
06079919305130000,2019,358397,397430,755827,COST
06079919305160000,2021,428457,322430,750887,COST
06079919305160000,2020,319017,313570,632587,COST
06079919305160000,2019,319017,313570,632587,COST
06079919305190000,2021,473147,607253,1080400,MKT
06079919305190000,2020,351798,587130,938928,COST
06079919305190000,2019,351798,587130,938928,COST
06079919305220000,2021,243582,284918,528500,MKT
06079919305220000,2020,176831,290269,467100,MKT
06079919305220000,2019,176831,290269,467100,MKT
06079919305250000,2021,245096,444904,690000,MKT
06079919305250000,2020,177914,362686,540600,MKT
06079919305250000,2019,177914,362686,540600,MKT
06079919305280000,2021,245096,592404,837500,MKT
06079919305280000,2020,177914,461486,639400,MKT
06079919305280000,2019,177914,461486,639400,MKT
06079919305310000,2021,245096,365704,610800,MKT
06079919305310000,2020,177914,316586,494500,MKT
06079919305310000,2019,177914,316586,494500,MKT
06079919305340000,2021,245096,351204,596300,MKT
06079919305340000,2020,177914,305686,483600,MKT
06079919305340000,2019,177914,305686,483600,MKT
06079919305370000,2021,245096,318304,563400,MKT
06079919305370000,2020,177914,330586,508500,MKT
06079919305370000,2019,177914,330586,508500,MKT
06079919305400000,2021,245096,331504,576600,MKT
06079919305400000,2020,177914,274586,452500,MKT
06079919305400000,2019,177914,274586,452500,MKT
06079919305430000,2021,241362,401438,642800,MKT
06079919305430000,2020,175242,341458,516700,MKT
06079919305430000,2019,175242,341458,516700,MKT
06079919305460000,2021,494648,671452,1166100,MKT
06079919305460000,2020,367554,751330,1118884,COST
06079919305460000,2019,367554,737570,1105124,COST
06079919305490000,2021,449118,481582,930700,MKT
06079919305490000,2020,334178,580360,914538,COST
06079919305490000,2019,334178,580360,914538,COST
06079919305520000,2021,499732,671668,1171400,MKT
06079919305520000,2020,371278,640210,1011488,COST
06079919305520000,2019,371278,640210,1011488,COST
06079919305550000,2021,242923,316477,559400,MKT
06079919305550000,2020,176359,292741,469100,MKT
06079919305550000,2019,176359,292741,469100,MKT
06079919305580000,2021,246207,345993,592200,MKT
06079919305580000,2020,178709,317591,496300,MKT
06079919305580000,2019,178709,317591,496300,MKT
06079919305610000,2021,245765,266935,512700,MKT
06079919305610000,2020,178393,283207,461600,MKT
06079919305610000,2019,178393,283207,461600,MKT
06079919305640000,2021,245322,280878,526200,MKT
06079919305640000,2020,178076,247324,425400,MKT
06079919305640000,2019,178076,247324,425400,MKT
06079919306010000,2021,305561,301790,607351,COST
06079919306010000,2020,281186,279930,561116,COST
06079919306010000,2019,281186,279930,561116,COST
06079919306070000,2021,269514,0,269514,COST
06079919306070000,2020,160731,0,160731,COST
06079919306070000,2019,160731,0,160731,COST
06079919306100000,2021,557814,258620,816434,COST
06079919306100000,2020,295307,255393,550700,MKT
06079919306100000,2019,295307,251393,546700,MKT
06079919307016500,2021,191806,0,191806,COST
06079919307016500,2020,122111,0,122111,COST
06079919307016500,2019,122111,0,122111,COST
06079919307017000,2021,1498339,0,1498339,COST
06079919307017000,2020,1743585,0,1743585,COST
06079919307017000,2019,1743585,0,1743585,COST
06079919307036500,2021,255111,0,255111,COST
06079919307036500,2020,119708,0,119708,COST
06079919307036500,2019,119708,0,119708,COST
06079919308010000,2021,1008471,5076880,6085351,COST
06079919308010000,2020,746570,4795770,5542340,COST
06079919308010000,2019,746570,4795770,5542340,COST
06079919309016500,2021,222103,0,222103,COST
06079919309016500,2020,104423,0,104423,COST
06079919309016500,2019,104423,0,104423,COST
06079919309036500,2021,117356,0,117356,COST
06079919309036500,2020,55676,0,55676,COST
06079919309036500,2019,55676,0,55676,COST
06079919310010000,2021,168689,288511,457200,MKT
06079919310010000,2020,128344,221756,350100,MKT
06079919310010000,2019,128344,219056,347400,MKT
06079919310020000,2021,130211,0,130211,COST
06079919310020000,2020,95225,0,95225,COST
06079919310020000,2019,95225,0,95225,COST
06079919310040000,2021,191952,286848,478800,MKT
06079919310040000,2020,148956,265544,414500,MKT
06079919310040000,2019,148956,265544,414500,MKT
06079919310050000,2021,166234,303866,470100,MKT
06079919310050000,2020,126193,227307,353500,MKT
06079919310050000,2019,126193,227307,353500,MKT
06079919310070000,2021,219929,607190,827119,COST
06079919310070000,2020,174254,584390,758644,COST
06079919310070000,2019,174254,584390,758644,COST
06079919310080000,2021,183705,234595,418300,MKT
06079919310080000,2020,141603,236297,377900,MKT
06079919310080000,2019,141603,236297,377900,MKT
06079919310090000,2021,159020,428280,587300,MKT
06079919310090000,2020,119901,438799,558700,MKT
06079919310090000,2019,119901,438799,558700,MKT
06079919310100000,2021,159020,294780,453800,MKT
06079919310100000,2020,119901,233799,353700,MKT
06079919310100000,2019,119901,233799,353700,MKT
06079919310110000,2021,198447,279153,477600,MKT
06079919310110000,2020,154782,285118,439900,MKT
06079919310110000,2019,154782,285118,439900,MKT
06079919310120000,2021,166234,113166,279400,INCOME
06079919310120000,2020,126193,140307,266500,INCOME
06079919310120000,2019,126193,140307,266500,INCOME
06079919310145012,2021,78847,234753,313600,MKT
06079919310145012,2020,57817,242083,299900,MKT
06079919310145012,2019,57817,242083,299900,MKT
06079919310165011,2021,67933,316267,384200,MKT
06079919310165011,2020,49919,302981,352900,MKT
06079919310165011,2019,49919,302981,352900,MKT
06079919310185010,2021,67933,321567,389500,MKT
06079919310185010,2020,49919,308381,358300,MKT
06079919310185010,2019,49919,308381,358300,MKT
06079919310205009,2021,78847,235553,314400,MKT
06079919310205009,2020,57817,243683,301500,MKT
06079919310205009,2019,57817,243683,301500,MKT
06079919311010000,2021,140418,275582,416000,MKT
06079919311010000,2020,97032,229968,327000,MKT
06079919311010000,2019,97032,229968,327000,MKT
06079919311020000,2021,142154,0,142154,COST
06079919311020000,2020,98417,0,98417,COST
06079919311020000,2019,98417,0,98417,COST
06079919311030000,2021,185865,391020,576885,COST
06079919311030000,2020,134062,285938,420000,MKT
06079919311030000,2019,134062,287938,422000,MKT
06079919311060000,2021,164154,306446,470600,MKT
06079919311060000,2020,116176,283224,399400,MKT
06079919311060000,2019,116176,283224,399400,MKT
06079919311070000,2021,164154,274546,438700,MKT
06079919311070000,2020,116176,288524,404700,MKT
06079919311070000,2019,116176,288524,404700,MKT
06079919311080000,2021,142154,170,142324,COST
06079919311080000,2020,98417,180,98597,COST
06079919311080000,2019,98417,180,98597,COST
06079919311100000,2021,142154,0,142154,COST
06079919311100000,2020,98417,0,98417,COST
06079919311100000,2019,98417,0,98417,COST
06079919311130000,2021,176378,346180,522558,COST
06079919311130000,2020,126204,271096,397300,MKT
06079919311130000,2019,126204,271096,397300,MKT
06079919311140000,2021,167013,285187,452200,MKT
06079919311140000,2020,118511,223689,342200,MKT
06079919311140000,2019,118511,223689,342200,MKT
06079919311150000,2021,161474,166926,328400,INCOME
06079919311150000,2020,113991,199309,313300,INCOME
06079919311150000,2019,113991,199309,313300,INCOME
06079919311160000,2021,180126,257874,438000,MKT
06079919311160000,2020,129302,250198,379500,MKT
06079919311160000,2019,129302,250198,379500,MKT
06079919311185005,2021,78847,377753,456600,MKT
06079919311185005,2020,57817,376783,434600,MKT
06079919311185005,2019,57817,376783,434600,MKT
06079919311205006,2021,67933,320867,388800,MKT
06079919311205006,2020,49919,320681,370600,MKT
06079919311205006,2019,49919,320681,370600,MKT
06079919311225007,2021,67933,328467,396400,MKT
06079919311225007,2020,49919,328881,378800,MKT
06079919311225007,2019,49919,328881,378800,MKT
06079919311245008,2021,78847,350653,429500,MKT
06079919311245008,2020,57817,344583,402400,MKT
06079919311245008,2019,57817,344583,402400,MKT
06079919312010000,2021,193373,363170,556543,COST
06079919312010000,2020,140324,346920,487244,COST
06079919312010000,2019,140324,346920,487244,COST
06079919312030000,2021,130482,197918,328400,INCOME
06079919312030000,2020,89160,224140,313300,INCOME
06079919312030000,2019,89160,224140,313300,INCOME
06079919312040000,2021,129471,278129,407600,MKT
06079919312040000,2020,88364,218936,307300,MKT
06079919312040000,2019,88364,215636,304000,MKT
06079919312050000,2021,145007,275093,420100,MKT
06079919312050000,2020,107804,213796,321600,MKT
06079919312050000,2019,107804,213796,321600,MKT
06079919312060000,2021,699832,0,699832,COST
06079919312060000,2020,491543,0,491543,COST
06079919312060000,2019,491543,0,491543,COST
06079919312105001,2021,78847,227753,306600,MKT
06079919312105001,2020,57817,234883,292700,MKT
06079919312105001,2019,57817,234883,292700,MKT
06079919312106500,2021,195159,0,195159,COST
06079919312106500,2020,59574,0,59574,COST
06079919312106500,2019,59574,0,59574,COST
06079919312125002,2021,67933,319667,387600,MKT
06079919312125002,2020,49919,306481,356400,MKT
06079919312125002,2019,49919,306481,356400,MKT
06079919312145003,2021,67933,319667,387600,MKT
06079919312145003,2020,49919,306481,356400,MKT
06079919312145003,2019,49919,306481,356400,MKT
06079919312165004,2021,78847,227753,306600,MKT
06079919312165004,2020,57817,234883,292700,MKT
06079919312165004,2019,57817,234883,292700,MKT
06079919313010000,2021,241034,597666,838700,MKT
06079919313010000,2020,180933,490167,671100,MKT
06079919313010000,2019,180933,490167,671100,MKT
06079919313030000,2021,260933,632267,893200,MKT
06079919313030000,2020,195651,521239,716890,OVR
06079919313030000,2019,195651,521239,716890,OVR
06079919313050000,2021,260944,554756,815700,MKT
06079919313050000,2020,195659,426241,621900,MKT
06079919313050000,2019,195659,426241,621900,MKT
06079919313070000,2021,263665,628335,892000,MKT
06079919313070000,2020,197671,578129,775800,MKT
06079919313070000,2019,197671,578129,775800,MKT
06079919314010000,2021,257698,420902,678600,MKT
06079919314010000,2020,186930,392470,579400,MKT
06079919314010000,2019,186930,385470,572400,MKT
06079919314030000,2021,262910,432090,695000,MKT
06079919314030000,2020,190656,390444,581100,MKT
06079919314030000,2019,190656,390444,581100,MKT
06079919315010000,2021,225436,702564,928000,MKT
06079919315010000,2020,163837,696363,860200,MKT
06079919315010000,2019,163837,696363,860200,MKT
06079919315030000,2021,234571,647929,882500,MKT
06079919315030000,2020,170380,570620,741000,MKT
06079919315030000,2019,170380,570620,741000,MKT
06079919315050000,2021,232474,641726,874200,MKT
06079919315050000,2020,168878,601822,770700,MKT
06079919315050000,2019,168878,601822,770700,MKT
06079919316010000,2021,218788,685312,904100,MKT
06079919316010000,2020,159073,570346,729419,OVR
06079919316010000,2019,159073,570346,729419,OVR
06079919316030000,2021,226640,478960,705600,MKT
06079919316030000,2020,164699,419701,584400,MKT
06079919316030000,2019,164699,419701,584400,MKT
06079919316050000,2021,231876,0,231876,COST
06079919316050000,2020,168450,0,168450,COST
06079919316050000,2019,168450,0,168450,COST
06079919316070000,2021,240170,0,240170,COST
06079919316070000,2020,174389,0,174389,COST
06079919316070000,2019,174389,0,174389,COST
06079919316090000,2021,236807,687593,924400,MKT
06079919316090000,2020,171981,580119,752100,MKT
06079919316090000,2019,171981,580119,752100,MKT
06079919316110000,2021,237175,606325,843500,MKT
06079919316110000,2020,172245,506055,678300,MKT
06079919316110000,2019,172245,501655,673900,MKT
06079919316130000,2021,218324,583176,801500,MKT
06079919316130000,2020,158740,505660,664400,MKT
06079919316130000,2019,158740,505660,664400,MKT
06079919317010000,2021,299421,791679,1091100,MKT
06079919317010000,2020,224074,744539,968613,MRA
06079919317010000,2019,224074,744539,968613,MRA
06079919317030000,2021,315798,1303902,1619700,MKT
06079919317030000,2020,236151,1157160,1393311,COST
06079919317030000,2019,236151,1157160,1393311,COST
06079919317050000,2021,284769,1095231,1380000,MKT
06079919317050000,2020,213260,1083790,1297050,COST
06079919317050000,2019,213260,1083790,1297050,COST
06079919317070000,2021,289803,529297,819100,MKT
06079919317070000,2020,216976,429424,646400,MKT
06079919317070000,2019,216976,429424,646400,MKT
06079919317090000,2021,299192,697608,996800,MKT
06079919317090000,2020,223904,585896,809800,MKT
06079919317090000,2019,223904,585896,809800,MKT
06079919317110000,2021,239535,725465,965000,MKT
06079919317110000,2020,173934,610666,784600,MKT
06079919317110000,2019,173934,610666,784600,MKT
06079919317130000,2021,275194,754806,1030000,MKT
06079919317130000,2020,206189,802490,1008679,COST
06079919317130000,2019,206189,802490,1008679,COST
06079919317150000,2021,285059,729441,1014500,MKT
06079919317150000,2020,213474,622026,835500,MKT
06079919317150000,2019,213474,622026,835500,MKT
06079919317170000,2021,221758,0,221758,COST
06079919317170000,2020,161201,0,161201,COST
06079919317170000,2019,161201,0,161201,COST
06079919317190000,2021,217722,578978,796700,MKT
06079919317190000,2020,158309,485391,643700,MKT
06079919317190000,2019,158309,485391,643700,MKT
06079919318010000,2021,217484,516816,734300,MKT
06079919318010000,2020,158138,493662,651800,MKT
06079919318010000,2019,158138,493662,651800,MKT
06079919318030000,2021,211592,575108,786700,MKT
06079919318030000,2020,153914,465986,619900,MKT
06079919318030000,2019,153914,465986,619900,MKT
06079919318050000,2021,211592,500408,712000,MKT
06079919318050000,2020,153914,533730,687644,COST
06079919318050000,2019,153914,533730,687644,COST
06079919318070000,2021,219886,626214,846100,MKT
06079919318070000,2020,159859,543841,703700,MKT
06079919318070000,2019,159859,543841,703700,MKT
06079919319010000,2021,232900,584300,817200,MKT
06079919319010000,2020,169184,507316,676500,MKT
06079919319010000,2019,169184,507316,676500,MKT
06079919319030000,2021,228341,738780,967121,COST
06079919319030000,2020,165918,710860,876778,COST
06079919319030000,2019,165918,696740,862658,COST
06079919319050000,2021,236238,484262,720500,MKT
06079919319050000,2020,171573,421427,593000,MKT
06079919319050000,2019,171573,421427,593000,MKT
06079919320010000,2021,200796,414604,615400,MKT
06079919320010000,2020,146169,430331,576500,MKT
06079919320010000,2019,146169,430331,576500,MKT
06079919320030000,2021,196226,412074,608300,MKT
06079919320030000,2020,142888,437312,580200,MKT
06079919320030000,2019,142888,437312,580200,MKT
06079919320050000,2021,191394,507106,698500,MKT
06079919320050000,2020,139419,433481,572900,MKT
06079919320050000,2019,139419,433481,572900,MKT
06079919320070000,2021,193133,595567,788700,MKT
06079919320070000,2020,140668,505832,646500,MKT
06079919320070000,2019,140668,510332,651000,MKT
06079919321010000,2021,216880,588720,805600,MKT
06079919321010000,2020,157705,462095,619800,MKT
06079919321010000,2019,157705,462095,619800,MKT
06079919321030000,2021,212297,541270,753567,COST
06079919321030000,2020,154419,528820,683239,COST
06079919321030000,2019,154419,528820,683239,COST
06079919321050000,2021,209786,541914,751700,MKT
06079919321050000,2020,152618,437782,590400,MKT
06079919321050000,2019,152618,437782,590400,MKT
06079919321070000,2021,211554,480146,691700,MKT
06079919321070000,2020,153887,434813,588700,MKT
06079919321070000,2019,153887,434813,588700,MKT
06079919321090000,2021,215951,697949,913900,MKT
06079919321090000,2020,157039,609661,766700,MKT
06079919321090000,2019,157039,609661,766700,MKT
06079919321110000,2021,219252,552548,771800,MKT
06079919321110000,2020,159405,473295,632700,MKT
06079919321110000,2019,159405,473295,632700,MKT
06079919321130000,2021,219016,445684,664700,MKT
06079919321130000,2020,159236,415564,574800,MKT
06079919321130000,2019,159236,415564,574800,MKT
06079919322010000,2021,219342,624858,844200,MKT
06079919322010000,2020,159470,509330,668800,MKT
06079919322010000,2019,159470,509330,668800,MKT
06079919322030000,2021,218798,511902,730700,MKT
06079919322030000,2020,159080,435320,594400,MKT
06079919322030000,2019,159080,435320,594400,MKT
06079919322050000,2021,225507,705193,930700,MKT
06079919322050000,2020,163888,596712,760600,MKT
06079919322050000,2019,163888,596712,760600,MKT
06079919323010000,2021,217439,568661,786100,MKT
06079919323010000,2020,158106,448394,606500,MKT
06079919323010000,2019,158106,448394,606500,MKT
06079919323030000,2021,211592,452508,664100,MKT
06079919323030000,2020,153914,403486,557400,MKT
06079919323030000,2019,153914,403486,557400,MKT
06079919323050000,2021,211592,639808,851400,MKT
06079919323050000,2020,153914,568886,722800,MKT
06079919323050000,2019,153914,568886,722800,MKT
06079919323070000,2021,213839,584461,798300,MKT
06079919323070000,2020,155525,457975,613500,MKT
06079919323070000,2019,155525,457975,613500,MKT
06079919324010000,2021,230976,560324,791300,MKT
06079919324010000,2020,167806,494894,662700,MKT
06079919324010000,2019,167806,494894,662700,MKT
06079919324030000,2021,217585,638115,855700,MKT
06079919324030000,2020,158210,552990,711200,MKT
06079919324030000,2019,158210,552990,711200,MKT
06079919324050000,2021,217585,0,217585,COST
06079919324050000,2020,158210,0,158210,COST
06079919324050000,2019,158210,0,158210,COST
06079919324070000,2021,238175,556925,795100,MKT
06079919324070000,2020,172961,467039,640000,MKT
06079919324070000,2019,172961,467039,640000,MKT
06079919325010000,2021,214564,484536,699100,MKT
06079919325010000,2020,156045,432255,588300,MKT
06079919325010000,2019,156045,432255,588300,MKT
06079919325030000,2021,224120,0,224120,COST
06079919325030000,2020,162894,0,162894,COST
06079919325030000,2019,162894,0,162894,COST
06079919325050000,2021,226438,646062,872500,MKT
06079919325050000,2020,164555,560145,724700,MKT
06079919325050000,2019,164555,560145,724700,MKT
06079919325070000,2021,242009,701291,943300,MKT
06079919325070000,2020,175705,605695,781400,MKT
06079919325070000,2019,175705,605695,781400,MKT
06079919326010000,2021,258181,0,258181,COST
06079919326010000,2020,193617,0,193617,COST
06079919326010000,2019,193617,0,193617,COST
06079919326030000,2021,254420,746880,1001300,MKT
06079919326030000,2020,190835,628165,819000,MKT
06079919326030000,2019,190835,619365,810200,MKT
06079919326050000,2021,247816,693484,941300,MKT
06079919326050000,2020,185951,582549,768500,MKT
06079919326050000,2019,185951,582549,768500,MKT
06079919326070000,2021,260891,623809,884700,MKT
06079919326070000,2020,195620,597480,793100,MKT
06079919326070000,2019,195620,597480,793100,MKT
06079919327010000,2021,262097,0,262097,COST
06079919327010000,2020,196511,0,196511,COST
06079919327010000,2019,196511,0,196511,COST
06079919327030000,2021,288374,607626,896000,MKT
06079919327030000,2020,215921,532679,748600,MKT
06079919327030000,2019,215921,532679,748600,MKT
06079919327050000,2021,289869,514531,804400,MKT
06079919327050000,2020,217025,429275,646300,MKT
06079919327050000,2019,217025,429275,646300,MKT
06079919327070000,2021,280585,0,280585,COST
06079919327070000,2020,210170,0,210170,COST
06079919327070000,2019,210170,0,210170,COST
06079919327090000,2021,299467,686033,985500,MKT
06079919327090000,2020,224107,685493,909600,MKT
06079919327090000,2019,224107,685493,909600,MKT
06079919327110000,2021,277471,642629,920100,MKT
06079919327110000,2020,207870,527930,735800,MKT
06079919327110000,2019,207870,527930,735800,MKT
06079919328010000,2021,271710,501790,773500,MKT
06079919328010000,2020,203615,426685,630300,MKT
06079919328010000,2019,203615,426685,630300,MKT
06079919328030000,2021,278681,642519,921200,MKT
06079919328030000,2020,208764,631336,840100,MKT
06079919328030000,2019,208764,0,208764,COST
06079919328050000,2021,290950,506150,797100,MKT
06079919328050000,2020,217822,401678,619500,MKT
06079919328050000,2019,217822,401678,619500,MKT
06079919328070000,2021,267518,760582,1028100,MKT
06079919328070000,2020,200518,632182,832700,MKT
06079919328070000,2019,200518,632182,832700,MKT
06079919328090000,2021,282505,0,282505,COST
06079919328090000,2020,211588,0,211588,COST
06079919328090000,2019,211588,0,211588,COST
06079919329010000,2021,209167,601633,810800,MKT
06079919329010000,2020,152175,541625,693800,MKT
06079919329010000,2019,152175,541625,693800,MKT
06079919329030000,2021,202292,533908,736200,MKT
06079919329030000,2020,147242,461658,608900,MKT
06079919329030000,2019,147242,461658,608900,MKT
06079919329050000,2021,202292,588808,791100,MKT
06079919329050000,2020,147242,470858,618100,MKT
06079919329050000,2019,147242,470858,618100,MKT
06079919329070000,2021,193257,484443,677700,MKT
06079919329070000,2020,140757,441143,581900,MKT
06079919329070000,2019,140757,426843,567600,MKT
06079919330010000,2021,214304,598796,813100,MKT
06079919330010000,2020,155858,488842,644700,MKT
06079919330010000,2019,155858,488842,644700,MKT
06079919330030000,2021,213401,632099,845500,MKT
06079919330030000,2020,155211,613989,769200,MKT
06079919330030000,2019,155211,519389,674600,MKT
06079919330050000,2021,219523,398577,618100,MKT
06079919330050000,2020,159600,386400,546000,MKT
06079919330050000,2019,159600,379900,539500,MKT
06079919330070000,2021,213560,386140,599700,MKT
06079919330070000,2020,155324,358576,513900,MKT
06079919330070000,2019,155324,356876,512200,MKT
06079919331016500,2021,242707,0,242707,COST
06079919331016500,2020,173230,0,173230,COST
06079919331016500,2019,173230,0,173230,COST
06079919331030000,2021,257257,602143,859400,MKT
06079919331030000,2020,192933,526067,719000,MKT
06079919331030000,2019,192933,526067,719000,MKT
06079919331050000,2021,277481,637219,914700,MKT
06079919331050000,2020,207878,624822,832700,MKT
06079919331050000,2019,207878,0,207878,COST
06079919331070000,2021,274199,645101,919300,MKT
06079919331070000,2020,205454,515546,721000,MKT
06079919331070000,2019,205454,515546,721000,MKT
06079919331090000,2021,282006,745094,1027100,MKT
06079919331090000,2020,211220,630880,842100,MKT
06079919331090000,2019,211220,630880,842100,MKT
06079919331110000,2021,284217,453583,737800,MKT
06079919331110000,2020,212852,411748,624600,MKT
06079919331110000,2019,212852,411748,624600,MKT
06079919331130000,2021,277839,624961,902800,MKT
06079919331130000,2020,208142,625958,834100,MKT
06079919331130000,2019,208142,625958,834100,MKT
06079919331150000,2021,279265,704735,984000,MKT
06079919331150000,2020,209195,711205,920400,MKT
06079919331150000,2019,209195,711205,920400,MKT
06079919332010000,2021,252780,464920,717700,MKT
06079919332010000,2020,189623,434177,623800,MKT
06079919332010000,2019,189623,434177,623800,MKT
06079919332030000,2021,261028,0,261028,COST
06079919332030000,2020,195722,0,195722,COST
06079919332030000,2019,195722,0,195722,COST
06079919332050000,2021,286890,1143410,1430300,MKT
06079919332050000,2020,214825,1146610,1361435,OVR
06079919332050000,2019,214825,1146610,1361435,COST
06079919332070000,2021,285928,686572,972500,MKT
06079919332070000,2020,214115,629585,843700,MKT
06079919332070000,2019,214115,629585,843700,MKT
06079919333010000,2021,309259,846341,1155600,MKT
06079919333010000,2020,231330,698870,930200,MKT
06079919333010000,2019,231330,698870,930200,MKT
06079919333030000,2021,225912,823288,1049200,MKT
06079919333030000,2020,164178,773922,938100,MKT
06079919333030000,2019,164178,762322,926500,MKT
06079919333050000,2021,249096,713504,962600,MKT
06079919333050000,2020,180777,246910,427687,COST
06079919333050000,2019,180777,0,180777,COST
06079919333070000,2021,284738,515662,800400,MKT
06079919333070000,2020,206253,464147,670400,MKT
06079919333070000,2019,206253,464147,670400,MKT
06079919333090000,2021,237016,672284,909300,MKT
06079919333090000,2020,172131,196780,368911,COST
06079919333090000,2019,172131,0,172131,COST
06079919333110000,2021,218443,513157,731600,MKT
06079919333110000,2020,158825,484075,642900,MKT
06079919333110000,2019,158825,484075,642900,MKT
06079919333130000,2021,222465,468535,691000,MKT
06079919333130000,2020,161708,431992,593700,MKT
06079919333130000,2019,161708,431992,593700,MKT
06079919334010000,2021,220247,0,220247,COST
06079919334010000,2020,160118,0,160118,COST
06079919334010000,2019,160118,0,160118,COST
06079919334030000,2021,211281,688219,899500,MKT
06079919334030000,2020,153691,638230,791921,OVR
06079919334030000,2019,153691,638230,791921,COST
06079919334050000,2021,207704,635496,843200,MKT
06079919334050000,2020,151125,584275,735400,MKT
06079919334050000,2019,151125,584275,735400,MKT
06079919334070000,2021,210289,591411,801700,MKT
06079919334070000,2020,152979,164140,317119,COST
06079919334070000,2019,152979,0,152979,COST
06079919334090000,2021,210279,604921,815200,MKT
06079919334090000,2020,152972,491528,644500,MKT
06079919334090000,2019,152972,480328,633300,MKT
06079919334110000,2021,221381,739019,960400,MKT
06079919334110000,2020,160931,717969,878900,MKT
06079919334110000,2019,160931,717969,878900,MKT
06079919335010000,2021,231285,558115,789400,MKT
06079919335010000,2020,168027,545573,713600,MKT
06079919335010000,2019,168027,545573,713600,MKT
06079919335030000,2021,231825,674875,906700,MKT
06079919335030000,2020,168413,607287,775700,MKT
06079919335030000,2019,168413,607287,775700,MKT
06079919335050000,2021,229995,0,229995,COST
06079919335050000,2020,167103,0,167103,COST
06079919335050000,2019,167103,0,167103,COST
06079919335070000,2021,192073,511327,703400,MKT
06079919335070000,2020,139906,463494,603400,MKT
06079919335070000,2019,139906,463494,603400,MKT
06079919335090000,2021,161502,362598,524100,MKT
06079919335090000,2020,117928,364072,482000,MKT
06079919335090000,2019,117928,364072,482000,MKT
06079919335110000,2021,161490,0,161490,COST
06079919335110000,2020,117919,0,117919,COST
06079919335110000,2019,117919,0,117919,COST
06079919335130000,2021,161502,362598,524100,MKT
06079919335130000,2020,117928,364072,482000,MKT
06079919335130000,2019,117928,364072,482000,MKT
06079919335150000,2021,161490,350910,512400,MKT
06079919335150000,2020,117919,355381,473300,MKT
06079919335150000,2019,117919,355381,473300,MKT
06079919335170000,2021,177168,388532,565700,MKT
06079919335170000,2020,129197,396703,525900,MKT
06079919335170000,2019,129197,396703,525900,MKT
06079919336010000,2021,178816,479184,658000,MKT
06079919336010000,2020,130382,453718,584100,MKT
06079919336010000,2019,130382,455618,586000,MKT
06079919336030000,2021,165147,364453,529600,MKT
06079919336030000,2020,120551,360749,481300,MKT
06079919336030000,2019,120551,360749,481300,MKT
06079919336050000,2021,165159,508541,673700,MKT
06079919336050000,2020,120560,460840,581400,MKT
06079919336050000,2019,120560,460840,581400,MKT
06079919336070000,2021,165147,545653,710800,MKT
06079919336070000,2020,120551,514549,635100,MKT
06079919336070000,2019,120551,514549,635100,MKT
06079919336090000,2021,165159,351941,517100,MKT
06079919336090000,2020,120560,349640,470200,MKT
06079919336090000,2019,120560,349640,470200,MKT
06079919336110000,2021,165147,0,165147,COST
06079919336110000,2020,120551,0,120551,COST
06079919336110000,2019,120551,0,120551,COST
06079919336130000,2021,168327,512973,681300,MKT
06079919336130000,2020,122839,472561,595400,MKT
06079919336130000,2019,122839,472561,595400,MKT
06079919336150000,2021,177236,394564,571800,MKT
06079919336150000,2020,129246,394854,524100,MKT
06079919336150000,2019,129246,394854,524100,MKT
06079919336170000,2021,165196,369604,534800,MKT
06079919336170000,2020,120586,374614,495200,MKT
06079919336170000,2019,120586,374614,495200,MKT
06079919336190000,2021,165196,393604,558800,MKT
06079919336190000,2020,120586,386314,506900,MKT
06079919336190000,2019,120586,386314,506900,MKT
06079919336210000,2021,165196,0,165196,COST
06079919336210000,2020,120586,0,120586,COST
06079919336210000,2019,120586,0,120586,COST
06079919336230000,2021,165196,366604,531800,MKT
06079919336230000,2020,120586,363214,483800,MKT
06079919336230000,2019,120586,363214,483800,MKT
06079919336250000,2021,165196,475404,640600,MKT
06079919336250000,2020,120586,445614,566200,MKT
06079919336250000,2019,120586,445614,566200,MKT
06079919336270000,2021,178928,487672,666600,MKT
06079919336270000,2020,130463,446137,576600,MKT
06079919336270000,2019,130463,446137,576600,MKT
06079919337010000,2021,218952,570848,789800,MKT
06079919337010000,2020,159190,499010,658200,MKT
06079919337010000,2019,159190,499010,658200,MKT
06079919337050000,2021,201283,384117,585400,MKT
06079919337050000,2020,146518,367682,514200,MKT
06079919337050000,2019,146518,367682,514200,MKT
06079919337070000,2021,165159,471741,636900,MKT
06079919337070000,2020,120560,443840,564400,MKT
06079919337070000,2019,120560,454140,574700,MKT
06079919337090000,2021,165159,375841,541000,MKT
06079919337090000,2020,120560,371340,491900,OVR
06079919337090000,2019,120560,371340,491900,MKT
06079919337110000,2021,189089,340011,529100,MKT
06079919337110000,2020,137763,353737,491500,MKT
06079919337110000,2019,137763,353737,491500,MKT
06079919337130000,2021,222697,420203,642900,MKT
06079919337130000,2020,161874,392426,554300,MKT
06079919337130000,2019,161874,392426,554300,MKT
06079919337150000,2021,211959,423441,635400,MKT
06079919337150000,2020,154177,418723,572900,MKT
06079919337150000,2019,154177,418723,572900,MKT
06079919337170000,2021,213811,662689,876500,MKT
06079919337170000,2020,155505,589095,744600,MKT
06079919337170000,2019,155505,589095,744600,MKT
06079919401020000,2021,367352,0,367352,COST
06079919401020000,2020,294051,0,294051,COST
06079919401020000,2019,294051,0,294051,COST
06079919401030000,2021,366134,427766,793900,MKT
06079919401030000,2020,292927,432390,725317,COST
06079919401030000,2019,292927,432390,725317,COST
06079919401040000,2021,382745,957640,1340385,COST
06079919401040000,2020,308301,923450,1231751,COST
06079919401040000,2019,308301,825700,1134001,COST
06079919401050000,2021,397505,578160,975665,COST
06079919401050000,2020,322047,563900,885947,COST
06079919401050000,2019,322047,563900,885947,COST
06079919401060000,2021,66248,0,66248,COST
06079919401060000,2020,48997,0,48997,COST
06079919401060000,2019,48997,0,48997,COST
06079919401070000,2021,302280,77400,379680,COST
06079919401070000,2020,234859,75990,310849,COST
06079919401070000,2019,234859,75990,310849,COST
06079919401080000,2021,358829,393371,752200,MKT
06079919401080000,2020,286200,347740,633940,COST
06079919401080000,2019,286200,347740,633940,COST
06079919401110000,2021,413830,242610,656440,COST
06079919401110000,2020,337343,235730,573073,COST
06079919401110000,2019,337343,235730,573073,COST
06079919401120000,2021,279727,571590,851317,COST
06079919401120000,2020,214775,546180,760955,COST
06079919401120000,2019,214775,546180,760955,COST
06079919401130000,2021,280523,0,280523,COST
06079919401130000,2020,215480,0,215480,COST
06079919401130000,2019,215480,0,215480,COST
06079919401150000,2021,241511,227389,468900,MKT
06079919401150000,2020,181315,264285,445600,MKT
06079919401150000,2019,181315,264285,445600,MKT
06079919401170000,2021,241511,741989,983500,MKT
06079919401170000,2020,181315,801170,982485,COST
06079919401170000,2019,181315,801170,982485,COST
06079919401190000,2021,290194,327470,617664,COST
06079919401190000,2020,224066,316500,540566,COST
06079919401190000,2019,224066,316500,540566,COST
06079919401190900,2021,318259,253410,571669,COST
06079919401190900,2020,249228,244440,493668,COST
06079919401190900,2019,249228,244440,493668,COST
06079919401210000,2021,251745,657550,909295,COST
06079919401210000,2020,190201,636480,826681,COST
06079919401210000,2019,190201,636480,826681,COST
06079919401230000,2021,201491,326509,528000,MKT
06079919401230000,2020,157523,296040,453563,COST
06079919401230000,2019,157523,296040,453563,COST
06079919401240000,2021,342137,561663,903800,MKT
06079919401240000,2020,270906,525810,796716,COST
06079919401240000,2019,270906,525810,796716,COST
06079919401250000,2021,351668,32620,384288,COST
06079919401250000,2020,299360,33290,332650,COST
06079919401250000,2019,299360,33290,332650,COST
06079919401260000,2021,150516,187100,337616,COST
06079919401260000,2020,112540,183350,295890,COST
06079919401260000,2019,112540,183350,295890,COST
06079919401270000,2021,164257,237843,402100,MKT
06079919401270000,2020,124465,262835,387300,MKT
06079919401270000,2019,124465,262835,387300,MKT
06079919401300000,2021,193470,340430,533900,MKT
06079919401300000,2020,140406,330194,470600,MKT
06079919401300000,2019,140406,330194,470600,MKT
06079919401310000,2021,201932,279068,481000,MKT
06079919401310000,2020,147509,256991,404500,MKT
06079919401310000,2019,147509,256991,404500,MKT
06079919401420000,2021,196365,179835,376200,MKT
06079919401420000,2020,142831,222969,365800,MKT
06079919401420000,2019,142831,222969,365800,MKT
06079919401430000,2021,171751,219749,391500,MKT
06079919401430000,2020,122396,255304,377700,MKT
06079919401430000,2019,122396,255304,377700,MKT
06079919401470000,2021,298779,242221,541000,MKT
06079919401470000,2020,231725,192075,423800,MKT
06079919401470000,2019,231725,192075,423800,MKT
06079919401550000,2021,245840,466560,712400,MKT
06079919401550000,2020,198128,430272,628400,MKT
06079919401550000,2019,198128,430272,628400,MKT
06079919402010000,2021,1290,21090,22380,COST
06079919402010000,2020,1201,24440,25641,COST
06079919402010000,2019,1201,24440,25641,COST
06079919402050000,2021,394463,0,394463,COST
06079919402050000,2020,319208,0,319208,COST
06079919402050000,2019,319208,0,319208,COST
06079919402200000,2021,220561,1219440,1440001,COST
06079919402200000,2020,163387,1203310,1366697,COST
06079919402200000,2019,163387,1203310,1366697,COST
06079919402420000,2021,466537,3689390,4155927,COST
06079919402420000,2020,397370,3551430,3948800,COST
06079919402420000,2019,397370,3551430,3948800,COST
06079919430010000,2021,247881,645919,893800,MKT
06079919430010000,2020,186839,721461,908300,MKT
06079919430010000,2019,186839,721461,908300,MKT
06079919430020000,2021,292003,684597,976600,MKT
06079919430020000,2020,225677,639885,865562,MRA
06079919430020000,2019,225677,639885,865562,MRA
06079919430030000,2021,284927,429673,714600,MKT
06079919430030000,2020,219384,406616,626000,OVR
06079919430030000,2019,219384,406616,626000,MKT
06079919430040000,2021,246631,608369,855000,MKT
06079919430040000,2020,185753,606647,792400,MKT
06079919430040000,2019,185753,606647,792400,MKT
06079919430050000,2021,280523,677170,957693,COST
06079919430050000,2020,215480,662620,878100,COST
06079919430050000,2019,215480,662620,878100,COST
06079919430060000,2021,234818,706182,941000,MKT
06079919430060000,2020,175534,674066,849600,MKT
06079919430060000,2019,175534,555140,730674,COST
06079919430070000,2021,252168,528532,780700,MKT
06079919430070000,2020,190569,433731,624300,MKT
06079919430070000,2019,190569,402431,593000,MKT
06079919430080000,2021,234818,596682,831500,MKT
06079919430080000,2020,175534,537666,713200,MKT
06079919430080000,2019,175534,537666,713200,MKT
06079920101010000,2021,56718,354910,411628,COST
06079920101010000,2020,53070,345500,398570,COST
06079920101010000,2019,53070,345500,398570,COST
06079920101030000,2021,303618,352780,656398,COST
06079920101030000,2020,236057,342000,578057,COST
06079920101030000,2019,236057,342000,578057,COST
06079920101060000,2021,7483,371750,379233,COST
06079920101060000,2020,7360,363070,370430,COST
06079920101060000,2019,534792,299310,834102,COST
06079920102010000,2021,286646,499654,786300,MKT
06079920102010000,2020,244331,455069,699400,MKT
06079920102010000,2019,244331,455069,699400,MKT
06079920102020000,2021,279364,389136,668500,MKT
06079920102020000,2020,235634,349666,585300,MKT
06079920102020000,2019,235634,349666,585300,MKT
06079920102030000,2021,273187,616013,889200,MKT
06079920102030000,2020,228328,569272,797600,OVR
06079920102030000,2019,228328,569272,797600,MKT
06079920102040000,2021,269673,443627,713300,MKT
06079920102040000,2020,224202,382498,606700,MKT
06079920102040000,2019,224202,382498,606700,MKT
06079920102050000,2021,275184,331416,606600,MKT
06079920102050000,2020,230683,302250,532933,COST
06079920102050000,2019,230683,302250,532933,COST
06079920102060000,2021,270140,501760,771900,MKT
06079920102060000,2020,224750,471650,696400,MKT
06079920102060000,2019,224750,471650,696400,MKT
06079920102070000,2021,280413,419787,700200,MKT
06079920102070000,2020,236881,415819,652700,MKT
06079920102070000,2019,236881,415819,652700,MKT
06079920102080000,2021,269954,405260,675214,COST
06079920102080000,2020,224531,395040,619571,OVR
06079920102080000,2019,224531,395040,619571,COST
06079920102090000,2021,273916,489984,763900,MKT
06079920102090000,2020,229187,429413,658600,MKT
06079920102090000,2019,229187,429413,658600,MKT
06079920102100000,2021,275454,558946,834400,MKT
06079920102100000,2020,231002,521730,752732,COST
06079920102100000,2019,231002,521730,752732,COST
06079920102110000,2021,285217,556583,841800,MKT
06079920102110000,2020,242617,517483,760100,MKT
06079920102110000,2019,242617,536283,778900,MKT
06079920102120000,2021,271994,247206,519200,MKT
06079920102120000,2020,226925,250575,477500,OVR
06079920102120000,2019,226925,250575,477500,MKT
06079920102130000,2021,269111,427010,696121,COST
06079920102130000,2020,223544,416240,639784,COST
06079920102130000,2019,223544,416240,639784,COST
06079920102140000,2021,267885,349815,617700,MKT
06079920102140000,2020,222111,344680,566791,COST
06079920102140000,2019,222111,344680,566791,COST
06079920102150000,2021,268640,323260,591900,MKT
06079920102150000,2020,222994,244406,467400,MKT
06079920102150000,2019,222994,244406,467400,MKT
06079920102160000,2021,268735,462865,731600,MKT
06079920102160000,2020,223104,488996,712100,MKT
06079920102160000,2019,223104,488996,712100,MKT
06079920102170000,2021,273004,443196,716200,MKT
06079920102170000,2020,228113,417387,645500,MKT
06079920102170000,2019,228113,417387,645500,MKT
06079920102180000,2021,272086,461214,733300,MKT
06079920102180000,2020,227033,400840,627873,COST
06079920102180000,2019,227033,400840,627873,COST
06079920102190000,2021,285891,549809,835700,MKT
06079920102190000,2020,243425,492430,735855,COST
06079920102190000,2019,243425,492430,735855,COST
06079920102200000,2021,267885,408515,676400,MKT
06079920102200000,2020,222111,363589,585700,MKT
06079920102200000,2019,222111,363589,585700,MKT
06079920102210000,2021,267790,627310,895100,MKT
06079920102210000,2020,222000,535500,757500,MKT
06079920102210000,2019,222000,535500,757500,MKT
06079920102220000,2021,278925,510975,789900,MKT
06079920102220000,2020,235112,495888,731000,MKT
06079920102220000,2019,235112,495888,731000,MKT
06079920102230000,2021,267885,354815,622700,MKT
06079920102230000,2020,222111,317689,539800,MKT
06079920102230000,2019,222111,317689,539800,MKT
06079920102240000,2021,312289,554111,866400,MKT
06079920102240000,2020,275673,497627,773300,OVR
06079920102240000,2019,275673,497627,773300,MKT
06079920102250000,2021,348719,424181,772900,MKT
06079920102250000,2020,313464,350896,664360,OVR
06079920102250000,2019,313464,350896,664360,OVR
06079920102260000,2021,273825,552575,826400,MKT
06079920102260000,2020,229080,491920,721000,MKT
06079920102260000,2019,229080,491920,721000,MKT
06079920102270000,2021,326035,462065,788100,MKT
06079920102270000,2020,285129,444860,729989,COST
06079920102270000,2019,285129,444860,729989,COST
06079920102280000,2021,335446,0,335446,COST
06079920102280000,2020,296790,0,296790,COST
06079920102280000,2019,296790,0,296790,COST
06079920102290000,2021,267790,442310,710100,MKT
06079920102290000,2020,222000,469580,691580,COST
06079920102290000,2019,222000,469580,691580,COST
06079920102300000,2021,301194,480590,781784,COST
06079920102300000,2020,255012,461620,716632,OVR
06079920102300000,2019,255012,461620,716632,COST
06079920102310000,2021,267885,574780,842665,COST
06079920102310000,2020,222111,545780,767891,OVR
06079920102310000,2019,222111,545780,767891,COST
06079920102320000,2021,300031,798940,1098971,COST
06079920102320000,2020,253626,765080,1018706,COST
06079920102320000,2019,253626,765080,1018706,COST
06079920102330000,2021,268074,413950,682024,COST
06079920102330000,2020,222332,402740,625072,COST
06079920102330000,2019,222332,402740,625072,COST
06079920102340000,2021,303287,335130,638417,COST
06079920102340000,2020,257512,330020,587532,COST
06079920102340000,2019,257512,330020,587532,COST
06079920102350000,2021,271533,356567,628100,MKT
06079920102350000,2020,226383,320600,546983,COST
06079920102350000,2019,226383,320600,546983,COST
06079920102360000,2021,300137,372563,672700,MKT
06079920102360000,2020,253753,336550,590303,OVR
06079920102360000,2019,253753,336550,590303,COST
06079920102516500,2021,147320,0,147320,COST
06079920102516500,2020,156299,0,156299,COST
06079920102516500,2019,156299,0,156299,COST
06079920103010000,2021,276620,335680,612300,MKT
06079920103010000,2020,232380,301210,533590,COST
06079920103010000,2019,232380,301210,533590,COST
06079920103030000,2021,268735,329965,598700,MKT
06079920103030000,2020,223104,350296,573400,MKT
06079920103030000,2019,223104,350296,573400,MKT
06079920103050000,2021,267885,705515,973400,MKT
06079920103050000,2020,222111,698089,920200,MKT
06079920103050000,2019,222111,698089,920200,MKT
06079920103070000,2021,268263,551537,819800,MKT
06079920103070000,2020,222553,485540,708093,COST
06079920103070000,2019,222553,485540,708093,COST
06079920103090000,2021,268546,424454,693000,MKT
06079920103090000,2020,222884,444016,666900,MKT
06079920103090000,2019,222884,444016,666900,MKT
06079920103110000,2021,272362,527438,799800,MKT
06079920103110000,2020,227358,503510,730868,COST
06079920103110000,2019,227358,503510,730868,COST
06079920103130000,2021,310513,640890,951403,COST
06079920103130000,2020,266196,637530,903726,COST
06079920103130000,2019,266196,637530,903726,COST
06079920103150000,2021,314841,553959,868800,MKT
06079920103150000,2020,271438,597450,868888,COST
06079920103150000,2019,271438,597450,868888,COST
06079920103170000,2021,268829,482371,751200,MKT
06079920103170000,2020,223214,463086,686300,MKT
06079920103170000,2019,223214,463086,686300,MKT
06079920103190000,2021,305457,380343,685800,MKT
06079920103190000,2020,260111,340989,601100,MKT
06079920103190000,2019,260111,340989,601100,MKT
06079920103210000,2021,300353,691647,992000,MKT
06079920103210000,2020,260947,593253,854200,MKT
06079920103210000,2019,260947,593253,854200,MKT
06079920103230000,2021,374934,697440,1072374,COST
06079920103230000,2020,347161,543667,890828,OVR
06079920103230000,2019,347161,543667,890828,OVR
06079920103416500,2021,149164,0,149164,COST
06079920103416500,2020,159062,0,159062,COST
06079920103416500,2019,159062,0,159062,COST
06079920201010000,2021,201932,171768,373700,MKT
06079920201010000,2020,147509,195891,343400,MKT
06079920201010000,2019,147509,195891,343400,MKT
06079920201050000,2021,480487,0,480487,COST
06079920201050000,2020,400724,0,400724,COST
06079920201050000,2019,400724,0,400724,COST
06079920201500000,2021,1620,0,1620,COST
06079920201500000,2020,1632,0,1632,COST
06079920201500000,2019,1632,0,1632,COST
06079920201750000,2021,260251,749820,1010071,COST
06079920201750000,2020,197628,748710,946338,COST
06079920201750000,2019,197628,748710,946338,COST
06079920201800000,2021,1568,0,1568,COST
06079920201800000,2020,1581,0,1581,COST
06079920201800000,2019,1581,0,1581,COST
06079920202010000,2021,8995,0,8995,COST
06079920202010000,2020,9446,0,9446,COST
06079920202010000,2019,9446,0,9446,COST
06079920202150000,2021,10080,0,10080,COST
06079920202150000,2020,10602,0,10602,COST
06079920202150000,2019,10602,0,10602,COST
06079920202200000,2021,2237,0,2237,COST
06079920202200000,2020,2082,0,2082,COST
06079920202200000,2019,2082,0,2082,COST
06079920202700000,2021,5771,2770,8541,COST
06079920202700000,2020,6090,2720,8810,COST
06079920202700000,2019,6090,2720,8810,COST
06079920203010000,2021,2022,3830,5852,COST
06079920203010000,2020,2240,3810,6050,COST
06079920203010000,2019,2240,3810,6050,COST
06079920203100000,2021,279,1860,2139,COST
06079920203100000,2020,260,1830,2090,COST
06079920203100000,2019,260,1830,2090,COST
06079920204010000,2021,1678,0,1678,COST
06079920204010000,2020,1562,0,1562,COST
06079920204010000,2019,1562,0,1562,COST
06079920301010000,2021,221274,379326,600600,MKT
06079920301010000,2020,204809,309491,514300,MKT
06079920301010000,2019,204809,309491,514300,MKT
06079920301020000,2021,220274,526426,746700,MKT
06079920301020000,2020,203507,506193,709700,MKT
06079920301020000,2019,203507,595240,798747,COST
06079920301030000,2021,256560,307290,563850,COST
06079920301030000,2020,252269,315831,568100,MKT
06079920301030000,2019,252269,315831,568100,MKT
06079920301040000,2021,1619,0,1619,COST
06079920301040000,2020,1507,0,1507,COST
06079920301040000,2019,1507,0,1507,COST
06079920302010000,2021,233229,394940,628169,COST
06079920302010000,2020,220566,341334,561900,MKT
06079920302010000,2019,220566,341334,561900,MKT
06079920302020000,2021,228771,798129,1026900,MKT
06079920302020000,2020,214651,758849,973500,MKT
06079920302020000,2019,214651,761749,976400,MKT
06079920302030000,2021,262678,573790,836468,COST
06079920302030000,2020,260783,558720,819503,COST
06079920302030000,2019,260783,558720,819503,COST
06079920302040000,2021,279027,894300,1173327,COST
06079920302040000,2020,283933,888260,1172193,COST
06079920302040000,2019,283933,888260,1172193,COST
06079920302050000,2021,230132,581268,811400,MKT
06079920302050000,2020,216452,536648,753100,MKT
06079920302050000,2019,216452,536648,753100,MKT
06079920302060000,2021,255033,756667,1011700,MKT
06079920302060000,2020,250156,639144,889300,MKT
06079920302060000,2019,250156,639144,889300,MKT
06079920302070000,2021,222568,562132,784700,MKT
06079920302070000,2020,206498,496202,702700,MKT
06079920302070000,2019,206498,496202,702700,MKT
06079920302080000,2021,222568,219132,441700,MKT
06079920302080000,2020,206498,221602,428100,MKT
06079920302080000,2019,206498,221602,428100,MKT
06079920302090000,2021,222037,420890,642927,COST
06079920302090000,2020,205804,413210,619014,COST
06079920302090000,2019,205804,413210,619014,COST
06079920302100000,2021,222037,476163,698200,MKT
06079920302100000,2020,205804,456396,662200,MKT
06079920302100000,2019,205804,456396,662200,MKT
06079920305010000,2021,381984,511430,893414,COST
06079920305010000,2020,441923,498200,940123,COST
06079920305010000,2019,441923,498200,940123,COST
06079920305020000,2021,364848,660850,1025698,COST
06079920305020000,2020,414257,650510,1064767,COST
06079920305020000,2019,414257,650510,1064767,COST
06079920305030000,2021,374973,262230,637203,COST
06079920305030000,2020,430542,253490,684032,COST
06079920305030000,2019,430542,253490,684032,COST
06079920305040000,2021,330959,343241,674200,MKT
06079920305040000,2020,361104,274740,635844,COST
06079920305040000,2019,361104,274740,635844,COST
06079920305050000,2021,255681,400740,656421,COST
06079920305050000,2020,251052,398060,649112,COST
06079920305050000,2019,251052,398060,649112,COST
06079920305060000,2021,252228,468400,720628,COST
06079920305060000,2020,246290,471880,718170,COST
06079920305060000,2019,246290,471880,718170,COST
06079920307010000,2021,302497,0,302497,COST
06079920307010000,2020,318143,0,318143,COST
06079920307010000,2019,318143,0,318143,COST
06079920307020000,2021,264789,276611,541400,MKT
06079920307020000,2020,263740,217560,481300,MKT
06079920307020000,2019,263740,217560,481300,MKT
06079920307030000,2021,277009,380491,657500,MKT
06079920307030000,2020,281045,306655,587700,MKT
06079920307030000,2019,281045,306655,587700,MKT
06079920307040000,2021,321346,98070,419416,COST
06079920307040000,2020,346419,100960,447379,COST
06079920307040000,2019,346419,100960,447379,COST
06079920307050000,2021,330812,562190,893002,COST
06079920307050000,2020,360878,622980,983858,OVR
06079920307050000,2019,360878,622980,983858,COST
06079920307060000,2021,316914,398886,715800,MKT
06079920307060000,2020,339707,350420,690127,COST
06079920307060000,2019,339707,350420,690127,COST
06079920310010000,2021,370303,610570,980873,COST
06079920310010000,2020,423008,594860,1017868,COST
06079920310010000,2019,423008,594860,1017868,COST
06079920310020000,2021,289820,467050,756870,COST
06079920310020000,2020,299525,458540,758065,COST
06079920310020000,2019,299525,458540,758065,COST
06079920310030000,2021,287796,0,287796,COST
06079920310030000,2020,296583,0,296583,COST
06079920310030000,2019,296583,0,296583,COST
06079920310040000,2021,311506,722770,1034276,COST
06079920310040000,2020,331571,692970,1024541,COST
06079920310040000,2019,331571,692970,1024541,COST
06079920310050000,2021,297580,720680,1018260,COST
06079920310050000,2020,310883,700330,1011213,COST
06079920310050000,2019,310883,700330,1011213,COST
06079920310060000,2021,285072,365028,650100,MKT
06079920310060000,2020,292636,294750,587386,COST
06079920310060000,2019,292636,294750,587386,COST
06079920310070000,2021,249980,472920,722900,MKT
06079920310070000,2020,243203,400797,644000,MKT
06079920310070000,2019,243203,400797,644000,MKT
06079920310080000,2021,283717,655883,939600,MKT
06079920310080000,2020,290678,649922,940600,MKT
06079920310080000,2019,290678,649922,940600,MKT
06079920315010000,2021,230346,640554,870900,MKT
06079920315010000,2020,216735,557590,774325,COST
06079920315010000,2019,216735,557590,774325,COST
06079920315020000,2021,230346,734454,964800,MKT
06079920315020000,2020,216735,557220,773955,COST
06079920315020000,2019,216735,557220,773955,COST
06079920330030000,2021,315558,348160,663718,COST
06079920330030000,2020,337661,300339,638000,MKT
06079920330030000,2019,337661,300339,638000,MKT
06079920345010000,2021,219500,491300,710800,MKT
06079920345010000,2020,202500,469900,672400,MKT
06079920345010000,2019,202500,469900,672400,MKT
06079920345020000,2021,219810,241890,461700,MKT
06079920345020000,2020,202903,241197,444100,MKT
06079920345020000,2019,202903,241197,444100,MKT
06079920345030000,2021,219655,420745,640400,MKT
06079920345030000,2020,202702,344798,547500,MKT
06079920345030000,2019,202702,344798,547500,MKT
06079920345040000,2021,222189,0,222189,COST
06079920345040000,2020,206003,0,206003,COST
06079920345040000,2019,206003,0,206003,COST
06079920345050000,2021,271631,388969,660600,MKT
06079920345050000,2020,273390,360680,634070,COST
06079920345050000,2019,273390,425440,698830,COST
06079920345070000,2021,260194,435770,695964,COST
06079920345070000,2020,257316,421770,679086,COST
06079920345070000,2019,257316,421770,679086,COST
06079920345090000,2021,244095,489305,733400,MKT
06079920345090000,2020,235178,382320,617498,COST
06079920345090000,2019,235178,382320,617498,COST
06079920345100000,2021,225782,0,225782,COST
06079920345100000,2020,210711,0,210711,COST
06079920345100000,2019,210711,0,210711,COST
06079920345110000,2021,221120,537680,758800,MKT
06079920345110000,2020,204609,577360,781969,COST
06079920345110000,2019,204609,577360,781969,COST
06079920345120000,2021,227904,431896,659800,MKT
06079920345120000,2020,213505,548360,761865,COST
06079920345120000,2019,213505,548360,761865,COST
06079920345130000,2021,249120,288880,538000,MKT
06079920345130000,2020,242025,264375,506400,MKT
06079920345130000,2019,242025,264375,506400,MKT
06079920345150000,2021,242551,421200,663751,COST
06079920345150000,2020,233084,413550,646634,COST
06079920345150000,2019,233084,413550,646634,COST
06079920345170000,2021,237268,374632,611900,MKT
06079920345170000,2020,225965,321035,547000,MKT
06079920345170000,2019,225965,321035,547000,MKT
06079920345190000,2021,245369,607000,852369,COST
06079920345190000,2020,236908,596230,833138,COST
06079920345190000,2019,236908,596230,833138,COST
06079920345200000,2021,275374,741060,1016434,COST
06079920345200000,2020,278712,726820,1005532,COST
06079920345200000,2019,278712,726820,1005532,COST
06079920345210000,2021,297713,343187,640900,MKT
06079920345210000,2020,311079,334560,645639,COST
06079920345210000,2019,311079,334560,645639,COST
06079920345220000,2021,242097,237570,479667,COST
06079920345220000,2020,232470,229550,462020,COST
06079920345220000,2019,232470,229550,462020,COST
06079920345230000,2021,254914,574186,829100,MKT
06079920345230000,2020,249992,541908,791900,MKT
06079920345230000,2019,249992,541908,791900,MKT
06079920345240000,2021,252349,522451,774800,MKT
06079920345240000,2020,246456,468544,715000,MKT
06079920345240000,2019,246456,558410,804866,COST
06079920345250000,2021,268061,219239,487300,MKT
06079920345250000,2020,268343,206857,475200,MKT
06079920345250000,2019,268343,206857,475200,MKT
06079920345260000,2021,261554,487046,748600,MKT
06079920345260000,2020,259213,401387,660600,MKT
06079920345260000,2019,259213,401387,660600,MKT
06079920345270000,2021,237200,566800,804000,MKT
06079920345270000,2020,225874,492726,718600,MKT
06079920345270000,2019,225874,492726,718600,MKT
06079920345416500,2021,75234,0,75234,COST
06079920345416500,2020,73212,0,73212,COST
06079920345416500,2019,73212,0,73212,COST
06079920401010000,2021,363459,907290,1270749,COST
06079920401010000,2020,332288,891590,1223878,COST
06079920401010000,2019,332288,891590,1223878,COST
06079920401030000,2021,269205,775690,1044895,COST
06079920401030000,2020,223654,775510,999164,COST
06079920401030000,2019,223654,775510,999164,COST
06079920401050000,2021,340565,413630,754195,COST
06079920401050000,2020,303190,398300,701490,COST
06079920401050000,2019,303190,398300,701490,COST
06079920401070000,2021,374864,583550,958414,COST
06079920401070000,2020,347069,556470,903539,COST
06079920401070000,2019,347069,556470,903539,COST
06079920401090000,2021,271255,404990,676245,COST
06079920401090000,2020,226057,349043,575100,MKT
06079920401090000,2019,226057,349043,575100,MKT
06079920401110000,2021,269580,362250,631830,COST
06079920401110000,2020,224093,356310,580403,COST
06079920401110000,2019,224093,356310,580403,COST
06079920401130000,2021,310513,480787,791300,MKT
06079920401130000,2020,266196,397900,664096,OVR
06079920401130000,2019,266196,397900,664096,COST
06079920401150000,2021,306786,414714,721500,MKT
06079920401150000,2020,261707,420810,682517,COST
06079920401150000,2019,261707,420810,682517,COST
06079920401170000,2021,268358,536042,804400,MKT
06079920401170000,2020,222663,521437,744100,OVR
06079920401170000,2019,222663,521437,744100,MKT
06079920401190000,2021,269580,488110,757690,COST
06079920401190000,2020,224093,478907,703000,MKT
06079920401190000,2019,224093,478907,703000,MKT
06079920401210000,2021,269580,374420,644000,MKT
06079920401210000,2020,224093,345000,569093,OVR
06079920401210000,2019,224093,345000,569093,COST
06079920401230000,2021,269392,461608,731000,MKT
06079920401230000,2020,223873,493427,717300,MKT
06079920401230000,2019,223873,486427,710300,MKT
06079920401250000,2021,314550,512760,827310,COST
06079920401250000,2020,271084,498840,769924,OVR
06079920401250000,2019,271084,498840,769924,COST
06079920401270000,2021,307091,672609,979700,MKT
06079920401270000,2020,262074,592926,855000,MKT
06079920401270000,2019,262074,592926,855000,MKT
06079920401290000,2021,268358,503742,772100,MKT
06079920401290000,2020,222663,473737,696400,MKT
06079920401290000,2019,222663,473737,696400,MKT
06079920401310000,2021,267790,658610,926400,MKT
06079920401310000,2020,222000,650780,872780,COST
06079920401310000,2019,222000,649610,871610,COST
06079920401330000,2021,293043,463557,756600,MKT
06079920401330000,2020,252047,422753,674800,MKT
06079920401330000,2019,252047,422753,674800,MKT
06079920401350000,2021,334143,415857,750000,MKT
06079920401350000,2020,295168,377132,672300,MKT
06079920401350000,2019,295168,377132,672300,MKT
06079920403016500,2021,201490,0,201490,COST
06079920403016500,2020,242948,0,242948,COST
06079920403016500,2019,242948,0,242948,COST
06079920406010000,2021,333881,688619,1022500,MKT
06079920406010000,2020,294842,634621,929463,MRA
06079920406010000,2019,294842,634621,929463,MRA
06079920406030000,2021,330712,935100,1265812,COST
06079920406030000,2020,290908,658392,949300,OVR
06079920406030000,2019,290908,658392,949300,OVR
06079920406050000,2021,312888,595212,908100,MKT
06079920406050000,2020,269068,531632,800700,MKT
06079920406050000,2019,269068,531632,800700,MKT
06079920406070000,2021,310911,563889,874800,MKT
06079920406070000,2020,266677,493423,760100,MKT
06079920406070000,2019,266677,493423,760100,MKT
06079920406090000,2021,302975,547925,850900,MKT
06079920406090000,2020,257138,470062,727200,MKT
06079920406090000,2019,257138,476462,733600,MKT
06079920406110000,2021,303079,661421,964500,MKT
06079920406110000,2020,257263,607237,864500,MKT
06079920406110000,2019,257263,607237,864500,MKT
06079920406130000,2021,301088,707412,1008500,MKT
06079920406130000,2020,254886,648314,903200,MKT
06079920406130000,2019,254886,648314,903200,MKT
06079920406150000,2021,313476,508424,821900,MKT
06079920406150000,2020,269781,418019,687800,MKT
06079920406150000,2019,269781,418019,687800,MKT
06079920406170000,2021,325212,722700,1047912,COST
06079920406170000,2020,284117,718240,1002357,COST
06079920406170000,2019,284117,718240,1002357,COST
06079920406190000,2021,330801,829960,1160761,COST
06079920406190000,2020,291018,826120,1117138,COST
06079920406190000,2019,291018,826120,1117138,COST
06079920406210000,2021,326490,866040,1192530,COST
06079920406210000,2020,285690,864890,1150580,COST
06079920406210000,2019,285690,864890,1150580,COST
06079920406230000,2021,331067,702400,1033467,COST
06079920406230000,2020,291348,681250,972598,COST
06079920406230000,2019,291348,681250,972598,COST
06079920409010000,2021,283262,384938,668200,MKT
06079920409010000,2020,240278,346522,586800,MKT
06079920409010000,2019,240278,346522,586800,MKT
06079920409030000,2021,282060,903950,1186010,COST
06079920409030000,2020,238843,883440,1122283,COST
06079920409030000,2019,238843,883440,1122283,COST
06079920409050000,2021,280151,564249,844400,MKT
06079920409050000,2020,236570,530430,767000,MKT
06079920409050000,2019,236570,530430,767000,MKT
06079920409070000,2021,277333,563370,840703,COST
06079920409070000,2020,233224,533376,766600,MKT
06079920409070000,2019,233224,533376,766600,MKT
06079920430010000,2021,286813,591787,878600,MKT
06079920430010000,2020,244532,505768,750300,MKT
06079920430010000,2019,244532,505768,750300,MKT
06079920430030000,2021,281455,575645,857100,MKT
06079920430030000,2020,238122,502878,741000,MKT
06079920430030000,2019,238122,502878,741000,MKT
06079920430050000,2021,269486,647940,917426,COST
06079920430050000,2020,223983,634070,858053,COST
06079920430050000,2019,223983,634070,858053,COST
06079920430070000,2021,269954,696970,966924,COST
06079920430070000,2020,224531,691560,916091,COST
06079920430070000,2019,224531,691560,916091,COST
06079920430090000,2021,277333,386567,663900,MKT
06079920430090000,2020,233224,407976,641200,MKT
06079920430090000,2019,233224,407976,641200,MKT
06079920430110000,2021,283176,425724,708900,MKT
06079920430110000,2020,240175,420180,660355,COST
06079920430110000,2019,240175,420180,660355,COST
06079920448010000,2021,277688,356012,633700,MKT
06079920448010000,2020,233645,332055,565700,MKT
06079920448010000,2019,233645,332055,565700,MKT
06079920448030000,2021,276977,541123,818100,MKT
06079920448030000,2020,232802,517498,750300,MKT
06079920448030000,2019,232802,517498,750300,MKT
06079920448050000,2021,321348,610352,931700,MKT
06079920448050000,2020,222000,590500,812500,MKT
06079920448050000,2019,222000,590500,812500,MKT
06079920448070000,2021,327934,1140,329074,COST
06079920448070000,2020,228436,1200,229636,COST
06079920448070000,2019,228436,1200,229636,COST
06079920448090000,2021,322537,322860,645397,COST
06079920448090000,2020,280830,322170,603000,COST
06079920448090000,2019,280830,322170,603000,COST
06079920448110000,2021,276620,487980,764600,MKT
06079920448110000,2020,232380,436220,668600,MKT
06079920448110000,2019,232380,436220,668600,MKT
06079920448130000,2021,281887,408860,690747,COST
06079920448130000,2020,238637,366763,605400,MKT
06079920448130000,2019,238637,366763,605400,MKT
06079920448150000,2021,288145,320980,609125,COST
06079920448150000,2020,246133,289967,536100,MKT
06079920448150000,2019,246133,289967,536100,MKT
06079920448170000,2021,273095,350705,623800,MKT
06079920448170000,2020,228220,335590,563810,COST
06079920448170000,2019,228220,335590,563810,COST
06079920450010000,2021,305200,492200,797400,MKT
06079920450010000,2020,266899,493650,760549,COST
06079920450010000,2019,266899,493650,760549,COST
06079920454010000,2021,270606,371594,642200,MKT
06079920454010000,2020,225295,369680,594975,COST
06079920454010000,2019,225295,369680,594975,COST
06079920454030000,2021,270327,703373,973700,MKT
06079920454030000,2020,224968,641832,866800,MKT
06079920454030000,2019,224968,641832,866800,MKT
06079920454050000,2021,319726,532760,852486,COST
06079920454050000,2020,277389,516580,793969,COST
06079920454050000,2019,277389,516580,793969,COST
06079921101010000,2021,389095,0,389095,COST
06079921101010000,2020,250000,0,250000,OVR
06079921101010000,2019,250000,0,250000,OVR
06079921101030000,2021,389095,620150,1009245,COST
06079921101030000,2020,314205,613090,927295,COST
06079921101030000,2019,314205,613090,927295,COST
06079921101060000,2021,388821,429179,818000,MKT
06079921101060000,2020,313950,393090,707040,COST
06079921101060000,2019,313950,268800,582750,COST
06079921101070000,2021,442732,0,442732,COST
06079921101070000,2020,364647,0,364647,COST
06079921101070000,2019,364647,0,364647,COST
06079921101080000,2021,342033,446670,788703,COST
06079921101080000,2020,270811,428060,698871,COST
06079921101080000,2019,270811,428060,698871,COST
06079921101090000,2021,8489,238760,247249,COST
06079921101090000,2020,8294,307870,316164,COST
06079921101090000,2019,8294,307870,316164,COST
06079921101100000,2021,388684,220370,609054,COST
06079921101100000,2020,313823,212140,525963,COST
06079921101100000,2019,313823,212140,525963,COST
06079921101110000,2021,572339,265120,837459,COST
06079921101110000,2020,490265,258550,748815,COST
06079921101110000,2019,490265,258550,748815,COST
06079921101120000,2021,495832,229760,725592,COST
06079921101120000,2020,415514,222560,638074,COST
06079921101120000,2019,415514,222560,638074,COST
06079921101130000,2021,495832,387280,883112,COST
06079921101130000,2020,415514,371550,787064,COST
06079921101130000,2019,415514,371550,787064,COST
06079921101140000,2021,389067,0,389067,COST
06079921101140000,2020,250000,0,250000,OVR
06079921101140000,2019,250000,0,250000,OVR
06079921102050000,2021,170666,0,170666,COST
06079921102050000,2020,173403,0,173403,COST
06079921102050000,2019,173403,0,173403,COST
06079921104010000,2021,467924,382860,850784,COST
06079921104010000,2020,388669,366450,755119,COST
06079921104010000,2019,388669,366450,755119,COST
06079921201010000,2021,180793,270507,451300,MKT
06079921201010000,2020,129853,270930,400783,COST
06079921201010000,2019,129853,277920,407773,COST
06079921201020000,2021,180682,346318,527000,MKT
06079921201020000,2020,129761,343839,473600,MKT
06079921201020000,2019,129761,343839,473600,MKT
06079921201030000,2021,184380,621890,806270,COST
06079921201030000,2020,132828,548358,681186,OVR
06079921201030000,2019,132828,548358,681186,OVR
06079921201040000,2021,186389,314411,500800,MKT
06079921201040000,2020,134498,300202,434700,MKT
06079921201040000,2019,134498,300202,434700,MKT
06079921201050000,2021,186285,244715,431000,MKT
06079921201050000,2020,134411,273289,407700,MKT
06079921201050000,2019,134411,273289,407700,MKT
06079921201060000,2021,178780,254620,433400,INCOME
06079921201060000,2020,128188,294112,422300,INCOME
06079921201060000,2019,128188,294112,422300,INCOME
06079921202010000,2021,245840,453860,699700,MKT
06079921202010000,2020,181888,389512,571400,MKT
06079921202010000,2019,181888,389512,571400,MKT
06079921202020000,2021,272884,470616,743500,MKT
06079921202020000,2020,205144,411856,617000,MKT
06079921202020000,2019,205144,411856,617000,MKT
06079921203010000,2021,220429,281171,501600,MKT
06079921203010000,2020,163192,272908,436100,MKT
06079921203010000,2019,163192,272908,436100,MKT
06079921203020000,2021,220660,297340,518000,MKT
06079921203020000,2020,163390,273710,437100,MKT
06079921203020000,2019,163390,273710,437100,MKT
06079921203030000,2021,220660,350240,570900,MKT
06079921203030000,2020,163390,364910,528300,MKT
06079921203030000,2019,163390,364910,528300,MKT
06079921203040000,2021,221044,192556,413600,MKT
06079921203040000,2020,163717,208683,372400,MKT
06079921203040000,2019,163717,208683,372400,MKT
06079921203050000,2021,220660,301940,522600,MKT
06079921203050000,2020,163390,308510,471900,MKT
06079921203050000,2019,163390,290310,453700,MKT
06079921203060000,2021,220660,365040,585700,MKT
06079921203060000,2020,163390,346510,509900,MKT
06079921203060000,2019,163390,335710,499100,MKT
06079921203070000,2021,220660,533240,753900,MKT
06079921203070000,2020,163390,505410,668800,MKT
06079921203070000,2019,163390,505410,668800,MKT
06079921203080000,2021,288080,265020,553100,MKT
06079921203080000,2020,222185,269215,491400,MKT
06079921203080000,2019,222185,269215,491400,MKT
06079921203090000,2021,307734,515010,822744,COST
06079921203090000,2020,239750,506860,746610,COST
06079921203090000,2019,239750,286750,526500,MKT
06079921203110000,2021,222037,247863,469900,MKT
06079921203110000,2020,164566,243534,408100,MKT
06079921203110000,2019,164566,243534,408100,MKT
06079921203120000,2021,222037,458363,680400,MKT
06079921203120000,2020,164566,452934,617500,MKT
06079921203120000,2019,164566,405734,570300,MKT
06079921203146500,2021,55707,0,55707,COST
06079921203146500,2020,40123,0,40123,COST
06079921203146500,2019,40123,0,40123,COST
06079921204010000,2021,288780,378720,667500,MKT
06079921204010000,2020,218981,349919,568900,MKT
06079921204010000,2019,218981,349919,568900,MKT
06079921204020000,2021,277138,244562,521700,MKT
06079921204020000,2020,208835,239565,448400,MKT
06079921204020000,2019,208835,239565,448400,MKT
06079921204030000,2021,296007,305993,602000,MKT
06079921204030000,2020,225311,288189,513500,MKT
06079921204030000,2019,225311,288189,513500,MKT
06079921204040000,2021,382457,374310,756767,COST
06079921204040000,2020,302743,325657,628400,MKT
06079921204040000,2019,302743,325657,628400,MKT
06079921204070000,2021,254601,394099,648700,MKT
06079921204070000,2020,189381,383119,572500,MKT
06079921204070000,2019,189381,383119,572500,MKT
06079921204080000,2021,247741,203759,451500,MKT
06079921204080000,2020,183510,197090,380600,MKT
06079921204080000,2019,183510,197090,380600,MKT
06079921204090000,2021,247741,582359,830100,MKT
06079921204090000,2020,183510,525790,709300,MKT
06079921204090000,2019,183510,524890,708400,MKT
06079921204100000,2021,248083,407717,655800,MKT
06079921204100000,2020,183803,370497,554300,MKT
06079921204100000,2019,183803,370497,554300,MKT
06079921204110000,2021,249446,181154,430600,MKT
06079921204110000,2020,184967,194333,379300,MKT
06079921204110000,2019,184967,194333,379300,MKT
06079921204120000,2021,246880,264920,511800,MKT
06079921204120000,2020,182775,245525,428300,MKT
06079921204120000,2019,182775,245525,428300,MKT
06079921204130000,2021,248169,270231,518400,MKT
06079921204130000,2020,183876,291824,475700,MKT
06079921204130000,2019,183876,291824,475700,MKT
06079921204140000,2021,246621,307679,554300,MKT
06079921204140000,2020,182554,294746,477300,MKT
06079921204140000,2019,182554,294746,477300,MKT
06079921204150000,2021,247225,415275,662500,MKT
06079921204150000,2020,183070,366030,549100,MKT
06079921204150000,2019,183070,366030,549100,MKT
06079921204160000,2021,222568,370832,593400,MKT
06079921204160000,2020,165020,335580,500600,MKT
06079921204160000,2019,165020,335580,500600,MKT
06079921204170000,2021,223248,235152,458400,MKT
06079921204170000,2020,165601,247299,412900,MKT
06079921204170000,2019,165601,247299,412900,MKT
06079921204186500,2021,143120,0,143120,COST
06079921204186500,2020,119078,0,119078,COST
06079921204186500,2019,119078,0,119078,COST
06079921205010000,2021,223398,206102,429500,MKT
06079921205010000,2020,165730,218270,384000,MKT
06079921205010000,2019,165730,218270,384000,MKT
06079921205020000,2021,222946,312450,535396,COST
06079921205020000,2020,165343,327657,493000,MKT
06079921205020000,2019,165343,327657,493000,MKT
06079921205030000,2021,222946,245354,468300,MKT
06079921205030000,2020,165343,260757,426100,MKT
06079921205030000,2019,165343,260757,426100,MKT
06079921205040000,2021,219810,332790,552600,MKT
06079921205040000,2020,162665,243435,406100,MKT
06079921205040000,2019,162665,243435,406100,MKT
06079921205050000,2021,221350,510750,732100,MKT
06079921205050000,2020,163979,448621,612600,MKT
06079921205050000,2019,163979,448621,612600,MKT
06079921205060000,2021,220429,304871,525300,MKT
06079921205060000,2020,163192,292108,455300,MKT
06079921205060000,2019,163192,292108,455300,MKT
06079921205070000,2021,220274,311826,532100,MKT
06079921205070000,2020,163061,311139,474200,MKT
06079921205070000,2019,163061,311139,474200,MKT
06079921205080000,2021,220274,368426,588700,MKT
06079921205080000,2020,163061,340139,503200,MKT
06079921205080000,2019,163061,340139,503200,MKT
06079921205090000,2021,220274,344526,564800,MKT
06079921205090000,2020,163061,347939,511000,MKT
06079921205090000,2019,163061,347939,511000,MKT
06079921205100000,2021,226150,367250,593400,MKT
06079921205100000,2020,168086,322914,491000,MKT
06079921205100000,2019,168086,322914,491000,MKT
06079922101030000,2021,53431,0,53431,COST
06079922101030000,2020,55769,0,55769,COST
06079922101030000,2019,55769,0,55769,COST
06079922101060000,2021,16484,0,16484,COST
06079922101060000,2020,15714,0,15714,COST
06079922101060000,2019,15714,0,15714,COST
06079922102020000,2021,49671,434320,483991,COST
06079922102020000,2020,51369,427700,479069,COST
06079922102020000,2019,51369,427700,479069,COST
06079922201010000,2021,14830,0,14830,COST
06079922201010000,2020,13767,0,13767,COST
06079922201010000,2019,13767,0,13767,COST
06079922301150000,2021,29289,141020,170309,COST
06079922301150000,2020,27604,139870,167474,COST
06079922301150000,2019,27604,139870,167474,COST
06079922301500000,2021,24686,0,24686,COST
06079922301500000,2020,22916,0,22916,COST
06079922301500000,2019,22916,0,22916,COST
06079922301700000,2021,3665,284150,287815,COST
06079922301700000,2020,3818,275970,279788,COST
06079922301700000,2019,3818,275970,279788,COST
06079922401010000,2021,1088,0,1088,COST
06079922401010000,2020,1012,0,1012,COST
06079922401010000,2019,1012,0,1012,COST
06079922402010000,2021,1087,0,1087,COST
06079922402010000,2020,1011,0,1011,COST
06079922402010000,2019,1011,0,1011,COST
06079922404010000,2021,220533,406760,627293,COST
06079922404010000,2020,163361,390920,554281,COST
06079922404010000,2019,163361,390920,554281,COST
06079922406010000,2021,220533,255040,475573,COST
06079922406010000,2020,163363,252930,416293,COST
06079922406010000,2019,163363,252930,416293,COST
06079922410010000,2021,630060,490380,1120440,COST
06079922410010000,2020,547696,474450,1022146,COST
06079922410010000,2019,547696,474450,1022146,COST
06079922412010000,2021,7379,350080,357459,COST
06079922412010000,2020,7678,339980,347658,COST
06079922412010000,2019,7678,339980,347658,COST
06079922418010000,2021,9269,232120,241389,COST
06079922418010000,2020,9016,230470,239486,COST
06079922418010000,2019,9016,230470,239486,COST
06079922436010000,2021,6087,1820,7907,COST
06079922436010000,2020,5655,1890,7545,COST
06079922436010000,2019,5655,1890,7545,COST
06079923101020000,2021,260610,98170,358780,COST
06079923101020000,2020,376731,83300,460031,COST
06079923101020000,2019,376731,83300,460031,COST
06079923101040000,2021,205829,0,205829,COST
06079923101040000,2020,138591,0,138591,COST
06079923101040000,2019,138591,0,138591,COST
06079923101060000,2021,436547,0,436547,COST
06079923101060000,2020,358780,0,358780,COST
06079923101060000,2019,358780,0,358780,COST
06079923101080000,2021,345390,0,345390,COST
06079923101080000,2020,273878,0,273878,COST
06079923101080000,2019,273878,0,273878,COST
06079923101100000,2021,323808,306892,630700,MKT
06079923101100000,2020,254244,256220,510464,COST
06079923101100000,2019,254244,256220,510464,COST
06079923101400000,2021,374932,522980,897912,COST
06079923101400000,2020,236595,508350,744945,COST
06079923101400000,2019,236595,508350,744945,COST
06079923102010000,2021,472719,1215380,1688099,COST
06079923102010000,2020,275731,1174920,1450651,COST
06079923102010000,2019,275731,1174920,1450651,COST
06079923110010000,2021,777281,2774919,3552200,INCOME
06079923110010000,2020,394407,2858293,3252700,INCOME
06079923110010000,2019,394407,2858293,3252700,INCOME
06079923201010000,2021,620425,2462560,3082985,COST
06079923201010000,2020,486102,2298090,2784192,COST
06079923201010000,2019,486102,2298090,2784192,COST
06079923201050000,2021,563247,5525030,6088277,COST
06079923201050000,2020,415673,5124380,5540053,COST
06079923201050000,2019,415673,5124380,5540053,COST
06079923201120000,2021,236185,163115,399300,MKT
06079923201120000,2020,176713,187087,363800,MKT
06079923201120000,2019,176713,187087,363800,MKT
06079923201160000,2021,155709,250091,405800,MKT
06079923201160000,2020,109313,144410,253723,COST
06079923201160000,2019,109313,144410,253723,COST
06079923201200000,2021,191496,288004,479500,MKT
06079923201200000,2020,138755,294645,433400,MKT
06079923201200000,2019,138755,294645,433400,MKT
06079923204100000,2021,5119,1083200,1088319,COST
06079923204100000,2020,5576,1043110,1048686,COST
06079923204100000,2019,5576,1043110,1048686,COST
06079923301010000,2021,40377,129260,169637,COST
06079923301010000,2020,39339,125880,165219,COST
06079923301010000,2019,39339,125880,165219,COST
06079923301020000,2021,31600,114260,145860,COST
06079923301020000,2020,30628,111880,142508,COST
06079923301020000,2019,30628,111880,142508,COST
06079923301030000,2021,592250,35850,628100,INCOME
06079923301030000,2020,320001,169499,489500,INCOME
06079923301030000,2019,320001,169499,489500,INCOME
06079923301040000,2021,181014,323510,504524,COST
06079923301040000,2020,130036,240440,370476,COST
06079923301040000,2019,130036,240440,370476,COST
06079923301050000,2021,204613,184887,389500,MKT
06079923301050000,2020,149769,152331,302100,MKT
06079923301050000,2019,149769,131031,280800,MKT
06079923301080000,2021,144020,283180,427200,MKT
06079923301080000,2020,99908,253492,353400,MKT
06079923301080000,2019,99908,253492,353400,MKT
06079923301100000,2021,22720,123110,145830,COST
06079923301100000,2020,22898,120330,143228,COST
06079923301100000,2019,22898,120330,143228,COST
06079923301120000,2021,307002,353440,660442,COST
06079923301120000,2020,238360,331450,569810,COST
06079923301120000,2019,238360,332720,571080,COST
06079923301130000,2021,314046,956850,1270896,COST
06079923301130000,2020,247486,902190,1149676,COST
06079923301130000,2019,247486,902190,1149676,COST
06079923301150000,2021,255740,279860,535600,MKT
06079923301150000,2020,193684,251016,444700,MKT
06079923301150000,2019,193684,251016,444700,MKT
06079923301160000,2021,145020,0,145020,COST
06079923301160000,2020,100707,0,100707,COST
06079923301160000,2019,100707,0,100707,COST
06079923301170000,2021,410461,174810,585271,COST
06079923301170000,2020,334179,176370,510549,COST
06079923301170000,2019,334179,176370,510549,COST
06079923301180000,2021,1385920,1089080,2475000,INCOME
06079923301180000,2020,561095,1573105,2134200,INCOME
06079923301180000,2019,561095,1573105,2134200,INCOME
06079923301190000,2021,409692,199240,608932,COST
06079923301190000,2020,333457,193660,527117,COST
06079923301190000,2019,333457,193660,527117,COST
06079923302010000,2021,483260,1614770,2098030,COST
06079923302010000,2020,403392,1608040,2011432,COST
06079923302010000,2019,403392,1608040,2011432,COST
06079923302020000,2021,466946,0,466946,COST
06079923302020000,2020,387734,0,387734,COST
06079923302020000,2019,387734,0,387734,COST
06079923302030000,2021,468313,910890,1379203,COST
06079923302030000,2020,389043,369600,758643,COST
06079923302030000,2019,389043,138350,527393,COST
06079923302040000,2021,558830,1074690,1633520,COST
06079923302040000,2020,476949,1066480,1543429,COST
06079923302040000,2019,476949,1066480,1543429,COST
06079923305010000,2021,2245,0,2245,COST
06079923305010000,2020,2084,0,2084,COST
06079923305010000,2019,2084,0,2084,COST
06079923401010000,2021,247038,0,247038,COST
06079923401010000,2020,185120,0,185120,COST
06079923401010000,2019,185120,0,185120,COST
06079924101010000,2021,19926,0,19926,COST
06079924101010000,2020,13657,0,13657,COST
06079924101010000,2019,13657,0,13657,COST
06079924102100000,2021,316,0,316,COST
06079924102100000,2020,294,0,294,COST
06079924102100000,2019,294,0,294,COST
06079924102200000,2021,206881,835410,1042291,COST
06079924102200000,2020,139570,717680,857250,COST
06079924102200000,2019,139570,717680,857250,COST
06079924102300000,2021,1137,0,1137,COST
06079924102300000,2020,1058,0,1058,COST
06079924102300000,2019,1058,0,1058,COST
06079924102400000,2021,1668,0,1668,COST
06079924102400000,2020,1552,0,1552,COST
06079924102400000,2019,1552,0,1552,COST
06079924201100000,2021,206644,657640,864284,COST
06079924201100000,2020,139350,558780,698130,COST
06079924201100000,2019,139350,558780,698130,COST
06079924201130000,2021,111,0,111,COST
06079924201130000,2020,103,0,103,COST
06079924201130000,2019,103,0,103,COST
06079924201180000,2021,136,0,136,COST
06079924201180000,2020,127,0,127,COST
06079924201180000,2019,127,0,127,COST
06079924201200000,2021,374398,0,374398,COST
06079924201200000,2020,1030,0,1030,COST
06079924201200000,2019,1030,0,1030,COST
06079924201220000,2021,311694,0,311694,COST
06079924201240000,2021,323138,0,323138,COST
06079924201300000,2021,209447,249370,458817,COST
06079924201300000,2020,141958,227100,369058,COST
06079924201300000,2019,141958,227100,369058,COST
06079924301020000,2021,1661,24410,26071,COST
06079924301020000,2020,1545,24380,25925,COST
06079924301020000,2019,1545,24380,25925,COST
06079924301030000,2021,309,0,309,COST
06079924301030000,2020,288,0,288,COST
06079924301030000,2019,288,0,288,COST
06079924301050000,2021,439167,354220,793387,COST
06079924301050000,2020,324955,347650,672605,COST
06079924301050000,2019,324955,347650,672605,COST
06079924301100000,2021,387972,156420,544392,COST
06079924301100000,2020,313160,154030,467190,COST
06079924301100000,2019,313160,154030,467190,COST
06079924401100000,2021,3728,0,3728,COST
06079924401100000,2020,3470,0,3470,COST
06079924401100000,2019,3470,0,3470,COST
06079924401300000,2021,1107,0,1107,COST
06079924401300000,2020,1030,0,1030,COST
06079924401300000,2019,1030,0,1030,COST
06079924401400000,2021,1107,0,1107,COST
06079924401400000,2020,1030,0,1030,COST
06079924401400000,2019,1030,0,1030,COST
06079925102010000,2021,168200,279960,448160,COST
06079925102010000,2020,161517,272010,433527,COST
06079925102010000,2019,161517,272010,433527,COST
06079925102020000,2021,495885,460115,956000,MKT
06079925102020000,2020,241028,387930,628958,COST
06079925102020000,2019,241028,0,241028,COST
06079925102030000,2021,242901,307670,550571,COST
06079925102030000,2020,246730,297720,544450,COST
06079925102030000,2019,246730,297720,544450,COST
06079925102050000,2021,166421,536579,703000,MKT
06079925102050000,2020,159549,441651,601200,MKT
06079925102050000,2019,159549,415551,575100,MKT
06079925102060000,2021,106458,405790,512248,COST
06079925102060000,2020,95214,398810,494024,COST
06079925102060000,2019,95214,398810,494024,COST
06079925102070000,2021,253862,628950,882812,COST
06079925102070000,2020,259609,622630,882239,COST
06079925102070000,2019,259609,622630,882239,COST
06079925102080000,2021,106417,427760,534177,COST
06079925102080000,2020,95175,415850,511025,COST
06079925102080000,2019,95175,415850,511025,COST
06079925102090000,2021,239190,488970,728160,COST
06079925102090000,2020,242389,478450,720839,COST
06079925102090000,2019,242389,478450,720839,COST
06079925102100000,2021,239198,347980,587178,COST
06079925102100000,2020,242398,331800,574198,COST
06079925102100000,2019,242398,331800,574198,COST
06079925102110000,2021,106412,778170,884582,COST
06079925102110000,2020,95171,765690,860861,COST
06079925102110000,2019,95171,765690,860861,COST
06079925102120000,2021,106476,262740,369216,COST
06079925102120000,2020,95231,255040,350271,COST
06079925102120000,2019,95231,255040,350271,COST
06079925102130000,2021,242104,0,242104,COST
06079925102130000,2020,245796,0,245796,COST
06079925102130000,2019,245796,0,245796,COST
06079925102140000,2021,106550,277020,383570,COST
06079925102140000,2020,95299,268480,363779,COST
06079925102140000,2019,95299,267410,362709,COST
06079925102160000,2021,269284,217690,486974,COST
06079925102160000,2020,277874,216530,494404,COST
06079925102160000,2019,277874,216530,494404,COST
06079925201010000,2021,1207,0,1207,COST
06079925201010000,2020,1123,0,1123,COST
06079925201010000,2019,1123,0,1123,COST
06079925201020000,2021,227639,397380,625019,COST
06079925201020000,2020,166728,392720,559448,COST
06079925201020000,2019,166728,392720,559448,COST
06079925201030000,2021,449213,666120,1115333,COST
06079925201030000,2020,330327,659130,989457,COST
06079925201030000,2019,330327,659130,989457,COST
06079925201040000,2021,366256,876990,1243246,COST
06079925201040000,2020,293040,869800,1162840,COST
06079925201040000,2019,293040,869800,1162840,COST
06079925201050000,2021,344914,580670,925584,COST
06079925201050000,2020,273443,556770,830213,COST
06079925201050000,2019,273443,556770,830213,COST
06079925201060000,2021,190195,694590,884785,COST
06079925201060000,2020,186103,624890,810993,COST
06079925201060000,2019,186103,499080,685183,COST
06079925202010000,2021,208550,0,208550,COST
06079925202010000,2020,206956,0,206956,COST
06079925202010000,2019,206956,0,206956,COST
06079925202020000,2021,293895,0,293895,COST
06079925202020000,2020,307352,0,307352,COST
06079925202020000,2019,307352,0,307352,COST
06079925202020900,2021,207743,0,207743,COST
06079925202020900,2020,206034,0,206034,COST
06079925202020900,2019,206034,0,206034,COST
06079925202030000,2021,180533,0,180533,COST
06079925202030000,2020,175246,0,175246,COST
06079925202030000,2019,175246,0,175246,COST
06079925202040000,2021,130910,0,130910,COST
06079925202040000,2020,107445,0,107445,COST
06079925202040000,2019,107445,0,107445,COST
06079925202050000,2021,134725,0,134725,COST
06079925202050000,2020,111062,0,111062,COST
06079925202050000,2019,111062,0,111062,COST
06079925202060000,2021,214860,0,214860,COST
06079925202060000,2020,214192,0,214192,COST
06079925202060000,2019,214192,0,214192,COST
06079925203010000,2021,237999,0,237999,COST
06079925203010000,2020,240998,0,240998,COST
06079925203010000,2019,240998,0,240998,COST
06079925301010000,2021,220906,217150,438056,COST
06079925301010000,2020,221156,211130,432286,COST
06079925301010000,2019,221156,211130,432286,COST
06079925301020000,2021,1238,0,1238,COST
06079925301020000,2020,1152,0,1152,COST
06079925301020000,2019,1152,0,1152,COST
06079925301030000,2021,106543,384340,490883,COST
06079925301030000,2020,95293,381480,476773,COST
06079925301030000,2019,95293,381480,476773,COST
06079925301040000,2021,194896,0,194896,COST
06079925301040000,2020,191415,0,191415,COST
06079925301040000,2019,191415,0,191415,COST
06079925301050000,2021,220552,523430,743982,COST
06079925301050000,2020,163379,521510,684889,COST
06079925301050000,2019,163379,521510,684889,COST
06079925301060000,2021,106744,437170,543914,COST
06079925301060000,2020,95480,420260,515740,COST
06079925301060000,2019,95480,420260,515740,COST
06079925301070000,2021,1108,0,1108,COST
06079925301070000,2020,1031,0,1031,COST
06079925301070000,2019,1031,0,1031,COST
06079925301080000,2021,231267,364533,595800,MKT
06079925301080000,2020,172477,342223,514700,MKT
06079925301080000,2019,172477,342223,514700,MKT
06079925301100000,2021,291365,580690,872055,COST
06079925301100000,2020,304304,560870,865174,COST
06079925301100000,2019,304304,505290,809594,COST
06079925302010000,2021,278,0,278,COST
06079925302010000,2020,259,0,259,COST
06079925302010000,2019,259,0,259,COST
06079925302030000,2021,275,0,275,COST
06079925302030000,2020,256,0,256,COST
06079925302030000,2019,256,0,256,COST
06079925401010000,2021,106412,445030,551442,COST
06079925401010000,2020,95171,434890,530061,COST
06079925401010000,2019,95171,434890,530061,COST
06079925401020000,2021,9999,128130,138129,COST
06079925401020000,2020,5271,99610,104881,COST
06079925401020000,2019,5271,99610,104881,COST
06079925401030000,2021,115924,434900,550824,COST
06079925401030000,2020,99768,424770,524538,COST
06079925401030000,2019,99768,424770,524538,COST
06079925401040000,2021,106412,280510,386922,COST
06079925401040000,2020,95171,270370,365541,COST
06079925401040000,2019,95171,270370,365541,COST
06079925401050000,2021,106412,258850,365262,COST
06079925401050000,2020,95171,254570,349741,COST
06079925401050000,2019,95171,254570,349741,COST
06079925401060000,2021,106430,917240,1023670,COST
06079925401060000,2020,95188,906690,1001878,COST
06079925401060000,2019,95188,906690,1001878,COST
06079925401070000,2021,106425,233620,340045,COST
06079925401070000,2020,95183,219420,314603,COST
06079925401070000,2019,95183,219420,314603,COST
06079925401080000,2021,106412,736450,842862,COST
06079925401080000,2020,95171,731700,826871,COST
06079925401080000,2019,95171,856210,951381,COST
06079925401100000,2021,830,0,830,COST
06079925401100000,2020,773,0,773,COST
06079925401100000,2019,284377,0,284377,COST
06079925401120000,2021,186226,85140,271366,COST
06079925401120000,2020,181633,86150,267783,COST
06079925401120000,2019,181633,86150,267783,COST
06079926101010000,2021,416741,562710,979451,COST
06079926101010000,2020,340080,541950,882030,COST
06079926101010000,2019,340080,541950,882030,COST
06079926101020000,2021,300101,0,300101,COST
06079926101020000,2020,232907,0,232907,COST
06079926101020000,2019,232907,0,232907,COST
06079926101030000,2021,378422,221110,599532,COST
06079926101030000,2020,304290,215390,519680,COST
06079926101030000,2019,304290,215390,519680,COST
06079926101040000,2021,332749,278220,610969,COST
06079926101040000,2020,262354,270850,533204,COST
06079926101040000,2019,262354,270850,533204,COST
06079926101050000,2021,321114,322686,643800,MKT
06079926101050000,2020,251807,292093,543900,MKT
06079926101050000,2019,251807,292093,543900,MKT
06079926101060000,2021,291170,322630,613800,MKT
06079926101060000,2020,224935,317710,542645,COST
06079926101060000,2019,224935,317710,542645,COST
06079926101070000,2021,291170,613550,904720,COST
06079926101070000,2020,224935,601010,825945,COST
06079926101070000,2019,224935,505590,730525,COST
06079926101080000,2021,296102,323098,619200,MKT
06079926101080000,2020,229333,237767,467100,MKT
06079926101080000,2019,229333,237767,467100,MKT
06079926101090000,2021,296102,335198,631300,MKT
06079926101090000,2020,229333,310767,540100,MKT
06079926101090000,2019,229333,310767,540100,MKT
06079926101100000,2021,280523,279077,559600,MKT
06079926101100000,2020,215480,250220,465700,MKT
06079926101100000,2019,215480,250220,465700,MKT
06079926102030000,2021,98944,194810,293754,COST
06079926102030000,2020,100182,188350,288532,COST
06079926102030000,2019,100182,188350,288532,COST
06079926102040000,2021,18987,137410,156397,COST
06079926102040000,2020,19355,131250,150605,COST
06079926102040000,2019,19355,131250,150605,COST
06079926102050000,2021,315,0,315,COST
06079926102050000,2020,293,0,293,COST
06079926102050000,2019,293,0,293,COST
06079926102060000,2021,279527,615520,895047,COST
06079926102060000,2020,214598,600790,815388,COST
06079926102060000,2019,214598,600790,815388,COST
06079926102070000,2021,236863,188137,425000,MKT
06079926102070000,2020,177297,154830,332127,COST
06079926102070000,2019,177297,154830,332127,COST
06079926102070900,2021,280523,471610,752133,COST
06079926102070900,2020,215480,452880,668360,COST
06079926102070900,2019,215480,452880,668360,COST
06079926102080000,2021,469576,378450,848026,COST
06079926102080000,2020,390252,377180,767432,COST
06079926102080000,2019,390252,377180,767432,COST
06079926102200000,2021,286607,12160,298767,COST
06079926102200000,2020,220876,11810,232686,COST
06079926102200000,2019,220876,11810,232686,COST
06079926102300000,2021,471199,1456960,1928159,COST
06079926102300000,2020,391808,1295170,1686978,COST
06079926102300000,2019,391808,700000,1091808,COST
06079926103010000,2021,244095,49600,293695,COST
06079926103010000,2020,183553,49520,233073,COST
06079926103010000,2019,183553,49520,233073,COST
06079926105050000,2021,44403,0,44403,COST
06079926105050000,2020,41229,0,41229,COST
06079926105050000,2019,41229,0,41229,COST
06079926201150000,2021,449625,183280,632905,COST
06079926201150000,2020,371200,178740,549940,COST
06079926201150000,2019,371200,178740,549940,COST
06079926201300000,2021,220828,283000,503828,COST
06079926201300000,2020,163636,279480,443116,COST
06079926201300000,2019,163636,279480,443116,COST
06079926201450000,2021,220552,897600,1118152,COST
06079926201450000,2020,163379,886610,1049989,COST
06079926201450000,2019,163379,886610,1049989,COST
06079926201600000,2021,220878,467440,688318,COST
06079926201600000,2020,163683,451050,614733,OVR
06079926201600000,2019,163683,451050,614733,COST
06079926201860000,2021,23400,1808310,1831710,COST
06079926201860000,2020,22557,1268940,1291497,COST
06079926201860000,2019,22557,1268940,1291497,COST
06079926201956500,2021,171982,0,171982,COST
06079926201956500,2020,147167,0,147167,COST
06079926201956500,2019,147167,0,147167,COST
06079926401010000,2021,453579,248570,702149,COST
06079926401010000,2020,374966,245970,620936,COST
06079926401010000,2019,374966,245970,620936,COST
06079926401050000,2021,219760,223120,442880,COST
06079926401050000,2020,162642,217250,379892,COST
06079926401050000,2019,162642,217250,379892,COST
06079927101010000,2021,9089,750270,759359,COST
06079927101010000,2020,8849,744310,753159,COST
06079927101010000,2019,8849,744310,753159,COST
06079927101030000,2021,221659,102010,323669,COST
06079927101030000,2020,164409,99900,264309,COST
06079927101030000,2019,164409,99900,264309,COST
06079927101120000,2021,39743,0,39743,COST
06079927101120000,2020,36897,0,36897,COST
06079927101120000,2019,36897,0,36897,COST
06079927106010000,2021,629856,1763990,2393846,COST
06079927106010000,2020,547491,1720820,2268311,COST
06079927106010000,2019,547491,1720820,2268311,COST
06079927112010000,2021,1661,0,1661,COST
06079927112010000,2020,1545,0,1545,COST
06079927112010000,2019,1545,0,1545,COST
06079927118010000,2021,219958,461810,681768,COST
06079927118010000,2020,162827,438730,601557,COST
06079927118010000,2019,162827,438730,601557,COST
06079927148010000,2021,8845,0,8845,COST
06079927148010000,2020,8211,0,8211,COST
06079927148010000,2019,8211,0,8211,COST
06079927154010000,2021,9609,497950,507559,COST
06079927154010000,2020,9334,486240,495574,COST
06079927154010000,2019,9334,486240,495574,COST
06079927160010000,2021,220963,1113060,1334023,COST
06079927160010000,2020,163761,1095610,1259371,COST
06079927160010000,2019,163761,1095610,1259371,COST
06079927166010000,2021,5898,983020,988918,COST
06079927166010000,2020,5888,963970,969858,COST
06079927166010000,2019,5888,963970,969858,COST
06079927301010000,2021,57654,142130,199784,COST
06079927301010000,2020,57911,138790,196701,COST
06079927301010000,2019,57911,138790,196701,COST
06079927401010000,2021,50176,85070,135246,COST
06079927401010000,2020,49463,83310,132773,COST
06079927401010000,2019,49463,83310,132773,COST
06079927401300000,2021,220552,1181620,1402172,COST
06079927401300000,2020,163379,1233110,1396489,COST
06079927401300000,2019,163379,1233110,1396489,COST
06079927401400000,2021,601754,663700,1265454,COST
06079927401400000,2020,519427,660820,1180247,COST
06079927401400000,2019,519427,660820,1180247,COST
06079928101020000,2021,27249,1389750,1416999,COST
06079928101020000,2020,25715,1330020,1355735,COST
06079928101020000,2019,25715,1330020,1355735,COST
06079928101030000,2021,604915,276410,881325,COST
06079928101030000,2020,548339,268110,816449,COST
06079928101030000,2019,548339,268110,816449,COST
06079928101040000,2021,554,0,554,COST
06079928101040000,2020,515,0,515,COST
06079928101040000,2019,515,0,515,COST
06079928101050000,2021,554,0,554,COST
06079928101050000,2020,515,0,515,COST
06079928101050000,2019,515,0,515,COST
06079928101060000,2021,604915,194450,799365,COST
06079928101060000,2020,548339,149538,697877,OVR
06079928101060000,2019,548339,149538,697877,OVR
06079928101070000,2021,604915,183790,788705,COST
06079928101070000,2020,548339,178510,726849,COST
06079928101070000,2019,548339,178510,726849,COST
06079928101080000,2021,554,0,554,COST
06079928101080000,2020,515,0,515,COST
06079928101080000,2019,515,0,515,COST
06079928101090000,2021,268288,783300,1051588,COST
06079928101090000,2020,174464,710700,885164,COST
06079928101090000,2019,174464,710700,885164,COST
06079928101100000,2021,495832,0,495832,COST
06079928101100000,2020,515,0,515,COST
06079928101100000,2019,515,0,515,COST
06079928201010000,2021,54230,0,54230,COST
06079928201010000,2020,50353,0,50353,COST
06079928201010000,2019,50353,0,50353,COST
06079928301060000,2021,700192,203140,903332,COST
06079928301060000,2020,673794,201370,875164,COST
06079928301060000,2019,673794,201370,875164,COST
06079928301100000,2021,605557,303790,909347,COST
06079928301100000,2020,517,0,517,COST
06079928301100000,2019,517,0,517,COST
06079928301120000,2021,605450,0,605450,COST
06079928301120000,2020,516,0,516,COST
06079928301120000,2019,516,0,516,COST
06079928301140000,2021,268849,272170,541019,COST
06079928301140000,2020,174986,267130,442116,COST
06079928301140000,2019,174986,267130,442116,COST
06079928301160000,2021,605343,246230,851573,COST
06079928301160000,2020,548886,235750,784636,COST
06079928301160000,2019,548886,235750,784636,COST
06079928301180000,2021,605257,762340,1367597,COST
06079928301180000,2020,548776,757690,1306466,COST
06079928301180000,2019,548776,757690,1306466,COST
06079928304040000,2021,6640,798430,805070,COST
06079928304040000,2020,6573,761290,767863,COST
06079928304040000,2019,407993,761290,1169283,COST
06079928304090000,2021,537334,703050,1240384,COST
06079928304090000,2020,407620,678280,1085900,COST
06079928304090000,2019,407620,678280,1085900,COST
06079928310100000,2021,268846,931440,1200286,COST
06079928310100000,2020,174982,906220,1081202,COST
06079928310100000,2019,174982,844370,1019352,COST
06079928350010000,2021,548882,0,548882,COST
06079928350010000,2020,611855,0,611855,COST
06079928350010000,2019,611855,0,611855,COST
06079928350050000,2021,517436,887820,1405256,COST
06079928350050000,2020,563063,868790,1431853,COST
06079928350050000,2019,563063,868790,1431853,COST
06079928350100000,2021,515500,797270,1312770,COST
06079928350100000,2020,560099,795050,1355149,COST
06079928350100000,2019,560099,795050,1355149,COST
06079928350150000,2021,515549,510140,1025689,COST
06079928350150000,2020,560173,491860,1052033,COST
06079928350150000,2019,560173,491860,1052033,COST
06079928350250000,2021,1225,0,1225,COST
06079928350250000,2020,1140,0,1140,COST
06079928350250000,2019,1140,0,1140,COST
06079928401010000,2021,366565,0,366565,COST
06079928401010000,2020,367500,0,367500,COST
06079928401010000,2019,367500,0,367500,COST
06079928401030000,2021,366565,0,366565,COST
06079928401030000,2020,367500,0,367500,COST
06079928401030000,2019,367500,0,367500,COST
06079928401050000,2021,366565,1410360,1776925,COST
06079928401050000,2020,367500,1502340,1869840,OVR
06079928401050000,2019,367500,1502340,1869840,COST
06079928401070000,2021,366565,0,366565,COST
06079928401070000,2020,367500,0,367500,COST
06079928401070000,2019,367500,0,367500,COST
06079928401090000,2021,366565,0,366565,COST
06079928401090000,2020,367500,0,367500,COST
06079928401090000,2019,367500,0,367500,COST
06079928401110000,2021,366565,835800,1202365,COST
06079928401110000,2020,367500,805760,1173260,COST
06079928401110000,2019,367500,805760,1173260,COST
06079928401130000,2021,366565,0,366565,COST
06079928401130000,2020,367500,0,367500,COST
06079928401130000,2019,367500,0,367500,COST
06079928401150000,2021,366565,449830,816395,COST
06079928401150000,2020,367500,0,367500,COST
06079928401150000,2019,367500,0,367500,COST
06079928401170000,2021,366565,694180,1060745,COST
06079928401170000,2020,367500,229740,597240,COST
06079928401170000,2019,367500,0,367500,COST
06079928401200000,2021,2214,0,2214,COST
06079928401200000,2020,2060,0,2060,COST
06079928401200000,2019,2060,0,2060,COST
06079928401226500,2021,549301,0,549301,COST
06079928401226500,2020,4840,0,4840,COST
06079928401226500,2019,4840,0,4840,COST
06079928401246500,2021,244582,1770,246352,COST
06079928401246500,2020,339555,1940,341495,COST
06079928401246500,2019,339555,1940,341495,COST
06079929101010000,2021,1156,0,1156,COST
06079929101010000,2020,1075,0,1075,COST
06079929101010000,2019,1075,0,1075,COST
06079929112010000,2021,1529,0,1529,COST
06079929112010000,2020,1423,0,1423,COST
06079929112010000,2019,1423,0,1423,COST
06079929124010000,2021,1174,0,1174,COST
06079929124010000,2020,1092,0,1092,COST
06079929124010000,2019,1092,0,1092,COST
06079929124070000,2021,1283,0,1283,COST
06079929124070000,2020,1194,0,1194,COST
06079929124070000,2019,1194,0,1194,COST
06079929136010000,2021,1109,0,1109,COST
06079929136010000,2020,1032,0,1032,COST
06079929136010000,2019,1032,0,1032,COST
06079929154070000,2021,1275,0,1275,COST
06079929154070000,2020,1187,0,1187,COST
06079929154070000,2019,1187,0,1187,COST
06079929160010000,2021,1112,0,1112,COST
06079929160010000,2020,1035,0,1035,COST
06079929160010000,2019,1035,0,1035,COST
06079929181010000,2021,1108,0,1108,COST
06079929181010000,2020,1031,0,1031,COST
06079929181010000,2019,1031,0,1031,COST
06079929201010000,2021,300651,302049,602700,MKT
06079929201010000,2020,262072,217120,479192,COST
06079929201010000,2019,262072,217120,479192,COST
06079929201050000,2021,1533,7970,9503,COST
06079929201050000,2020,1427,7710,9137,COST
06079929201050000,2019,1427,0,1427,COST
06079929201100000,2021,1452,0,1452,COST
06079929201100000,2020,1352,0,1352,COST
06079929201100000,2019,1352,0,1352,COST
06079929236010000,2021,1132,0,1132,COST
06079929236010000,2020,1054,0,1054,COST
06079929236010000,2019,1054,0,1054,COST
06079929248010000,2021,1452,0,1452,COST
06079929248010000,2020,1351,0,1351,COST
06079929248010000,2019,1351,0,1351,COST
06079929260010000,2021,1134,0,1134,COST
06079929260010000,2020,1055,0,1055,COST
06079929260010000,2019,1055,0,1055,COST
06079929281010000,2021,1134,0,1134,COST
06079929281010000,2020,1055,0,1055,COST
06079929281010000,2019,1055,0,1055,COST
06079929301010000,2021,423779,495110,918889,COST
06079929301010000,2020,241845,466655,708500,MKT
06079929301010000,2019,241845,466655,708500,MKT
06079929301050000,2021,425356,0,425356,COST
06079929301050000,2020,242883,0,242883,COST
06079929301050000,2019,242883,0,242883,COST
06079929301150000,2021,425525,263220,688745,COST
06079929301150000,2020,242994,214906,457900,MKT
06079929301150000,2019,242994,214906,457900,MKT
06079929301200000,2021,368497,0,368497,COST
06079929301200000,2020,205851,0,205851,COST
06079929301200000,2019,205851,0,205851,COST
06079929301300000,2021,471223,591200,1062423,COST
06079929301300000,2020,273319,493114,766433,MRA
06079929301300000,2019,273319,493114,766433,MRA
06079929301350000,2021,414908,0,414908,COST
06079929301350000,2020,236018,0,236018,COST
06079929301350000,2019,236018,0,236018,COST
06079929301450000,2021,300000,331320,631320,COST
06079929301450000,2020,162400,322380,484780,COST
06079929301450000,2019,162400,322380,484780,COST
06079929301510000,2021,473356,334930,808286,COST
06079929301510000,2020,274745,301970,576715,MRA
06079929301510000,2019,274745,301970,576715,MRA
06079929301530000,2021,434655,350150,784805,COST
06079929301530000,2020,249015,392585,641600,MKT
06079929301530000,2019,249015,392585,641600,MKT
06079929301550000,2021,728873,0,728873,COST
06079929301550000,2020,548339,0,548339,COST
06079929301550000,2019,548339,0,548339,COST
06079929301570000,2021,403463,415960,819423,COST
06079929301570000,2020,228528,397080,625608,COST
06079929301570000,2019,228528,397080,625608,COST
06079929301600000,2021,378252,255660,633912,COST
06079929301600000,2020,212145,241055,453200,MKT
06079929301600000,2019,212145,241055,453200,MKT
06079929302010000,2021,463199,0,463199,COST
06079929302010000,2020,429481,0,429481,COST
06079929302010000,2019,429481,0,429481,COST
06079929401010000,2021,728873,644860,1373733,COST
06079929401010000,2020,548339,622620,1170959,COST
06079929401010000,2019,548339,622620,1170959,COST
06079929401030000,2021,729414,942520,1671934,COST
06079929401030000,2020,548913,936820,1485733,COST
06079929401030000,2019,548913,936820,1485733,COST
06079929401050000,2021,729131,526560,1255691,COST
06079929401050000,2020,548612,523380,1071992,COST
06079929401050000,2019,548612,523380,1071992,COST
06079929401070000,2021,729079,1025510,1754589,COST
06079929401070000,2020,548558,990950,1539508,COST
06079929401070000,2019,548558,990950,1539508,COST
06079929401100000,2021,9281,404540,413821,COST
06079929401100000,2020,9028,394180,403208,COST
06079929401100000,2019,9028,394180,403208,COST
06079929401150000,2021,323717,1126170,1449887,COST
06079929401150000,2020,290479,1102690,1393169,COST
06079929401150000,2019,290479,1102690,1393169,COST
06079929401200000,2021,578,0,578,COST
06079929401200000,2020,931984,0,931984,COST
06079929401200000,2019,538,0,538,COST
06079929401250000,2021,323916,522670,846586,COST
06079929401250000,2020,290664,499090,789754,COST
06079929401250000,2019,290664,499090,789754,COST
06079929401300000,2021,750174,423870,1174044,COST
06079929401300000,2020,950102,406370,1356472,COST
06079929401300000,2019,950102,406370,1356472,COST
06079929401350000,2021,323716,2491590,2815306,COST
06079929401350000,2020,290478,2402140,2692618,COST
06079929401350000,2019,290478,2402140,2692618,COST
06079929401400000,2021,323735,827760,1151495,COST
06079929401400000,2020,290495,826390,1116885,COST
06079929401400000,2019,290495,826390,1116885,COST
06079929401430000,2021,733056,2419930,3152986,COST
06079929401430000,2020,919706,2350120,3269826,COST
06079929401430000,2019,919706,2350120,3269826,COST
06079929401450000,2021,733056,526790,1259846,COST
06079929401450000,2020,919706,457020,1376726,COST
06079929401450000,2019,919706,457020,1376726,COST
06079929401500000,2021,323728,529400,853128,COST
06079929401500000,2020,290489,517000,807489,COST
06079929401500000,2019,290489,517000,807489,COST
06079929401550000,2021,1108,0,1108,COST
06079929401550000,2020,1031,0,1031,COST
06079929401550000,2019,1031,0,1031,COST
06079929401600000,2021,730700,1124200,1854900,COST
06079929401600000,2020,915546,1105520,2021066,COST
06079929401600000,2019,915546,1105520,2021066,COST
06079929401620000,2021,728873,500140,1229013,COST
06079929401620000,2020,912323,475710,1388033,COST
06079929401620000,2019,912323,475710,1388033,COST
06079929401650000,2021,323719,719420,1043139,COST
06079929401650000,2020,290481,665830,956311,COST
06079929401650000,2019,290481,665830,956311,COST
06079930101010000,2021,340696,476570,817266,COST
06079930101010000,2020,264031,471780,735811,COST
06079930101010000,2019,264031,471780,735811,COST
06079930101020000,2021,371681,492710,864391,COST
06079930101020000,2020,291902,469640,761542,COST
06079930101020000,2019,291902,469640,761542,COST
06079930101030000,2021,401150,553270,954420,COST
06079930101030000,2020,318742,534350,853092,COST
06079930101030000,2019,318742,534350,853092,COST
06079930101040000,2021,407092,588450,995542,COST
06079930101040000,2020,324191,577650,901841,COST
06079930101040000,2019,324191,577650,901841,COST
06079930101050000,2021,388758,386720,775478,COST
06079930101050000,2020,307418,367470,674888,COST
06079930101050000,2019,307418,367470,674888,COST
06079930101060000,2021,357335,715610,1072945,COST
06079930101060000,2020,278952,697850,976802,COST
06079930101060000,2019,278952,697850,976802,COST
06079930101070000,2021,333606,300329,633935,OVR
06079930101070000,2020,257707,269593,527300,MKT
06079930101070000,2019,257707,269593,527300,MKT
06079930101080000,2021,319842,541400,861242,COST
06079930101080000,2020,245488,538360,783848,COST
06079930101080000,2019,245488,538360,783848,COST
06079930101090000,2021,326230,482470,808700,MKT
06079930101090000,2020,251149,509151,760300,MKT
06079930101090000,2019,251149,507780,758929,COST
06079930101100000,2021,309107,463040,772147,COST
06079930101100000,2020,236014,450040,686054,COST
06079930101100000,2019,236014,450040,686054,COST
06079930101110000,2021,296155,264345,560500,MKT
06079930101110000,2020,224650,199750,424400,MKT
06079930101110000,2019,224650,199750,424400,MKT
06079930101120000,2021,80903,0,80903,COST
06079930101120000,2020,61590,0,61590,COST
06079930101120000,2019,61590,0,61590,COST
06079930102016500,2021,192227,0,192227,COST
06079930102016500,2020,167039,0,167039,COST
06079930102016500,2019,167039,0,167039,COST
06079930102036500,2021,183189,0,183189,COST
06079930102036500,2020,158017,0,158017,COST
06079930102036500,2019,158017,0,158017,COST
06079930103010000,2021,414791,1230860,1645651,COST
06079930103010000,2020,337396,1214200,1551596,COST
06079930103010000,2019,337396,1214200,1551596,COST
06079930103040000,2021,330973,462227,793200,MKT
06079930103040000,2020,260086,416914,677000,MKT
06079930103040000,2019,260086,416914,677000,MKT
06079930103050000,2021,304193,1014960,1319153,COST
06079930103050000,2020,235978,984900,1220878,COST
06079930103050000,2019,235978,984900,1220878,COST
06079930103070000,2021,305225,427275,732500,MKT
06079930103070000,2020,236901,377199,614100,MKT
06079930103070000,2019,236901,377199,614100,MKT
06079930103080000,2021,70422,0,70422,COST
06079930103080000,2020,52486,0,52486,COST
06079930103080000,2019,52486,0,52486,COST
06079930103090000,2021,241221,419979,661200,MKT
06079930103090000,2020,180609,418591,599200,MKT
06079930103090000,2019,180609,418591,599200,MKT
06079930103100000,2021,305225,347800,653025,COST
06079930103100000,2020,236901,367699,604600,MKT
06079930103100000,2019,236901,367699,604600,MKT
06079930103110000,2021,372970,1030110,1403080,COST
06079930103110000,2020,298489,336740,635229,COST
06079930103110000,2019,298489,486040,784529,COST
06079930103120000,2021,359700,0,359700,COST
06079930103120000,2020,286280,0,286280,COST
06079930103120000,2019,286280,0,286280,COST
06079930103130000,2021,416664,658100,1074764,COST
06079930103130000,2020,339153,638460,977613,COST
06079930103130000,2019,339153,638460,977613,COST
06079930103150000,2021,309290,836610,1145900,MKT
06079930103150000,2020,240543,725757,966300,MKT
06079930103150000,2019,240543,725757,966300,MKT
06079930103170000,2021,238021,446050,684071,COST
06079930103170000,2020,177849,430551,608400,MKT
06079930103170000,2019,177849,430551,608400,MKT
06079930103180000,2021,236391,342609,579000,MKT
06079930103180000,2020,176446,337754,514200,MKT
06079930103180000,2019,176446,337754,514200,MKT
06079930103190000,2021,277220,352750,629970,COST
06079930103190000,2020,212023,363777,575800,MKT
06079930103190000,2019,212023,363777,575800,MKT
06079930103200000,2021,326390,389410,715800,COST
06079930103200000,2020,255938,379062,635000,MKT
06079930103200000,2019,255938,379062,635000,MKT
06079930103230000,2021,260906,0,260906,COST
06079930103230000,2020,197704,0,197704,COST
06079930103230000,2019,197704,0,197704,COST
06079930103240000,2021,250385,3210,253595,COST
06079930103240000,2020,188542,3370,191912,COST
06079930103240000,2019,188542,3370,191912,COST
06079930103250000,2021,331858,958020,1289878,COST
06079930103250000,2020,260888,918990,1179878,COST
06079930103250000,2019,260888,918990,1179878,COST
06079930105010000,2021,248901,252699,501600,MKT
06079930105010000,2020,187253,240747,428000,MKT
06079930105010000,2019,187253,240747,428000,MKT
06079930105020000,2021,248901,333500,582401,COST
06079930105020000,2020,187253,316547,503800,MKT
06079930105020000,2019,187253,316547,503800,MKT
06079930105030000,2021,306251,252540,558791,COST
06079930105030000,2020,237819,222181,460000,MKT
06079930105030000,2019,237819,222181,460000,MKT
06079930105040000,2021,322804,382996,705800,MKT
06079930105040000,2020,252699,302301,555000,MKT
06079930105040000,2019,252699,302301,555000,MKT
06079930105050000,2021,294823,405777,700600,MKT
06079930105050000,2020,227618,432482,660100,MKT
06079930105050000,2019,227618,432482,660100,MKT
06079930105060000,2021,307473,479570,787043,COST
06079930105060000,2020,238914,461720,700634,COST
06079930105060000,2019,238914,461720,700634,COST
06079930105070000,2021,242793,236407,479200,MKT
06079930105070000,2020,181966,242634,424600,MKT
06079930105070000,2019,181966,242634,424600,MKT
06079930105080000,2021,234740,260360,495100,MKT
06079930105080000,2020,175026,224274,399300,MKT
06079930105080000,2019,175026,224274,399300,MKT
06079930105090000,2021,236391,258309,494700,MKT
06079930105090000,2020,176446,249254,425700,MKT
06079930105090000,2019,176446,249254,425700,MKT
06079930105100000,2021,231373,298527,529900,MKT
06079930105100000,2020,172135,284665,456800,MKT
06079930105100000,2019,172135,284665,456800,MKT
06079930105120000,2021,309290,303710,613000,MKT
06079930105120000,2020,240543,237657,478200,MKT
06079930105120000,2019,240543,237657,478200,MKT
06079930105130000,2021,300000,284000,584000,MKT
06079930105130000,2020,232232,216568,448800,MKT
06079930105130000,2019,232232,216568,448800,MKT
06079930105140000,2021,247550,261650,509200,MKT
06079930105140000,2020,186083,252917,439000,MKT
06079930105140000,2019,186083,252917,439000,MKT
06079930105150000,2021,246794,260506,507300,MKT
06079930105150000,2020,185428,259172,444600,MKT
06079930105150000,2019,185428,259172,444600,MKT
06079930105160000,2021,228614,262986,491600,MKT
06079930105160000,2020,169770,259930,429700,MKT
06079930105160000,2019,169770,259930,429700,MKT
06079930105170000,2021,254746,282454,537200,MKT
06079930105170000,2020,192333,263867,456200,MKT
06079930105170000,2019,192333,261167,453500,MKT
06079930105180000,2021,321873,294127,616000,MKT
06079930105180000,2020,251859,211541,463400,MKT
06079930105180000,2019,251859,211541,463400,MKT
06079930105190000,2021,336221,503120,839341,COST
06079930105190000,2020,264846,522670,787516,COST
06079930105190000,2019,264846,522670,787516,COST
06079930105200000,2021,251854,624446,876300,MKT
06079930105200000,2020,189818,525182,715000,OVR
06079930105200000,2019,189818,525182,715000,OVR
06079930105210000,2021,251854,269746,521600,MKT
06079930105210000,2020,189818,271982,461800,MKT
06079930105210000,2019,189818,271982,461800,MKT
06079930105220000,2021,300000,422220,722220,COST
06079930105220000,2020,232232,402790,635022,COST
06079930105220000,2019,232232,402790,635022,COST
06079930105230000,2021,234740,352460,587200,MKT
06079930105230000,2020,175026,329674,504700,MKT
06079930105230000,2019,175026,329674,504700,MKT
06079930105240000,2021,234740,284160,518900,MKT
06079930105240000,2020,175026,249474,424500,MKT
06079930105240000,2019,175026,249474,424500,MKT
06079930105250000,2021,253308,280992,534300,MKT
06079930105250000,2020,191081,249219,440300,MKT
06079930105250000,2019,191081,249219,440300,MKT
06079930105260000,2021,269676,259824,529500,MKT
06079930105260000,2020,205385,235815,441200,MKT
06079930105260000,2019,205385,235815,441200,MKT
06079930105270000,2021,319995,515505,835500,MKT
06079930105270000,2020,250166,537810,787976,COST
06079930105270000,2019,250166,537810,787976,COST
06079930105280000,2021,349530,539110,888640,COST
06079930105280000,2020,276969,515850,792819,COST
06079930105280000,2019,276969,515850,792819,COST
06079930105290000,2021,301058,432700,733758,COST
06079930105290000,2020,233177,416680,649857,COST
06079930105290000,2019,233177,416680,649857,COST
06079930105300000,2021,309290,381160,690450,COST
06079930105300000,2020,240543,366457,607000,MKT
06079930105300000,2019,240543,366457,607000,MKT
06079930105310000,2021,347917,348583,696500,MKT
06079930105310000,2020,275495,270605,546100,MKT
06079930105310000,2019,275495,270605,546100,MKT
06079930105320000,2021,260357,355943,616300,MKT
06079930105320000,2020,197224,320576,517800,MKT
06079930105320000,2019,197224,320576,517800,MKT
06079930105330000,2021,308687,0,308687,COST
06079930105330000,2020,240002,0,240002,COST
06079930105330000,2019,240002,0,240002,COST
06079930105340000,2021,309089,354211,663300,MKT
06079930105340000,2020,240362,280938,521300,MKT
06079930105340000,2019,240362,280938,521300,MKT
06079930105350000,2021,341658,360542,702200,MKT
06079930105350000,2020,269790,290710,560500,MKT
06079930105350000,2019,269790,290710,560500,MKT
06079930105360000,2021,231373,338327,569700,MKT
06079930105360000,2020,172135,324565,496700,MKT
06079930105360000,2019,172135,324565,496700,MKT
06079930105370000,2021,231373,215527,446900,MKT
06079930105370000,2020,172135,222065,394200,MKT
06079930105370000,2019,172135,222065,394200,MKT
06079930105380000,2021,296784,333516,630300,MKT
06079930105380000,2020,229364,260536,489900,MKT
06079930105380000,2019,229364,260536,489900,MKT
06079930105390000,2021,302110,223690,525800,MKT
06079930105390000,2020,234116,205184,439300,MKT
06079930105390000,2019,234116,205184,439300,MKT
06079930107010000,2021,241221,288079,529300,MKT
06079930107010000,2020,180609,258691,439300,MKT
06079930107010000,2019,180609,258691,439300,MKT
06079930107020000,2021,241221,300779,542000,MKT
06079930107020000,2020,180609,263391,444000,MKT
06079930107020000,2019,180609,263391,444000,MKT
06079930107030000,2021,376567,270833,647400,MKT
06079930107030000,2020,296331,216769,513100,MKT
06079930107030000,2019,296331,216769,513100,MKT
06079930107050000,2021,346405,425230,771635,COST
06079930107050000,2020,269139,405720,674859,COST
06079930107050000,2019,269139,405720,674859,COST
06079930107060000,2021,310292,498808,809100,MKT
06079930107060000,2020,241441,517890,759331,COST
06079930107060000,2019,241441,517890,759331,COST
06079930107070000,2021,350852,456248,807100,MKT
06079930107070000,2020,273125,478320,751445,COST
06079930107070000,2019,273125,478320,751445,COST
06079930107080000,2021,346405,403995,750400,MKT
06079930107080000,2020,269139,329061,598200,MKT
06079930107080000,2019,269139,329061,598200,MKT
06079930107090000,2021,346405,309220,655625,COST
06079930107090000,2020,269139,275561,544700,MKT
06079930107090000,2019,269139,275561,544700,MKT
06079930107100000,2021,346405,471395,817800,MKT
06079930107100000,2020,269139,382661,651800,MKT
06079930107100000,2019,269139,382661,651800,MKT
06079930107110000,2021,362578,496660,859238,COST
06079930107110000,2020,283676,474240,757916,COST
06079930107110000,2019,283676,469220,752896,COST
06079930107120000,2021,364637,365340,729977,COST
06079930107120000,2020,285534,353510,639044,COST
06079930107120000,2019,285534,353510,639044,COST
06079930107130000,2021,313261,309439,622700,MKT
06079930107130000,2020,244106,240494,484600,MKT
06079930107130000,2019,244106,240494,484600,MKT
06079930107140000,2021,234740,234860,469600,MKT
06079930107140000,2020,175026,250274,425300,MKT
06079930107140000,2019,175026,250274,425300,MKT
06079930107150000,2021,231373,312727,544100,MKT
06079930107150000,2020,172135,264365,436500,MKT
06079930107150000,2019,172135,264365,436500,MKT
06079930107160000,2021,298935,307365,606300,MKT
06079930107160000,2020,231282,275118,506400,MKT
06079930107160000,2019,231282,275118,506400,MKT
06079930108016500,2021,156796,0,156796,COST
06079930108016500,2020,132072,0,132072,COST
06079930108016500,2019,132072,0,132072,COST
06079930150010000,2021,300000,317800,617800,MKT
06079930150010000,2020,232232,344068,576300,MKT
06079930150010000,2019,232232,344068,576300,MKT
06079930150020000,2021,312277,330923,643200,MKT
06079930150020000,2020,243222,272578,515800,MKT
06079930150020000,2019,243222,272578,515800,MKT
06079930150030000,2021,247399,237501,484900,MKT
06079930150030000,2020,185952,226648,412600,MKT
06079930150030000,2019,185952,226648,412600,MKT
06079930150040000,2021,246642,251858,498500,MKT
06079930150040000,2020,185296,237704,423000,MKT
06079930150040000,2019,185296,237704,423000,MKT
06079930150050000,2021,246642,233958,480600,MKT
06079930150050000,2020,185296,245104,430400,MKT
06079930150050000,2019,185296,245104,430400,MKT
06079930150060000,2021,247399,265101,512500,MKT
06079930150060000,2020,185952,234548,420500,MKT
06079930150060000,2019,185952,234548,420500,MKT
06079930150070000,2021,327388,283112,610500,MKT
06079930150070000,2020,256841,236559,493400,MKT
06079930150070000,2019,256841,233659,490500,MKT
06079930150080000,2021,241221,271079,512300,MKT
06079930150080000,2020,180609,237591,418200,MKT
06079930150080000,2019,180609,237591,418200,MKT
06079930150090000,2021,238021,268079,506100,MKT
06079930150090000,2020,177849,238951,416800,MKT
06079930150090000,2019,177849,238951,416800,MKT
06079930150100000,2021,250385,265815,516200,MKT
06079930150100000,2020,188542,245858,434400,MKT
06079930150100000,2019,188542,245858,434400,MKT
06079930150110000,2021,247399,269201,516600,MKT
06079930150110000,2020,185952,241148,427100,MKT
06079930150110000,2019,185952,241148,427100,MKT
06079930150120000,2021,341323,310077,651400,MKT
06079930150120000,2020,269485,228715,498200,MKT
06079930150120000,2019,269485,228715,498200,MKT
06079930150130000,2021,246642,291558,538200,MKT
06079930150130000,2020,185296,274504,459800,MKT
06079930150130000,2019,185296,274504,459800,MKT
06079930150140000,2021,246642,340958,587600,MKT
06079930150140000,2020,185296,318404,503700,MKT
06079930150140000,2019,185296,318404,503700,MKT
06079930150150000,2021,246642,310458,557100,MKT
06079930150150000,2020,185296,309204,494500,MKT
06079930150150000,2019,185296,309204,494500,MKT
06079930150160000,2021,246642,246558,493200,MKT
06079930150160000,2020,185296,241604,426900,MKT
06079930150160000,2019,185296,241604,426900,MKT
06079930150170000,2021,241221,232279,473500,MKT
06079930150170000,2020,180609,234391,415000,MKT
06079930150170000,2019,180609,234391,415000,MKT
06079930150180000,2021,244346,179354,423700,MKT
06079930150180000,2020,183309,199691,383000,MKT
06079930150180000,2019,183309,197091,380400,MKT
06079930150200000,2021,375874,727480,1103354,COST
06079930150200000,2020,301170,716220,1017390,COST
06079930150200000,2019,301170,716220,1017390,COST
06079930170020000,2021,298828,0,298828,COST
06079930170020000,2020,231186,0,231186,COST
06079930170020000,2019,231186,0,231186,COST
06079930170030000,2021,269676,0,269676,COST
06079930170030000,2020,205385,0,205385,COST
06079930170030000,2019,205385,0,205385,COST
06079930170040000,2021,299123,390977,690100,MKT
06079930170040000,2020,227247,314453,541700,MKT
06079930170040000,2019,227247,314453,541700,MKT
06079930170050000,2021,250680,332210,582890,COST
06079930170050000,2020,132027,316820,448847,COST
06079930170050000,2019,132027,316820,448847,COST
06079930170060000,2021,294603,224497,519100,MKT
06079930170060000,2020,227422,206378,433800,MKT
06079930170060000,2019,227422,206378,433800,MKT
06079930170070000,2021,290152,306148,596300,MKT
06079930170070000,2020,223466,244634,468100,MKT
06079930170070000,2019,223466,244634,468100,MKT
06079930170080000,2021,294603,319497,614100,MKT
06079930170080000,2020,227422,252678,480100,MKT
06079930170080000,2019,227422,252678,480100,MKT
06079930170090000,2021,321873,256327,578200,MKT
06079930170090000,2020,251859,201741,453600,MKT
06079930170090000,2019,251859,201741,453600,MKT
06079930175010000,2021,254441,642060,896501,COST
06079930175010000,2020,192551,624580,817131,COST
06079930175010000,2019,192551,624580,817131,COST
06079930175030000,2021,204259,0,204259,COST
06079930175030000,2020,149471,0,149471,COST
06079930175030000,2019,149471,0,149471,COST
06079930175050000,2021,204259,0,204259,COST
06079930175050000,2020,149471,0,149471,COST
06079930175050000,2019,149471,0,149471,COST
06079930175070000,2021,275989,467011,743000,MKT
06079930175070000,2020,211469,488931,700400,MKT
06079930175070000,2019,211469,488931,700400,MKT
06079930175080000,2021,223323,310077,533400,MKT
06079930175080000,2020,165665,284935,450600,MKT
06079930175080000,2019,165665,284935,450600,MKT
06079930175090000,2021,224819,0,224819,COST
06079930175090000,2020,166945,0,166945,COST
06079930175090000,2019,166945,0,166945,COST
06079930175100000,2021,226298,284302,510600,MKT
06079930175100000,2020,168212,270688,438900,MKT
06079930175100000,2019,168212,270688,438900,MKT
06079930175110000,2021,229059,271541,500600,MKT
06079930175110000,2020,170580,269120,439700,MKT
06079930175110000,2019,170580,269120,439700,MKT
06079930175120000,2021,229059,0,229059,COST
06079930175120000,2020,170580,0,170580,COST
06079930175120000,2019,170580,0,170580,COST
06079930175140000,2021,280523,375870,656393,COST
06079930175140000,2020,215480,359520,575000,COST
06079930175140000,2019,215480,359520,575000,COST
06079930175160000,2021,234130,215870,450000,MKT
06079930175160000,2020,174941,223059,398000,MKT
06079930175160000,2019,174941,223059,398000,MKT
06079930175180000,2021,293381,756760,1050141,COST
06079930175180000,2020,226905,751620,978525,OVR
06079930175180000,2019,226905,751620,978525,COST
06079930175200000,2021,256326,366674,623000,MKT
06079930175200000,2020,194196,328004,522200,MKT
06079930175200000,2019,194196,328004,522200,MKT
06079930201016500,2021,456358,0,456358,COST
06079930201016500,2020,353490,0,353490,COST
06079930201016500,2019,353490,0,353490,COST
06079930201016501,2021,289700,0,289700,COST
06079930201016501,2020,225845,0,225845,COST
06079930201016501,2019,225845,0,225845,COST
06079930203010000,2021,733668,829960,1563628,COST
06079930203010000,2020,920788,809610,1730398,COST
06079930203010000,2019,920788,809610,1730398,COST
06079930203070000,2021,590528,541170,1131698,COST
06079930203070000,2020,678246,523250,1201496,COST
06079930203070000,2019,678246,523250,1201496,COST
06079930203120000,2021,695314,791040,1486354,COST
06079930203120000,2020,853717,799570,1653287,COST
06079930203120000,2019,853717,799570,1653287,COST
06079930203180000,2021,661134,1711160,2372294,COST
06079930203180000,2020,795202,1654560,2449762,COST
06079930203180000,2019,795202,1577900,2373102,COST
06079930203300000,2021,285995,387405,673400,MKT
06079930203300000,2020,226826,344674,571500,MKT
06079930203300000,2019,226826,344674,571500,MKT
06079930203320000,2021,295792,432008,727800,MKT
06079930203320000,2020,234485,433015,667500,MKT
06079930203320000,2019,234485,433015,667500,MKT
06079930203340000,2021,274200,374900,649100,MKT
06079930203340000,2020,217601,342499,560100,MKT
06079930203340000,2019,217601,342499,560100,MKT
06079930203360000,2021,282885,528715,811600,MKT
06079930203360000,2020,224395,466705,691100,MKT
06079930203360000,2019,224395,466705,691100,MKT
06079930203380000,2021,294459,461741,756200,MKT
06079930203380000,2020,233443,396957,630400,MKT
06079930203380000,2019,233443,396957,630400,MKT
06079930203400000,2021,291598,597002,888600,MKT
06079930203400000,2020,231207,483493,714700,MKT
06079930203400000,2019,231207,483493,714700,MKT
06079930203480000,2021,302247,524053,826300,MKT
06079930203480000,2020,239529,395671,635200,MKT
06079930203480000,2019,239529,405871,645400,MKT
06079930203500000,2021,318265,348535,666800,MKT
06079930203500000,2020,252039,279761,531800,MKT
06079930203500000,2019,252039,279761,531800,MKT
06079930203520000,2021,303712,713960,1017672,COST
06079930203520000,2020,240673,678827,919500,MKT
06079930203520000,2019,240673,678827,919500,MKT
06079930203540000,2021,311582,574418,886000,MKT
06079930203540000,2020,246821,443679,690500,MKT
06079930203540000,2019,246821,443679,690500,MKT
06079930203580000,2021,294602,563098,857700,MKT
06079930203580000,2020,233555,500245,733800,MKT
06079930203580000,2019,233555,500245,733800,MKT
06079930203600000,2021,289750,526650,816400,MKT
06079930203600000,2020,229762,412138,641900,MKT
06079930203600000,2019,229762,412138,641900,MKT
06079930203620000,2021,287252,620148,907400,MKT
06079930203620000,2020,227809,525591,753400,MKT
06079930203620000,2019,227809,525591,753400,MKT
06079930203640000,2021,287252,514648,801900,MKT
06079930203640000,2020,227809,471891,699700,MKT
06079930203640000,2019,227809,471891,699700,MKT
06079930203660000,2021,287252,642348,929600,MKT
06079930203660000,2020,227809,567091,794900,MKT
06079930203660000,2019,227809,567091,794900,MKT
06079930203680000,2021,293885,616015,909900,MKT
06079930203680000,2020,232994,550306,783300,MKT
06079930203680000,2019,232994,550306,783300,MKT
06079930209010000,2021,286761,389239,676000,MKT
06079930209010000,2020,227426,350174,577600,MKT
06079930209010000,2019,227426,350174,577600,MKT
06079930209030000,2021,296296,406904,703200,MKT
06079930209030000,2020,234878,343022,577900,MKT
06079930209030000,2019,234878,343022,577900,MKT
06079930209050000,2021,280283,460717,741000,MKT
06079930209050000,2020,222360,448940,671300,MKT
06079930209050000,2019,222360,448940,671300,MKT
06079930209070000,2021,283442,949460,1232902,COST
06079930209070000,2020,224830,925390,1150220,COST
06079930209070000,2019,224830,925390,1150220,COST
06079930209090000,2021,276903,296590,573493,COST
06079930209090000,2020,219716,273784,493500,MKT
06079930209090000,2019,219716,273784,493500,MKT
06079930209110000,2021,298366,634334,932700,MKT
06079930209110000,2020,236496,541204,777700,MKT
06079930209110000,2019,236496,541204,777700,MKT
06079930209130000,2021,305297,375603,680900,MKT
06079930209130000,2020,241912,301388,543300,MKT
06079930209130000,2019,241912,301388,543300,MKT
06079930209150000,2021,305132,448768,753900,MKT
06079930209150000,2020,241782,492118,733900,MKT
06079930209150000,2019,241782,492118,733900,MKT
06079930209170000,2021,307395,550705,858100,MKT
06079930209170000,2020,243550,484950,728500,MKT
06079930209170000,2019,243550,484950,728500,MKT
06079930209190000,2021,276424,637876,914300,MKT
06079930209190000,2020,219341,530559,749900,MKT
06079930209190000,2019,219341,530559,749900,MKT
06079930209210000,2021,285926,439274,725200,MKT
06079930209210000,2020,226772,370728,597500,MKT
06079930209210000,2019,226772,370728,597500,MKT
06079930209230000,2021,288054,612446,900500,MKT
06079930209230000,2020,228437,552463,780900,MKT
06079930209230000,2019,228437,552463,780900,MKT
06079930209290000,2021,298761,710139,1008900,MKT
06079930209290000,2020,236805,574495,811300,MKT
06079930209290000,2019,236805,574495,811300,MKT
06079930209310000,2021,304007,549393,853400,MKT
06079930209310000,2020,240904,419896,660800,MKT
06079930209310000,2019,240904,419896,660800,MKT
06079930209330000,2021,287252,443948,731200,MKT
06079930209330000,2020,227809,366891,594700,MKT
06079930209330000,2019,227809,366891,594700,MKT
06079930209350000,2021,287252,634948,922200,MKT
06079930209350000,2020,227809,560891,788700,MKT
06079930209350000,2019,227809,560891,788700,MKT
06079930209370000,2021,317948,568152,886100,MKT
06079930209370000,2020,251791,500009,751800,MKT
06079930209370000,2019,251791,500009,751800,MKT
06079930211016500,2021,115655,0,115655,COST
06079930211016500,2020,91341,0,91341,COST
06079930211016500,2019,91341,0,91341,COST
06079930211030000,2021,364038,672162,1036200,MKT
06079930211030000,2020,298734,544466,843200,MKT
06079930211030000,2019,298734,544466,843200,MKT
06079930211050000,2021,382251,658430,1040681,COST
06079930211050000,2020,313463,638960,952423,COST
06079930211050000,2019,313463,638960,952423,COST
06079930211070000,2021,364038,578062,942100,MKT
06079930211070000,2020,298734,470966,769700,MKT
06079930211070000,2019,298734,470966,769700,MKT
06079930211090000,2021,364038,668020,1032058,COST
06079930211090000,2020,298734,569866,868600,MKT
06079930211090000,2019,298734,569866,868600,MKT
06079930211110000,2021,395339,481790,877129,COST
06079930211110000,2020,324042,373658,697700,MKT
06079930211110000,2019,324042,373658,697700,MKT
06079930211130000,2021,364038,795280,1159318,COST
06079930211130000,2020,298734,618366,917100,MKT
06079930211130000,2019,298734,618366,917100,MKT
06079930211150000,2021,364038,640762,1004800,MKT
06079930211150000,2020,298734,528066,826800,MKT
06079930211150000,2019,298734,482666,781400,MKT
06079930211170000,2021,377789,608000,985789,COST
06079930211170000,2020,309856,477344,787200,MKT
06079930211170000,2019,309856,477344,787200,MKT
06079930211190000,2021,395339,617130,1012469,COST
06079930211190000,2020,324042,512558,836600,MKT
06079930211190000,2019,324042,512558,836600,MKT
06079930211210000,2021,497232,743840,1241072,COST
06079930211210000,2020,406239,676900,1083139,COST
06079930211210000,2019,406239,676900,1083139,COST
06079930219020000,2021,368674,698310,1066984,COST
06079930219020000,2020,302484,525816,828300,MKT
06079930219020000,2019,302484,525816,828300,MKT
06079930219040000,2021,354563,686537,1041100,MKT
06079930219040000,2020,291067,556333,847400,MKT
06079930219040000,2019,291067,556333,847400,MKT
06079930219060000,2021,344802,642910,987712,COST
06079930219060000,2020,283166,539634,822800,MKT
06079930219060000,2019,283166,539634,822800,MKT
06079930219080000,2021,344802,733850,1078652,COST
06079930219080000,2020,283166,587034,870200,MKT
06079930219080000,2019,283166,587034,870200,MKT
06079930219100000,2021,364038,645962,1010000,MKT
06079930219100000,2020,298734,526366,825100,MKT
06079930219100000,2019,298734,526366,825100,MKT
06079930219120000,2021,344802,1008588,1353390,MRA
06079930219120000,2020,283166,1082634,1365800,OVR
06079930219120000,2019,283166,1082634,1365800,OVR
06079930219140000,2021,324381,668919,993300,MKT
06079930219140000,2020,266625,564975,831600,MKT
06079930219140000,2019,266625,564975,831600,MKT
06079930219160000,2021,324381,340719,665100,MKT
06079930219160000,2020,266625,269675,536300,MKT
06079930219160000,2019,266625,269675,536300,MKT
06079930219180000,2021,324381,0,324381,COST
06079930219180000,2020,266625,0,266625,COST
06079930219180000,2019,266625,0,266625,COST
06079930219200000,2021,329617,1004320,1333937,COST
06079930219200000,2020,270868,977910,1248778,COST
06079930219200000,2019,270868,977910,1248778,COST
06079930219220000,2021,344802,511690,856492,COST
06079930219220000,2020,283166,410434,693600,MKT
06079930219220000,2019,283166,410434,693600,MKT
06079930222016500,2021,1501,0,1501,COST
06079930222016500,2020,1397,0,1397,COST
06079930222016500,2019,1397,0,1397,COST
06079930222020000,2021,300561,369139,669700,MKT
06079930222020000,2020,238211,323189,561400,MKT
06079930222020000,2019,238211,323189,561400,MKT
06079930222040000,2021,304515,360385,664900,MKT
06079930222040000,2020,241300,311300,552600,MKT
06079930222040000,2019,241300,311300,552600,MKT
06079930222060000,2021,304515,405585,710100,MKT
06079930222060000,2020,241300,324800,566100,MKT
06079930222060000,2019,241300,324800,566100,MKT
06079930222080000,2021,327685,336515,664200,MKT
06079930222080000,2020,259392,311308,570700,MKT
06079930222080000,2019,259392,311308,570700,MKT
06079930222100000,2021,320160,415640,735800,MKT
06079930222100000,2020,253518,440382,693900,MKT
06079930222100000,2019,253518,440382,693900,MKT
06079930222120000,2021,335033,346667,681700,MKT
06079930222120000,2020,265125,321875,587000,MKT
06079930222120000,2019,265125,321875,587000,MKT
06079930222140000,2021,300561,388400,688961,COST
06079930222140000,2020,238211,360689,598900,MKT
06079930222140000,2019,238211,360689,598900,MKT
06079930222160000,2021,274899,647801,922700,MKT
06079930222160000,2020,218148,534452,752600,MKT
06079930222160000,2019,218148,534452,752600,MKT
06079930222180000,2021,304515,1029390,1333905,COST
06079930222180000,2020,241300,1023530,1264830,COST
06079930222180000,2019,241300,1023530,1264830,COST
06079930222200000,2021,308507,622393,930900,MKT
06079930222200000,2020,244419,531481,775900,MKT
06079930222200000,2019,244419,531481,775900,MKT
06079930222220000,2021,327685,468615,796300,MKT
06079930222220000,2020,259392,364508,623900,MKT
06079930222220000,2019,259392,364508,623900,MKT
06079930222240000,2021,312436,562064,874500,MKT
06079930222240000,2020,247487,420713,668200,MKT
06079930222240000,2019,247487,420713,668200,MKT
06079930222260000,2021,279336,0,279336,COST
06079930222260000,2020,221619,0,221619,COST
06079930222260000,2019,221619,0,221619,COST
06079930222280000,2021,279336,494264,773600,MKT
06079930222280000,2020,221619,415581,637200,MKT
06079930222280000,2019,221619,415581,637200,MKT
06079930222300000,2021,279336,400864,680200,MKT
06079930222300000,2020,221619,330381,552000,MKT
06079930222300000,2019,221619,330381,552000,MKT
06079930222320000,2021,296371,394429,690800,MKT
06079930222320000,2020,234938,352562,587500,MKT
06079930222320000,2019,234938,352562,587500,MKT
06079930222340000,2021,292205,487995,780200,MKT
06079930222340000,2020,231682,383618,615300,MKT
06079930222340000,2019,231682,383618,615300,MKT
06079930222360000,2021,300467,515933,816400,MKT
06079930222360000,2020,238138,386362,624500,MKT
06079930222360000,2019,238138,386362,624500,MKT
06079930222380000,2021,287986,562814,850800,MKT
06079930222380000,2020,228383,457717,686100,MKT
06079930222380000,2019,228383,457717,686100,MKT
06079930222400000,2021,300467,433933,734400,MKT
06079930222400000,2020,238138,365962,604100,MKT
06079930222400000,2019,238138,365962,604100,MKT
06079930222420000,2021,300467,521333,821800,MKT
06079930222420000,2020,238138,461462,699600,MKT
06079930222420000,2019,238138,461462,699600,MKT
06079930222440000,2021,300467,451333,751800,MKT
06079930222440000,2020,238138,360462,598600,MKT
06079930222440000,2019,238138,360462,598600,MKT
06079930222460000,2021,304515,713285,1017800,MKT
06079930222460000,2020,241300,573000,814300,MKT
06079930222460000,2019,241300,604800,846100,MKT
06079930222480000,2021,274899,597401,872300,MKT
06079930222480000,2020,218148,470152,688300,MKT
06079930222480000,2019,218148,470152,688300,MKT
06079930222500000,2021,287986,657114,945100,MKT
06079930222500000,2020,228383,569517,797900,MKT
06079930222500000,2019,228383,569517,797900,MKT
06079930222520000,2021,287986,472514,760500,MKT
06079930222520000,2020,228383,418217,646600,MKT
06079930222520000,2019,228383,418217,646600,MKT
06079930222540000,2021,300467,374533,675000,MKT
06079930222540000,2020,238138,323862,562000,MKT
06079930222540000,2019,238138,323862,562000,MKT
06079930224020000,2021,339823,560077,899900,MKT
06079930224020000,2020,279135,422165,701300,MKT
06079930224020000,2019,279135,422165,701300,MKT
06079930224040000,2021,324381,0,324381,COST
06079930224040000,2020,266625,0,266625,COST
06079930224040000,2019,266625,0,266625,COST
06079930224060000,2021,274899,657001,931900,MKT
06079930224060000,2020,266625,508875,775500,MKT
06079930224060000,2019,266625,508875,775500,MKT
06079930224080000,2021,329617,555883,885500,MKT
06079930224080000,2020,270868,489532,760400,MKT
06079930224080000,2019,270868,489532,760400,MKT
06079930224100000,2021,339823,452877,792700,MKT
06079930224100000,2020,279135,372465,651600,MKT
06079930224100000,2019,279135,372465,651600,MKT
06079930224120000,2021,329617,462683,792300,MKT
06079930224120000,2020,270868,362132,633000,MKT
06079930224120000,2019,270868,362132,633000,MKT
06079930224140000,2021,329617,430583,760200,MKT
06079930224140000,2020,270868,342332,613200,MKT
06079930224140000,2019,270868,342332,613200,MKT
06079930224160000,2021,339823,600677,940500,MKT
06079930224160000,2020,279135,496365,775500,MKT
06079930224160000,2019,279135,496365,775500,MKT
06079930224180000,2021,296371,323829,620200,MKT
06079930224180000,2020,234938,288762,523700,MKT
06079930224180000,2019,234938,288762,523700,MKT
06079930224200000,2021,334755,640545,975300,MKT
06079930224200000,2020,275030,557070,832100,MKT
06079930224200000,2019,275030,557070,832100,MKT
06079930224220000,2021,329617,404083,733700,MKT
06079930224220000,2020,270868,321632,592500,MKT
06079930224220000,2019,270868,321632,592500,MKT
06079930224240000,2021,319054,435046,754100,MKT
06079930224240000,2020,262309,349091,611400,MKT
06079930224240000,2019,262309,349091,611400,MKT
06079930224260000,2021,302511,406189,708700,MKT
06079930224260000,2020,248895,334005,582900,MKT
06079930224260000,2019,248895,334005,582900,MKT
06079930224280000,2021,329617,651283,980900,MKT
06079930224280000,2020,270868,498632,769500,OVR
06079930224280000,2019,270868,498632,769500,MKT
06079930224300000,2021,359328,656972,1016300,MKT
06079930224300000,2020,294923,523577,818500,MKT
06079930224300000,2019,294923,523577,818500,MKT
06079930224320000,2021,296371,377529,673900,MKT
06079930224320000,2020,234938,321462,556400,MKT
06079930224320000,2019,234938,321462,556400,MKT
06079930224340000,2021,354552,534210,888762,COST
06079930224340000,2020,291058,419042,710100,MKT
06079930224340000,2019,291058,419042,710100,MKT
06079930224360000,2021,354552,517748,872300,MKT
06079930224360000,2020,291058,427142,718200,MKT
06079930224360000,2019,291058,427142,718200,MKT
06079930224380000,2021,354552,613648,968200,MKT
06079930224380000,2020,291058,447542,738600,MKT
06079930224380000,2019,291058,447542,738600,MKT
06079930224400000,2021,359328,455172,814500,MKT
06079930224400000,2020,294923,340477,635400,MKT
06079930224400000,2019,294923,340477,635400,MKT
06079930230016500,2021,194185,0,194185,COST
06079930230016500,2020,169002,0,169002,COST
06079930230016500,2019,169002,0,169002,COST
06079930301010000,2021,221425,272020,493445,COST
06079930301010000,2020,164191,262550,426741,COST
06079930301010000,2019,164191,262550,426741,COST
06079930301100000,2021,219888,408512,628400,MKT
06079930301100000,2020,162731,366769,529500,MKT
06079930301100000,2019,162731,366769,529500,MKT
06079930301200000,2021,1471,5710,7181,COST
06079930301200000,2020,1369,5510,6879,COST
06079930301200000,2019,1369,5510,6879,COST
06079930301300000,2021,759,0,759,COST
06079930301300000,2020,707,0,707,COST
06079930301300000,2019,707,0,707,COST
06079930301400000,2021,2616,0,2616,COST
06079930301400000,2020,2434,0,2434,COST
06079930301400000,2019,2434,0,2434,COST
06079930301500000,2021,1682,0,1682,COST
06079930301500000,2020,1565,0,1565,COST
06079930301500000,2019,1565,0,1565,COST
06079930401020000,2021,407990,213050,621040,COST
06079930401020000,2020,331027,501130,832157,COST
06079930401020000,2019,331027,549750,880777,COST
06079930401030000,2021,389093,842370,1231463,COST
06079930401030000,2020,313413,806030,1119443,OVR
06079930401030000,2019,313413,806030,1119443,COST
06079930401060000,2021,378808,0,378808,COST
06079930401060000,2020,303882,0,303882,COST
06079930401060000,2019,303882,0,303882,COST
06079930401100000,2021,300000,1536930,1836930,COST
06079930401100000,2020,232232,1228670,1460902,MRA
06079930401100000,2019,232232,1225946,1458178,MRA
06079930401150000,2021,300000,678530,978530,COST
06079930401150000,2020,232232,665030,897262,COST
06079930401150000,2019,232232,665030,897262,COST
06079930402010000,2021,261726,331430,593156,COST
06079930402010000,2020,198420,364580,563000,MKT
06079930402010000,2019,198420,364580,563000,MKT
06079930402020000,2021,264424,363376,627800,MKT
06079930402020000,2020,200781,294819,495600,MKT
06079930402020000,2019,200781,290119,490900,MKT
06079930402030000,2021,261726,315974,577700,MKT
06079930402030000,2020,198420,283380,481800,MKT
06079930402030000,2019,198420,273980,472400,MKT
06079930402040000,2021,274747,709453,984200,MKT
06079930402040000,2020,209844,561756,771600,MKT
06079930402040000,2019,209844,561756,771600,MKT
06079930402050000,2021,269676,275570,545246,COST
06079930402050000,2020,205385,260115,465500,MKT
06079930402050000,2019,205385,260115,465500,MKT
06079930402060000,2021,267074,353326,620400,MKT
06079930402060000,2020,203102,374498,577600,MKT
06079930402060000,2019,203102,374498,577600,MKT
06079930402070000,2021,283232,245968,529200,MKT
06079930402070000,2020,217333,185567,402900,MKT
06079930402070000,2019,217333,185567,402900,MKT
06079930402080000,2021,278442,266958,545400,MKT
06079930402080000,2020,213100,222800,435900,MKT
06079930402080000,2019,213100,222800,435900,MKT
06079930402090000,2021,290152,305060,595212,COST
06079930402090000,2020,223466,300340,523806,COST
06079930402090000,2019,223466,300340,523806,COST
06079930403010000,2021,279653,483047,762700,MKT
06079930403010000,2020,214170,383830,598000,MKT
06079930403010000,2019,214170,383830,598000,MKT
06079930403020000,2021,290152,397448,687600,MKT
06079930403020000,2020,223466,400434,623900,MKT
06079930403020000,2019,223466,400434,623900,MKT
06079930403030000,2021,286730,257190,543920,COST
06079930403030000,2020,220430,263870,484300,MKT
06079930403030000,2019,220430,263870,484300,MKT
06079930403040000,2021,305225,448075,753300,MKT
06079930403040000,2020,236901,369099,606000,MKT
06079930403040000,2019,236901,369099,606000,MKT
06079930403050000,2021,264424,235076,499500,MKT
06079930403050000,2020,200781,228419,429200,MKT
06079930403050000,2019,200781,228419,429200,MKT
06079930404010000,2021,300000,362400,662400,MKT
06079930404010000,2020,232232,302768,535000,MKT
06079930404010000,2019,232232,302768,535000,MKT
06079930405010000,2021,290152,1055830,1345982,COST
06079930405010000,2020,223466,1028400,1251866,COST
06079930405010000,2019,223466,1028400,1251866,COST
06079930405040000,2021,290152,364448,654600,MKT
06079930405040000,2020,223466,352234,575700,MKT
06079930405040000,2019,223466,352234,575700,MKT
06079930405060000,2021,347105,316420,663525,COST
06079930405060000,2020,274754,306330,581084,COST
06079930405060000,2019,274754,306330,581084,COST
06079930405080000,2021,347105,534670,881775,COST
06079930405080000,2020,274754,512760,787514,COST
06079930405080000,2019,274754,512760,787514,COST
06079930405120000,2021,319995,289105,609100,MKT
06079930405120000,2020,250166,212634,462800,MKT
06079930405120000,2019,250166,212634,462800,MKT
06079930405140000,2021,320936,377780,698716,COST
06079930405140000,2020,251014,330086,581100,MKT
06079930405140000,2019,251014,330086,581100,MKT
06079930405150000,2021,250385,489415,739800,MKT
06079930405150000,2020,188542,478250,666792,COST
06079930405150000,2019,188542,478250,666792,COST
06079930405160000,2021,250385,0,250385,COST
06079930405160000,2020,188542,0,188542,COST
06079930405160000,2019,188542,0,188542,COST
06079930406010000,2021,301058,343642,644700,MKT
06079930406010000,2020,233177,246923,480100,MKT
06079930406010000,2019,233177,246923,480100,MKT
06079930406020000,2021,303155,502745,805900,MKT
06079930406020000,2020,235050,534850,769900,MKT
06079930406020000,2019,235050,534850,769900,MKT
06079930406030000,2021,302110,279690,581800,MKT
06079930406030000,2020,234116,215084,449200,MKT
06079930406030000,2019,234116,215084,449200,MKT
06079930406040000,2021,303155,297045,600200,MKT
06079930406040000,2020,235050,213150,448200,MKT
06079930406040000,2019,235050,213150,448200,MKT
06079930406050000,2021,300000,300000,600000,MKT
06079930406050000,2020,232232,242668,474900,MKT
06079930406050000,2019,232232,242668,474900,MKT
06079930406060000,2021,300000,285120,585120,COST
06079930406060000,2020,232232,341268,573500,MKT
06079930406060000,2019,232232,341268,573500,MKT
06079930407010000,2021,300000,413230,713230,COST
06079930407010000,2020,232232,403720,635952,COST
06079930407010000,2019,232232,403720,635952,COST
06079930407020000,2021,300000,355860,655860,COST
06079930407020000,2020,232232,326068,558300,MKT
06079930407020000,2019,232232,326068,558300,MKT
06079930407030000,2021,300000,514600,814600,MKT
06079930407030000,2020,232232,513368,745600,MKT
06079930407030000,2019,232232,442990,675222,COST
06079930407040000,2021,336000,375270,711270,COST
06079930407040000,2020,259840,359150,618990,COST
06079930407040000,2019,259840,359150,618990,COST
06079930407050000,2021,336000,344450,680450,COST
06079930407050000,2020,259840,338260,598100,COST
06079930407050000,2019,259840,338260,598100,COST
06079930407060000,2021,336000,300900,636900,MKT
06079930407060000,2020,259840,248460,508300,MKT
06079930407060000,2019,259840,248460,508300,MKT
06079930407070000,2021,336000,263500,599500,MKT
06079930407070000,2020,259840,200060,459900,MKT
06079930407070000,2019,259840,200060,459900,MKT
06079930407080000,2021,336000,419520,755520,COST
06079930407080000,2020,259840,412760,672600,COST
06079930407080000,2019,259840,268450,528290,COST
06079930407090000,2021,336000,241200,577200,MKT
06079930407090000,2020,259840,189960,449800,MKT
06079930407090000,2019,259840,196260,456100,MKT
06079930408010000,2021,388762,2657410,3046172,COST
06079930408010000,2020,313106,2543410,2856516,COST
06079930408010000,2019,313106,2543410,2856516,COST
06079930408050000,2021,314239,555580,869819,COST
06079930408050000,2020,244985,520215,765200,MKT
06079930408050000,2019,244985,520215,765200,MKT
06079930408070000,2021,307270,623330,930600,MKT
06079930408070000,2020,238732,610568,849300,MKT
06079930408070000,2019,238732,610568,849300,MKT
06079930408090000,2021,300000,533280,833280,COST
06079930408090000,2020,232232,489568,721800,MKT
06079930408090000,2019,232232,489568,721800,MKT
06079930408110000,2021,300000,259400,559400,MKT
06079930408110000,2020,232232,234568,466800,MKT
06079930408110000,2019,232232,234568,466800,MKT
06079930408150000,2021,300000,322000,622000,MKT
06079930408150000,2020,232232,323368,555600,MKT
06079930408150000,2019,232232,323368,555600,MKT
06079930408250000,2021,300000,285130,585130,COST
06079930408250000,2020,232232,280540,512772,COST
06079930408250000,2019,232232,280540,512772,COST
06079930408270000,2021,304193,407107,711300,MKT
06079930408270000,2020,235978,340722,576700,MKT
06079930408270000,2019,235978,340722,576700,MKT
06079930409030000,2021,256826,494850,751676,COST
06079930409030000,2020,190619,416381,607000,OVR
06079930409030000,2019,190619,416381,607000,MKT
06079930409090000,2021,291165,643235,934400,MKT
06079930409090000,2020,224365,597360,821725,MRA
06079930409090000,2019,224365,597360,821725,MRA
06079930409206500,2021,155197,0,155197,COST
06079930409206500,2020,130521,0,130521,COST
06079930409206500,2019,130521,0,130521,COST
06079930409226500,2021,204376,0,204376,COST
06079930409226500,2020,179268,0,179268,COST
06079930409226500,2019,179268,0,179268,COST
06079930410010000,2021,227914,371486,599400,MKT
06079930410010000,2020,169172,332928,502100,MKT
06079930410010000,2019,169172,332928,502100,MKT
06079930410030000,2021,291277,346923,638200,MKT
06079930410030000,2020,224464,286436,510900,MKT
06079930410030000,2019,224464,286436,510900,MKT
06079930410040000,2021,227914,280786,508700,MKT
06079930410040000,2020,169172,261128,430300,MKT
06079930410040000,2019,169172,261128,430300,MKT
06079930410070000,2021,297863,429037,726900,MKT
06079930410070000,2020,230326,367974,598300,MKT
06079930410070000,2019,230326,367974,598300,MKT
06079930410090000,2021,233067,289433,522500,MKT
06079930410090000,2020,173589,255811,429400,MKT
06079930410090000,2019,173589,255811,429400,MKT
06079930410120000,2021,297863,514660,812523,COST
06079930410120000,2020,230326,499920,730246,COST
06079930410120000,2019,230326,499920,730246,COST
06079930415010000,2021,301269,385370,686639,COST
06079930415010000,2020,233365,383635,617000,MKT
06079930415010000,2019,233365,383635,617000,MKT
06079930415020000,2021,300000,514000,814000,MKT
06079930415020000,2020,232232,492468,724700,MKT
06079930415020000,2019,232232,492468,724700,MKT
06079930415030000,2021,300530,416070,716600,MKT
06079930415030000,2020,232705,409495,642200,MKT
06079930415030000,2019,232705,409495,642200,MKT
06079930415040000,2021,336119,941381,1277500,MKT
06079930415040000,2020,259946,779954,1039900,MKT
06079930415040000,2019,259946,779954,1039900,MKT
06079930415050000,2021,336119,382520,718639,COST
06079930415050000,2020,259946,356954,616900,MKT
06079930415050000,2019,259946,356954,616900,MKT
06079930415060000,2021,336119,311390,647509,COST
06079930415060000,2020,259946,319754,579700,MKT
06079930415060000,2019,259946,319754,579700,MKT
06079930415070000,2021,336475,801170,1137645,COST
06079930415070000,2020,260264,616336,876600,MKT
06079930415070000,2019,260264,635236,895500,MKT
06079930415080000,2021,336475,443940,780415,COST
06079930415080000,2020,260264,426640,686904,COST
06079930415080000,2019,260264,426640,686904,COST
06079930415090000,2021,345051,344149,689200,MKT
06079930415090000,2020,267926,278874,546800,MKT
06079930415090000,2019,267926,278874,546800,MKT
06079930415100000,2021,346967,325760,672727,COST
06079930415100000,2020,269642,347458,617100,MKT
06079930415100000,2019,269642,347458,617100,MKT
06079930415110000,2021,351948,978630,1330578,COST
06079930415110000,2020,274109,858125,1132234,OVR
06079930415110000,2019,274109,858125,1132234,MRA
06079930415120000,2021,311088,0,311088,COST
06079930415120000,2020,242155,0,242155,COST
06079930415120000,2019,242155,0,242155,COST
06079930415130000,2021,301269,377031,678300,MKT
06079930415130000,2020,233365,407535,640900,MKT
06079930415130000,2019,233365,407535,640900,MKT
06079930415140000,2021,301269,511890,813159,COST
06079930415140000,2020,233365,471535,704900,MKT
06079930415140000,2019,233365,471535,704900,MKT
06079930420010000,2021,439089,650490,1089579,COST
06079930420010000,2020,353741,628060,981801,COST
06079930420010000,2019,353741,628060,981801,COST
06079930420030000,2021,336000,954220,1290220,COST
06079930420030000,2020,259840,836963,1096803,MRA
06079930420030000,2019,259840,836963,1096803,MRA
06079930420040000,2021,372175,787130,1159305,COST
06079930420040000,2020,292350,663420,955770,COST
06079930420040000,2019,292350,663420,955770,COST
06079930425010000,2021,305328,281820,587148,COST
06079930425010000,2020,236993,256007,493000,MKT
06079930425010000,2019,236993,256007,493000,MKT
06079930425020000,2021,306046,290054,596100,MKT
06079930425020000,2020,237636,229164,466800,MKT
06079930425020000,2019,237636,229164,466800,MKT
06079930425030000,2021,313162,347138,660300,MKT
06079930425030000,2020,244018,278582,522600,OVR
06079930425030000,2019,244018,278582,522600,MKT
06079930425040000,2021,303259,322180,625439,COST
06079930425040000,2020,235143,286557,521700,MKT
06079930425040000,2019,235143,286557,521700,MKT
06079930425050000,2021,300318,514970,815288,COST
06079930425050000,2020,232516,507040,739556,COST
06079930425050000,2019,232516,507040,739556,COST
06079930425060000,2021,387701,446390,834091,COST
06079930425060000,2020,312121,423950,736071,COST
06079930425060000,2019,312121,423950,736071,COST
06079930425070000,2021,300742,417480,718222,COST
06079930425070000,2020,232894,374206,607100,MKT
06079930425070000,2019,232894,374206,607100,MKT
06079930425080000,2021,336000,325200,661200,MKT
06079930425080000,2020,259840,273660,533500,MKT
06079930425080000,2019,259840,273660,533500,MKT
06079930430010000,2021,300742,678658,979400,MKT
06079930430010000,2020,232894,672500,905394,COST
06079930430010000,2019,232894,672500,905394,COST
06079930430020000,2021,353471,0,353471,COST
06079930430020000,2020,275477,0,275477,COST
06079930430020000,2019,275477,0,275477,COST
06079930430030000,2021,336238,584710,920948,COST
06079930430030000,2020,260052,542048,802100,MKT
06079930430030000,2019,260052,542048,802100,MKT
06079930430040000,2021,336000,669047,1005047,MRA
06079930430040000,2020,259840,585460,845300,MKT
06079930430040000,2019,259840,585460,845300,MKT
06079930430050000,2021,336238,872762,1209000,MKT
06079930430050000,2020,260052,733220,993272,COST
06079930430050000,2019,260052,733220,993272,COST
06079930430060000,2021,336475,627340,963815,COST
06079930430060000,2020,260264,507736,768000,MKT
06079930430060000,2019,260264,507736,768000,MKT
06079930430070000,2021,337067,1040110,1377177,COST
06079930430070000,2020,260792,1013770,1274562,COST
06079930430070000,2019,260792,788090,1048882,COST
06079930430080000,2021,372569,561720,934289,COST
06079930430080000,2020,292707,555970,848677,COST
06079930430080000,2019,292707,555970,848677,COST
06079930430090000,2021,300212,554688,854900,MKT
06079930430090000,2020,232421,538370,770791,COST
06079930430090000,2019,232421,525530,757951,COST
06079930430100000,2021,301900,607590,909490,COST
06079930430100000,2020,233929,603590,837519,COST
06079930430100000,2019,233929,603590,837519,COST
06079930430110000,2021,300106,646450,946556,COST
06079930430110000,2020,232327,628570,860897,COST
06079930430110000,2019,232327,628570,860897,COST
06079930435010000,2021,300742,590358,891100,MKT
06079930435010000,2020,232894,556506,789400,MKT
06079930435010000,2019,232894,556506,789400,MKT
06079930435020000,2021,300212,537488,837700,MKT
06079930435020000,2020,232421,562579,795000,MKT
06079930435020000,2019,232421,562579,795000,MKT
06079930435030000,2021,300847,803150,1103997,COST
06079930435030000,2020,232988,779740,1012728,COST
06079930435030000,2019,232988,779740,1012728,COST
06079930435040000,2021,300424,832630,1133054,COST
06079930435040000,2020,232611,828620,1061231,COST
06079930435040000,2019,232611,828620,1061231,COST
06079930435050000,2021,300424,805310,1105734,COST
06079930435050000,2020,232611,789210,1021821,COST
06079930435050000,2019,232611,789210,1021821,COST
06079930435060000,2021,300106,525494,825600,MKT
06079930435060000,2020,232327,461973,694300,MKT
06079930435060000,2019,232327,461973,694300,MKT
06079930435070000,2021,300000,1081790,1381790,COST
06079930435070000,2020,232232,1043790,1276022,COST
06079930435070000,2019,232232,1043790,1276022,COST
06079930435080000,2021,300318,1391610,1691928,COST
06079930435080000,2020,232516,1340480,1572996,COST
06079930435080000,2019,232516,1340480,1572996,COST
06079930435090000,2021,300000,1555510,1855510,COST
06079930435090000,2020,232232,1258838,1491070,MRA
06079930435090000,2019,232232,1258838,1491070,MRA
06079930435100000,2021,300212,924000,1224212,COST
06079930435100000,2020,232421,912770,1145191,COST
06079930435100000,2019,232421,912770,1145191,COST
06079930440010000,2021,300000,826590,1126590,COST
06079930440010000,2020,232232,795790,1028022,COST
06079930440010000,2019,232232,795790,1028022,COST
06079930440050000,2021,383471,976870,1360341,COST
06079930440050000,2020,308199,960930,1269129,COST
06079930440050000,2019,308199,960930,1269129,COST
06079930440150000,2021,300000,566250,866250,COST
06079930440150000,2020,232232,457368,689600,MKT
06079930440150000,2019,232232,457368,689600,MKT
06079930440200000,2021,300318,413982,714300,MKT
06079930440200000,2020,232516,412184,644700,MKT
06079930440200000,2019,232516,412184,644700,MKT
06079930440250000,2021,313162,686990,1000152,COST
06079930440250000,2020,244018,671030,915048,COST
06079930440250000,2019,244018,671030,915048,COST
06079930440300000,2021,366518,420560,787078,COST
06079930440300000,2020,292544,411760,704304,COST
06079930440300000,2019,292544,411760,704304,COST
06079930440350000,2021,300000,358620,658620,COST
06079930440350000,2020,232232,367968,600200,MKT
06079930440350000,2019,232232,367968,600200,MKT
06079930445010000,2021,383945,609840,993785,COST
06079930445010000,2020,308638,580320,888958,COST
06079930445010000,2019,308638,580320,888958,COST
06079930445050000,2021,324192,817320,1141512,COST
06079930445050000,2020,253952,606848,860800,MKT
06079930445050000,2019,253952,606848,860800,MKT
06079930445070000,2021,335183,641150,976333,COST
06079930445070000,2020,263904,545896,809800,MKT
06079930445070000,2019,263904,545896,809800,MKT
06079930445090000,2021,324560,638710,963270,COST
06079930445090000,2020,254284,630650,884934,COST
06079930445090000,2019,254284,630650,884934,COST
06079930445120000,2021,315793,692920,1008713,COST
06079930445120000,2020,246382,686720,933102,COST
06079930445120000,2019,246382,686720,933102,COST
06079930445150000,2021,306659,480841,787500,MKT
06079930445150000,2020,238185,511015,749200,MKT
06079930445150000,2019,238185,511015,749200,MKT
06079930445200000,2021,304193,859807,1164000,MKT
06079930445200000,2020,235978,694110,930088,COST
06079930445200000,2019,235978,723380,959358,COST
06079930445250000,2021,308888,537600,846488,COST
06079930445250000,2020,240182,531318,771500,MKT
06079930445250000,2019,240182,531318,771500,MKT
06079931101010000,2021,99248,214410,313658,COST
06079931101010000,2020,113689,208040,321729,COST
06079931101010000,2019,113689,208040,321729,COST
06079931101020000,2021,9648,3395500,3405148,COST
06079931101020000,2020,9371,3276600,3285971,COST
06079931101020000,2019,9371,3276600,3285971,COST
06079931180010000,2021,323547,2544170,2867717,COST
06079931180010000,2020,290321,1785940,2076261,COST
06079931180010000,2019,290321,1785940,2076261,COST
06079931182010000,2021,323717,1117340,1441057,COST
06079931182010000,2020,290479,1101200,1391679,COST
06079931182010000,2019,290479,1101200,1391679,COST
06079931182100000,2021,323909,8171720,8495629,COST
06079931182100000,2020,290657,7909720,8200377,COST
06079931182100000,2019,290657,7909720,8200377,COST
06079931182150000,2021,1107,0,1107,COST
06079931182150000,2020,1030,0,1030,COST
06079931182150000,2019,1030,0,1030,COST
06079931182300000,2021,1107,0,1107,COST
06079931182300000,2020,1030,0,1030,COST
06079931182300000,2019,1030,0,1030,COST
06079931182450000,2021,14970,1110140,1125110,COST
06079931182450000,2020,18623,1058950,1077573,COST
06079931182450000,2019,18623,1103160,1121783,COST
06079931182600000,2021,1107,0,1107,COST
06079931182600000,2020,1030,0,1030,COST
06079931182600000,2019,1030,0,1030,COST
06079931182750000,2021,323717,4045360,4369077,COST
06079931182750000,2020,290479,3941680,4232159,OVR
06079931182750000,2019,290479,3941680,4232159,COST
06079931201010000,2021,12697,647750,660447,COST
06079931201010000,2020,12199,627040,639239,COST
06079931201010000,2019,12199,627040,639239,COST
06079931301100000,2021,1674,0,1674,COST
06079931301100000,2020,1558,0,1558,COST
06079931301100000,2019,1558,0,1558,COST
06079931301200000,2021,45552,0,45552,COST
06079931301200000,2020,51677,0,51677,COST
06079931301200000,2019,51677,0,51677,COST
06079931301300000,2021,558,0,558,COST
06079931301300000,2020,519,0,519,COST
06079931301300000,2019,519,0,519,COST
06079931301400000,2021,9626,2970,12596,COST
06079931301400000,2020,8941,2870,11811,COST
06079931301400000,2019,8941,2870,11811,COST
06079931301450000,2021,558,0,558,COST
06079931301450000,2020,519,0,519,COST
06079931301450000,2019,519,0,519,COST
06079931301500000,2021,8712,0,8712,COST
06079931301500000,2020,8089,0,8089,COST
06079931301500000,2019,8089,0,8089,COST
06079932101020000,2021,1363,0,1363,COST
06079932101020000,2020,1269,0,1269,COST
06079932101020000,2019,1269,0,1269,COST
06079932101120000,2021,323903,1454260,1778163,COST
06079932101120000,2020,290652,1420770,1711422,COST
06079932101120000,2019,290652,1420770,1711422,COST
06079932101220000,2021,323791,1288490,1612281,COST
06079932101220000,2020,290548,1264130,1554678,COST
06079932101220000,2019,290548,1172230,1462778,COST
06079932101320000,2021,1182,3790,4972,COST
06079932101320000,2020,1100,3680,4780,COST
06079932101320000,2019,1100,3680,4780,COST
06079932118010000,2021,1112,0,1112,COST
06079932118010000,2020,1035,0,1035,COST
06079932118010000,2019,1035,0,1035,COST
06079932142010000,2021,752663,1115330,1867993,COST
06079932142010000,2020,573716,1106840,1680556,COST
06079932142010000,2019,573716,1106840,1680556,COST
06079932142150000,2021,752663,1002390,1755053,COST
06079932142150000,2020,573716,979330,1553046,COST
06079932142150000,2019,573716,714440,1288156,COST
06079932190010000,2021,728950,478230,1207180,COST
06079932190010000,2020,548421,467370,1015791,COST
06079932190010000,2019,548421,467370,1015791,COST
06079932190050000,2021,728925,937610,1666535,COST
06079932190050000,2020,548394,919440,1467834,COST
06079932190050000,2019,548394,919440,1467834,COST
06079932201010000,2021,1107,970,2077,COST
06079932201010000,2020,1030,930,1960,COST
06079932201010000,2019,1030,930,1960,COST
06079932201100000,2021,323735,2772070,3095805,COST
06079932201100000,2020,290496,2209504,2500000,OVR
06079932201100000,2019,290496,2209504,2500000,OVR
06079932201200000,2021,323878,2256130,2580008,COST
06079932201200000,2020,290629,2018290,2308919,OVR
06079932201200000,2019,290629,2018290,2308919,COST
06079932201300000,2021,323753,1865420,2189173,COST
06079932201300000,2020,290512,1815380,2105892,COST
06079932201300000,2019,290512,1815380,2105892,COST
06079932201400000,2021,1130,0,1130,COST
06079932201400000,2020,1051,0,1051,COST
06079932201400000,2019,1051,0,1051,COST
06079932201500000,2021,323898,1799290,2123188,COST
06079932201500000,2020,290648,1743580,2034228,COST
06079932201500000,2019,290648,1743580,2034228,COST
06079932201600000,2021,323717,925410,1249127,COST
06079932201600000,2020,290479,910360,1200839,COST
06079932201600000,2019,290479,910360,1200839,COST
06079932201700000,2021,8483,1167970,1176453,COST
06079932201700000,2020,290510,1138330,1428840,COST
06079932201700000,2019,290510,1138330,1428840,COST
06079932301010000,2021,1486,0,1486,COST
06079932301010000,2020,1382,0,1382,COST
06079932301010000,2019,1382,0,1382,COST
06079932301220000,2021,322665,0,322665,COST
06079932301220000,2020,277500,0,277500,COST
06079932301220000,2019,277500,0,277500,COST
06079932301240000,2021,322665,688235,1010900,MKT
06079932301240000,2020,277500,608510,886010,COST
06079932301240000,2019,277500,608510,886010,COST
06079932301260000,2021,450947,295053,746000,MKT
06079932301260000,2020,444668,286850,731518,COST
06079932301260000,2019,444668,286850,731518,COST
06079932301280000,2021,372540,509910,882450,COST
06079932301280000,2020,339773,509120,848893,COST
06079932301280000,2019,339773,509120,848893,COST
06079932301300000,2021,322665,660310,982975,COST
06079932301300000,2020,277500,655750,933250,COST
06079932301300000,2019,277500,655750,933250,COST
06079932301320000,2021,531592,738890,1270482,COST
06079932301320000,2020,560639,712120,1272759,COST
06079932301320000,2019,560639,712120,1272759,COST
06079932301400000,2021,1107,0,1107,COST
06079932301400000,2020,1030,0,1030,COST
06079932301400000,2019,1030,0,1030,COST
06079932302010000,2021,403438,654800,1058238,COST
06079932302010000,2020,396567,629910,1026477,COST
06079932302010000,2019,396567,629910,1026477,COST
06079932302016500,2021,708139,0,708139,COST
06079932302016500,2020,741507,0,741507,COST
06079932302016500,2019,14224,0,14224,COST
06079932302030000,2021,412369,952120,1364489,COST
06079932302030000,2020,408989,926070,1335059,COST
06079932302030000,2019,408989,926070,1335059,COST
06079932302070000,2021,322665,0,322665,COST
06079932302070000,2020,289500,0,289500,COST
06079932302070000,2019,289500,0,289500,COST
06079932302090000,2021,322665,502190,824855,COST
06079932302090000,2020,289500,487590,777090,COST
06079932302090000,2019,289500,487590,777090,COST
06079932302110000,2021,322665,949860,1272525,COST
06079932302110000,2020,289500,932480,1221980,COST
06079932302110000,2019,289500,932480,1221980,COST
06079932302130000,2021,322665,349235,671900,MKT
06079932302130000,2020,289500,329370,618870,COST
06079932302130000,2019,289500,329370,618870,COST
06079932302150000,2021,322665,816910,1139575,COST
06079932302150000,2020,289500,812840,1102340,COST
06079932302150000,2019,289500,812840,1102340,COST
06079932302170000,2021,322665,720310,1042975,COST
06079932302170000,2020,289500,0,289500,COST
06079932302170000,2019,289500,0,289500,COST
06079932302190000,2021,322665,0,322665,COST
06079932302190000,2020,289500,0,289500,COST
06079932302190000,2019,289500,0,289500,COST
06079932305010000,2021,322665,1311570,1634235,COST
06079932305010000,2020,289500,1256130,1545630,COST
06079932305010000,2019,289500,1256130,1545630,COST
06079932305040000,2021,322665,590160,912825,COST
06079932305040000,2020,289500,576620,866120,COST
06079932305040000,2019,289500,576620,866120,COST
06079932305070000,2021,322665,911835,1234500,MKT
06079932305070000,2020,289500,525770,815270,OVR
06079932305070000,2019,289500,525770,815270,OVR
06079932305100000,2021,322665,604400,927065,COST
06079932305100000,2020,289500,582670,872170,COST
06079932305100000,2019,289500,582670,872170,COST
06079932401010000,2021,379364,707936,1087300,MKT
06079932401010000,2020,363646,616420,980066,COST
06079932401010000,2019,363646,616420,980066,COST
06079932401040000,2021,376799,517090,893889,COST
06079932401040000,2020,360188,504730,864918,COST
06079932401040000,2019,360188,504730,864918,COST
06079932401070000,2021,385229,743570,1128799,COST
06079932401070000,2020,371590,656610,1028200,COST
06079932401070000,2019,371590,656610,1028200,COST
06079932401100000,2021,396494,572390,968884,COST
06079932401100000,2020,386986,558370,945356,COST
06079932401100000,2019,386986,558370,945356,COST
06079932401130000,2021,423755,432750,856505,COST
06079932401130000,2020,424985,415550,840535,COST
06079932401130000,2019,424985,415550,840535,COST
06079932403010000,2021,406455,790760,1197215,COST
06079932403010000,2020,400751,779830,1180581,COST
06079932403010000,2019,400751,779830,1180581,COST
06079932403030000,2021,404951,1170100,1575051,COST
06079932403030000,2020,398664,1156170,1554834,COST
06079932403030000,2019,398664,1156170,1554834,COST
06079932403050000,2021,410170,0,410170,COST
06079932403050000,2020,405920,0,405920,COST
06079932403050000,2019,405920,0,405920,COST
06079932403070000,2021,414548,759360,1173908,COST
06079932403070000,2020,412036,808410,1220446,OVR
06079932403070000,2019,412036,808410,1220446,COST
06079932403090000,2021,517532,2301300,2818832,COST
06079932403090000,2020,563210,2252820,2816030,COST
06079932403090000,2019,563210,2252820,2816030,COST
06079932403130000,2021,322665,1505460,1828125,COST
06079932403130000,2020,289500,1476050,1765550,COST
06079932403130000,2019,289500,1476050,1765550,COST
06079932403150000,2021,322665,694080,1016745,COST
06079932403150000,2020,289500,679340,968840,COST
06079932403150000,2019,289500,679340,968840,COST
06079932403170000,2021,322665,0,322665,COST
06079932403170000,2020,289500,0,289500,COST
06079932403170000,2019,289500,0,289500,COST
06079932403190000,2021,322665,1077520,1400185,COST
06079932403190000,2020,289500,1056330,1345830,COST
06079932403190000,2019,289500,1056330,1345830,COST
06079932403210000,2021,322665,2723090,3045755,COST
06079932403210000,2020,289500,2605200,2894700,COST
06079932403210000,2019,289500,2605200,2894700,COST
06079932403230000,2021,322665,900070,1222735,COST
06079932403230000,2020,289500,0,289500,COST
06079932403230000,2019,289500,0,289500,COST
06079932403250000,2021,322665,935535,1258200,MKT
06079932403250000,2020,289500,769100,1058600,MKT
06079932403250000,2019,289500,739600,1029100,MKT
06079932405010000,2021,435931,835830,1271761,COST
06079932405010000,2020,442285,816870,1259155,COST
06079932405010000,2019,442285,816870,1259155,COST
06079932405040000,2021,463339,991870,1455209,COST
06079932405040000,2020,481953,966260,1448213,COST
06079932405040000,2019,481953,966260,1448213,COST
06079932405070000,2021,450637,574860,1025497,COST
06079932405070000,2020,463447,473990,937437,COST
06079932405070000,2019,463447,473990,937437,COST
06079932405100000,2021,437246,1106340,1543586,COST
06079932405100000,2020,444166,1091900,1536066,COST
06079932405100000,2019,444166,1027110,1471276,COST
06079932407010000,2021,409432,1156868,1566300,MKT
06079932407010000,2020,404891,1093580,1498471,COST
06079932407010000,2019,404891,1093580,1498471,COST
06079932407040000,2021,381898,694890,1076788,COST
06079932407040000,2020,367072,678330,1045402,COST
06079932407040000,2019,367072,678330,1045402,COST
06079932407070000,2021,424448,1713530,2137978,COST
06079932407070000,2020,425965,1225762,1651727,MRA
06079932407070000,2019,425965,1225762,1651727,MRA
06079932407100000,2021,510702,0,510702,COST
06079932407100000,2020,552769,0,552769,COST
06079932407100000,2019,552769,0,552769,COST
06079932407130000,2021,416706,1348320,1765026,COST
06079932407130000,2020,415060,1308470,1723530,COST
06079932407130000,2019,415060,1429100,1844160,COST
06079932407160000,2021,441792,1071820,1513612,COST
06079932407160000,2020,450685,800643,1251328,MRA
06079932407160000,2019,450685,1027180,1477865,COST
06079932409010000,2021,504208,630560,1134768,COST
06079932409010000,2020,542893,619940,1162833,COST
06079932409010000,2019,542893,619940,1162833,COST
06079932409030000,2021,448143,1383610,1831753,COST
06079932409030000,2020,459837,1461390,1921227,OVR
06079932409030000,2019,459837,1461390,1921227,COST
06079932409050000,2021,418843,1810710,2229553,COST
06079932409050000,2020,418063,1153137,1571200,OVR
06079932409050000,2019,418063,1153137,1571200,OVR
06079932409070000,2021,427201,1707100,2134301,COST
06079932409070000,2020,429861,1658890,2088751,COST
06079932409070000,2019,429861,1658890,2088751,COST
06079932409090000,2021,455553,0,455553,COST
06079932409090000,2020,470583,0,470583,COST
06079932409090000,2019,470583,0,470583,COST
06079932409110000,2021,452492,1160480,1612972,COST
06079932409110000,2020,466136,793614,1259750,OVR
06079932409110000,2019,466136,793614,1259750,OVR
06079932409130000,2021,443076,862140,1305216,COST
06079932409130000,2020,452531,845510,1298041,COST
06079932409130000,2019,452531,845510,1298041,COST
06079932409150000,2021,397276,795510,1192786,COST
06079932409150000,2020,388063,866500,1254563,COST
06079932409150000,2019,388063,866500,1254563,COST
06079932409170000,2021,322665,640470,963135,COST
06079932409170000,2020,289500,630950,920450,COST
06079932409170000,2019,289500,630950,920450,COST
06079932409190000,2021,322665,936935,1259600,MKT
06079932409190000,2020,289500,692640,982140,COST
06079932409190000,2019,289500,692640,982140,COST
06079932409210000,2021,322665,0,322665,COST
06079932409210000,2020,289500,0,289500,COST
06079932409210000,2019,289500,0,289500,COST
06079932409230000,2021,322665,523840,846505,COST
06079932409230000,2020,289500,514010,803510,COST
06079932409230000,2019,289500,514010,803510,COST
06079932409250000,2021,322665,2196590,2519255,COST
06079932409250000,2020,289500,2134210,2423710,COST
06079932409250000,2019,289500,2134210,2423710,COST
06079932409266500,2021,270484,0,270484,COST
06079932409266500,2020,368906,0,368906,COST
06079932409266500,2019,368906,0,368906,COST
06079932409270000,2021,322665,1158730,1481395,COST
06079932409270000,2020,289500,1124060,1413560,COST
06079932409270000,2019,289500,1124060,1413560,COST
06079932409290000,2021,322665,1465400,1788065,COST
06079932409290000,2020,289500,1411690,1701190,COST
06079932409290000,2019,289500,1411690,1701190,COST
06079932409310000,2021,322665,1731480,2054145,COST
06079932409310000,2020,289500,1656280,1945780,COST
06079932409310000,2019,289500,1656280,1945780,COST
06079932409330000,2021,442435,803270,1245705,COST
06079932409330000,2020,451609,788740,1240349,COST
06079932409330000,2019,451609,788740,1240349,COST
06079932409350000,2021,426516,1785030,2211546,COST
06079932409350000,2020,428890,1725180,2154070,COST
06079932409350000,2019,428890,1725180,2154070,COST
06079932409370000,2021,468015,896130,1364145,COST
06079932409370000,2020,488818,881470,1370288,COST
06079932409370000,2019,488818,881470,1370288,COST
06079932409390000,2021,429922,1372560,1802482,COST
06079932409390000,2020,433722,1334540,1768262,COST
06079932409390000,2019,433722,1334540,1768262,COST
06079932409410000,2021,407203,1617960,2025163,COST
06079932409410000,2020,401790,1585690,1987480,COST
06079932409410000,2019,401790,1585690,1987480,COST
06079932409430000,2021,402677,1136390,1539067,COST
06079932409430000,2020,395514,1103600,1499114,COST
06079932409430000,2019,395514,1103600,1499114,COST
06079932409450000,2021,409432,1168490,1577922,COST
06079932409450000,2020,404891,1137170,1542061,COST
06079932409450000,2019,404891,1137170,1542061,COST
06079932411010000,2021,440502,693490,1133992,COST
06079932411010000,2020,448832,0,448832,COST
06079932411010000,2019,448832,0,448832,COST
06079932411040000,2021,470321,2472390,2942711,COST
06079932411040000,2020,492214,2501810,2994024,COST
06079932411040000,2019,492214,2501810,2994024,COST
06079932411070000,2021,483198,1650490,2133688,COST
06079932411070000,2020,511302,1614770,2126072,COST
06079932411070000,2019,511302,1614770,2126072,COST
06079932411100000,2021,467435,0,467435,COST
06079932411100000,2020,487965,0,487965,COST
06079932411100000,2019,487965,0,487965,COST
06079932411156500,2021,178570,0,178570,COST
06079932411156500,2020,205541,0,205541,COST
06079932411156500,2019,205541,0,205541,COST
06079933101080000,2021,220552,361010,581562,COST
06079933101080000,2020,150979,409440,560419,COST
06079933101080000,2019,150979,409440,560419,COST
06079933101090000,2021,1107,0,1107,COST
06079933101090000,2020,1031,0,1031,COST
06079933101090000,2019,1031,0,1031,COST
06079933101100000,2021,220552,1289400,1509952,COST
06079933101100000,2020,150979,63000,213979,COST
06079933101100000,2019,1030,0,1030,COST
06079933101110000,2021,1107,0,1107,COST
06079933101110000,2020,1030,0,1030,COST
06079933101110000,2019,1030,0,1030,COST
06079933101120000,2021,220552,691320,911872,COST
06079933101120000,2020,150979,689280,840259,COST
06079933101120000,2019,150979,689280,840259,COST
06079933101171001,2021,887,0,887,COST
06079933101171001,2020,826,0,826,COST
06079933101171001,2019,826,0,826,COST
06079933101171002,2021,220,0,220,COST
06079933101171002,2020,204,0,204,COST
06079933101171002,2019,204,0,204,COST
06079933101191001,2021,219570,1289630,1509200,COST
06079933101191001,2020,150065,1251120,1401185,COST
06079933101191001,2019,150065,1251120,1401185,COST
06079933101191002,2021,981,0,981,COST
06079933101191002,2020,913,0,913,COST
06079933101191002,2019,913,0,913,COST
06079933101201001,2021,1031,0,1031,COST
06079933101201001,2020,960,0,960,COST
06079933101201001,2019,960,0,960,COST
06079933101201002,2021,219520,1484190,1703710,COST
06079933101201002,2020,150019,1203060,1353079,COST
06079933101201002,2019,150019,1203060,1353079,COST
06079933101211001,2021,55,0,55,COST
06079933101211001,2020,52,0,52,COST
06079933101211001,2019,52,0,52,COST
06079933101211002,2021,220496,2277950,2498446,COST
06079933101211002,2020,150927,2196110,2347037,COST
06079933101211002,2019,150927,2196110,2347037,COST
06079933101851001,2021,219778,408370,628148,COST
06079933101851001,2020,150259,399900,550159,COST
06079933101851001,2019,150259,399900,550159,COST
06079933101851002,2021,774,0,774,COST
06079933101851002,2020,720,0,720,COST
06079933101851002,2019,720,0,720,COST
06079933201010000,2021,220553,2167990,2388543,COST
06079933201010000,2020,150980,2514000,2664980,COST
06079933201010000,2019,150980,2514000,2664980,COST
06079933201020000,2021,220552,2282960,2503512,COST
06079933201020000,2020,150979,2200910,2351889,COST
06079933201020000,2019,150979,2200910,2351889,COST
06079933201030000,2021,220552,626060,846612,COST
06079933201030000,2020,150979,612970,763949,COST
06079933201030000,2019,150979,623150,774129,COST
06079933201040000,2021,220552,1766050,1986602,COST
06079933201040000,2020,150979,1710510,1861489,COST
06079933201040000,2019,150979,1710510,1861489,COST
06079933201050000,2021,220552,1753470,1974022,COST
06079933201050000,2020,150979,1702140,1853119,COST
06079933201050000,2019,150979,1702140,1853119,COST
06079933208010000,2021,515112,1275390,1790502,COST
06079933208010000,2020,559504,1243120,1802624,COST
06079933208010000,2019,559504,1243120,1802624,COST
06079933208040000,2021,486995,1398810,1885805,COST
06079933208040000,2020,516971,1344740,1861711,COST
06079933208040000,2019,516971,1344740,1861711,COST
06079933208070000,2021,476559,739180,1215739,COST
06079933208070000,2020,501434,729620,1231054,COST
06079933208070000,2019,501434,729620,1231054,COST
06079933208100000,2021,461564,0,461564,COST
06079933208100000,2020,479354,0,479354,COST
06079933208100000,2019,479354,0,479354,COST
06079933208130000,2021,454333,1543190,1997523,COST
06079933208130000,2020,468810,1496930,1965740,COST
06079933208130000,2019,468810,1496930,1965740,COST
06079933228010000,2021,327251,317110,644361,COST
06079933228010000,2020,263273,313627,576900,MKT
06079933228010000,2019,263273,313627,576900,MKT
06079933305010000,2021,415989,717310,1133299,COST
06079933305010000,2020,414055,705250,1119305,COST
06079933305010000,2019,414055,691470,1105525,COST
06079933305040000,2021,415269,913550,1328819,COST
06079933305040000,2020,413047,907680,1320727,COST
06079933305040000,2019,413047,907680,1320727,COST
06079933305070000,2021,398833,659960,1058793,COST
06079933305070000,2020,390206,643530,1033736,COST
06079933305070000,2019,390206,643530,1033736,COST
06079933305100000,2021,389321,766700,1156021,COST
06079933305100000,2020,377162,747870,1125032,COST
06079933305100000,2019,377162,747870,1125032,COST
06079933305130000,2021,394129,781500,1175629,COST
06079933305130000,2020,383740,766940,1150680,COST
06079933305130000,2019,383740,766940,1150680,COST
06079933305160000,2021,401913,0,401913,COST
06079933305160000,2020,394458,0,394458,COST
06079933305160000,2019,394458,0,394458,COST
06079933305190000,2021,386875,580500,967375,COST
06079933305190000,2020,373829,567640,941469,COST
06079933305190000,2019,373829,567640,941469,COST
06079933305220000,2021,410170,641800,1051970,COST
06079933305220000,2020,405920,622570,1028490,COST
06079933305220000,2019,405920,622570,1028490,COST
06079933305250000,2021,400379,629170,1029549,COST
06079933305250000,2020,392338,622830,1015168,COST
06079933305250000,2019,392338,622830,1015168,COST
06079933305280000,2021,400379,724090,1124469,COST
06079933305280000,2020,392338,701030,1093368,COST
06079933305280000,2019,392338,701030,1093368,COST
06079933307010000,2021,413824,1922270,2336094,COST
06079933307010000,2020,411023,1866880,2277903,COST
06079933307010000,2019,411023,1860060,2271083,COST
06079933307040000,2021,428565,492510,921075,COST
06079933307040000,2020,431796,477840,909636,COST
06079933307040000,2019,431796,477840,909636,COST
06079933307070000,2021,430597,936403,1367000,MKT
06079933307070000,2020,434682,868918,1303600,MKT
06079933307070000,2019,434682,868918,1303600,MKT
06079933307100000,2021,408691,1192240,1600931,COST
06079933307100000,2020,403860,852030,1255890,COST
06079933307100000,2019,403860,722205,1126065,MRA
06079933307130000,2021,413824,1500750,1914574,COST
06079933307130000,2020,411023,1457270,1868293,COST
06079933307130000,2019,411023,1457270,1868293,COST
06079933307160000,2021,420257,0,420257,COST
06079933307160000,2020,420052,0,420052,COST
06079933307160000,2019,420052,0,420052,COST
06079933307190000,2021,409432,0,409432,COST
06079933307190000,2020,404891,0,404891,COST
06079933307190000,2019,404891,0,404891,COST
06079933307220000,2021,414548,909270,1323818,COST
06079933307220000,2020,412036,0,412036,COST
06079933307220000,2019,412036,0,412036,COST
06079933307250000,2021,412369,1563860,1976229,COST
06079933307250000,2020,408989,1506460,1915449,COST
06079933307250000,2019,408989,1506460,1915449,COST
06079933307280000,2021,405704,970280,1375984,COST
06079933307280000,2020,399709,951340,1351049,COST
06079933307280000,2019,399709,951340,1351049,COST
06079933312010000,2021,1107,0,1107,COST
06079933312010000,2020,1030,0,1030,COST
06079933312010000,2019,1030,0,1030,COST
06079933312050000,2021,220551,1149000,1369551,COST
06079933312050000,2020,150979,1111310,1262289,COST
06079933312050000,2019,150979,1111310,1262289,COST
06079933401130000,2021,220552,1317460,1538012,COST
06079933401130000,2020,150979,1414810,1565789,COST
06079933401130000,2019,150979,1414810,1565789,COST
06079933401140000,2021,1107,0,1107,COST
06079933401140000,2020,1030,0,1030,COST
06079933401140000,2019,1030,0,1030,COST
06079933401150000,2021,220552,1127160,1347712,COST
06079933401150000,2020,150979,1092340,1243319,COST
06079933401150000,2019,150979,1092340,1243319,COST
06079933401170000,2021,220552,1328940,1549492,COST
06079933401170000,2020,150979,1288180,1439159,COST
06079933401170000,2019,150979,1288180,1439159,COST
06079933401200000,2021,220552,824470,1045022,COST
06079933401200000,2020,150979,810220,961199,COST
06079933401200000,2019,150979,810220,961199,COST
06079933401220000,2021,1107,0,1107,COST
06079933401220000,2020,1031,0,1031,COST
06079933401220000,2019,1031,0,1031,COST
06079934101010000,2021,213525,0,213525,COST
06079934101010000,2020,141437,0,141437,COST
06079934101010000,2019,141437,0,141437,COST
06079934201160000,2021,220552,1214470,1435022,COST
06079934201160000,2020,150979,1289000,1439979,COST
06079934201160000,2019,150979,1289000,1439979,COST
06079934201250000,2021,1107,0,1107,COST
06079934201250000,2020,1030,0,1030,COST
06079934201250000,2019,1030,0,1030,COST
06079934201260000,2021,220552,2466830,2687382,COST
06079934201260000,2020,150979,2394580,2545559,COST
06079934201260000,2019,150979,2394580,2545559,COST
06079934201271001,2021,220312,711710,932022,COST
06079934201271001,2020,150756,691910,842666,COST
06079934201271001,2019,150756,691910,842666,COST
06079934201271002,2021,240,0,240,COST
06079934201271002,2020,223,0,223,COST
06079934201271002,2019,223,0,223,COST
06079934201281001,2021,220395,1170190,1390585,COST
06079934201281001,2020,150833,1135630,1286463,COST
06079934201281001,2019,150833,1135630,1286463,COST
06079934201281002,2021,157,0,157,COST
06079934201281002,2020,146,0,146,COST
06079934201281002,2019,146,0,146,COST
06079934201290000,2021,220552,624680,845232,COST
06079934201290000,2020,150979,612250,763229,COST
06079934201290000,2019,150979,612250,763229,COST
06079934201300000,2021,220552,1734750,1955302,COST
06079934201300000,2020,150979,1669550,1820529,COST
06079934201300000,2019,150979,1669550,1820529,COST
06079934201311001,2021,444,0,444,COST
06079934201311001,2020,413,0,413,COST
06079934201311001,2019,413,0,413,COST
06079934201311002,2021,663,0,663,COST
06079934201311002,2020,617,0,617,COST
06079934201311002,2019,617,0,617,COST
06079934201321001,2021,704,0,704,COST
06079934201321001,2020,150604,721620,872224,COST
06079934201321001,2019,150604,721620,872224,COST
06079934201321002,2021,219848,733040,952888,COST
06079934201321002,2020,375,0,375,COST
06079934201321002,2019,375,0,375,COST
06079935101020000,2021,49190,981290,1030480,COST
06079935101020000,2020,46507,955650,1002157,COST
06079935101020000,2019,46507,959730,1006237,COST
06079936101030000,2021,240502,153210,393712,COST
06079936101030000,2020,243922,148440,392362,COST
06079936101030000,2019,243922,148440,392362,COST
06079936101040000,2021,424349,0,424349,COST
06079936101040000,2020,347247,0,347247,COST
06079936101040000,2019,347247,0,347247,COST
06079936101050000,2021,499856,152330,652186,COST
06079936101050000,2020,419404,146890,566294,COST
06079936101050000,2019,419404,146890,566294,COST
06079936101070000,2021,497319,254250,751569,COST
06079936101070000,2020,416952,248640,665592,COST
06079936101070000,2019,416952,248640,665592,COST
06079936101080000,2021,266816,283484,550300,MKT
06079936101080000,2020,203387,291013,494400,MKT
06079936101080000,2019,203387,291013,494400,MKT
06079936101090000,2021,495832,199350,695182,COST
06079936101090000,2020,415514,193000,608514,COST
06079936101090000,2019,415514,193000,608514,COST
06079936101100000,2021,219500,356570,576070,COST
06079936101100000,2020,162400,345840,508240,COST
06079936101100000,2019,162400,345840,508240,COST
06079936101110000,2021,106414,372640,479054,COST
06079936101110000,2020,95173,361220,456393,COST
06079936101110000,2019,95173,361220,456393,COST
06079936101110900,2021,107131,398440,505571,COST
06079936101110900,2020,95840,396360,492200,COST
06079936101110900,2019,95840,396360,492200,COST
06079936101120000,2021,943,0,943,COST
06079936101120000,2020,878,0,878,COST
06079936101120000,2019,878,0,878,COST
06079936101130000,2021,275434,410090,685524,COST
06079936101130000,2020,285203,393890,679093,COST
06079936101130000,2019,285203,393890,679093,COST
06079936101140000,2021,186055,156330,342385,COST
06079936101140000,2020,181440,196260,377700,MKT
06079936101140000,2019,181440,196260,377700,MKT
06079936101150000,2021,360,0,360,COST
06079936101150000,2020,335,0,335,COST
06079936101150000,2019,335,0,335,COST
06079936101150900,2021,105415,371030,476445,COST
06079936101150900,2020,94244,358750,452994,COST
06079936101150900,2019,94244,358750,452994,COST
06079936101200000,2021,106417,662860,769277,COST
06079936101200000,2020,95176,665200,760376,COST
06079936101200000,2019,95176,665200,760376,COST
06079936101210000,2021,107080,375060,482140,COST
06079936101210000,2020,95793,360970,456763,COST
06079936101210000,2019,95793,360970,456763,COST
06079936101220000,2021,106647,413900,520547,COST
06079936101220000,2020,95390,395140,490530,COST
06079936101220000,2019,95390,395140,490530,COST
06079936101230000,2021,106412,760810,867222,COST
06079936101230000,2020,95171,747060,842231,COST
06079936101230000,2019,95171,747060,842231,COST
06079936101250000,2021,186371,336630,523001,COST
06079936101250000,2020,181796,373604,555400,MKT
06079936101250000,2019,181796,373604,555400,MKT
06079936101270000,2021,186187,389930,576117,COST
06079936101270000,2020,181588,386320,567908,COST
06079936101270000,2019,181588,386320,567908,COST
06079936101300000,2021,274677,379520,654197,COST
06079936101300000,2020,284300,377090,661390,COST
06079936101300000,2019,284300,377090,661390,COST
06079936201010000,2021,387697,211670,599367,COST
06079936201010000,2020,312904,205430,518334,COST
06079936201010000,2019,312904,205430,518334,COST
06079936201020000,2021,351734,0,351734,COST
06079936201020000,2020,279686,0,279686,COST
06079936201020000,2019,279686,0,279686,COST
06079936201050000,2021,283765,315960,599725,COST
06079936201050000,2020,218353,307590,525943,COST
06079936201050000,2019,218353,83040,301393,COST
06079936201160000,2021,265175,0,265175,COST
06079936201160000,2020,201945,0,201945,COST
06079936201160000,2019,159921,0,159921,COST
06079936201170000,2021,308236,210264,518500,MKT
06079936201170000,2020,240201,155499,395700,MKT
06079936201170000,2019,240201,155499,395700,MKT
06079936201180000,2021,52919,0,52919,COST
06079936201180000,2020,37817,0,37817,COST
06079936201180000,2019,126109,0,126109,COST
06079936201190000,2021,260478,252222,512700,MKT
06079936201190000,2020,197828,206172,404000,MKT
06079936201190000,2019,197828,206172,404000,MKT
06079936205010000,2021,377154,311710,688864,COST
06079936205010000,2020,303114,306700,609814,COST
06079936205010000,2019,303114,306700,609814,COST
06079936301010000,2021,372888,580,373468,COST
06079936301010000,2020,302766,630,303396,COST
06079936301010000,2019,302766,630,303396,COST
06079936301020000,2021,229890,253400,483290,COST
06079936301020000,2020,167971,246290,414261,COST
06079936301020000,2019,167971,246290,414261,COST
06079936301030000,2021,9540,36870,46410,COST
06079936301030000,2020,5143,37040,42183,COST
06079936301030000,2019,5143,37040,42183,COST
06079936301040000,2021,219500,191800,411300,MKT
06079936301040000,2020,162400,214600,377000,MKT
06079936301040000,2019,162400,214600,377000,MKT
06079936301050000,2021,399258,409480,808738,COST
06079936301050000,2020,323685,406610,730295,COST
06079936301050000,2019,323685,364330,688015,COST
06079936301060000,2021,9857,0,9857,COST
06079936301060000,2020,5206,0,5206,COST
06079936301060000,2019,5214,0,5214,COST
06079936301070000,2021,210832,191610,402442,COST
06079936301070000,2020,209569,187020,396589,COST
06079936301070000,2019,209569,187020,396589,COST
06079936301080000,2021,241162,484880,726042,COST
06079936301080000,2020,244694,470820,715514,COST
06079936301080000,2019,244694,470820,715514,COST
06079936301090000,2021,280523,216377,496900,MKT
06079936301090000,2020,215480,204420,419900,MKT
06079936301090000,2019,215480,224720,440200,MKT
06079936301110000,2021,237442,314730,552172,COST
06079936301110000,2020,240348,300900,541248,COST
06079936301110000,2019,240998,300900,541898,COST
06079936301120000,2021,237999,489750,727749,COST
06079936301120000,2020,240998,473100,714098,COST
06079936301120000,2019,240998,473100,714098,COST
06079936301130000,2021,549651,140300,689951,COST
06079936301130000,2020,467929,136340,604269,COST
06079936301130000,2019,467929,136340,604269,COST
06079936301180000,2021,181533,0,181533,COST
06079936301180000,2020,156628,0,156628,COST
06079936301180000,2019,156628,0,156628,COST
06079936301260000,2021,114035,812440,926475,COST
06079936301260000,2020,98797,795580,894377,COST
06079936301260000,2019,98797,795580,894377,COST
06079936301380000,2021,14988,0,14988,COST
06079936301380000,2020,8143,0,8143,COST
06079936301380000,2019,8143,0,8143,COST
06079936302010000,2021,237332,233280,470612,COST
06079936302010000,2020,240220,223450,463670,COST
06079936302010000,2019,240220,223450,463670,COST
06079936302020000,2021,237966,187000,424966,COST
06079936302020000,2020,240959,185440,426399,COST
06079936302020000,2019,240959,185440,426399,COST
06079936302030000,2021,182604,0,182604,COST
06079936302030000,2020,177565,0,177565,COST
06079936302030000,2019,177565,0,177565,COST
06079936302040000,2021,190613,252220,442833,COST
06079936302040000,2020,186574,244780,431354,COST
06079936302040000,2019,186574,244780,431354,COST
06079936302050000,2021,252953,1038470,1291423,COST
06079936302050000,2020,258538,1012920,1271458,COST
06079936302050000,2019,258538,1012920,1271458,COST
06079936302060000,2021,204045,344510,548555,COST
06079936302060000,2020,201811,332390,534201,COST
06079936302060000,2019,201811,332390,534201,COST
06079936401010000,2021,26643,0,26643,COST
06079936401010000,2020,15208,0,15208,COST
06079936401010000,2019,15208,0,15208,COST
06079936401450000,2021,381191,0,381191,COST
06079936401450000,2020,306858,0,306858,COST
06079936401450000,2019,306858,0,306858,COST
06079936401500000,2021,421251,402450,823701,COST
06079936401500000,2020,344326,383190,727516,COST
06079936401500000,2019,344326,383190,727516,COST
06079936401590000,2021,449793,500140,949933,COST
06079936401590000,2020,371360,490820,862180,COST
06079936401590000,2019,371360,490820,862180,COST
06080001101010000,2021,53160,0,53160,COST
06080001101010000,2020,29102,0,29102,COST
06080001101010000,2019,29102,0,29102,COST
06080001101030000,2021,308338,74770,383108,COST
06080001101030000,2020,169878,63510,233388,COST
06080001101030000,2019,169878,63510,233388,COST
06080001101150000,2021,26165,0,26165,COST
06080001101150000,2020,14348,0,14348,COST
06080001101150000,2019,14348,0,14348,COST
06080001201010000,2021,68781,0,68781,COST
06080001201010000,2020,63849,0,63849,COST
06080001201010000,2019,63849,0,63849,COST
06080001301020000,2021,361528,249400,610928,COST
06080001301020000,2020,406049,210120,616169,COST
06080001301020000,2019,406049,210120,616169,COST
06080002101020000,2021,4301,0,4301,COST
06080002101020000,2020,3993,0,3993,COST
06080002101020000,2019,3993,0,3993,COST
06080002101040000,2021,4805,112000,116805,COST
06080002101040000,2020,4876,96760,101636,COST
06080002101040000,2019,4876,96760,101636,COST
06080002101180000,2021,2214,0,2214,COST
06080002101180000,2020,2061,0,2061,COST
06080002101180000,2019,2061,0,2061,COST
06080002201010000,2021,5215,201280,206495,COST
06080002201010000,2020,5263,180950,186213,COST
06080002201010000,2019,5263,180950,186213,COST
06080002201200000,2021,26241,0,26241,COST
06080002201200000,2020,24393,0,24393,COST
06080002201200000,2019,24393,0,24393,COST
06080002301010000,2021,11978,0,11978,COST
06080002301010000,2020,11158,0,11158,COST
06080002301010000,2019,11158,0,11158,COST
06080002401010000,2021,44964,1309660,1354624,COST
06080002401010000,2020,50599,1096270,1146869,COST
06080002401010000,2019,50599,1096270,1146869,COST
06080002401400000,2021,90,0,90,COST
06080002401400000,2020,84,0,84,COST
06080002401400000,2019,84,0,84,COST
06080003101010000,2021,31846,0,31846,COST
06080003101010000,2020,29660,0,29660,COST
06080003101010000,2019,29660,0,29660,COST
06080003201010000,2021,4428,0,4428,COST
06080003201010000,2020,4121,0,4121,COST
06080003201010000,2019,4121,0,4121,COST
06080003305010000,2021,4234,10650,14884,COST
06080003305010000,2020,3941,10320,14261,COST
06080003305010000,2019,3941,10320,14261,COST
06080004101010000,2021,14611,0,14611,COST
06080004101010000,2020,9243,0,9243,COST
06080004101010000,2019,9243,0,9243,COST
06080004101100000,2021,17880,0,17880,COST
06080004101100000,2020,10759,0,10759,COST
06080004101100000,2019,10759,0,10759,COST
06080004201010000,2021,48421,0,48421,COST
06080004201010000,2020,26275,0,26275,COST
06080004201010000,2019,26275,0,26275,COST
06080004301010000,2021,23371,0,23371,COST
06080004301010000,2020,12649,0,12649,COST
06080004301010000,2019,12649,0,12649,COST
06080004301100000,2021,646229,3666750,4312979,COST
06080004301100000,2020,354328,3133700,3488028,COST
06080004301100000,2019,354328,3133700,3488028,COST
06080004401010000,2021,35336,0,35336,COST
06080004401010000,2020,19563,0,19563,COST
06080004401010000,2019,19563,0,19563,COST
06080005101010000,2021,8309,0,8309,COST
06080005101010000,2020,4467,0,4467,COST
06080005101010000,2019,4467,0,4467,COST
06080005101020000,2021,293691,59350,353041,COST
06080005101020000,2020,161338,50680,212018,COST
06080005101020000,2019,161338,50680,212018,COST
06080005101040000,2021,350364,58170,408534,COST
06080005101040000,2020,355511,49590,405101,COST
06080005101040000,2019,355511,49590,405101,COST
06080005101050000,2021,3132,0,3132,COST
06080005101050000,2020,1684,0,1684,COST
06080005101050000,2019,1684,0,1684,COST
06080005101060000,2021,4180,0,4180,COST
06080005101060000,2020,2247,0,2247,COST
06080005101060000,2019,2247,0,2247,COST
06080005101070000,2021,4174,0,4174,COST
06080005101070000,2020,2244,0,2244,COST
06080005101070000,2019,2244,0,2244,COST
06080005101330000,2021,299110,241600,540710,COST
06080005101330000,2020,164291,115360,279651,COST
06080005101330000,2019,164291,79600,243891,COST
06080005102100000,2021,313767,1012920,1326687,COST
06080005102100000,2020,172129,761700,933829,COST
06080005102100000,2019,172129,761700,933829,COST
06080005102200000,2021,309531,2445770,2755301,COST
06080005102200000,2020,169852,2047940,2217792,COST
06080005102200000,2019,169852,2047940,2217792,COST
06080005201050000,2021,297860,2419270,2717130,COST
06080005201050000,2020,164078,2057270,2221348,COST
06080005201050000,2019,164078,2057270,2221348,COST
06080005201100000,2021,2172,0,2172,COST
06080005201100000,2020,2021,0,2021,COST
06080005201100000,2019,2021,0,2021,COST
06080005201150000,2021,308782,880450,1189232,COST
06080005201150000,2020,169493,738230,907723,COST
06080005201150000,2019,169493,738230,907723,COST
06080005301010000,2021,124577,0,124577,COST
06080005301010000,2020,68324,0,68324,COST
06080005301010000,2019,68324,0,68324,COST
06080006101030000,2021,290444,336970,627414,COST
06080006101030000,2020,159806,316740,476546,COST
06080006101030000,2019,159806,316740,476546,COST
06080006101040000,2021,363647,166300,529947,COST
06080006101040000,2020,416229,144300,560529,COST
06080006101040000,2019,416229,153220,569449,COST
06080006101050000,2021,290444,324170,614614,COST
06080006101050000,2020,159806,160750,320556,COST
06080006101050000,2019,159806,280070,439876,COST
06080006101060000,2021,362971,633429,996400,MKT
06080006101060000,2020,412961,566390,979351,COST
06080006101060000,2019,412961,613980,1026941,COST
06080006101070000,2021,1199,0,1199,COST
06080006101070000,2020,1116,0,1116,COST
06080006101070000,2019,1116,0,1116,COST
06080006101080000,2021,599,0,599,COST
06080006101080000,2020,558,0,558,COST
06080006101080000,2019,558,0,558,COST
06080006101090000,2021,363615,685450,1049065,COST
06080006101090000,2020,416074,589630,1005704,COST
06080006101090000,2019,416074,589630,1005704,COST
06080006101110000,2021,377876,989780,1367656,COST
06080006101110000,2020,489750,840390,1330140,COST
06080006101110000,2019,489750,800410,1290160,COST
06080006101120000,2021,290594,585780,876374,COST
06080006101120000,2020,159946,489440,649386,COST
06080006101120000,2019,159946,489440,649386,COST
06080006101130000,2021,296199,402840,699039,COST
06080006101130000,2020,162759,343040,505799,COST
06080006101130000,2019,162759,343040,505799,COST
06080006101140000,2021,588,0,588,COST
06080006101140000,2020,757,0,757,COST
06080006101140000,2019,757,0,757,COST
06080006101160000,2021,363647,1237550,1601197,COST
06080006101160000,2020,416229,1056830,1473059,COST
06080006101160000,2019,416229,1056830,1473059,COST
06080006101180000,2021,363647,663053,1026700,MKT
06080006101180000,2020,416229,608430,1024659,COST
06080006101180000,2019,416229,608430,1024659,COST
06080006201010000,2021,86214,0,86214,COST
06080006201010000,2020,43110,0,43110,COST
06080006201010000,2019,43110,0,43110,COST
06080006225010000,2021,384455,437945,822400,MKT
06080006225010000,2020,526915,268200,795115,OVR
06080006225010000,2019,526915,268200,795115,COST
06080006225030000,2021,364467,932960,1297427,COST
06080006225030000,2020,420224,787330,1207554,COST
06080006225030000,2019,420224,787330,1207554,COST
06080006225040000,2021,287161,0,287161,COST
06080006225040000,2020,153019,0,153019,COST
06080006225040000,2019,153019,0,153019,COST
06080006225050000,2021,371610,462860,834470,COST
06080006225050000,2020,456246,392750,848996,COST
06080006225050000,2019,456246,325200,781446,COST
06080006225100000,2021,346851,365280,712131,COST
06080006225100000,2020,340648,317000,657648,OVR
06080006225100000,2019,340648,317000,657648,COST
06080006225150000,2021,334195,226990,561185,COST
06080006225150000,2020,291003,245397,536400,MKT
06080006225150000,2019,291003,245397,536400,MKT
06080006225200000,2021,338654,348120,686774,COST
06080006225200000,2020,307816,309510,617326,COST
06080006225200000,2019,307816,309510,617326,COST
06080006225250000,2021,341158,529142,870300,MKT
06080006225250000,2020,317578,160992,478570,OVR
06080006225250000,2019,317578,478570,796148,COST
06080006225300000,2021,330738,588762,919500,MKT
06080006225300000,2020,278457,551030,829487,OVR
06080006225300000,2019,278457,551030,829487,COST
06080006230010000,2021,366495,621005,987500,MKT
06080006230010000,2020,430223,481680,911903,COST
06080006230010000,2019,430223,481680,911903,COST
06080006230030000,2021,457,0,457,COST
06080006230030000,2020,425,0,425,COST
06080006230030000,2019,425,0,425,COST
06080006230050000,2021,290373,442810,733183,COST
06080006230050000,2020,159741,368090,527831,COST
06080006230050000,2019,159741,368090,527831,COST
06080006230060000,2021,242,0,242,COST
06080006230060000,2020,225,0,225,COST
06080006230060000,2019,225,0,225,COST
06080006230090000,2021,290231,392450,682681,COST
06080006230090000,2020,159608,341120,500728,OVR
06080006230090000,2019,159608,341120,500728,COST
06080006230100000,2021,386,0,386,COST
06080006230100000,2020,359,0,359,COST
06080006230100000,2019,359,0,359,COST
06080006230150000,2021,332814,623586,956400,MKT
06080006230150000,2020,285942,544158,830100,OVR
06080006230150000,2019,285942,557630,843572,COST
06080006230200000,2021,336538,0,336538,COST
06080006230200000,2020,299748,0,299748,COST
06080006230200000,2019,299748,0,299748,COST
06080006250010000,2021,343378,356530,699908,COST
06080006250010000,2020,326427,303820,630247,COST
06080006250010000,2019,326427,303820,630247,COST
06080006250050000,2021,337975,579125,917100,MKT
06080006250050000,2020,305210,374240,679450,COST
06080006250050000,2019,305210,374240,679450,COST
06080006250100000,2021,342835,705765,1048600,MKT
06080006250100000,2020,324243,685640,1009883,COST
06080006250100000,2019,324243,685640,1009883,COST
06080006250150000,2021,290246,456820,747066,COST
06080006250150000,2020,159622,387330,546952,COST
06080006250150000,2019,159622,387330,546952,COST
06080006324010000,2021,292059,866640,1158699,COST
06080006324010000,2020,161309,749800,911109,COST
06080006324010000,2019,161309,749800,911109,COST
06080006372010000,2021,309721,1246100,1555821,COST
06080006372010000,2020,170592,446730,617322,COST
06080006372010000,2019,170592,234850,405442,COST
06080006401010000,2021,18306,0,18306,COST
06080006401010000,2020,10258,0,10258,COST
06080006401010000,2019,10258,0,10258,COST
06080006401070000,2021,363688,277300,640988,COST
06080006401070000,2020,416430,236660,653090,COST
06080006401070000,2019,416430,236660,653090,COST
06080006401090000,2021,4562,0,4562,COST
06080006401090000,2020,3458,0,3458,COST
06080006401090000,2019,3458,0,3458,COST
06080006401100000,2021,18982,0,18982,COST
06080006401100000,2020,10304,0,10304,COST
06080006401100000,2019,10304,0,10304,COST
06080006401150000,2021,300819,634090,934909,COST
06080006401150000,2020,165407,528210,693617,COST
06080006401150000,2019,165407,442000,607407,COST
06080006401180000,2021,360868,248240,609108,COST
06080006401180000,2020,402917,210200,613117,COST
06080006401180000,2019,402917,210200,613117,COST
06080006401200000,2021,291365,788530,1079895,COST
06080006401200000,2020,160663,647800,808463,OVR
06080006401200000,2019,160663,647800,808463,COST
06080006401250000,2021,292260,509680,801940,COST
06080006401250000,2020,161498,428810,590308,COST
06080006401250000,2019,161498,428810,590308,COST
06080007101030000,2021,49,0,49,COST
06080007101030000,2020,45,0,45,COST
06080007101030000,2019,45,0,45,COST
06080007101040000,2021,239168,282932,522100,MKT
06080007101040000,2020,261828,208472,470300,MKT
06080007101040000,2019,261828,208472,470300,MKT
06080007101050000,2021,239173,466627,705800,MKT
06080007101050000,2020,261850,358550,620400,MKT
06080007101050000,2019,261850,358550,620400,MKT
06080007101060000,2021,256216,604810,861026,COST
06080007101060000,2020,350538,475160,825698,COST
06080007101060000,2019,350538,475160,825698,COST
06080007101080000,2021,265472,0,265472,COST
06080007101080000,2020,407421,0,407421,COST
06080007101080000,2019,407421,0,407421,COST
06080007101100000,2021,241963,645320,887283,COST
06080007101100000,2020,275042,477558,752600,OVR
06080007101100000,2019,275042,477558,752600,OVR
06080007101120000,2021,266289,405211,671500,MKT
06080007101120000,2020,412762,259610,672372,COST
06080007101120000,2019,412762,259610,672372,COST
06080007101140000,2021,256223,274977,531200,MKT
06080007101140000,2020,350580,201330,551910,OVR
06080007101140000,2019,350580,201330,551910,COST
06080007101200000,2021,258549,1523551,1782100,MKT
06080007101200000,2020,364264,1662180,2026444,COST
06080007101200000,2019,364264,1685200,2049464,COST
06080007101220000,2021,253662,661638,915300,MKT
06080007101220000,2020,335966,554480,890446,COST
06080007101220000,2019,335966,554480,890446,COST
06080007101240000,2021,206881,373180,580061,COST
06080007101240000,2020,139570,318360,457930,COST
06080007101240000,2019,139570,318360,457930,COST
06080007101280000,2021,259649,445151,704800,MKT
06080007101280000,2020,370874,341990,712864,COST
06080007101280000,2019,370874,341990,712864,COST
06080007101320000,2021,252287,408080,660367,COST
06080007101320000,2020,328315,343120,671435,COST
06080007101320000,2019,328315,343120,671435,COST
06080007101350000,2021,266262,267538,533800,MKT
06080007101350000,2020,412585,222690,635275,COST
06080007101350000,2019,412585,222690,635275,COST
06080007101400000,2021,206881,593030,799911,COST
06080007101400000,2020,139570,505150,644720,COST
06080007101400000,2019,139570,505150,644720,COST
06080007201010000,2021,207946,861370,1069316,COST
06080007201010000,2020,140561,755450,896011,COST
06080007201010000,2019,140561,755450,896011,COST
06080007201200000,2021,2213,0,2213,COST
06080007201200000,2020,2060,0,2060,COST
06080007201200000,2019,2060,0,2060,COST
06080007201300000,2021,207990,1739640,1947630,COST
06080007201300000,2020,140602,1482930,1623532,COST
06080007201300000,2019,140602,1482930,1623532,COST
06080007201600000,2021,2172,0,2172,COST
06080007201600000,2020,2022,0,2022,COST
06080007201600000,2019,2022,0,2022,COST
06080007301010000,2021,206437,126890,333327,COST
06080007301010000,2020,138986,71470,210456,COST
06080007301010000,2019,138986,71470,210456,COST
06080007301050000,2021,3163,2740,5903,COST
06080007301050000,2020,2173,2800,4973,COST
06080007301050000,2019,2173,2800,4973,COST
06080007301100000,2021,256982,0,256982,COST
06080007301100000,2020,532,0,532,COST
06080007301100000,2019,532,0,532,COST
06080007301150000,2021,257,0,257,COST
06080007301150000,2020,239,0,239,COST
06080007301150000,2019,239,0,239,COST
06080007302150000,2021,101265,158320,259585,COST
06080007302150000,2020,57498,134050,191548,COST
06080007302150000,2019,57498,134050,191548,COST
06080008101010000,2021,62567,0,62567,COST
06080008101010000,2020,34099,0,34099,COST
06080008101010000,2019,34099,0,34099,COST
06080008120010000,2021,74778,0,74778,COST
06080008120010000,2020,40782,0,40782,COST
06080008120010000,2019,40782,0,40782,COST
06080008301010000,2021,72307,0,72307,COST
06080008301010000,2020,38903,0,38903,COST
06080008301010000,2019,38903,0,38903,COST
06080008401010000,2021,66705,0,66705,COST
06080008401010000,2020,35903,0,35903,COST
06080008401010000,2019,35903,0,35903,COST
06080009101010000,2021,581903,865100,1447003,COST
06080009101010000,2020,320557,806060,1126617,COST
06080009101010000,2019,320557,806060,1126617,COST
06080009101100000,2021,61762,0,61762,COST
06080009101100000,2020,33685,0,33685,COST
06080009101100000,2019,33685,0,33685,COST
06080009201010000,2021,50878,0,50878,COST
06080009201010000,2020,28113,0,28113,COST
06080009201010000,2019,28113,0,28113,COST
06080009301010000,2021,125462,0,125462,COST
06080009301010000,2020,67569,0,67569,COST
06080009301010000,2019,67569,0,67569,COST
06080010101010000,2021,109400,161240,270640,COST
06080010101010000,2020,71176,139440,210616,COST
06080010101010000,2019,71176,139440,210616,COST
06080010101020000,2021,6573,189230,195803,COST
06080010101020000,2020,6525,166190,172715,COST
06080010101020000,2019,6525,166190,172715,COST
06080010101030000,2021,260573,190027,450600,MKT
06080010101030000,2020,376502,90410,466912,COST
06080010101030000,2019,376502,90410,466912,COST
06080010102010000,2021,48528,0,48528,COST
06080010102010000,2020,45052,0,45052,COST
06080010102010000,2019,45052,0,45052,COST
06080010401010000,2021,205829,0,205829,COST
06080010401010000,2020,138591,0,138591,COST
06080010401010000,2019,138591,0,138591,COST
06080011101010000,2021,92,0,92,COST
06080011101010000,2020,86,0,86,COST
06080011101010000,2019,86,0,86,COST
06080011201016500,2021,65893,25860,91753,COST
06080011201016500,2020,61247,21710,82957,COST
06080011201016500,2019,61247,21710,82957,COST
06080011201020000,2021,238031,0,238031,COST
06080011201020000,2020,256593,3150,259743,COST
06080011201020000,2019,256593,3150,259743,COST
06080011201030000,2021,256003,583597,839600,MKT
06080011201030000,2020,349306,462340,811646,COST
06080011201030000,2019,349306,486690,835996,COST
06080011201040000,2021,253656,0,253656,COST
06080011201040000,2020,335935,0,335935,COST
06080011201040000,2019,335935,0,335935,COST
06080011201060000,2021,259411,882060,1141471,COST
06080011201060000,2020,369441,750920,1120361,COST
06080011201060000,2019,369441,750920,1120361,COST
06080011201080000,2021,261989,0,261989,COST
06080011201080000,2020,385247,0,385247,COST
06080011201080000,2019,385247,0,385247,COST
06080011201120000,2021,3626,0,3626,COST
06080011201120000,2020,3366,0,3366,COST
06080011201120000,2019,3366,0,3366,COST
06080011201140000,2021,257394,911690,1169084,COST
06080011201140000,2020,357416,782840,1140256,OVR
06080011201140000,2019,357416,782840,1140256,COST
06080011201160000,2021,1586,0,1586,COST
06080011201160000,2020,1476,0,1476,COST
06080011201160000,2019,1476,0,1476,COST
06080011201180000,2021,1871,0,1871,COST
06080011201180000,2020,1738,0,1738,COST
06080011201180000,2019,1738,0,1738,COST
06080011201200000,2021,1479,0,1479,COST
06080011201200000,2020,1374,0,1374,COST
06080011201200000,2019,1374,0,1374,COST
06080011201220000,2021,4106,0,4106,COST
06080011201220000,2020,3809,0,3809,COST
06080011201220000,2019,3809,0,3809,COST
06080011201240000,2021,259144,1015820,1274964,COST
06080011201240000,2020,367828,839972,1207800,OVR
06080011201240000,2019,367828,839972,1207800,OVR
06080011201260000,2021,252335,0,252335,COST
06080011201260000,2020,328580,0,328580,COST
06080011201260000,2019,328580,0,328580,COST
06080011201280000,2021,252657,0,252657,COST
06080011201280000,2020,237500,0,237500,COST
06080011201280000,2019,237500,0,237500,COST
06080011201300000,2021,259214,0,259214,COST
06080011201300000,2020,368249,0,368249,COST
06080011201300000,2019,368249,0,368249,COST
06080011201320000,2021,206915,351390,558305,COST
06080011201320000,2020,139601,306340,445941,OVR
06080011201320000,2019,139601,306340,445941,COST
06080011201340000,2021,253202,0,253202,COST
06080011201340000,2020,333394,0,333394,COST
06080011201340000,2019,333394,0,333394,COST
06080011201360000,2021,257522,847770,1105292,COST
06080011201360000,2020,358170,738680,1096850,COST
06080011201360000,2019,358170,738680,1096850,COST
06080011201380000,2021,253120,713650,966770,COST
06080011201380000,2020,332937,525963,858900,MKT
06080011201380000,2019,332937,371730,704667,COST
06080011201400000,2021,262699,0,262699,COST
06080011201400000,2020,389692,0,389692,COST
06080011201400000,2019,389692,0,389692,COST
06080011201420000,2021,261286,0,261286,COST
06080011201420000,2020,380887,0,380887,COST
06080011201420000,2019,380887,0,380887,COST
06080011201440000,2021,248466,0,248466,COST
06080011201440000,2020,307758,0,307758,COST
06080011201440000,2019,307758,0,307758,COST
06080011201460000,2021,258831,0,258831,COST
06080011201460000,2020,269207,0,269207,COST
06080011201460000,2019,269207,0,269207,COST
06080011201480000,2021,258325,0,258325,COST
06080011201480000,2020,362926,0,362926,COST
06080011201480000,2019,362926,0,362926,COST
06080011201500000,2021,256514,0,256514,COST
06080011201500000,2020,352269,0,352269,COST
06080011201500000,2019,352269,0,352269,COST
06080011201520000,2021,257510,666790,924300,MKT
06080011201520000,2020,358102,559370,917472,COST
06080011201520000,2019,358102,559370,917472,COST
06080012101010000,2021,39958,495730,535688,COST
06080012101010000,2020,26574,416710,443284,COST
06080012101010000,2019,26574,309020,335594,COST
06080012208050000,2021,6558,0,6558,COST
06080012208050000,2020,6092,0,6092,COST
06080012208050000,2019,6092,0,6092,COST
06080012240010000,2021,13721,0,13721,COST
06080012240010000,2020,12735,0,12735,COST
06080012240010000,2019,12735,0,12735,COST
06080012240420000,2021,6554,1626640,1633194,COST
06080012240420000,2020,6496,1374420,1380916,COST
06080012240420000,2019,6496,1374420,1380916,COST
06080012240670000,2021,10990,215940,226930,COST
06080012240670000,2020,10615,182520,193135,COST
06080012240670000,2019,10615,182520,193135,COST
06080012240860000,2021,829,0,829,COST
06080012240860000,2020,769,0,769,COST
06080012240860000,2019,769,0,769,COST
06080012301010000,2021,19503,654630,674133,COST
06080012301010000,2020,18544,565960,584504,COST
06080012301010000,2019,18544,565960,584504,COST
06080012402131001,2021,699,0,699,COST
06080012402131001,2020,651,0,651,COST
06080012402131001,2019,651,0,651,COST
06080012402161001,2021,168085,385050,553135,COST
06080012402161001,2020,138326,330540,468866,COST
06080012402161001,2019,138326,330540,468866,COST
06080012402210000,2021,123958,212142,336100,MKT
06080012402210000,2020,122377,105370,227747,COST
06080012402210000,2019,122377,105370,227747,COST
06080012402330000,2021,5341,0,5341,COST
06080012402330000,2020,4961,0,4961,COST
06080012402330000,2019,4961,0,4961,COST
06080012402350000,2021,3433,45300,48733,COST
06080012402350000,2020,3195,16870,20065,COST
06080012402350000,2019,3195,16870,20065,COST
06080012402370000,2021,813,0,813,COST
06080012402370000,2020,757,0,757,COST
06080012402370000,2019,757,0,757,COST
06080012402650000,2021,9139,0,9139,COST
06080012402650000,2020,6733,0,6733,COST
06080012402650000,2019,6733,0,6733,COST
06080013101011001,2021,65,0,65,COST
06080013101011001,2020,61,0,61,COST
06080013101011001,2019,61,0,61,COST
06080013101060000,2021,54520,238110,292630,COST
06080013101060000,2020,40262,205870,246132,COST
06080013101060000,2019,40262,205870,246132,COST
06080013101101001,2021,325,0,325,COST
06080013101101001,2020,302,0,302,COST
06080013101101001,2019,302,0,302,COST
06080013101220000,2021,3204,335570,338774,COST
06080013101220000,2020,3391,279840,283231,COST
06080013101220000,2019,3391,279840,283231,COST
06080013101240000,2021,140143,200120,340263,COST
06080013101240000,2020,113331,208969,322300,MKT
06080013101240000,2019,113331,208969,322300,MKT
06080013101260000,2021,666,0,666,COST
06080013101260000,2020,621,0,621,COST
06080013101260000,2019,621,0,621,COST
06080013101270000,2021,164349,257840,422189,COST
06080013101270000,2020,134959,312041,447000,MKT
06080013101270000,2019,134959,312041,447000,MKT
06080013101290000,2021,164041,245030,409071,COST
06080013101290000,2020,134682,209270,343952,COST
06080013101290000,2019,134682,209270,343952,COST
06080013101311001,2021,134422,0,134422,COST
06080013101311001,2020,108269,0,108269,COST
06080013101311001,2019,108269,0,108269,COST
06080013101380000,2021,902,0,902,COST
06080013101380000,2020,840,0,840,COST
06080013101380000,2019,840,0,840,COST
06080013101390000,2021,155941,0,155941,COST
06080013101390000,2020,127409,0,127409,COST
06080013101390000,2019,127409,0,127409,COST
06080013101400000,2021,113730,0,113730,COST
06080013101400000,2020,90141,0,90141,COST
06080013101400000,2019,90141,0,90141,COST
06080013101501001,2021,54658,143380,198038,COST
06080013101501001,2020,40391,139300,179691,COST
06080013101501001,2019,40391,139300,179691,COST
06080013102010000,2021,99436,301870,401306,COST
06080013102010000,2020,76199,278700,354899,COST
06080013102010000,2019,76199,278700,354899,COST
06080013103010000,2021,285454,0,285454,COST
06080013103010000,2020,149201,0,149201,COST
06080013201100000,2021,2817,0,2817,COST
06080013201100000,2020,2622,0,2622,COST
06080013201100000,2019,2622,0,2622,COST
06080013301010000,2021,69195,157090,226285,COST
06080013301010000,2020,42717,135130,177847,COST
06080013301010000,2019,42717,135130,177847,COST
06080013302010000,2021,34057,0,34057,COST
06080013302010000,2020,24036,0,24036,COST
06080013302010000,2019,24036,0,24036,COST
06080013410010000,2021,1431,0,1431,COST
06080013410010000,2020,1332,0,1332,COST
06080013410010000,2019,1332,0,1332,COST
06080013410050000,2021,69426,421640,491066,COST
06080013410050000,2020,48464,359550,408014,COST
06080013410050000,2019,48464,359550,408014,COST
06080013410100000,2021,13198,0,13198,COST
06080013410100000,2020,7177,0,7177,COST
06080013410100000,2019,7177,0,7177,COST
06080013410150000,2021,1107,0,1107,COST
06080013410150000,2020,1030,0,1030,COST
06080013410150000,2019,1030,0,1030,COST
06080013410200000,2021,1154,0,1154,COST
06080013410200000,2020,1074,0,1074,COST
06080013410200000,2019,1074,0,1074,COST
06080013410250000,2021,55745,396600,452345,COST
06080013410250000,2020,41403,338580,379983,COST
06080013410250000,2019,41403,338580,379983,COST
06080013410350000,2021,56048,403960,460008,COST
06080013410350000,2020,41684,326130,367814,COST
06080013410350000,2019,41684,326130,367814,COST
06080014101010000,2021,150871,307180,458051,COST
06080014101010000,2020,132392,310408,442800,MKT
06080014101010000,2019,132392,310408,442800,MKT
06080014101100000,2021,2214,0,2214,COST
06080014101100000,2020,2060,0,2060,COST
06080014101100000,2019,2060,0,2060,COST
06080014201010000,2021,61414,136540,197954,COST
06080014201010000,2020,49427,115820,165247,COST
06080014201010000,2019,49427,115820,165247,COST
06080014202010000,2021,88563,189420,277983,COST
06080014202010000,2020,68525,175630,244155,COST
06080014202010000,2019,68525,175630,244155,COST
06080014203010000,2021,1714,0,1714,COST
06080014203010000,2020,1595,0,1595,COST
06080014203010000,2019,1595,0,1595,COST
06080014203400000,2021,3778,1390,5168,COST
06080014203400000,2020,3516,1340,4856,COST
06080014203400000,2019,3516,1340,4856,COST
06080014203800000,2021,5439,0,5439,COST
06080014203800000,2020,5065,0,5065,COST
06080014203800000,2019,5065,0,5065,COST
06080014301010000,2021,11046,0,11046,COST
06080014301010000,2020,10478,0,10478,COST
06080014301010000,2019,10478,0,10478,COST
06080014301030000,2021,59993,128250,188243,COST
06080014301030000,2020,45802,111670,157472,COST
06080014301030000,2019,45802,111670,157472,COST
06080014301100000,2021,55676,574900,630576,COST
06080014301100000,2020,41785,504280,546065,COST
06080014301100000,2019,41785,504280,546065,COST
06080014405010000,2021,45809,0,45809,COST
06080014405010000,2020,28077,0,28077,COST
06080014405010000,2019,28077,0,28077,COST
06080015101010000,2021,207988,1540330,1748318,COST
06080015101010000,2020,140600,1337010,1477610,COST
06080015101010000,2019,140600,1266150,1406750,COST
06080015101200000,2021,6212,298200,304412,COST
06080015101200000,2020,6184,258660,264844,COST
06080015101200000,2019,6184,258660,264844,COST
06080015101400000,2021,207988,1799610,2007598,COST
06080015101400000,2020,140600,1531700,1672300,COST
06080015101400000,2019,140600,1531700,1672300,COST
06080015101800000,2021,207989,818910,1026899,COST
06080015101800000,2020,140601,709280,849881,COST
06080015101800000,2019,140601,709280,849881,COST
06080015201010000,2021,207989,231090,439079,COST
06080015201010000,2020,161310,203200,364510,COST
06080015201010000,2019,161310,203200,364510,COST
06080015201400000,2021,13330,0,13330,COST
06080015201400000,2020,7428,0,7428,COST
06080015201400000,2019,7428,0,7428,COST
06080015201800000,2021,208007,979980,1187987,COST
06080015201800000,2020,140619,869570,1010189,COST
06080015201800000,2019,140619,869570,1010189,COST
06080015202220000,2021,210016,485750,695766,COST
06080015202220000,2020,124050,422400,546450,COST
06080015202220000,2019,124050,422400,546450,COST
06080015202230000,2021,211405,0,211405,COST
06080015202230000,2020,124949,0,124949,COST
06080015202230000,2019,538,0,538,COST
06080015202240000,2021,208161,328339,536500,MKT
06080015202240000,2020,122849,259551,382400,MKT
06080015202240000,2019,40712,243320,284032,COST
06080015202250000,2021,177984,288416,466400,MKT
06080015202250000,2020,111482,253718,365200,MKT
06080015202250000,2019,111482,253718,365200,MKT
06080015301010000,2021,2220,0,2220,COST
06080015301010000,2020,2066,0,2066,COST
06080015301010000,2019,2066,0,2066,COST
06080015301400000,2021,207990,874330,1082320,COST
06080015301400000,2020,140602,757880,898482,COST
06080015301400000,2019,140602,757880,898482,COST
06080015302010000,2021,1718,0,1718,COST
06080015302010000,2020,1599,0,1599,COST
06080015302010000,2019,1599,0,1599,COST
06080015302100000,2021,207061,673730,880791,COST
06080015302100000,2020,139738,575810,715548,COST
06080015302100000,2019,139738,575810,715548,COST
06080015302300000,2021,207578,674850,882428,COST
06080015302300000,2020,140218,564810,705028,COST
06080015302300000,2019,140218,564810,705028,COST
06080015302600000,2021,1655,0,1655,COST
06080015302600000,2020,1540,0,1540,COST
06080015302600000,2019,1540,0,1540,COST
06080015401010000,2021,2240,0,2240,COST
06080015401010000,2020,2085,0,2085,COST
06080015401010000,2019,2085,0,2085,COST
06080015401150000,2021,217554,250946,468500,MKT
06080015401150000,2020,128939,42760,171699,COST
06080015401150000,2019,128939,0,128939,COST
06080015401200000,2021,126485,461080,587565,COST
06080015401200000,2020,109126,349974,459100,MKT
06080015401200000,2019,109126,349974,459100,MKT
06080015401350000,2021,182746,417254,600000,OVR
06080015401350000,2020,114756,370644,485400,MKT
06080015401350000,2019,114756,370644,485400,MKT
06080015402010000,2021,82629,0,82629,COST
06080015402010000,2020,68427,0,68427,COST
06080015402010000,2019,68427,0,68427,COST
06080016101010000,2021,204427,0,204427,COST
06080016101010000,2020,120969,0,120969,COST
06080016101010000,2019,120969,0,120969,COST
06080016102010000,2021,247705,0,247705,COST
06080016102010000,2020,349173,0,349173,COST
06080016102010000,2019,349173,0,349173,COST
06080017101010000,2021,207958,704710,912668,COST
06080017101010000,2020,140572,590590,731162,COST
06080017101010000,2019,140572,590590,731162,COST
06080017101016500,2021,172909,0,172909,COST
06080017101016500,2020,94628,0,94628,COST
06080017101016500,2019,94628,0,94628,COST
06080017102010000,2021,2169,0,2169,COST
06080017102010000,2020,2019,0,2019,COST
06080017102010000,2019,2019,0,2019,COST
06080017103010000,2021,207789,1719060,1926849,COST
06080017103010000,2020,140415,1673910,1814325,COST
06080017103010000,2019,140415,1673910,1814325,COST
06080017201010000,2021,9111,0,9111,COST
06080017201010000,2020,5359,0,5359,COST
06080017201010000,2019,5359,0,5359,COST
06080017202010000,2021,217641,648260,865901,COST
06080017202010000,2020,145054,549130,694184,COST
06080017202010000,2019,145054,549130,694184,COST
06080017301010000,2021,206881,3227160,3434041,COST
06080017301010000,2020,139570,3023790,3163360,COST
06080017301010000,2019,139570,3023790,3163360,COST
06080018104020000,2021,239688,312312,552000,MKT
06080018104020000,2020,264249,215451,479700,MKT
06080018104020000,2019,264249,209251,473500,MKT
06080018104030000,2021,239582,249418,489000,MKT
06080018104030000,2020,263755,169445,433200,OVR
06080018104030000,2019,263755,169445,433200,MKT
06080018107020000,2021,255749,1850,257599,COST
06080018107020000,2020,347838,1480,349318,COST
06080018107020000,2019,347838,1480,349318,COST
06080018107030000,2021,246229,539571,785800,MKT
06080018107030000,2020,296183,253817,550000,OVR
06080018107030000,2019,296183,253817,550000,OVR
06080018107050000,2021,5250,0,5250,COST
06080018107050000,2020,2250,0,2250,COST
06080018107050000,2019,2250,0,2250,COST
06080018107100000,2021,237435,355265,592700,MKT
06080018107100000,2020,253880,262490,516370,COST
06080018107100000,2019,253880,262490,516370,COST
06080018112020000,2021,256167,716620,972787,COST
06080018112020000,2020,350255,628570,978825,COST
06080018112020000,2019,350255,628570,978825,COST
06080018112030000,2021,246896,324304,571200,MKT
06080018112030000,2020,299599,246880,546479,COST
06080018112030000,2019,299599,246880,546479,COST
06080018112050000,2021,249365,192635,442000,MKT
06080018112050000,2020,312501,155080,467581,COST
06080018112050000,2019,312501,155080,467581,COST
06080018112070000,2021,246830,438070,684900,MKT
06080018112070000,2020,299260,270730,569990,COST
06080018112070000,2019,299260,270730,569990,COST
06080018112090000,2021,229281,270319,499600,MKT
06080018112090000,2020,218936,222964,441900,MKT
06080018112090000,2019,218936,222964,441900,MKT
06080018118010000,2021,245950,0,245950,COST
06080018118010000,2020,294763,252876,547639,MRA
06080018118010000,2019,294763,252876,547639,MRA
06080018118020000,2021,231808,491892,723700,MKT
06080018118020000,2020,229347,386360,615707,COST
06080018118020000,2019,229347,386360,615707,COST
06080018118040000,2021,255700,950,256650,COST
06080018118040000,2020,347553,980,348533,COST
06080018118040000,2019,347553,980,348533,COST
06080018118050000,2021,255898,287302,543200,MKT
06080018118050000,2020,348694,232770,581464,COST
06080018118050000,2019,348694,232770,581464,COST
06080018118060000,2021,230571,0,230571,COST
06080018118060000,2020,224204,0,224204,COST
06080018118060000,2019,224204,0,224204,COST
06080018132010000,2021,69,0,69,COST
06080018132010000,2020,64,0,64,COST
06080018132010000,2019,64,0,64,COST
06080018132020000,2021,218039,331650,549689,COST
06080018132020000,2020,145381,314260,459641,COST
06080018132020000,2019,145381,314260,459641,COST
06080018132040000,2021,238464,230236,468700,MKT
06080018132040000,2020,258577,164723,423300,MKT
06080018132040000,2019,258577,164723,423300,MKT
06080018132050000,2021,255675,376225,631900,MKT
06080018132050000,2020,347409,255330,602739,COST
06080018132050000,2019,347409,255330,602739,COST
06080018132060000,2021,239885,204615,444500,MKT
06080018132060000,2020,265170,106810,371980,COST
06080018132060000,2019,265170,106810,371980,COST
06080018202030000,2021,207234,0,207234,COST
06080018202030000,2020,139898,0,139898,COST
06080018202030000,2019,139898,0,139898,COST
06080018202100000,2021,255427,224010,479437,COST
06080018202100000,2020,139039,193290,332329,COST
06080018202100000,2019,139039,193290,332329,COST
06080018202110000,2021,221376,213450,434826,COST
06080018202110000,2020,147170,182680,329850,COST
06080018202110000,2019,147170,182680,329850,COST
06080018301010000,2021,46294,0,46294,COST
06080018301010000,2020,26352,0,26352,COST
06080018301010000,2019,26352,0,26352,COST
06080018301100000,2021,67624,0,67624,COST
06080018301100000,2020,36114,0,36114,COST
06080018301100000,2019,36114,0,36114,COST
06080018401010000,2021,215534,222320,437854,COST
06080018401010000,2020,143822,193800,337622,COST
06080018401010000,2019,143822,193800,337622,COST
06080018402010000,2021,235370,918350,1153720,COST
06080018402010000,2020,154510,447240,601750,COST
06080018402010000,2019,16175,0,16175,COST
06080019101010000,2021,165596,0,165596,COST
06080019101010000,2020,89394,0,89394,COST
06080019101010000,2019,89394,0,89394,COST
06080019301010000,2021,18951,0,18951,COST
06080019301010000,2020,10215,0,10215,COST
06080019301010000,2019,10215,0,10215,COST
06080019401010000,2021,1050,0,1050,COST
06080019401010000,2020,565,0,565,COST
06080019401010000,2019,565,0,565,COST
06080020101010000,2021,18325,0,18325,COST
06080020101010000,2020,9865,0,9865,COST
06080020101010000,2019,9865,0,9865,COST
06080020101020000,2021,61716,0,61716,COST
06080020101020000,2020,33083,0,33083,COST
06080020101020000,2019,33083,0,33083,COST
06080020101050000,2021,1741,0,1741,COST
06080020101050000,2020,996,0,996,COST
06080020101050000,2019,996,0,996,COST
06080020101060000,2021,67,0,67,COST
06080020101060000,2020,63,0,63,COST
06080020101060000,2019,63,0,63,COST
06080020101070000,2021,74,0,74,COST
06080020101070000,2020,69,0,69,COST
06080020101070000,2019,69,0,69,COST
06080020101120000,2021,177197,0,177197,COST
06080020101120000,2020,73463,0,73463,COST
06080020101120000,2019,73463,0,73463,COST
06080020101130000,2021,175758,242942,418700,MKT
06080020101130000,2020,70970,203130,274100,MKT
06080020101130000,2019,70970,203130,274100,MKT
06080020101140000,2021,216239,250461,466700,MKT
06080020101140000,2020,170818,166490,337308,COST
06080020101140000,2019,170818,166490,337308,COST
06080020101150000,2021,196681,119160,315841,COST
06080020101150000,2020,114306,100590,214896,COST
06080020101150000,2019,114306,100590,214896,COST
06080020101160000,2021,185233,133660,318893,COST
06080020101160000,2020,85313,114380,199693,COST
06080020101160000,2019,85313,114380,199693,COST
06080020101180000,2021,198802,162760,361562,COST
06080020101180000,2020,119620,137090,256710,COST
06080020101180000,2019,119620,137090,256710,COST
06080020201050000,2021,31861,0,31861,COST
06080020201050000,2020,17428,0,17428,COST
06080020201050000,2019,17428,0,17428,COST
06080020301010000,2021,92200,195730,287930,COST
06080020301010000,2020,52132,161600,213732,COST
06080020301010000,2019,52132,147820,199952,COST
06080020301150000,2021,9604,0,9604,COST
06080020301150000,2020,5171,0,5171,COST
06080020301150000,2019,5171,0,5171,COST
06080020301200000,2021,15710,0,15710,COST
06080020301200000,2020,8238,0,8238,COST
06080020301200000,2019,8238,0,8238,COST
06080020302010000,2021,6,0,6,COST
06080020302010000,2020,6,0,6,COST
06080020302010000,2019,6,0,6,COST
06080020378540000,2021,228374,105750,334124,COST
06080020378540000,2020,215288,50212,265500,OVR
06080020378540000,2019,215288,50212,265500,OVR
06080020401010000,2021,190288,0,190288,COST
06080020401010000,2020,99369,0,99369,COST
06080020401010000,2019,99369,0,99369,COST
06080020401060000,2021,221165,205935,427100,MKT
06080020401060000,2020,187927,130540,318467,COST
06080020401060000,2019,187927,130540,318467,COST
06080020440010000,2021,171521,246180,417701,COST
06080020440010000,2020,63998,310602,374600,INCOME
06080020440010000,2019,63998,310602,374600,INCOME
06080021101010000,2021,4774,0,4774,COST
06080021101010000,2020,4446,0,4446,COST
06080021101010000,2019,4446,0,4446,COST
06080021201010000,2021,67272,0,67272,COST
06080021201010000,2020,39674,0,39674,COST
06080021201010000,2019,39674,0,39674,COST
06080021304010000,2021,1717,0,1717,COST
06080021304010000,2020,1096,0,1096,COST
06080021304010000,2019,1096,0,1096,COST
06080021401080000,2021,118222,320710,438932,COST
06080021401080000,2020,74720,292480,367200,COST
06080021401080000,2019,74720,292480,367200,COST
06080021405010000,2021,57180,220680,277860,COST
06080021405010000,2020,41791,174630,216421,COST
06080021405010000,2019,41791,174630,216421,COST
06080021405050000,2021,1804,0,1804,COST
06080021405050000,2020,1679,0,1679,COST
06080021405050000,2019,1679,0,1679,COST
06080021405400000,2021,15760,0,15760,COST
06080021405400000,2020,8536,0,8536,COST
06080021405400000,2019,8536,0,8536,COST
06080022101010000,2021,1107,0,1107,COST
06080022101010000,2020,1030,0,1030,COST
06080022101010000,2019,1030,0,1030,COST
06080022101100000,2021,1107,0,1107,COST
06080022101100000,2020,1030,0,1030,COST
06080022101100000,2019,1030,0,1030,COST
06080022101200000,2021,66098,177070,243168,COST
06080022101200000,2020,46502,156420,202922,COST
06080022101200000,2019,46502,156420,202922,COST
06080022101300000,2021,63324,12820,76144,COST
06080022101300000,2020,45122,12900,58022,COST
06080022101300000,2019,45122,12900,58022,COST
06080022101400000,2021,55552,304970,360522,COST
06080022101400000,2020,41223,266730,307953,COST
06080022101400000,2019,41223,266730,307953,COST
06080022101500000,2021,46832,361920,408752,COST
06080022101500000,2020,36796,322470,359266,COST
06080022101500000,2019,36796,322470,359266,COST
06080022101600000,2021,57973,543580,601553,COST
06080022101600000,2020,42505,455250,497755,COST
06080022101600000,2019,42505,455250,497755,COST
06080022101700000,2021,68599,197840,266439,COST
06080022101700000,2020,47652,101910,149562,COST
06080022101700000,2019,47652,101910,149562,COST
06080022101800000,2021,109921,440640,550561,COST
06080022101800000,2020,86837,322763,409600,MKT
06080022101800000,2019,86837,322763,409600,MKT
06080022201050000,2021,4992,0,4992,COST
06080022201050000,2020,4647,0,4647,COST
06080022201050000,2019,4647,0,4647,COST
06080022210010000,2021,55702,316130,371832,COST
06080022210010000,2020,41362,283840,325202,COST
06080022210010000,2019,41362,283840,325202,COST
06080022210100000,2021,46832,167260,214092,COST
06080022210100000,2020,36796,161690,198486,COST
06080022210100000,2019,36796,161690,198486,COST
06080022210200000,2021,12722,0,12722,COST
06080022210200000,2020,7039,0,7039,COST
06080022210200000,2019,7039,0,7039,COST
06080022301010000,2021,55557,434190,489747,COST
06080022301010000,2020,41227,359560,400787,COST
06080022301010000,2019,41227,167250,208477,COST
06080022301200000,2021,11176,1260,12436,COST
06080022301200000,2020,6033,1390,7423,COST
06080022301200000,2019,6033,1390,7423,COST
06080022301300000,2021,62213,347260,409473,COST
06080022301300000,2020,44506,305340,349846,COST
06080022301300000,2019,44506,305340,349846,COST
06080022301400000,2021,10889,0,10889,COST
06080022301400000,2020,5863,0,5863,COST
06080022301400000,2019,5863,0,5863,COST
06080022302010000,2021,10886,0,10886,COST
06080022302010000,2020,5880,0,5880,COST
06080022302010000,2019,5880,0,5880,COST
06080022302200000,2021,65120,111940,177060,COST
06080022302200000,2020,45977,99770,145747,COST
06080022302200000,2019,45977,99770,145747,COST
06080022302400000,2021,65120,355730,420850,COST
06080022302400000,2020,45977,315560,361537,COST
06080022302400000,2019,45977,315560,361537,COST
06080022302600000,2021,65120,362520,427640,COST
06080022302600000,2020,45977,311760,357737,COST
06080022302600000,2019,45977,311260,357237,COST
06080022401010000,2021,10590,0,10590,COST
06080022401010000,2020,5720,0,5720,COST
06080022401010000,2019,5720,0,5720,COST
06080022401020000,2021,9309,0,9309,COST
06080022401020000,2020,5091,0,5091,COST
06080022401020000,2019,5091,0,5091,COST
06080022401030000,2021,10048,0,10048,COST
06080022401030000,2020,5466,0,5466,COST
06080022401030000,2019,5466,0,5466,COST
06080022401040000,2021,10322,0,10322,COST
06080022401040000,2020,5561,0,5561,COST
06080022401040000,2019,5561,0,5561,COST
06080022401050000,2021,10085,0,10085,COST
06080022401050000,2020,5438,0,5438,COST
06080022401050000,2019,5438,0,5438,COST
06080022401060000,2021,9832,0,9832,COST
06080022401060000,2020,5301,0,5301,COST
06080022401060000,2019,5301,0,5301,COST
06080022401070000,2021,10312,0,10312,COST
06080022401070000,2020,5557,0,5557,COST
06080022401070000,2019,5557,0,5557,COST
06080022401080000,2021,10394,0,10394,COST
06080022401080000,2020,5597,0,5597,COST
06080022401080000,2019,5597,0,5597,COST
06080023101010000,2021,29718,0,29718,COST
06080023101010000,2020,16700,0,16700,COST
06080023101010000,2019,16700,0,16700,COST
06080023101050000,2021,1107,0,1107,COST
06080023101050000,2020,1030,0,1030,COST
06080023101050000,2019,1030,0,1030,COST
06080023102100000,2021,1107,0,1107,COST
06080023102100000,2020,1030,0,1030,COST
06080023102100000,2019,1030,0,1030,COST
06080023102200000,2021,55552,124050,179602,COST
06080023102200000,2020,41223,103780,145003,COST
06080023102200000,2019,41223,103780,145003,COST
06080023102300000,2021,1107,0,1107,COST
06080023102300000,2020,1030,0,1030,COST
06080023102300000,2019,1030,0,1030,COST
06080023204010000,2021,74252,607570,681822,COST
06080023204010000,2020,45599,523600,569199,COST
06080023204010000,2019,45599,523600,569199,COST
06080023204050000,2021,4522,0,4522,COST
06080023204050000,2020,2440,0,2440,COST
06080023204050000,2019,2440,0,2440,COST
06080023208010000,2021,79081,0,79081,COST
06080023208010000,2020,48207,0,48207,COST
06080023208010000,2019,48207,0,48207,COST
06080023220010000,2021,22963,0,22963,COST
06080023220010000,2020,12669,0,12669,COST
06080023220010000,2019,12669,0,12669,COST
06080023220040000,2021,1116,0,1116,COST
06080023220040000,2020,1039,0,1039,COST
06080023220040000,2019,1039,0,1039,COST
06080023220080000,2021,55561,136050,191611,COST
06080023220080000,2020,41231,117040,158271,COST
06080023220080000,2019,41231,118540,159771,COST
06080023301010000,2021,150386,644214,794600,MKT
06080023301010000,2020,122442,526120,648562,COST
06080023301010000,2019,122442,526120,648562,COST
06080023301060000,2021,150406,529270,679676,COST
06080023301060000,2020,122460,454170,576630,COST
06080023301060000,2019,122460,454170,576630,COST
06080023301120000,2021,64812,378440,443252,COST
06080023301120000,2020,40711,330420,371131,COST
06080023301120000,2019,40711,330420,371131,COST
06080023301180000,2021,557,0,557,COST
06080023301180000,2020,518,0,518,COST
06080023301180000,2019,518,0,518,COST
06080023301240000,2021,556,39000,39556,COST
06080023301240000,2020,518,38350,38868,COST
06080023301240000,2019,518,38350,38868,COST
06080023301360000,2021,177713,0,177713,COST
06080023301360000,2020,122637,0,122637,COST
06080023301360000,2019,122637,0,122637,COST
06080023301420000,2021,124063,184537,308600,MKT
06080023301420000,2020,122519,101580,224099,COST
06080023301420000,2019,122519,101580,224099,COST
06080023301480000,2021,177463,399737,577200,MKT
06080023301480000,2020,122448,333552,456000,MKT
06080023301480000,2019,122448,333552,456000,MKT
06080023301540000,2021,177549,408451,586000,MKT
06080023301540000,2020,122513,319187,441700,MKT
06080023301540000,2019,122513,319187,441700,MKT
06080023301600000,2021,177572,384428,562000,MKT
06080023301600000,2020,122531,309869,432400,MKT
06080023301600000,2019,122531,309869,432400,MKT
06080023301660000,2021,177588,371250,548838,COST
06080023301660000,2020,122543,328957,451500,MKT
06080023301660000,2019,122543,328957,451500,MKT
06080023301720000,2021,177619,585450,763069,COST
06080023301720000,2020,122566,470134,592700,MKT
06080023301720000,2019,122566,470134,592700,MKT
06080023301780000,2021,2228,0,2228,COST
06080023301780000,2020,2074,0,2074,COST
06080023301780000,2019,2074,0,2074,COST
06080023401010000,2021,42034,0,42034,COST
06080023401010000,2020,26069,0,26069,COST
06080023401010000,2019,26069,0,26069,COST
06080024105010000,2021,62124,359360,421484,COST
06080024105010000,2020,44452,312380,356832,COST
06080024105010000,2019,44452,312380,356832,COST
06080024105050000,2021,10448,0,10448,COST
06080024105050000,2020,5673,0,5673,COST
06080024105050000,2019,5673,0,5673,COST
06080024105100000,2021,1704,0,1704,COST
06080024105100000,2020,1585,0,1585,COST
06080024105100000,2019,1585,0,1585,COST
06080024105150000,2021,70127,453180,523307,COST
06080024105150000,2020,50706,389600,440306,COST
06080024105150000,2019,50706,389600,440306,COST
06080024105200000,2021,178143,0,178143,COST
06080024105200000,2020,147425,0,147425,COST
06080024105200000,2019,147425,0,147425,COST
06080024205010000,2021,55778,600120,655898,COST
06080024205010000,2020,41434,437780,479214,COST
06080024205010000,2019,41434,51380,92814,COST
06080024205050000,2021,151519,408150,559669,COST
06080024205050000,2020,123454,348546,472000,MKT
06080024205050000,2019,123454,348546,472000,MKT
06080024205150000,2021,70771,657190,727961,COST
06080024205150000,2020,49416,574560,623976,COST
06080024205150000,2019,49416,574560,623976,COST
06080024205200000,2021,1119,0,1119,COST
06080024205200000,2020,1042,0,1042,COST
06080024205200000,2019,1042,0,1042,COST
06080024205250000,2021,62895,37840,100735,COST
06080024205250000,2020,44802,32470,77272,COST
06080024205250000,2019,44802,32470,77272,COST
06080024205300000,2021,55620,428320,483940,COST
06080024205300000,2020,41286,355490,396776,COST
06080024205300000,2019,41286,353400,394686,COST
06080024205350000,2021,63183,556590,619773,COST
06080024205350000,2020,45182,477030,522212,COST
06080024205350000,2019,45182,477030,522212,COST
06080024205400000,2021,153463,264560,418023,COST
06080024205400000,2020,125192,253108,378300,MKT
06080024205400000,2019,125192,253108,378300,MKT
06080024205500000,2021,9131,0,9131,COST
06080024205500000,2020,4974,0,4974,COST
06080024205500000,2019,4974,0,4974,COST
06080024205550000,2021,63899,209730,273629,COST
06080024205550000,2020,45309,184700,230009,COST
06080024205550000,2019,45309,184700,230009,COST
06080024205600000,2021,1112,0,1112,COST
06080024205600000,2020,1035,0,1035,COST
06080024205600000,2019,1035,0,1035,COST
06080024205650000,2021,55667,484180,539847,COST
06080024205650000,2020,41330,408070,449400,COST
06080024205650000,2019,41330,408070,449400,COST
06080024205700000,2021,150320,438520,588840,COST
06080024205700000,2020,122383,431517,553900,MKT
06080024205700000,2019,122383,387817,510200,MKT
06080024205800000,2021,151361,0,151361,COST
06080024205800000,2020,123313,0,123313,COST
06080024205800000,2019,123313,0,123313,COST
06080024210010000,2021,1268,0,1268,COST
06080024210010000,2020,1180,0,1180,COST
06080024210010000,2019,1180,0,1180,COST
06080024301100000,2021,67086,268960,336046,COST
06080024301100000,2020,41394,172390,213784,COST
06080024301100000,2019,41394,172390,213784,COST
06080024301300000,2021,65445,503990,569435,COST
06080024301300000,2020,41300,421740,463040,COST
06080024301300000,2019,41300,420180,461480,COST
06080024301500000,2021,65560,449310,514870,COST
06080024301500000,2020,41408,387570,428978,COST
06080024301500000,2019,41408,387570,428978,COST
06080024405010000,2021,1156,0,1156,COST
06080024405010000,2020,1075,0,1075,COST
06080024405010000,2019,1075,0,1075,COST
06080024405050000,2021,150320,429590,579910,COST
06080024405050000,2020,122383,358417,480800,MKT
06080024405050000,2019,122383,358417,480800,MKT
06080024405070000,2021,1150,0,1150,COST
06080024405070000,2020,1070,0,1070,COST
06080024405070000,2019,1070,0,1070,COST
06080024405100000,2021,56664,107520,164184,COST
06080024405100000,2020,42258,95500,137758,COST
06080024405100000,2019,42258,95500,137758,COST
06080025101010000,2021,65563,245470,311033,COST
06080025101010000,2020,41410,214980,256390,COST
06080025101010000,2019,41410,214980,256390,COST
06080025101250000,2021,1485,0,1485,COST
06080025101250000,2020,1382,0,1382,COST
06080025101250000,2019,1382,0,1382,COST
06080025103010000,2021,67138,400390,467528,COST
06080025103010000,2020,41443,208550,249993,COST
06080025103010000,2019,41443,208550,249993,COST
06080025103250000,2021,1452,0,1452,COST
06080025103250000,2020,1351,0,1351,COST
06080025103250000,2019,1351,0,1351,COST
06080025103500000,2021,1145,0,1145,COST
06080025103500000,2020,1066,0,1066,COST
06080025103500000,2019,1066,0,1066,COST
06080025107010000,2021,65459,493490,558949,COST
06080025107010000,2020,41313,409430,450743,COST
06080025107010000,2019,41313,409430,450743,COST
06080025107200000,2021,66995,276430,343425,COST
06080025107200000,2020,41310,137520,178830,COST
06080025107200000,2019,41310,137520,178830,COST
06080025201010000,2021,55557,779630,835187,COST
06080025201010000,2020,41228,664260,705488,COST
06080025201010000,2019,41228,519120,560348,COST
06080025201200000,2021,55765,451760,507525,COST
06080025201200000,2020,41421,384030,425451,COST
06080025201200000,2019,41421,384030,425451,COST
06080025203010000,2021,1256,0,1256,COST
06080025203010000,2020,1169,0,1169,COST
06080025203010000,2019,1169,0,1169,COST
06080025203200000,2021,1307,0,1307,COST
06080025203200000,2020,1216,0,1216,COST
06080025203200000,2019,1216,0,1216,COST
06080025205010000,2021,65403,509720,575123,COST
06080025205010000,2020,41261,435620,476881,COST
06080025205010000,2019,41261,325650,366911,COST
06080025205200000,2021,1159,2290,3449,COST
06080025205200000,2020,1078,2350,3428,COST
06080025205200000,2019,1078,2350,3428,COST
06080025207010000,2021,65432,896260,961692,COST
06080025207010000,2020,41288,764980,806268,COST
06080025207010000,2019,41288,764980,806268,COST
06080025207250000,2021,65592,256600,322192,COST
06080025207250000,2020,41437,223150,264587,COST
06080025207250000,2019,41437,223150,264587,COST
06080025301010000,2021,76288,477450,553738,COST
06080025301010000,2020,41248,403520,444768,COST
06080025301010000,2019,41248,403520,444768,COST
06080025301200000,2021,1113,0,1113,COST
06080025301200000,2020,1035,0,1035,COST
06080025301200000,2019,1035,0,1035,COST
06080025303010000,2021,1236,0,1236,COST
06080025303010000,2020,1150,0,1150,COST
06080025303010000,2019,1150,0,1150,COST
06080025303200000,2021,55659,188280,243939,COST
06080025303200000,2020,41323,162210,203533,COST
06080025303200000,2019,41323,162210,203533,COST
06080025305010000,2021,55836,290420,346256,COST
06080025305010000,2020,41487,250650,292137,COST
06080025305010000,2019,41487,250650,292137,COST
06080025305250000,2021,55788,426550,482338,COST
06080025305250000,2020,41442,320370,361812,COST
06080025305250000,2019,41442,321590,363032,COST
06080025401010000,2021,1107,0,1107,COST
06080025401010000,2020,1030,0,1030,COST
06080025401010000,2019,1030,0,1030,COST
06080025401200000,2021,76267,520160,596427,COST
06080025401200000,2020,41228,439000,480228,COST
06080025401200000,2019,41228,439000,480228,COST
06080025403010000,2021,1118,0,1118,COST
06080025403010000,2020,1041,0,1041,COST
06080025403010000,2019,1041,0,1041,COST
06080025405010000,2021,1246,0,1246,COST
06080025405010000,2020,1160,0,1160,COST
06080025405010000,2019,1160,0,1160,COST
06080025405200000,2021,55690,407530,463220,COST
06080025405200000,2020,41352,340290,381642,COST
06080025405200000,2019,41352,340290,381642,COST
06080025407010000,2021,1340,0,1340,COST
06080025407010000,2020,1247,0,1247,COST
06080025407010000,2019,1247,0,1247,COST
06080025407250000,2021,55570,635410,690980,COST
06080025407250000,2020,41240,535170,576410,COST
06080025407250000,2019,41240,535170,576410,COST
06080025407500000,2021,1118,0,1118,COST
06080025407500000,2020,1041,0,1041,COST
06080025407500000,2019,1041,0,1041,COST
06080026101010000,2021,63616,456120,519736,COST
06080026101010000,2020,45228,377740,422968,COST
06080026101010000,2019,45228,377740,422968,COST
06080026101090000,2021,154337,705750,860087,COST
06080026101090000,2020,125974,596550,722524,COST
06080026101090000,2019,125974,596550,722524,COST
06080026101170000,2021,55562,453900,509462,COST
06080026101170000,2020,41232,378240,419472,COST
06080026101170000,2019,41232,378240,419472,COST
06080026101250000,2021,157978,279710,437688,COST
06080026101250000,2020,129235,236600,365835,COST
06080026101250000,2019,129235,236600,365835,COST
06080026101330000,2021,155846,351854,507700,MKT
06080026101330000,2020,127324,315576,442900,MKT
06080026101330000,2019,127324,305076,432400,MKT
06080026101410000,2021,55563,368530,424093,COST
06080026101410000,2020,41233,305930,347163,COST
06080026101410000,2019,41233,305930,347163,COST
06080026101490000,2021,158059,295041,453100,MKT
06080026101490000,2020,129307,272993,402300,MKT
06080026101490000,2019,129307,272993,402300,MKT
06080026101570000,2021,155409,488291,643700,MKT
06080026101570000,2020,126932,384868,511800,MKT
06080026101570000,2019,126932,384868,511800,MKT
06080026101650000,2021,55620,201930,257550,COST
06080026101650000,2020,41286,174350,215636,COST
06080026101650000,2019,41286,174350,215636,COST
06080026101730000,2021,158071,0,158071,COST
06080026101730000,2020,129318,0,129318,COST
06080026101730000,2019,129318,0,129318,COST
06080026101810000,2021,115026,0,115026,COST
06080026101810000,2020,126961,0,126961,COST
06080026101810000,2019,126961,0,126961,COST
06080026101880000,2021,162653,263070,425723,COST
06080026101880000,2020,133433,267167,400600,MKT
06080026101880000,2019,133433,267167,400600,MKT
06080026201010000,2021,589,0,589,COST
06080026201010000,2020,548,0,548,COST
06080026201010000,2019,548,0,548,COST
06080026201060000,2021,159829,315790,475619,COST
06080026201060000,2020,130896,320804,451700,MKT
06080026201060000,2019,130896,320804,451700,MKT
06080026201110000,2021,55028,232530,287558,COST
06080026201110000,2020,40735,200990,241725,COST
06080026201110000,2019,40735,200990,241725,COST
06080026201160000,2021,151676,670924,822600,MKT
06080026201160000,2020,123594,576110,699704,COST
06080026201160000,2019,123594,576110,699704,COST
06080026201210000,2021,116837,262610,379447,COST
06080026201210000,2020,92844,254856,347700,MKT
06080026201210000,2019,92844,254856,347700,MKT
06080026201260000,2021,116618,406360,522978,COST
06080026201260000,2020,92653,319510,412163,COST
06080026201260000,2019,92653,319510,412163,COST
06080026201310000,2021,55699,180060,235759,COST
06080026201310000,2020,41360,155670,197030,COST
06080026201310000,2019,41360,155670,197030,COST
06080026201410000,2021,158747,710053,868800,MKT
06080026201410000,2020,129924,526626,656550,OVR
06080026201410000,2019,129924,526626,656550,OVR
06080026201460000,2021,114153,498140,612293,COST
06080026201460000,2020,94429,356971,451400,MKT
06080026201460000,2019,94429,0,94429,COST
06080026201510000,2021,112916,0,112916,COST
06080026201510000,2020,93308,0,93308,COST
06080026201510000,2019,93308,0,93308,COST
06080026201560000,2021,158740,289560,448300,MKT
06080026201560000,2020,129919,259881,389800,MKT
06080026201560000,2019,129919,259881,389800,MKT
06080026201610000,2021,159394,924660,1084054,COST
06080026201610000,2020,130505,600410,730915,COST
06080026201610000,2019,130505,594790,725295,COST
06080026201660000,2021,151519,361381,512900,MKT
06080026201660000,2020,123454,355146,478600,MKT
06080026201660000,2019,123454,355146,478600,MKT
06080026201710000,2021,156117,579900,736017,COST
06080026201710000,2020,127567,484930,612497,COST
06080026201710000,2019,127567,484930,612497,COST
06080026201760000,2021,170629,636880,807509,COST
06080026201760000,2020,140623,531840,672463,COST
06080026201760000,2019,140623,431877,572500,MKT
06080026201810000,2021,158059,653341,811400,MKT
06080026201810000,2020,129307,585470,714777,OVR
06080026201810000,2019,129307,585470,714777,COST
06080026301010000,2021,166262,0,166262,COST
06080026301010000,2020,136683,0,136683,COST
06080026301010000,2019,136683,0,136683,COST
06080026301060000,2021,165391,370409,535800,MKT
06080026301060000,2020,135898,310002,445900,MKT
06080026301060000,2019,135898,310002,445900,MKT
06080026301100000,2021,558,0,558,COST
06080026301100000,2020,520,0,520,COST
06080026301100000,2019,520,0,520,COST
06080026301150000,2021,55297,300790,356087,COST
06080026301150000,2020,40985,260120,301105,COST
06080026301150000,2019,40985,260120,301105,COST
06080026301200000,2021,150247,650210,800457,COST
06080026301200000,2020,122318,488690,611008,COST
06080026301200000,2019,122318,488690,611008,COST
06080026301250000,2021,150207,527893,678100,MKT
06080026301250000,2020,122283,364117,486400,MKT
06080026301250000,2019,122283,364117,486400,MKT
06080026301300000,2021,150564,349650,500214,COST
06080026301300000,2020,122602,290198,412800,MKT
06080026301300000,2019,122602,290198,412800,MKT
06080026301340000,2021,150663,762390,913053,COST
06080026301340000,2020,122690,651690,774380,COST
06080026301340000,2019,122690,651690,774380,COST
06080026301400000,2021,150571,809730,960301,COST
06080026301400000,2020,122608,671940,794548,COST
06080026301400000,2019,122608,671940,794548,COST
06080026301450000,2021,173005,726995,900000,OVR
06080026301450000,2020,142771,587029,729800,MKT
06080026301450000,2019,142771,587029,729800,MKT
06080026301510000,2021,554,107910,108464,COST
06080026301510000,2020,516,106010,106526,COST
06080026301510000,2019,516,106010,106526,COST
06080026301550000,2021,560,0,560,COST
06080026301550000,2020,521,0,521,COST
06080026301550000,2019,521,0,521,COST
06080026301750000,2021,55000,1077500,1132500,COST
06080026301750000,2020,40709,923910,964619,COST
06080026301750000,2019,40709,923910,964619,COST
06080026301850000,2021,173315,448385,621700,MKT
06080026301850000,2020,143051,377249,520300,MKT
06080026301850000,2019,143051,377249,520300,MKT
06080026401010000,2021,39427,0,39427,COST
06080026401010000,2020,21444,0,21444,COST
06080026401010000,2019,21444,0,21444,COST
06080026401150000,2021,55614,518720,574334,COST
06080026401150000,2020,41280,461100,502380,COST
06080026401150000,2019,41280,461100,502380,COST
06080026401300000,2021,8574,3480,12054,COST
06080026401300000,2020,44665,541500,586165,COST
06080026401300000,2019,44665,541500,586165,COST
06080026401450000,2021,55615,616600,672215,COST
06080026401450000,2020,41281,510160,551441,COST
06080026401450000,2019,41281,510160,551441,COST
06080027101500000,2021,55338,791130,846468,COST
06080027101500000,2020,41024,687770,728794,COST
06080027101500000,2019,41024,683850,724874,COST
06080027101550000,2021,955,0,955,COST
06080027101550000,2020,889,0,889,COST
06080027101550000,2019,889,0,889,COST
06080027110010000,2021,55579,257210,312789,COST
06080027110010000,2020,41248,220960,262208,COST
06080027110010000,2019,41248,220960,262208,COST
06080027110200000,2021,56266,507720,563986,COST
06080027110200000,2020,41887,432790,474677,COST
06080027110200000,2019,41887,432790,474677,COST
06080027110300000,2021,55729,212930,268659,COST
06080027110300000,2020,41388,187290,228678,COST
06080027110300000,2019,41388,187290,228678,COST
06080027110400000,2021,77493,286680,364173,COST
06080027110400000,2020,56647,251590,308237,OVR
06080027110400000,2019,56647,251590,308237,COST
06080027110500000,2021,1636,0,1636,COST
06080027110500000,2020,1522,0,1522,COST
06080027110500000,2019,1522,0,1522,COST
06080027110580000,2021,139957,211143,351100,MKT
06080027110580000,2020,144429,143680,288109,COST
06080027110580000,2019,144429,143680,288109,COST
06080027110660000,2021,193862,366638,560500,MKT
06080027110660000,2020,161745,330055,491800,MKT
06080027110660000,2019,161745,330055,491800,MKT
06080027110740000,2021,202192,457820,660012,COST
06080027110740000,2020,169379,179630,349009,COST
06080027110740000,2019,169379,76480,245859,COST
06080027110820000,2021,150789,570,151359,COST
06080027110820000,2020,122802,550,123352,COST
06080027110820000,2019,122802,550,123352,COST
06080027201050000,2021,63531,378330,441861,COST
06080027201050000,2020,54897,249320,304217,COST
06080027201050000,2019,54897,128720,183617,COST
06080027210010000,2021,55719,272140,327859,COST
06080027210010000,2020,41379,240820,282199,COST
06080027210010000,2019,41379,240820,282199,COST
06080027210440000,2021,2705,780,3485,COST
06080027210440000,2020,166524,0,166524,OVR
06080027210440000,2019,166524,0,166524,COST
06080027210520000,2021,156162,536938,693100,MKT
06080027210520000,2020,127607,394293,521900,OVR
06080027210520000,2019,127607,447340,574947,COST
06080027210600000,2021,193819,383910,577729,COST
06080027210600000,2020,161705,347395,509100,MKT
06080027210600000,2019,161705,347395,509100,MKT
06080027301100000,2021,160337,455230,615567,COST
06080027301100000,2020,131352,369348,500700,MKT
06080027301100000,2019,131352,369348,500700,MKT
06080027301150000,2021,1507,0,1507,COST
06080027301150000,2020,1434,0,1434,COST
06080027301150000,2019,1434,0,1434,COST
06080027301200000,2021,77450,283650,361100,COST
06080027301200000,2020,56381,251280,307661,COST
06080027301200000,2019,56381,251280,307661,COST
06080027301250000,2021,246016,275684,521700,MKT
06080027301250000,2020,200422,224978,425400,MKT
06080027301250000,2019,200422,211578,412000,MKT
06080027301400000,2021,1643,0,1643,COST
06080027301400000,2020,1529,0,1529,COST
06080027301400000,2019,1529,0,1529,COST
06080027302010000,2021,219560,260740,480300,MKT
06080027302010000,2020,176922,125200,302122,COST
06080027302010000,2019,176922,125200,302122,COST
06080027302050000,2021,219393,210280,429673,COST
06080027302050000,2020,176775,185070,361845,COST
06080027302050000,2019,176775,185070,361845,COST
06080027302100000,2021,78072,168750,246822,COST
06080027302100000,2020,57186,145530,202716,COST
06080027302100000,2019,57186,145530,202716,COST
06080027302250000,2021,219630,298670,518300,MKT
06080027302250000,2020,176984,291450,468434,COST
06080027302250000,2019,176984,291450,468434,COST
06080027302300000,2021,219815,406285,626100,MKT
06080027302300000,2020,177147,338316,515463,OVR
06080027302300000,2019,177147,338316,515463,OVR
06080027401050000,2021,55555,397110,452665,COST
06080027401050000,2020,41226,327500,368726,COST
06080027401050000,2019,41226,327500,368726,COST
06080027401300000,2021,221890,589380,811270,COST
06080027401300000,2020,178982,419418,598400,MKT
06080027401300000,2019,178982,384918,563900,MKT
06080027401450000,2021,151302,451298,602600,MKT
06080027401450000,2020,123261,413739,537000,MKT
06080027401450000,2019,123261,239390,362651,COST
06080027401500000,2021,179751,0,179751,COST
06080027401500000,2020,148885,0,148885,COST
06080027401500000,2019,773,0,773,COST
06080027401550000,2021,218953,612930,831883,COST
06080027401550000,2020,176386,537650,714036,COST
06080027401550000,2019,176386,537650,714036,COST
06080027401600000,2021,151296,0,151296,COST
06080027401600000,2020,123255,0,123255,COST
06080027401600000,2019,123255,0,123255,COST
06080027402010000,2021,224762,323338,548100,MKT
06080027402010000,2020,181522,280078,461600,MKT
06080027402010000,2019,56084,280640,336724,COST
06080027402080000,2021,180513,548680,729193,COST
06080027402080000,2020,142742,377058,519800,MKT
06080027402080000,2019,142742,377058,519800,MKT
06080027402100000,2021,139708,320250,459958,COST
06080027402100000,2020,112945,277455,390400,MKT
06080027402100000,2019,112945,277455,390400,MKT
06080027402150000,2021,124365,267335,391700,MKT
06080027402150000,2020,169638,283230,452868,COST
06080027402150000,2019,169638,272440,442078,COST
06080028101010000,2021,26439,0,26439,COST
06080028101010000,2020,16298,0,16298,COST
06080028101010000,2019,16298,0,16298,COST
06080028101100000,2021,22634,0,22634,COST
06080028101100000,2020,15876,0,15876,COST
06080028101100000,2019,15876,0,15876,COST
06080028103010000,2021,20148,0,20148,COST
06080028103010000,2020,12931,0,12931,COST
06080028103010000,2019,12931,0,12931,COST
06080028201010000,2021,15525,0,15525,COST
06080028201010000,2020,8915,0,8915,COST
06080028201010000,2019,8915,0,8915,COST
06080028202010000,2021,12831,0,12831,COST
06080028202010000,2020,7859,0,7859,COST
06080028202010000,2019,7859,0,7859,COST
06080028301010000,2021,41233,0,41233,COST
06080028301010000,2020,22345,0,22345,COST
06080028301010000,2019,22345,0,22345,COST
06080028401010000,2021,280110,0,280110,COST
06080028401010000,2020,231066,0,231066,COST
06080028401010000,2019,231066,0,231066,COST
06080028402010000,2021,17823,0,17823,COST
06080028402010000,2020,9620,0,9620,COST
06080028402010000,2019,9620,0,9620,COST
06080028403010000,2021,19578,0,19578,COST
06080028403010000,2020,10564,0,10564,COST
06080028403010000,2019,10564,0,10564,COST
06080028424010000,2021,15828,0,15828,COST
06080028424010000,2020,9608,0,9608,COST
06080028424010000,2019,9608,0,9608,COST
06080028478030000,2021,210679,368790,579469,COST
06080028478030000,2020,169093,320620,489713,COST
06080028478030000,2019,169093,320620,489713,COST
06080029101010000,2021,210572,0,210572,COST
06080029101010000,2020,113619,0,113619,COST
06080029101010000,2019,113619,0,113619,COST
06080029202010000,2021,121600,0,121600,COST
06080029202010000,2020,65559,0,65559,COST
06080029202010000,2019,65559,0,65559,COST
