id,year,land,building,total,method
06042822402030000,2021,565136,2160,567296,COST
06042822402030000,2020,709526,2090,711616,COST
06042822402030000,2019,709526,2090,711616,COST
06042822402040000,2021,513385,942799,1456184,OVR
06042822402040000,2020,635391,454270,1089661,COST
06042822402040000,2019,635391,454270,1089661,COST
06042823101010000,2021,238079,0,238079,COST
06042823101010000,2020,128638,0,128638,COST
06042823101010000,2019,128638,0,128638,COST
06042823201020000,2021,206745,484580,691325,COST
06042823201020000,2020,174342,228910,403252,COST
06042823201020000,2019,174342,228910,403252,COST
06042823201150000,2021,18958,0,18958,COST
06042823201150000,2020,10913,0,10913,COST
06042823201150000,2019,10913,0,10913,COST
06042824101010000,2021,260000,0,260000,COST
06042824101010000,2020,139680,0,139680,COST
06042824101010000,2019,139680,0,139680,COST
06042825101010000,2021,257968,0,257968,COST
06042825101010000,2020,138611,0,138611,COST
06042825101010000,2019,138611,0,138611,COST
06042826101010000,2021,256610,0,256610,COST
06042826101010000,2020,138092,0,138092,COST
06042826101010000,2019,138092,0,138092,COST
06042827101020000,2021,318707,1436240,1754947,COST
06042827101020000,2020,286666,960420,1247086,COST
06042827101020000,2019,286666,960420,1247086,COST
06042827101040000,2021,176740,114140,290880,COST
06042827101040000,2020,145597,111436,257033,MRA
06042827101040000,2019,145597,111436,257033,MRA
06042827101120000,2021,33404,0,33404,COST
06042827101120000,2020,40528,0,40528,COST
06042827101120000,2019,40528,0,40528,COST
06042827101990000,2021,34158,0,34158,COST
06042827101990000,2020,41580,0,41580,COST
06042827101990000,2019,41580,0,41580,COST
06042827102010000,2021,193643,0,193643,COST
06042827102010000,2020,104902,0,104902,COST
06042827102010000,2019,104902,0,104902,COST
06042827201040000,2021,352524,543630,896154,COST
06042827201040000,2020,321885,277650,599535,COST
06042827201040000,2019,321885,277650,599535,COST
06042827201050000,2021,258281,562120,820401,COST
06042827201050000,2020,225148,365820,590968,COST
06042827201050000,2019,225148,365820,590968,COST
06042827201060000,2021,222037,556110,778147,COST
06042827201060000,2020,189240,380310,569550,COST
06042827201060000,2019,189240,380310,569550,COST
06042827201070000,2021,257332,0,257332,COST
06042827201070000,2020,224198,0,224198,COST
06042827201070000,2019,224198,0,224198,COST
06042827201100000,2021,223355,434620,657975,COST
06042827201100000,2020,190531,294180,484711,COST
06042827201100000,2019,190531,294180,484711,COST
06042827201120000,2021,113854,0,113854,COST
06042827201120000,2020,134692,0,134692,COST
06042827201120000,2019,134692,0,134692,COST
06042827201140000,2021,373535,1201746,1575281,OVR
06042827201140000,2020,440902,585620,1026522,COST
06042827201140000,2019,440902,585620,1026522,COST
06042827201160000,2021,537809,327890,865699,COST
06042827201160000,2020,670247,269970,940217,COST
06042827201160000,2019,670247,269970,940217,COST
06042827201180000,2021,370839,871460,1242299,COST
06042827201180000,2020,341175,585390,926565,COST
06042827201180000,2019,341175,585390,926565,COST
06042827201200000,2021,193410,392340,585750,COST
06042827201200000,2020,161484,276088,437572,MRA
06042827201200000,2019,161484,276088,437572,MRA
06042827201210000,2021,304780,802440,1107220,COST
06042827201210000,2020,272319,525090,797409,COST
06042827201210000,2019,272319,525090,797409,COST
06042827201220000,2021,312020,0,312020,COST
06042827201220000,2020,441180,0,441180,COST
06042827201220000,2019,441180,0,441180,COST
06042827201300000,2021,291344,524770,816114,COST
06042827201300000,2020,258571,349130,607701,COST
06042827201300000,2019,258571,349130,607701,COST
06042827201400000,2021,211374,0,211374,COST
06042827201400000,2020,178835,0,178835,COST
06042827201400000,2019,178835,0,178835,COST
06042827202020000,2021,421200,46800,468000,OVR
06042827202020000,2020,624493,48580,673073,COST
06042827202020000,2019,624493,48580,673073,COST
06042827301020000,2021,213642,447950,661592,COST
06042827301020000,2020,181041,295210,476251,COST
06042827301020000,2019,181041,295210,476251,COST
06042827301030000,2021,605597,1468630,2074227,COST
06042827301030000,2020,768203,1097480,1865683,COST
06042827301030000,2019,768203,1097480,1865683,COST
06042827301060000,2021,360861,622440,983301,COST
06042827301060000,2020,423522,505180,928702,COST
06042827301060000,2019,423522,505180,928702,COST
06042827301200000,2021,605,0,605,COST
06042827301200000,2020,563,0,563,COST
06042827301200000,2019,563,0,563,COST
06042828101010000,2021,166996,0,166996,COST
06042828101010000,2020,91805,0,91805,COST
06042828101010000,2019,91805,0,91805,COST
06042828401200000,2021,568559,1017170,1585729,COST
06042828401200000,2020,854919,1083190,1938109,COST
06042828401200000,2019,854919,1083190,1938109,COST
06042828403010000,2021,413931,0,413931,COST
06042828403010000,2020,377017,0,377017,COST
06042828403010000,2019,377017,0,377017,COST
06042828403020000,2021,370000,0,370000,COST
06042828403020000,2020,387442,0,387442,COST
06042828403020000,2019,387442,0,387442,COST
06042828403030000,2021,345398,1067390,1412788,COST
06042828403030000,2020,306221,896460,1202681,COST
06042828403030000,2019,306221,896460,1202681,COST
06042829101010000,2021,160930,0,160930,COST
06042829101010000,2020,87410,0,87410,COST
06042829101010000,2019,87410,0,87410,COST
06042829301010000,2021,7689,0,7689,COST
06042829301010000,2020,4126,0,4126,COST
06042829301010000,2019,4126,0,4126,COST
06042829303010000,2021,7661,0,7661,COST
06042829303010000,2020,4110,0,4110,COST
06042829303010000,2019,4110,0,4110,COST
06042829306010000,2021,188838,1087190,1276028,COST
06042829306010000,2020,276953,921010,1197963,COST
06042829306010000,2019,276953,921010,1197963,COST
06042829309010000,2021,98225,467470,565695,COST
06042829309010000,2020,140519,396850,537369,COST
06042829309010000,2019,140519,396850,537369,COST
06042829311010000,2021,7661,0,7661,COST
06042829311010000,2020,4110,0,4110,COST
06042829311010000,2019,4110,0,4110,COST
06042829313010000,2021,98197,264950,363147,COST
06042829313010000,2020,140504,225990,366494,COST
06042829313010000,2019,140504,225990,366494,COST
06042829315010000,2021,98225,241160,339385,COST
06042829315010000,2020,140519,206690,347209,COST
06042829315010000,2019,140519,206690,347209,COST
06042829317010000,2021,98225,505660,603885,COST
06042829317010000,2020,140519,428590,569109,COST
06042829317010000,2019,140519,428590,569109,COST
06042830101010000,2021,240878,0,240878,COST
06042830101010000,2020,129285,0,129285,COST
06042830101010000,2019,129285,0,129285,COST
06042831101010000,2021,47039,0,47039,COST
06042831101010000,2020,25600,0,25600,COST
06042831101010000,2019,25600,0,25600,COST
06042831101050000,2021,548736,0,548736,COST
06042831101050000,2020,513083,0,513083,COST
06042831101050000,2019,502141,0,502141,COST
06042831101120000,2021,478520,1055780,1534300,COST
06042831101120000,2020,438390,884320,1322710,COST
06042831101120000,2019,438390,645110,1083500,COST
06042831101140000,2021,474214,422730,896944,COST
06042831101140000,2020,433860,259790,693650,COST
06042831101140000,2019,433860,259790,693650,COST
06042831101180000,2021,283618,0,283618,COST
06042831101180000,2020,240344,0,240344,COST
06042831101180000,2019,240344,0,240344,COST
06042831101260000,2021,321463,529230,850693,COST
06042831101260000,2020,277549,375480,653029,COST
06042831101260000,2019,277549,328330,605879,COST
06042831101500000,2021,1628,0,1628,COST
06042831101500000,2020,1515,0,1515,COST
06042831101500000,2019,1515,0,1515,COST
06042831201017000,2021,494518,68810,563328,COST
06042831201017000,2020,862446,1748954,2611400,INCOME
06042831201017000,2019,2051819,559581,2611400,INCOME
06042831201100000,2021,510383,0,510383,COST
06042831201100000,2020,910654,0,910654,COST
06042831201200000,2021,482164,0,482164,COST
06042831201200000,2020,825671,0,825671,COST
06042831201300000,2021,642487,0,642487,COST
06042831201300000,2020,1353773,0,1353773,COST
06042831205160000,2021,340616,232780,573396,COST
06042831205160000,2020,1082926,238660,1321586,COST
06042831205160000,2019,1105845,238660,1344505,COST
06042831301010000,2021,388558,0,388558,COST
06042831301010000,2020,345092,0,345092,COST
06042831301010000,2019,345092,0,345092,COST
06042831301150000,2021,593219,0,593219,COST
06042831301150000,2020,561159,0,561159,COST
06042831301150000,2019,561159,0,561159,COST
06042831301160000,2021,544993,2439520,2984513,COST
06042831301160000,2020,509064,1647330,2156394,COST
06042831301160000,2019,509064,1645640,2154704,COST
06042831301200000,2021,347466,910310,1257776,COST
06042831301200000,2020,303498,507210,810708,COST
06042831301200000,2019,303498,507210,810708,COST
06042831301260000,2021,505734,75450,581184,COST
06042831301260000,2020,467158,119710,586868,COST
06042831301260000,2019,467158,119710,586868,COST
06042831301280000,2021,373415,213170,586585,COST
06042831301280000,2020,329684,130870,460554,COST
06042831301280000,2019,329684,130870,460554,COST
06042831301320000,2021,533298,386370,919668,COST
06042831301320000,2020,496532,294590,791122,COST
06042831301320000,2019,496532,294590,791122,COST
06042831301360000,2021,389056,1020744,1409800,INCOME
06042831301360000,2020,570562,821838,1392400,INCOME
06042831301360000,2019,570562,821838,1392400,INCOME
06042831301380000,2021,441539,0,441539,COST
06042831301380000,2020,709520,0,709520,COST
06042831301380000,2019,709520,0,709520,COST
06042831301440000,2021,373248,480710,853958,COST
06042831301440000,2020,1654,422610,424264,COST
06042831301440000,2019,1654,422610,424264,COST
06042831301460000,2021,242175,640998,883173,MRA
06042831301460000,2020,200449,557151,757600,MKT
06042831301460000,2019,200449,557151,757600,MKT
06042831301480000,2021,195094,418950,614044,COST
06042831301480000,2020,156359,234400,390759,COST
06042831301480000,2019,156359,234400,390759,COST
06042831301500000,2021,304425,658690,963115,COST
06042831301500000,2020,260713,539269,799982,MRA
06042831301500000,2019,260713,539269,799982,MRA
06042831301520000,2021,379629,777450,1157079,COST
06042831301520000,2020,335996,664150,1000146,COST
06042831301520000,2019,335996,547620,883616,COST
06042831301560000,2021,223,0,223,COST
06042831301560000,2020,207,0,207,COST
06042831301560000,2019,207,0,207,COST
06042831301580000,2021,533,0,533,COST
06042831301580000,2020,496,0,496,COST
06042831301580000,2019,496,0,496,COST
06042831301600000,2021,294686,166110,460796,COST
06042831301600000,2020,251152,119700,370852,COST
06042831301600000,2019,251152,119700,370852,COST
06042831301620000,2021,276074,56810,332884,COST
06042831301620000,2020,233013,112538,345551,MRA
06042831301620000,2019,233013,112538,345551,MRA
06042831301680000,2021,189846,512430,702276,COST
06042831301680000,2020,151536,400547,552083,MRA
06042831301680000,2019,151536,400547,552083,MRA
06042831301700000,2021,246478,3376570,3623048,COST
06042831301700000,2020,204531,2064710,2269241,COST
06042831301700000,2019,204531,1931100,2135631,COST
06042831301720000,2021,371,0,371,COST
06042831301720000,2020,345,0,345,COST
06042831301720000,2019,345,0,345,COST
06042831301760000,2021,245952,368280,614232,COST
06042831301760000,2020,204045,321090,525135,COST
06042831301760000,2019,204045,321090,525135,COST
06042831301780000,2021,265895,103440,369335,COST
06042831301780000,2020,223168,138232,361400,MKT
06042831301780000,2019,223168,138232,361400,MKT
06042831302010000,2021,69003,0,69003,COST
06042831302010000,2020,37454,0,37454,COST
06042831302010000,2019,37454,0,37454,COST
06042831401026500,2021,164279,0,164279,COST
06042831401026500,2020,153729,0,153729,COST
06042831401026500,2019,153729,0,153729,COST
06042831401420000,2021,290058,0,290058,COST
06042831401420000,2020,246625,0,246625,COST
06042831401420000,2019,246625,0,246625,COST
06042831401440000,2021,320378,0,320378,COST
06042831401440000,2020,276472,0,276472,COST
06042831401440000,2019,276472,0,276472,COST
06042831419010000,2021,181,0,181,COST
06042831419010000,2020,169,0,169,COST
06042831419010000,2019,169,0,169,COST
06042831440010000,2021,331967,0,331967,COST
06042831440010000,2020,287994,0,287994,COST
06042831440010000,2019,287994,0,287994,COST
06042831440040000,2021,345250,0,345250,COST
06042831440040000,2020,301275,0,301275,COST
06042831440040000,2019,301275,0,301275,COST
06042832103020000,2021,554576,1163124,1717700,INCOME
06042832103020000,2020,303533,1307140,1610673,COST
06042832103020000,2019,303533,1307140,1610673,COST
06042832103040000,2021,237674,322890,560564,COST
06042832103040000,2020,177104,310180,487284,COST
06042832103040000,2019,177104,310180,487284,COST
06042832103050000,2021,197356,460960,658316,COST
06042832103050000,2020,158444,249030,407474,COST
06042832103050000,2019,158444,249030,407474,COST
06042832103070000,2021,270328,1555572,1825900,INCOME
06042832103070000,2020,227449,1477651,1705100,INCOME
06042832103070000,2019,227449,1477651,1705100,INCOME
06042832103080000,2021,312762,0,312762,COST
06042832103080000,2020,268934,0,268934,COST
06042832103080000,2019,268934,0,268934,COST
06042832103090000,2021,348271,278620,626891,COST
06042832103090000,2020,274724,250476,525200,INCOME
06042832103090000,2019,274724,250476,525200,INCOME
06042832103100000,2021,348271,0,348271,COST
06042832103100000,2020,274724,0,274724,COST
06042832103100000,2019,274724,0,274724,COST
06042832103110000,2021,372662,0,372662,COST
06042832103110000,2020,296946,0,296946,COST
06042832103110000,2019,296946,0,296946,COST
06042832103120000,2021,399154,84080,483234,COST
06042832103120000,2020,321328,80940,402268,COST
06042832103120000,2019,321328,80940,402268,COST
06042832103130000,2021,404631,0,404631,COST
06042832103130000,2020,361545,0,361545,COST
06042832103130000,2019,361545,0,361545,COST
06042832401010000,2021,2458,0,2458,COST
06042832401010000,2020,1320,0,1320,COST
06042832401010000,2019,1320,0,1320,COST
06042832401040000,2021,308200,810420,1118620,COST
06042832401040000,2020,423000,844600,1267600,COST
06042832401040000,2019,423000,525270,948270,COST
06042832401060000,2021,301769,170840,472609,COST
06042832401060000,2020,224515,177500,402015,COST
06042832401060000,2019,224515,177500,402015,COST
06042832402020000,2021,134162,0,134162,COST
06042832402020000,2020,72154,0,72154,COST
06042832402020000,2019,72154,0,72154,COST
06042832402070000,2021,502404,78520,580924,COST
06042832402070000,2020,300134,23243,323377,MRA
06042832402070000,2019,300134,23243,323377,MRA
06042832402090000,2021,544087,564313,1108400,INCOME
06042832402090000,2020,296946,740654,1037600,INCOME
06042832402090000,2019,296946,740654,1037600,INCOME
06042832402100000,2021,4,0,4,COST
06042832402100000,2020,4,0,4,COST
06042832402100000,2019,4,0,4,COST
06042832403010000,2021,275496,373200,648696,COST
06042832403010000,2020,220373,315510,535883,COST
06042832403010000,2019,220373,315510,535883,COST
06042832403070000,2021,554576,225024,779600,INCOME
06042832403070000,2020,303533,452067,755600,INCOME
06042832403070000,2019,303533,452067,755600,INCOME
06042832403200000,2021,322238,717930,1040168,COST
06042832403200000,2020,251263,680430,931693,COST
06042832403200000,2019,251263,680430,931693,COST
06042832403250000,2021,390055,1136860,1526915,COST
06042832403250000,2020,342790,72960,415750,COST
06042832403250000,2019,342790,72960,415750,COST
06042832404010000,2021,129629,0,129629,COST
06042832404010000,2020,124922,0,124922,COST
06042832404010000,2019,124922,0,124922,COST
06042832404030000,2021,326247,297660,623907,COST
06042832404030000,2020,282300,249720,532020,COST
06042832404030000,2019,282300,249720,532020,COST
06042832404050000,2021,744770,140550,885320,COST
06042832404050000,2020,425947,138340,564287,COST
06042832404050000,2019,425947,138340,564287,COST
06042832404200000,2021,767986,0,767986,COST
06042832404200000,2020,394656,0,394656,COST
06042832404200000,2019,394656,0,394656,COST
06042833101010000,2021,157983,0,157983,COST
06042833101010000,2020,85012,0,85012,COST
06042833101010000,2019,85012,0,85012,COST
06042833101030000,2021,804503,1299280,2103783,COST
06042833101030000,2020,1102762,654370,1757132,COST
06042833101030000,2019,1102762,654370,1757132,COST
06042833101060000,2021,308200,167940,476140,COST
06042833101060000,2020,423000,173570,596570,COST
06042833101060000,2019,423000,173570,596570,COST
06042833101100000,2021,819152,497530,1316682,COST
06042833101100000,2020,1110177,519440,1629617,COST
06042833101100000,2019,1110177,519440,1629617,COST
06042833102100000,2021,216421,618470,834891,COST
06042833102100000,2020,176154,536670,712824,COST
06042833102100000,2019,176154,536670,712824,COST
06042833102120000,2021,174580,0,174580,COST
06042833102120000,2020,137620,0,137620,COST
06042833102120000,2019,137620,0,137620,COST
06042833102160000,2021,177779,239570,417349,COST
06042833102160000,2020,140522,202390,342912,COST
06042833102160000,2019,140522,202390,342912,COST
06042833102180000,2021,331773,243340,575113,COST
06042833102180000,2020,287801,177640,465441,COST
06042833102180000,2019,287801,177640,465441,COST
06042833102190000,2021,457623,744510,1202133,COST
06042833102190000,2020,666201,767680,1433881,OVR
06042833102190000,2019,666201,767680,1433881,COST
06042833102200000,2021,309748,487480,797228,COST
06042833102200000,2020,424440,509530,933970,COST
06042833102200000,2019,424440,509530,933970,COST
06042833102210000,2021,323415,875710,1199125,COST
06042833102210000,2020,447082,911760,1358842,COST
06042833102210000,2019,447082,911760,1358842,COST
06042833102230000,2021,323415,215080,538495,COST
06042833102230000,2020,447082,219100,666182,COST
06042833102230000,2019,447082,219100,666182,COST
06042833201140000,2021,324914,0,324914,COST
06042833201140000,2020,280975,0,280975,COST
06042833201140000,2019,280975,0,280975,COST
06042833201200000,2021,221913,0,221913,COST
06042833201200000,2020,181300,0,181300,COST
06042833201200000,2019,213597,0,213597,COST
06042833202010000,2021,16588,0,16588,COST
06042833202010000,2020,9072,0,9072,COST
06042833202010000,2019,9072,0,9072,COST
06042833203030000,2021,232924,0,232924,COST
06042833203030000,2020,191676,0,191676,COST
06042833203030000,2019,191676,0,191676,COST
06042833203040000,2021,329003,960200,1289203,COST
06042833203040000,2020,289579,560720,850299,COST
06042833203040000,2019,289579,560720,850299,COST
06042833203050000,2021,327285,612730,940015,COST
06042833203050000,2020,287842,513990,801832,COST
06042833203050000,2019,287842,513990,801832,COST
06042833203060000,2021,291806,2000830,2292636,COST
06042833203060000,2020,252287,1721130,1973417,COST
06042833203060000,2019,252287,1721130,1973417,COST
06042833203070000,2021,369692,599430,969122,COST
06042833203070000,2020,331098,501000,832098,COST
06042833203070000,2019,331098,501000,832098,COST
06042833204010000,2021,97854,0,97854,COST
06042833204010000,2020,135375,0,135375,COST
06042833204010000,2019,135375,0,135375,COST
06042834101010000,2021,265993,0,265993,COST
06042834101010000,2020,142960,0,142960,COST
06042834101010000,2019,142960,0,142960,COST
06042835101010000,2021,260000,0,260000,COST
06042835101010000,2020,139680,0,139680,COST
06042835101010000,2019,139680,0,139680,COST
06042836101010000,2021,199379,0,199379,COST
06042836101010000,2020,107802,0,107802,COST
06042836101010000,2019,107802,0,107802,COST
06042901101010000,2021,129717,0,129717,COST
06042901101010000,2020,69834,0,69834,COST
06042901101010000,2019,69834,0,69834,COST
06042901201010000,2021,110909,0,110909,COST
06042901201010000,2020,59801,0,59801,COST
06042901201010000,2019,59801,0,59801,COST
06042902101010000,2021,194706,0,194706,COST
06042902101010000,2020,105330,0,105330,COST
06042902101010000,2019,105330,0,105330,COST
06042903101010000,2021,184863,0,184863,COST
06042903101010000,2020,100161,0,100161,COST
06042903101010000,2019,100161,0,100161,COST
06042904101010000,2021,254673,0,254673,COST
06042904101010000,2020,136879,0,136879,COST
06042904101010000,2019,136879,0,136879,COST
06042905101010000,2021,278927,0,278927,COST
06042905101010000,2020,150313,0,150313,COST
06042905101010000,2019,150313,0,150313,COST
06042906101010000,2021,410426,0,410426,COST
06042906101010000,2020,221480,0,221480,COST
06042906101010000,2019,221480,0,221480,COST
06042906201200000,2021,6365,0,6365,COST
06042906201200000,2020,5924,0,5924,COST
06042906201200000,2019,5924,0,5924,COST
06042907101010000,2021,415490,0,415490,COST
06042907101010000,2020,223996,0,223996,COST
06042907101010000,2019,223996,0,223996,COST
06042908101010000,2021,273887,0,273887,COST
06042908101010000,2020,147282,0,147282,COST
06042908101010000,2019,147282,0,147282,COST
06042909101010000,2021,247715,0,247715,COST
06042909101010000,2020,133220,0,133220,COST
06042909101010000,2019,133220,0,133220,COST
06042910101010000,2021,205897,0,205897,COST
06042910101010000,2020,111231,0,111231,COST
06042910101010000,2019,111231,0,111231,COST
06042911101010000,2021,88776,0,88776,COST
06042911101010000,2020,49630,0,49630,COST
06042911101010000,2019,49630,0,49630,COST
06042912101010000,2021,56367,0,56367,COST
06042912101010000,2020,31120,0,31120,COST
06042912101010000,2019,31120,0,31120,COST
06042912301010000,2021,22750,0,22750,COST
06042912301010000,2020,13443,0,13443,COST
06042912301010000,2019,13443,0,13443,COST
06042913101010000,2021,185623,0,185623,COST
06042913101010000,2020,100569,0,100569,COST
06042913101010000,2019,100569,0,100569,COST
06042914101010000,2021,171858,0,171858,COST
06042914101010000,2020,93332,0,93332,COST
06042914101010000,2019,93332,0,93332,COST
06042915101010000,2021,159180,0,159180,COST
06042915101010000,2020,86666,0,86666,COST
06042915101010000,2019,86666,0,86666,COST
06042916101010000,2021,230327,0,230327,COST
06042916101010000,2020,124074,0,124074,COST
06042916101010000,2019,124074,0,124074,COST
06042917101010000,2021,256052,0,256052,COST
06042917101010000,2020,137604,0,137604,COST
06042917101010000,2019,137604,0,137604,COST
06042918101010000,2021,331151,0,331151,COST
06042918101010000,2020,178132,0,178132,COST
06042918101010000,2019,178132,0,178132,COST
06042919101010000,2021,355953,0,355953,COST
06042919101010000,2020,191301,0,191301,COST
06042919101010000,2019,191301,0,191301,COST
06042920101010000,2021,260000,0,260000,COST
06042920101010000,2020,139680,0,139680,COST
06042920101010000,2019,139680,0,139680,COST
06042921101010000,2021,123225,0,123225,COST
06042921101010000,2020,67759,0,67759,COST
06042921101010000,2019,67759,0,67759,COST
06042922101010000,2021,79774,0,79774,COST
06042922101010000,2020,44169,0,44169,COST
06042922101010000,2019,44169,0,44169,COST
06042922201010000,2021,30762,0,30762,COST
06042922201010000,2020,16917,0,16917,COST
06042922201010000,2019,16917,0,16917,COST
06042923101010000,2021,188038,0,188038,COST
06042923101010000,2020,101099,0,101099,COST
06042923101010000,2019,101099,0,101099,COST
06042923201010000,2021,65000,0,65000,COST
06042923201010000,2020,34920,0,34920,COST
06042923201010000,2019,34920,0,34920,COST
06042924101010000,2021,247624,0,247624,COST
06042924101010000,2020,133172,0,133172,COST
06042924101010000,2019,133172,0,133172,COST
06042925101010000,2021,260000,0,260000,COST
06042925101010000,2020,139680,0,139680,COST
06042925101010000,2019,139680,0,139680,COST
06042926101010000,2021,260000,0,260000,COST
06042926101010000,2020,139680,0,139680,COST
06042926101010000,2019,139680,0,139680,COST
06042927101010000,2021,114880,0,114880,COST
06042927101010000,2020,62629,0,62629,COST
06042927101010000,2019,62629,0,62629,COST
06042927401010000,2021,65000,0,65000,COST
06042927401010000,2020,34920,0,34920,COST
06042927401010000,2019,34920,0,34920,COST
06042928101010000,2021,28101,0,28101,COST
06042928101010000,2020,16257,0,16257,COST
06042928101010000,2019,16257,0,16257,COST
06042928201010000,2021,115729,0,115729,COST
06042928201010000,2020,62338,0,62338,COST
06042928201010000,2019,62338,0,62338,COST
06042929101010000,2021,247548,0,247548,COST
06042929101010000,2020,133132,0,133132,COST
06042929101010000,2019,133132,0,133132,COST
06042930101010000,2021,348896,0,348896,COST
06042930101010000,2020,187437,0,187437,COST
06042930101010000,2019,187437,0,187437,COST
06042931101010000,2021,341450,0,341450,COST
06042931101010000,2020,183522,0,183522,COST
06042931101010000,2019,183522,0,183522,COST
06042932101010000,2021,258698,0,258698,COST
06042932101010000,2020,138995,0,138995,COST
06042932101010000,2019,138995,0,138995,COST
06042933101010000,2021,116034,0,116034,COST
06042933101010000,2020,63978,0,63978,COST
06042933101010000,2019,63978,0,63978,COST
06042934101010000,2021,99424,0,99424,COST
06042934101010000,2020,55243,0,55243,COST
06042934101010000,2019,55243,0,55243,COST
06042935101010000,2021,244000,0,244000,COST
06042935101010000,2020,131265,0,131265,COST
06042935101010000,2019,131265,0,131265,COST
06042936101010000,2021,260000,0,260000,COST
06042936101010000,2020,139680,0,139680,COST
06042936101010000,2019,139680,0,139680,COST
06051401101010000,2021,228128,0,228128,COST
06051401101010000,2020,122599,0,122599,COST
06051401101010000,2019,122599,0,122599,COST
06051402101010000,2021,234509,0,234509,COST
06051402101010000,2020,126040,0,126040,COST
06051402101010000,2019,126040,0,126040,COST
06051403101010000,2021,226963,0,226963,COST
06051403101010000,2020,121988,0,121988,COST
06051403101010000,2019,121988,0,121988,COST
06051410101010000,2021,200134,0,200134,COST
06051410101010000,2020,107919,0,107919,COST
06051410101010000,2019,107919,0,107919,COST
06051411101010000,2021,171326,0,171326,COST
06051411101010000,2020,92813,0,92813,COST
06051411101010000,2019,92813,0,92813,COST
06051412101010000,2021,221503,0,221503,COST
06051412101010000,2020,119124,0,119124,COST
06051412101010000,2019,119124,0,119124,COST
06051413101010000,2021,224469,0,224469,COST
06051413101010000,2020,120797,0,120797,COST
06051413101010000,2019,120797,0,120797,COST
06051414101010000,2021,218043,0,218043,COST
06051414101010000,2020,117312,0,117312,COST
06051414101010000,2019,117312,0,117312,COST
06051415101010000,2021,87694,0,87694,COST
06051415101010000,2020,48957,0,48957,COST
06051415101010000,2019,48957,0,48957,COST
06051422101010000,2021,174309,0,174309,COST
06051422101010000,2020,94378,0,94378,COST
06051422101010000,2019,94378,0,94378,COST
06051423101010000,2021,224372,0,224372,COST
06051423101010000,2020,120617,0,120617,COST
06051423101010000,2019,120617,0,120617,COST
06051424101010000,2021,249656,0,249656,COST
06051424101010000,2020,134016,0,134016,COST
06051424101010000,2019,134016,0,134016,COST
06051425101010000,2021,229161,0,229161,COST
06051425101010000,2020,123141,0,123141,COST
06051425101010000,2019,123141,0,123141,COST
06051426101010000,2021,241751,0,241751,COST
06051426101010000,2020,129742,0,129742,COST
06051426101010000,2019,129742,0,129742,COST
06051427101010000,2021,130959,0,130959,COST
06051427101010000,2020,71643,0,71643,COST
06051427101010000,2019,71643,0,71643,COST
06051434101010000,2021,197220,0,197220,COST
06051434101010000,2020,106391,0,106391,COST
06051434101010000,2019,106391,0,106391,COST
06051435101010000,2021,216243,0,216243,COST
06051435101010000,2020,116366,0,116366,COST
06051435101010000,2019,116366,0,116366,COST
06051436101010000,2021,134070,0,134070,COST
06051436101010000,2020,73276,0,73276,COST
06051436101010000,2019,73276,0,73276,COST
06051501101010000,2021,306569,0,306569,COST
06051501101010000,2020,165265,0,165265,COST
06051501101010000,2019,165265,0,165265,COST
06051502101010000,2021,265536,0,265536,COST
06051502101010000,2020,142958,0,142958,COST
06051502101010000,2019,142958,0,142958,COST
06051503101010000,2021,277026,0,277026,COST
06051503101010000,2020,149381,0,149381,COST
06051503101010000,2019,149381,0,149381,COST
06051504101010000,2021,263712,0,263712,COST
06051504101010000,2020,141965,0,141965,COST
06051504101010000,2019,141965,0,141965,COST
06051505101010000,2021,260801,0,260801,COST
06051505101010000,2020,140084,0,140084,COST
06051505101010000,2019,140084,0,140084,COST
06051506101010000,2021,243920,0,243920,COST
06051506101010000,2020,130880,0,130880,COST
06051506101010000,2019,130880,0,130880,COST
06051507101010000,2021,255646,0,255646,COST
06051507101010000,2020,137283,0,137283,COST
06051507101010000,2019,137283,0,137283,COST
06051508101010000,2021,267566,0,267566,COST
06051508101010000,2020,143830,0,143830,COST
06051508101010000,2019,143830,0,143830,COST
06051509101010000,2021,241111,0,241111,COST
06051509101010000,2020,129562,0,129562,COST
06051509101010000,2019,129562,0,129562,COST
06051510101010000,2021,255014,0,255014,COST
06051510101010000,2020,137091,0,137091,COST
06051510101010000,2019,137091,0,137091,COST
06051511101010000,2021,234388,0,234388,COST
06051511101010000,2020,126231,0,126231,COST
06051511101010000,2019,126231,0,126231,COST
06051512101010000,2021,270963,0,270963,COST
06051512101010000,2020,145797,0,145797,COST
06051512101010000,2019,145797,0,145797,COST
06051513101010000,2021,251495,0,251495,COST
06051513101010000,2020,135208,0,135208,COST
06051513101010000,2019,135208,0,135208,COST
06051514101010000,2021,260000,0,260000,COST
06051514101010000,2020,139680,0,139680,COST
06051514101010000,2019,139680,0,139680,COST
06051515101010000,2021,261054,0,261054,COST
06051515101010000,2020,140570,0,140570,COST
06051515101010000,2019,140570,0,140570,COST
06051516101010000,2021,258646,0,258646,COST
06051516101010000,2020,138938,0,138938,COST
06051516101010000,2019,138938,0,138938,COST
06051517101010000,2021,242844,0,242844,COST
06051517101010000,2020,130316,0,130316,COST
06051517101010000,2019,130316,0,130316,COST
06051518101010000,2021,250297,0,250297,COST
06051518101010000,2020,134535,0,134535,COST
06051518101010000,2019,134535,0,134535,COST
06051519101010000,2021,240262,0,240262,COST
06051519101010000,2020,128962,0,128962,COST
06051519101010000,2019,128962,0,128962,COST
06051520101010000,2021,230714,0,230714,COST
06051520101010000,2020,123955,0,123955,COST
06051520101010000,2019,123955,0,123955,COST
06051521101010000,2021,248529,0,248529,COST
06051521101010000,2020,133400,0,133400,COST
06051521101010000,2019,133400,0,133400,COST
06051522101010000,2021,246365,0,246365,COST
06051522101010000,2020,132222,0,132222,COST
06051522101010000,2019,132222,0,132222,COST
06051523101010000,2021,272604,0,272604,COST
06051523101010000,2020,146915,0,146915,COST
06051523101010000,2019,146915,0,146915,COST
06051524101010000,2021,260000,0,260000,COST
06051524101010000,2020,139906,0,139906,COST
06051524101010000,2019,139906,0,139906,COST
06051525101010000,2021,266196,0,266196,COST
06051525101010000,2020,143204,0,143204,COST
06051525101010000,2019,143204,0,143204,COST
06051526101010000,2021,235949,0,235949,COST
06051526101010000,2020,126850,0,126850,COST
06051526101010000,2019,126850,0,126850,COST
06051527101010000,2021,238366,0,238366,COST
06051527101010000,2020,127968,0,127968,COST
06051527101010000,2019,127968,0,127968,COST
06051528101010000,2021,192765,0,192765,COST
06051528101010000,2020,104054,0,104054,COST
06051528101010000,2019,104054,0,104054,COST
06051529101010000,2021,184243,0,184243,COST
06051529101010000,2020,99586,0,99586,COST
06051529101010000,2019,99586,0,99586,COST
06051530101010000,2021,136146,0,136146,COST
06051530101010000,2020,74364,0,74364,COST
06051530101010000,2019,74364,0,74364,COST
06051531101010000,2021,53376,0,53376,COST
06051531101010000,2020,30962,0,30962,COST
06051531101010000,2019,30962,0,30962,COST
06051532101010000,2021,186855,0,186855,COST
06051532101010000,2020,100956,0,100956,COST
06051532101010000,2019,100956,0,100956,COST
06051533101010000,2021,168831,0,168831,COST
06051533101010000,2020,91503,0,91503,COST
06051533101010000,2019,91503,0,91503,COST
06051534101010000,2021,238775,0,238775,COST
06051534101010000,2020,128182,0,128182,COST
06051534101010000,2019,128182,0,128182,COST
06051535101010000,2021,243920,0,243920,COST
06051535101010000,2020,130880,0,130880,COST
06051535101010000,2019,130880,0,130880,COST
06051536101010000,2021,248338,0,248338,COST
06051536101010000,2020,133589,0,133589,COST
06051536101010000,2019,133589,0,133589,COST
06051601101010000,2021,179370,0,179370,COST
06051601101010000,2020,97282,0,97282,COST
06051601101010000,2019,97282,0,97282,COST
06051602101010000,2021,257961,0,257961,COST
06051602101010000,2020,138608,0,138608,COST
06051602101010000,2019,138608,0,138608,COST
06051603101010000,2021,263169,0,263169,COST
06051603101010000,2020,141382,0,141382,COST
06051603101010000,2019,141382,0,141382,COST
06051604101010000,2021,270932,0,270932,COST
06051604101010000,2020,145658,0,145658,COST
06051604101010000,2019,145658,0,145658,COST
06051605101010000,2021,278822,0,278822,COST
06051605101010000,2020,149973,0,149973,COST
06051605101010000,2019,149973,0,149973,COST
06051606101010000,2021,261726,0,261726,COST
06051606101010000,2020,141537,0,141537,COST
06051606101010000,2019,141537,0,141537,COST
06051607101010000,2021,271030,0,271030,COST
06051607101010000,2020,145711,0,145711,COST
06051607101010000,2019,145711,0,145711,COST
06051608101010000,2021,307315,0,307315,COST
06051608101010000,2020,165555,0,165555,COST
06051608101010000,2019,165555,0,165555,COST
06051609101010000,2021,23284,7630,30914,COST
06051609101010000,2020,12569,7420,19989,COST
06051609101010000,2019,12569,7420,19989,COST
06051609101020000,2021,336545,327555,664100,INCOME
06051609101020000,2020,305178,205022,510200,INCOME
06051609101020000,2019,305178,205022,510200,INCOME
06051609103010000,2021,280892,0,280892,COST
06051609103010000,2020,151316,0,151316,COST
06051609103010000,2019,151316,0,151316,COST
06051610101010000,2021,284760,0,284760,COST
06051610101010000,2020,153220,0,153220,COST
06051610101010000,2019,153220,0,153220,COST
06051611101010000,2021,264194,0,264194,COST
06051611101010000,2020,141974,0,141974,COST
06051611101010000,2019,141974,0,141974,COST
06051612101010000,2021,244294,0,244294,COST
06051612101010000,2020,131492,0,131492,COST
06051612101010000,2019,131492,0,131492,COST
06051613101010000,2021,242181,0,242181,COST
06051613101010000,2020,130363,0,130363,COST
06051613101010000,2019,130363,0,130363,COST
06051614101010000,2021,242431,0,242431,COST
06051614101010000,2020,130545,0,130545,COST
06051614101010000,2019,130545,0,130545,COST
06051615101010000,2021,293313,0,293313,COST
06051615101010000,2020,157577,0,157577,COST
06051615101010000,2019,157577,0,157577,COST
06051616101010000,2021,256482,0,256482,COST
06051616101010000,2020,137861,0,137861,COST
06051616101010000,2019,137861,0,137861,COST
06051617101010000,2021,260955,0,260955,COST
06051617101010000,2020,140202,0,140202,COST
06051617101010000,2019,140202,0,140202,COST
06051618101010000,2021,255233,0,255233,COST
06051618101010000,2020,137173,0,137173,COST
06051618101010000,2019,137173,0,137173,COST
06051619101010000,2021,186828,0,186828,COST
06051619101010000,2020,100489,0,100489,COST
06051619101010000,2019,100489,0,100489,COST
06051619401010000,2021,60666,0,60666,COST
06051619401010000,2020,32644,0,32644,COST
06051619401010000,2019,32644,0,32644,COST
06051620101010000,2021,258711,0,258711,COST
06051620101010000,2020,139012,0,139012,COST
06051620101010000,2019,139012,0,139012,COST
06051621101010000,2021,252076,0,252076,COST
06051621101010000,2020,135536,0,135536,COST
06051621101010000,2019,135536,0,135536,COST
06051622101010000,2021,260000,0,260000,COST
06051622101010000,2020,139680,0,139680,COST
06051622101010000,2019,139680,0,139680,COST
06051623101010000,2021,255913,0,255913,COST
06051623101010000,2020,137530,0,137530,COST
06051623101010000,2019,137530,0,137530,COST
06051624101010000,2021,254724,0,254724,COST
06051624101010000,2020,136947,0,136947,COST
06051624101010000,2019,136947,0,136947,COST
06051625101010000,2021,259399,0,259399,COST
06051625101010000,2020,139441,0,139441,COST
06051625101010000,2019,139441,0,139441,COST
06051626101010000,2021,269107,0,269107,COST
06051626101010000,2020,144661,0,144661,COST
06051626101010000,2019,144661,0,144661,COST
06051627101010000,2021,300940,0,300940,COST
06051627101010000,2020,162074,0,162074,COST
06051627101010000,2019,162074,0,162074,COST
06051628101010000,2021,297658,0,297658,COST
06051628101010000,2020,160278,0,160278,COST
06051628101010000,2019,160278,0,160278,COST
06051629101010000,2021,297469,0,297469,COST
06051629101010000,2020,160176,0,160176,COST
06051629101010000,2019,160176,0,160176,COST
06051630101010000,2021,272391,0,272391,COST
06051630101010000,2020,146457,0,146457,COST
06051630101010000,2019,146457,0,146457,COST
06051631110010000,2021,9827,0,9827,COST
06051631110010000,2020,5296,0,5296,COST
06051631110010000,2019,5296,0,5296,COST
06051631120010000,2021,9447,0,9447,COST
06051631120010000,2020,5089,0,5089,COST
06051631120010000,2019,5089,0,5089,COST
06051631130010000,2021,9139,0,9139,COST
06051631130010000,2020,4921,0,4921,COST
06051631130010000,2019,4921,0,4921,COST
06051631140010000,2021,10373,0,10373,COST
06051631140010000,2020,5596,0,5596,COST
06051631140010000,2019,5596,0,5596,COST
06051631150010000,2021,8664,0,8664,COST
06051631150010000,2020,4659,0,4659,COST
06051631150010000,2019,4659,0,4659,COST
06051631160010000,2021,8759,0,8759,COST
06051631160010000,2020,4711,0,4711,COST
06051631160010000,2019,4711,0,4711,COST
06051631170010000,2021,9426,0,9426,COST
06051631170010000,2020,5076,0,5076,COST
06051631170010000,2019,5076,0,5076,COST
06051631180010000,2021,8807,0,8807,COST
06051631180010000,2020,4739,0,4739,COST
06051631180010000,2019,4739,0,4739,COST
06051631210010000,2021,21850,0,21850,COST
06051631210010000,2020,11751,0,11751,COST
06051631210010000,2019,11751,0,11751,COST
06051631230010000,2021,9295,0,9295,COST
06051631230010000,2020,5006,0,5006,COST
06051631230010000,2019,5006,0,5006,COST
06051631240010000,2021,8554,0,8554,COST
06051631240010000,2020,4601,0,4601,COST
06051631240010000,2019,4601,0,4601,COST
06051631260010000,2021,20888,0,20888,COST
06051631260010000,2020,11225,0,11225,COST
06051631260010000,2019,11225,0,11225,COST
06051631270010000,2021,8837,0,8837,COST
06051631270010000,2020,4754,0,4754,COST
06051631270010000,2019,4754,0,4754,COST
06051631280010000,2021,8472,0,8472,COST
06051631280010000,2020,4555,0,4555,COST
06051631280010000,2019,4555,0,4555,COST
06051631310010000,2021,23742,0,23742,COST
06051631310010000,2020,12787,0,12787,COST
06051631310010000,2019,12787,0,12787,COST
06051631330010000,2021,10423,0,10423,COST
06051631330010000,2020,5622,0,5622,COST
06051631330010000,2019,5622,0,5622,COST
06051631340010000,2021,10579,0,10579,COST
06051631340010000,2020,5708,0,5708,COST
06051631340010000,2019,5708,0,5708,COST
06051631360010000,2021,21481,0,21481,COST
06051631360010000,2020,11548,0,11548,COST
06051631360010000,2019,11548,0,11548,COST
06051631370010000,2021,165404,1462220,1627624,COST
06051631370010000,2020,131441,975750,1107191,COST
06051631370010000,2019,131441,975750,1107191,COST
06051631380010000,2021,10632,0,10632,COST
06051631380010000,2020,5738,0,5738,COST
06051631380010000,2019,5738,0,5738,COST
06051631410010000,2021,10920,0,10920,COST
06051631410010000,2020,5895,0,5895,COST
06051631410010000,2019,5895,0,5895,COST
06051631420010000,2021,10780,0,10780,COST
06051631420010000,2020,5818,0,5818,COST
06051631420010000,2019,5818,0,5818,COST
06051631430010000,2021,10006,0,10006,COST
06051631430010000,2020,5395,0,5395,COST
06051631430010000,2019,5395,0,5395,COST
06051631440010000,2021,10920,0,10920,COST
06051631440010000,2020,5895,0,5895,COST
06051631440010000,2019,5895,0,5895,COST
06051631450010000,2021,10920,0,10920,COST
06051631450010000,2020,5895,0,5895,COST
06051631450010000,2019,5895,0,5895,COST
06051631460010000,2021,10920,0,10920,COST
06051631460010000,2020,5895,0,5895,COST
06051631460010000,2019,5895,0,5895,COST
06051631470010000,2021,10920,0,10920,COST
06051631470010000,2020,5895,0,5895,COST
06051631470010000,2019,5895,0,5895,COST
06051631480010000,2021,10262,0,10262,COST
06051631480010000,2020,5535,0,5535,COST
06051631480010000,2019,5535,0,5535,COST
06051632101010000,2021,265523,0,265523,COST
06051632101010000,2020,142703,0,142703,COST
06051632101010000,2019,142703,0,142703,COST
06051633101010000,2021,255019,0,255019,COST
06051633101010000,2020,137090,0,137090,COST
06051633101010000,2019,137090,0,137090,COST
06051634101010000,2021,262444,0,262444,COST
06051634101010000,2020,141016,0,141016,COST
06051634101010000,2019,141016,0,141016,COST
06051635101010000,2021,268388,0,268388,COST
06051635101010000,2020,144268,0,144268,COST
06051635101010000,2019,144268,0,144268,COST
06051636101010000,2021,250296,0,250296,COST
06051636101010000,2020,134577,0,134577,COST
06051636101010000,2019,134577,0,134577,COST
06051701101010000,2021,122657,0,122657,COST
06051701101010000,2020,67518,0,67518,COST
06051701101010000,2019,67518,300,67818,COST
06051702101010000,2021,72792,0,72792,COST
06051702101010000,2020,41236,0,41236,COST
06051702101010000,2019,41236,0,41236,COST
06051703101010000,2021,212295,0,212295,COST
06051703101010000,2020,114634,300,114934,COST
06051703101010000,2019,114634,300,114934,COST
06051704101010000,2021,46666,0,46666,COST
06051704101010000,2020,27424,0,27424,COST
06051704101010000,2019,27424,0,27424,COST
06051705101010000,2021,131540,0,131540,COST
06051705101010000,2020,72188,0,72188,COST
06051705101010000,2019,72188,0,72188,COST
06051706101010000,2021,202473,0,202473,COST
06051706101010000,2020,109434,0,109434,COST
06051706101010000,2019,109434,0,109434,COST
06051707101010000,2021,211061,0,211061,COST
06051707101010000,2020,113898,0,113898,COST
06051707101010000,2019,113898,0,113898,COST
06051708101010000,2021,101894,0,101894,COST
06051708101010000,2020,56498,0,56498,COST
06051708101010000,2019,56498,0,56498,COST
06051709101010000,2021,12554,0,12554,COST
06051709101010000,2020,9526,300,9826,COST
06051709101010000,2019,9526,300,9826,COST
06051710101010000,2021,129677,0,129677,COST
06051710101010000,2020,70995,0,70995,COST
06051710101010000,2019,70995,0,70995,COST
06051711101010000,2021,94257,0,94257,COST
06051711101010000,2020,52525,300,52825,COST
06051711101010000,2019,52525,300,52825,COST
06051712101010000,2021,107025,0,107025,COST
06051712101010000,2020,58976,0,58976,COST
06051712101010000,2019,58976,0,58976,COST
06051713101010000,2021,32883,0,32883,COST
06051713101010000,2020,20119,0,20119,COST
06051713101010000,2019,20119,0,20119,COST
06051714101010000,2021,106029,0,106029,COST
06051714101010000,2020,58715,0,58715,COST
06051714101010000,2019,58715,0,58715,COST
06051715101010000,2021,51279,0,51279,COST
06051715101010000,2020,29863,0,29863,COST
06051715101010000,2019,29863,0,29863,COST
06051716101010000,2021,49002,0,49002,COST
06051716101010000,2020,28729,0,28729,COST
06051716101010000,2019,28729,0,28729,COST
06051717101010000,2021,222798,0,222798,COST
06051717101010000,2020,120118,0,120118,COST
06051717101010000,2019,120118,0,120118,COST
06051718101010000,2021,222633,0,222633,COST
06051718101010000,2020,120015,0,120015,COST
06051718101010000,2019,120015,0,120015,COST
06051719101010000,2021,246866,0,246866,COST
06051719101010000,2020,132730,0,132730,COST
06051719101010000,2019,132730,0,132730,COST
06051720101010000,2021,241823,0,241823,COST
06051720101010000,2020,130121,0,130121,COST
06051720101010000,2019,130121,0,130121,COST
06051721101010000,2021,154682,0,154682,COST
06051721101010000,2020,84299,0,84299,COST
06051721101010000,2019,84299,0,84299,COST
06051722101010000,2021,7300,0,7300,COST
06051722101010000,2020,6800,0,6800,COST
06051722101010000,2019,6800,0,6800,COST
06051723101010000,2021,38299,0,38299,COST
06051723101010000,2020,23101,0,23101,COST
06051723101010000,2019,23101,0,23101,COST
06051724101010000,2021,113528,0,113528,COST
06051724101010000,2020,62106,0,62106,COST
06051724101010000,2019,62106,0,62106,COST
06051725101010000,2021,182580,0,182580,COST
06051725101010000,2020,98058,0,98058,COST
06051725101010000,2019,98058,0,98058,COST
06051726101010000,2021,64508,0,64508,COST
06051726101010000,2020,36594,0,36594,COST
06051726101010000,2019,36594,0,36594,COST
06051727101010000,2021,77535,0,77535,COST
06051727101010000,2020,43732,0,43732,COST
06051727101010000,2019,43732,0,43732,COST
06051728101010000,2021,193703,0,193703,COST
06051728101010000,2020,104772,0,104772,COST
06051728101010000,2019,104772,0,104772,COST
06051729101010000,2021,215725,0,215725,COST
06051729101010000,2020,116398,0,116398,COST
06051729101010000,2019,116398,0,116398,COST
06051730101010000,2021,250213,0,250213,COST
06051730101010000,2020,134571,0,134571,COST
06051730101010000,2019,134571,0,134571,COST
06051731101010000,2021,194983,0,194983,COST
06051731101010000,2020,105482,0,105482,COST
06051731101010000,2019,105482,0,105482,COST
06051732101010000,2021,102634,0,102634,COST
06051732101010000,2020,56819,0,56819,COST
06051732101010000,2019,56819,0,56819,COST
06051733101010000,2021,103437,0,103437,COST
06051733101010000,2020,56882,0,56882,COST
06051733101010000,2019,56882,0,56882,COST
06051734101010000,2021,132310,0,132310,COST
06051734101010000,2020,71769,0,71769,COST
06051734101010000,2019,71769,0,71769,COST
06051735101010000,2021,192757,0,192757,COST
06051735101010000,2020,103357,0,103357,COST
06051735101010000,2019,103357,0,103357,COST
06051736101010000,2021,188404,0,188404,COST
06051736101010000,2020,101095,0,101095,COST
06051736101010000,2019,101095,0,101095,COST
06060101101010000,2021,168364,0,168364,COST
06060101101010000,2020,103229,0,103229,COST
06060101101010000,2019,103229,0,103229,COST
06060102101010000,2021,177898,0,177898,COST
06060102101010000,2020,105153,0,105153,COST
06060102101010000,2019,105153,0,105153,COST
06060103101010000,2021,169210,0,169210,COST
06060103101010000,2020,98891,0,98891,COST
06060103101010000,2019,98891,0,98891,COST
06060110101010000,2021,66511,0,66511,COST
06060110101010000,2020,42637,0,42637,COST
06060110101010000,2019,42637,0,42637,COST
06060110301011000,2021,179844,2757040,2936884,COST
06060110301011000,2020,126710,1802140,1928850,COST
06060110301011000,2019,126710,1802140,1928850,COST
06060111101010000,2021,219890,0,219890,COST
06060111101010000,2020,119349,0,119349,COST
06060111101010000,2019,119349,0,119349,COST
06060112101010000,2021,211567,179150,390717,COST
06060112101010000,2020,117171,124570,241741,COST
06060112101010000,2019,117171,124570,241741,COST
06060113101010000,2021,35520,0,35520,COST
06060113101010000,2020,28253,0,28253,COST
06060113101010000,2019,28253,0,28253,COST
06060114101010000,2021,40164,308810,348974,COST
06060114101010000,2020,37802,213730,251532,COST
06060114101010000,2019,37802,213730,251532,COST
06060115101010000,2021,56532,0,56532,COST
06060115101010000,2020,52627,0,52627,COST
06060115101010000,2019,52627,0,52627,COST
06060122101010000,2021,154882,0,154882,COST
06060122101010000,2020,94355,0,94355,COST
06060122101010000,2019,94355,0,94355,COST
06060123101010000,2021,143902,0,143902,COST
06060123101010000,2020,90020,0,90020,COST
06060123101010000,2019,90020,0,90020,COST
06060124101010000,2021,170676,0,170676,COST
06060124101010000,2020,93894,0,93894,COST
06060124101010000,2019,93894,0,93894,COST
06060124401010000,2021,61374,0,61374,COST
06060124401010000,2020,32936,0,32936,COST
06060124401010000,2019,32936,0,32936,COST
06060125101010000,2021,247686,0,247686,COST
06060125101010000,2020,132973,0,132973,COST
06060125101010000,2019,132973,0,132973,COST
06060126101010000,2021,277384,0,277384,COST
06060126101010000,2020,149305,0,149305,COST
06060126101010000,2019,149305,0,149305,COST
06060127101010000,2021,335773,0,335773,COST
06060127101010000,2020,184753,0,184753,COST
06060127101010000,2019,184753,0,184753,COST
06060134101010000,2021,223852,0,223852,COST
06060134101010000,2020,120439,0,120439,COST
06060134101010000,2019,120439,0,120439,COST
06060135101010000,2021,230980,0,230980,COST
06060135101010000,2020,124419,0,124419,COST
06060135101010000,2019,124419,0,124419,COST
06060136101010000,2021,221902,0,221902,COST
06060136101010000,2020,120066,0,120066,COST
06060136101010000,2019,120066,0,120066,COST
06060201101010000,2021,551822,231550,783372,COST
06060201101010000,2020,213865,155340,369205,COST
06060201101010000,2019,213865,155340,369205,COST
06060202101010000,2021,212817,584950,797767,COST
06060202101010000,2020,158415,389190,547605,COST
06060202101010000,2019,158415,389190,547605,COST
06060202201150000,2021,4774,0,4774,COST
06060202201150000,2020,4439,0,4439,COST
06060202201150000,2019,4439,0,4439,COST
06060202301010000,2021,191944,0,191944,COST
06060202301010000,2020,103780,0,103780,COST
06060202301010000,2019,103780,0,103780,COST
06060203101010000,2021,41715,0,41715,COST
06060203101010000,2020,29856,0,29856,COST
06060203101010000,2019,29856,0,29856,COST
06060203301010000,2021,125926,0,125926,COST
06060203301010000,2020,70205,0,70205,COST
06060203301010000,2019,70205,0,70205,COST
06060204101010000,2021,90997,0,90997,COST
06060204101010000,2020,66622,0,66622,COST
06060204101010000,2019,66622,0,66622,COST
06060204201010000,2021,16402,0,16402,COST
06060204201010000,2020,20033,0,20033,COST
06060204201010000,2019,20033,0,20033,COST
06060205101010000,2021,38315,0,38315,COST
06060205101010000,2020,28899,0,28899,COST
06060205101010000,2019,28899,0,28899,COST
06060205301010000,2021,71597,0,71597,COST
06060205301010000,2020,40230,0,40230,COST
06060205301010000,2019,40230,0,40230,COST
06060205401010000,2021,51626,0,51626,COST
06060205401010000,2020,28280,0,28280,COST
06060205401010000,2019,28280,0,28280,COST
06060206101010000,2021,123577,0,123577,COST
06060206101010000,2020,69180,0,69180,COST
06060206101010000,2019,69180,0,69180,COST
06060206301010000,2021,80321,0,80321,COST
06060206301010000,2020,46454,0,46454,COST
06060206301010000,2019,46454,0,46454,COST
06060206401010000,2021,25327,0,25327,COST
06060206401010000,2020,14266,0,14266,COST
06060206401010000,2019,14266,0,14266,COST
06060207101010000,2021,142320,0,142320,COST
06060207101010000,2020,81709,0,81709,COST
06060207101010000,2019,81709,0,81709,COST
06060207402010000,2021,2958,3601060,3604018,COST
06060207402010000,2020,2891,2997010,2999901,COST
06060207402010000,2019,2891,2997010,2999901,COST
06060208101010000,2021,32062,0,32062,COST
06060208101010000,2020,18154,0,18154,COST
06060208101010000,2019,18154,0,18154,COST
06060208102010000,2021,400101,389010,789111,COST
06060208102010000,2020,317426,320000,637426,COST
06060208102010000,2019,317426,320000,637426,COST
06060208201010000,2021,156947,225310,382257,COST
06060208201010000,2020,127023,147700,274723,COST
06060208201010000,2019,126881,147700,274581,COST
06060208201080000,2021,156261,0,156261,COST
06060208201080000,2020,126385,0,126385,COST
06060208201080000,2019,126385,0,126385,COST
06060208201100000,2021,2152,0,2152,COST
06060208201100000,2020,2002,0,2002,COST
06060208201100000,2019,2002,0,2002,COST
06060208201110000,2021,156600,0,156600,COST
06060208201110000,2020,126700,0,126700,COST
06060208201110000,2019,126700,0,126700,COST
06060208203010000,2021,158020,980470,1138490,COST
06060208203010000,2020,128022,680430,808452,COST
06060208203010000,2019,128022,680430,808452,COST
06060208203200000,2021,53,0,53,COST
06060208203200000,2020,49,0,49,COST
06060208203200000,2019,49,0,49,COST
06060208204210000,2021,349873,0,349873,COST
06060208204210000,2020,319106,0,319106,COST
06060208204210000,2019,319106,0,319106,COST
06060208220120000,2021,104642,0,104642,COST
06060208220120000,2020,85447,0,85447,COST
06060208220120000,2019,85447,0,85447,COST
06060208220150000,2021,142355,0,142355,COST
06060208220150000,2020,121700,0,121700,COST
06060208220150000,2019,121700,0,121700,COST
06060208220230000,2021,91373,0,91373,COST
06060208220230000,2020,73120,0,73120,COST
06060208220230000,2019,73120,0,73120,COST
06060208301010000,2021,445820,549760,995580,COST
06060208301010000,2020,377816,398314,776130,MRA
06060208301010000,2019,377816,398314,776130,MRA
06060208301030000,2021,66,0,66,COST
06060208301030000,2020,61,0,61,COST
06060208301030000,2019,61,0,61,COST
06060208301250000,2021,30945,0,30945,COST
06060208301250000,2020,16946,0,16946,COST
06060208301250000,2019,16946,0,16946,COST
06060208401010000,2021,143331,0,143331,COST
06060208401010000,2020,77374,0,77374,COST
06060208401010000,2019,77374,0,77374,COST
06060209101010000,2021,242334,0,242334,COST
06060209101010000,2020,131087,0,131087,COST
06060209101010000,2019,131087,0,131087,COST
06060210101010000,2021,269734,0,269734,COST
06060210101010000,2020,144744,0,144744,COST
06060210101010000,2019,144744,0,144744,COST
06060211101010000,2021,295348,0,295348,COST
06060211101010000,2020,158864,0,158864,COST
06060211101010000,2019,158864,0,158864,COST
06060212101010000,2021,263931,0,263931,COST
06060212101010000,2020,141824,0,141824,COST
06060212101010000,2019,141824,0,141824,COST
06060213101010000,2021,260000,0,260000,COST
06060213101010000,2020,139680,0,139680,COST
06060213101010000,2019,139680,0,139680,COST
06060214101010000,2021,260156,0,260156,COST
06060214101010000,2020,139680,0,139680,COST
06060214101010000,2019,139680,0,139680,COST
06060215101010000,2021,260000,0,260000,COST
06060215101010000,2020,139680,0,139680,COST
06060215101010000,2019,139680,0,139680,COST
06060216101010000,2021,262282,0,262282,COST
06060216101010000,2020,140921,0,140921,COST
06060216101010000,2019,140921,0,140921,COST
06060217101010000,2021,286776,294700,581476,COST
06060217101010000,2020,197387,195490,392877,COST
06060217101010000,2019,197387,195490,392877,COST
06060217301010000,2021,503361,1371560,1874921,COST
06060217301010000,2020,373367,1114120,1487487,COST
06060217301010000,2019,373367,1114120,1487487,COST
06060218101010000,2021,1404,0,1404,COST
06060218101010000,2020,1302,0,1302,COST
06060218101010000,2019,1302,0,1302,COST
06060218103010000,2021,56870,1211230,1268100,COST
06060218103010000,2020,42822,1022640,1065462,COST
06060218103010000,2019,42822,1022640,1065462,COST
06060219103020000,2021,266491,284300,550791,COST
06060219103020000,2020,233391,193920,427311,COST
06060219103020000,2019,233391,193920,427311,COST
06060219201010000,2021,158072,0,158072,COST
06060219201010000,2020,87017,0,87017,COST
06060219201010000,2019,87017,0,87017,COST
06060219401010000,2021,277702,0,277702,COST
06060219401010000,2020,244708,0,244708,COST
06060219401010000,2019,244708,0,244708,COST
06060220301010000,2021,5264,0,5264,COST
06060220301010000,2020,4899,0,4899,COST
06060220301010000,2019,4899,0,4899,COST
06060220301200000,2021,6452,0,6452,COST
06060220301200000,2020,3557,0,3557,COST
06060220301200000,2019,3557,0,3557,COST
06060220304010000,2021,288560,612700,901260,COST
06060220304010000,2020,229190,394359,623549,MRA
06060220304010000,2019,229190,394359,623549,MRA
06060220304020000,2021,290195,0,290195,COST
06060220304020000,2020,230683,0,230683,COST
06060220304020000,2019,230683,0,230683,COST
06060220304030000,2021,290014,0,290014,COST
06060220304030000,2020,230518,0,230518,COST
06060220304030000,2019,230518,0,230518,COST
06060220304040000,2021,288925,1849780,2138705,COST
06060220304040000,2020,229523,1535440,1764963,COST
06060220304040000,2019,229523,1535440,1764963,COST
06060220304050000,2021,283715,811270,1094985,COST
06060220304050000,2020,224774,536047,760821,MRA
06060220304050000,2019,224774,536047,760821,MRA
06060220304100000,2021,315449,0,315449,COST
06060220304100000,2020,253897,0,253897,COST
06060220304100000,2019,253897,0,253897,COST
06060220304200000,2021,733044,302460,1035504,COST
06060220304200000,2020,940268,278020,1218288,COST
06060220304200000,2019,940268,278020,1218288,COST
06060220310010000,2021,187458,290,187748,COST
06060220310010000,2020,100905,300,101205,COST
06060220310010000,2019,100905,300,101205,COST
06060220401100000,2021,31999,0,31999,COST
06060220401100000,2020,40078,0,40078,COST
06060220401100000,2019,40078,0,40078,COST
06060221101010000,2021,259350,0,259350,COST
06060221101010000,2020,139331,0,139331,COST
06060221101010000,2019,139331,0,139331,COST
06060222101010000,2021,259602,0,259602,COST
06060222101010000,2020,139471,0,139471,COST
06060222101010000,2019,139471,0,139471,COST
06060223101010000,2021,260000,0,260000,COST
06060223101010000,2020,139680,0,139680,COST
06060223101010000,2019,139680,0,139680,COST
06060224101010000,2021,260000,0,260000,COST
06060224101010000,2020,139680,0,139680,COST
06060224101010000,2019,139680,0,139680,COST
06060225201010000,2021,81250,0,81250,COST
06060225201010000,2020,43650,0,43650,COST
06060225201010000,2019,43650,0,43650,COST
06060225301010000,2021,178750,0,178750,COST
06060225301010000,2020,96030,0,96030,COST
06060225301010000,2019,96030,0,96030,COST
06060226101010000,2021,254242,0,254242,COST
06060226101010000,2020,136652,0,136652,COST
06060226101010000,2019,136652,0,136652,COST
06060227101010000,2021,221499,0,221499,COST
06060227101010000,2020,119435,0,119435,COST
06060227101010000,2019,119435,0,119435,COST
06060228102050000,2021,583053,723190,1306243,COST
06060228102050000,2020,603529,626580,1230109,COST
06060228102050000,2019,603529,626580,1230109,COST
06060228102120000,2021,162937,210890,373827,COST
06060228102120000,2020,139468,197332,336800,MKT
06060228102120000,2019,139468,197332,336800,MKT
06060228102140000,2021,233381,94340,327721,COST
06060228102140000,2020,142632,77690,220322,COST
06060228102140000,2019,142632,77690,220322,COST
06060228102180000,2021,317825,917350,1235175,COST
06060228102180000,2020,369801,569900,939701,COST
06060228102180000,2019,369801,569900,939701,COST
06060228102990000,2021,193740,699970,893710,COST
06060228102990000,2020,161801,461760,623561,COST
06060228102990000,2019,161801,461760,623561,COST
06060228205010000,2021,225068,0,225068,COST
06060228205010000,2020,121072,0,121072,COST
06060228205010000,2019,121072,0,121072,COST
06060228301100000,2021,94856,0,94856,COST
06060228301100000,2020,71219,0,71219,COST
06060228301100000,2019,71219,0,71219,COST
06060228301360000,2021,312268,332120,644388,COST
06060228301360000,2020,280021,245510,525531,COST
06060228301360000,2019,280021,245510,525531,COST
06060228301400000,2021,61737,0,61737,COST
06060228301400000,2020,51986,0,51986,COST
06060228301400000,2019,51986,0,51986,COST
06060228304010000,2021,481705,0,481705,COST
06060228304010000,2020,207581,0,207581,COST
06060228304010000,2019,207581,0,207581,COST
06060228304500000,2021,7193,0,7193,COST
06060228304500000,2020,3964,0,3964,COST
06060228304500000,2019,3964,0,3964,COST
06060228401020000,2021,175461,187670,363131,COST
06060228401020000,2020,169443,153757,323200,MKT
06060228401020000,2019,169443,153757,323200,MKT
06060228401040000,2021,72590,139180,211770,COST
06060228401040000,2020,61458,131442,192900,MKT
06060228401040000,2019,61458,131442,192900,MKT
06060228401080000,2021,176645,269780,446425,COST
06060228401080000,2020,170757,209543,380300,MKT
06060228401080000,2019,170757,209543,380300,MKT
06060228401090000,2021,66427,185173,251600,MKT
06060228401090000,2020,55999,131110,187109,COST
06060228401090000,2019,55999,131110,187109,COST
06060228401100000,2021,132334,307650,439984,COST
06060228401100000,2020,122533,221167,343700,MKT
06060228401100000,2019,122533,221167,343700,MKT
06060228401120000,2021,208658,226560,435218,COST
06060228401120000,2020,206774,151770,358544,COST
06060228401120000,2019,206774,151770,358544,COST
06060229101010000,2021,242873,214630,457503,COST
06060229101010000,2020,231341,177930,409271,COST
06060229101010000,2019,231341,177930,409271,COST
06060229101020000,2021,275246,1080,276326,COST
06060229101020000,2020,267113,1080,268193,COST
06060229101020000,2019,267113,1080,268193,COST
06060229101030000,2021,229302,0,229302,COST
06060229101030000,2020,216550,0,216550,COST
06060229101030000,2019,216550,0,216550,COST
06060229101040000,2021,344018,912080,1256098,COST
06060229101040000,2020,345138,594236,939374,MRA
06060229101040000,2019,345138,594236,939374,MRA
06060229101050000,2021,278598,394820,673418,COST
06060229101050000,2020,270854,236360,507214,COST
06060229101050000,2019,270854,236360,507214,COST
06060229101060000,2021,297986,856830,1154816,COST
06060229101060000,2020,292622,692820,985442,COST
06060229101060000,2019,292622,692820,985442,COST
06060229101070000,2021,239833,0,239833,COST
06060229101070000,2020,228017,0,228017,COST
06060229101070000,2019,228017,0,228017,COST
06060229101080000,2021,795110,0,795110,COST
06060229101080000,2020,734518,0,734518,COST
06060229101080000,2019,734518,0,734518,COST
06060229101260000,2021,895968,1789890,2685858,COST
06060229101260000,2020,842556,1458410,2300966,COST
06060229101260000,2019,842556,1458410,2300966,COST
06060229101400000,2021,262352,708190,970542,COST
06060229101400000,2020,229230,469660,698890,COST
06060229101400000,2019,229230,469660,698890,COST
06060229101420000,2021,196195,232470,428665,COST
06060229101420000,2020,164159,204341,368500,MKT
06060229101420000,2019,164159,204341,368500,MKT
06060229102010000,2021,611588,406940,1018528,COST
06060229102010000,2020,522467,364970,887437,COST
06060229102010000,2019,522467,364970,887437,COST
06060229102060000,2021,157941,62580,220521,COST
06060229102060000,2020,127948,41040,168988,COST
06060229102060000,2019,127948,41040,168988,COST
06060229102070000,2021,375167,164530,539697,COST
06060229102070000,2020,309868,133570,443438,COST
06060229102070000,2019,309868,133570,443438,COST
06060229103030000,2021,241680,303480,545160,COST
06060229103030000,2020,208601,260899,469500,MKT
06060229103030000,2019,208601,260899,469500,MKT
06060229103040000,2021,253619,996381,1250000,OVR
06060229103040000,2020,220485,865360,1085845,COST
06060229103040000,2019,220485,865360,1085845,COST
06060229103050000,2021,315524,124070,439594,COST
06060229103050000,2020,283379,141556,424935,MRA
06060229103050000,2019,283379,141556,424935,MRA
06060229104010000,2021,162974,273426,436400,MKT
06060229104010000,2020,132643,254457,387100,MKT
06060229104010000,2019,132643,254457,387100,MKT
06060229104020000,2021,172109,0,172109,COST
06060229104020000,2020,141222,0,141222,COST
06060229104020000,2019,141222,0,141222,COST
06060229104030000,2021,180413,286020,466433,COST
06060229104030000,2020,149079,234621,383700,MKT
06060229104030000,2019,149079,234621,383700,MKT
06060229104040000,2021,169605,0,169605,COST
06060229104040000,2020,138863,0,138863,COST
06060229104040000,2019,138863,0,138863,COST
06060229110100000,2021,16902,0,16902,COST
06060229110100000,2020,9088,0,9088,COST
06060229110100000,2019,9088,0,9088,COST
06060229201050000,2021,1789,0,1789,COST
06060229201050000,2020,1665,0,1665,COST
06060229201050000,2019,1665,0,1665,COST
06060229301010000,2021,112554,290,112844,COST
06060229301010000,2020,60544,300,60844,COST
06060229301010000,2019,60544,300,60844,COST
06060229401010000,2021,254437,337520,591957,COST
06060229401010000,2020,221302,222320,443622,COST
06060229401010000,2019,221302,222320,443622,COST
06060229401030000,2021,359094,0,359094,COST
06060229401030000,2020,328789,0,328789,COST
06060229401030000,2019,328789,0,328789,COST
06060229401300000,2021,229543,848330,1077873,COST
06060229401300000,2020,165975,558010,723985,COST
06060229401300000,2019,165975,558010,723985,COST
06060230101010000,2021,233201,0,233201,COST
06060230101010000,2020,125183,0,125183,COST
06060230101010000,2019,125183,0,125183,COST
06060231101010000,2021,232448,0,232448,COST
06060231101010000,2020,124743,0,124743,COST
06060231101010000,2019,124743,0,124743,COST
06060232101010000,2021,249313,0,249313,COST
06060232101010000,2020,133828,0,133828,COST
06060232101010000,2019,133828,0,133828,COST
06060233101010000,2021,45433,0,45433,COST
06060233101010000,2020,24725,0,24725,COST
06060233101010000,2019,24725,0,24725,COST
06060233102020000,2021,202552,0,202552,COST
06060233102020000,2020,170286,0,170286,COST
06060233102020000,2019,170286,0,170286,COST
06060233102030000,2021,477809,257510,735319,COST
06060233102030000,2020,409130,217130,626260,COST
06060233102030000,2019,409130,217130,626260,COST
06060233102040000,2021,553088,992670,1545758,COST
06060233102040000,2020,484031,811510,1295541,COST
06060233102040000,2019,484031,811510,1295541,COST
06060233102050000,2021,595690,0,595690,COST
06060233102050000,2020,527112,0,527112,COST
06060233102050000,2019,527112,0,527112,COST
06060233102070000,2021,448387,473400,921787,COST
06060233102070000,2020,446316,388560,834876,COST
06060233102070000,2019,446316,388560,834876,COST
06060233102100000,2021,465035,729680,1194715,COST
06060233102100000,2020,465409,593760,1059169,COST
06060233102100000,2019,502235,593760,1095995,COST
06060233102110000,2021,346451,629440,975891,COST
06060233102110000,2020,331844,513330,845174,COST
06060233102110000,2019,331844,513330,845174,COST
06060233102130000,2021,414093,330407,744500,MKT
06060233102130000,2020,407321,225470,632791,COST
06060233102130000,2019,407321,170420,577741,COST
06060233102160000,2021,362509,0,362509,COST
06060233102160000,2020,297884,0,297884,COST
06060233102160000,2019,297884,0,297884,COST
06060233102170000,2021,347573,0,347573,COST
06060233102170000,2020,195742,0,195742,COST
06060233102170000,2019,195742,0,195742,COST
06060233102180000,2021,335021,122050,457071,COST
06060233102180000,2020,149644,99040,248684,COST
06060233102180000,2019,149644,99040,248684,COST
06060233102200000,2021,355972,834520,1190492,COST
06060233102200000,2020,342345,609823,952168,MRA
06060233102200000,2019,342345,609823,952168,MRA
06060233201050000,2021,232921,140480,373401,COST
06060233201050000,2020,199938,0,199938,COST
06060233201050000,2019,199938,0,199938,COST
06060233201130000,2021,190687,108560,299247,COST
06060233201130000,2020,158875,136825,295700,MKT
06060233201130000,2019,158875,136825,295700,MKT
06060233201140000,2021,261604,257660,519264,COST
06060233201140000,2020,228480,171880,400360,COST
06060233201140000,2019,228480,171880,400360,COST
06060233201150000,2021,264417,248040,512457,COST
06060233201150000,2020,231305,196995,428300,MKT
06060233201150000,2019,231305,196995,428300,MKT
06060233201180000,2021,157655,146010,303665,COST
06060233201180000,2020,127681,156519,284200,MKT
06060233201180000,2019,127681,156519,284200,MKT
06060233201190000,2021,212405,0,212405,COST
06060233201190000,2020,179838,0,179838,COST
06060233201190000,2019,179838,0,179838,COST
06060233201200000,2021,327780,104700,432480,COST
06060233201200000,2020,145934,86610,232544,OVR
06060233201200000,2019,145934,86610,232544,COST
06060233201210000,2021,177474,0,177474,COST
06060233201210000,2020,146291,0,146291,COST
06060233201210000,2019,146291,0,146291,COST
06060233201220000,2021,166087,979610,1145697,COST
06060233201220000,2020,159083,657020,816103,COST
06060233201220000,2019,159083,657020,816103,COST
06060233201230000,2021,107925,57530,165455,COST
06060233201230000,2020,96940,37850,134790,COST
06060233201230000,2019,96940,37850,134790,COST
06060233201240000,2021,142942,214860,357802,COST
06060233201240000,2020,114087,168813,282900,MKT
06060233201240000,2019,114087,168813,282900,MKT
06060233201250000,2021,148940,342350,491290,COST
06060233201250000,2020,119605,300695,420300,MKT
06060233201250000,2019,119605,300695,420300,MKT
06060233201260000,2021,139155,191530,330685,COST
06060233201260000,2020,110621,163279,273900,MKT
06060233201260000,2019,110621,163279,273900,MKT
06060233201270000,2021,195880,18660,214540,COST
06060233201270000,2020,192291,15600,207891,COST
06060233201270000,2019,192291,15600,207891,COST
06060233201280000,2021,122577,310490,433067,COST
06060233201280000,2020,112210,213190,325400,MKT
06060233201280000,2019,112210,213190,325400,MKT
06060233201320000,2021,140309,128180,268489,COST
06060233201320000,2020,131055,143845,274900,MKT
06060233201320000,2019,131055,143845,274900,MKT
06060233201330000,2021,160918,0,160918,COST
06060233201330000,2020,153408,0,153408,COST
06060233201330000,2019,153408,0,153408,COST
06060233201340000,2021,160773,0,160773,COST
06060233201340000,2020,153249,0,153249,COST
06060233201340000,2019,153249,0,153249,COST
06060233201350000,2021,162010,277630,439640,COST
06060233201350000,2020,154604,185690,340294,COST
06060233201350000,2019,154604,182630,337234,COST
06060233201360000,2021,143297,563003,706300,MKT
06060233201360000,2020,114412,328990,443402,COST
06060233201360000,2019,114412,328990,443402,COST
06060233201380000,2021,112255,105070,217325,COST
06060233201380000,2020,86425,68740,155165,COST
06060233201380000,2019,86425,68740,155165,COST
06060233201410000,2021,199795,102790,302585,COST
06060233201410000,2020,167625,68880,236505,COST
06060233201410000,2019,167625,68880,236505,COST
06060233201420000,2021,131660,161300,292960,COST
06060233201420000,2020,103803,163197,267000,MKT
06060233201420000,2019,103803,163197,267000,MKT
06060233201440000,2021,122042,58510,180552,COST
06060233201440000,2020,111647,38630,150277,COST
06060233201440000,2019,111647,38630,150277,COST
06060233201450000,2021,106383,114917,221300,MKT
06060233201450000,2020,96203,11500,107703,COST
06060233201450000,2019,96203,11500,107703,COST
06060233201470000,2021,107925,0,107925,COST
06060233201470000,2020,96940,0,96940,COST
06060233201470000,2019,96940,0,96940,COST
06060233201480000,2021,107211,161500,268711,COST
06060233201480000,2020,96203,156997,253200,MKT
06060233201480000,2019,96203,156997,253200,MKT
06060233201490000,2021,110174,232590,342764,COST
06060233201490000,2020,84587,204513,289100,MKT
06060233201490000,2019,84587,204513,289100,MKT
06060233201500000,2021,114792,376910,491702,COST
06060233201500000,2020,104061,261596,365657,MRA
06060233201500000,2019,104061,261596,365657,MRA
06060233201520000,2021,156600,0,156600,COST
06060233201520000,2020,126700,0,126700,COST
06060233201520000,2019,126700,0,126700,COST
06060233201540000,2021,110679,626200,736879,COST
06060233201540000,2020,99789,417850,517639,COST
06060233201540000,2019,99789,417850,517639,COST
06060233201560000,2021,108628,258872,367500,MKT
06060233201560000,2020,97666,192134,289800,MKT
06060233201560000,2019,97666,182834,280500,MKT
06060233201580000,2021,115161,625100,740261,COST
06060233201580000,2020,104445,415610,520055,COST
06060233201580000,2019,104445,415610,520055,COST
06060233201600000,2021,85385,0,85385,COST
06060233201600000,2020,74063,0,74063,COST
06060233201600000,2019,74063,0,74063,COST
06060233201620000,2021,81608,319440,401048,COST
06060233201620000,2020,70311,230589,300900,MKT
06060233201620000,2019,70311,230589,300900,MKT
06060233201640000,2021,105750,0,105750,COST
06060233201640000,2020,94699,0,94699,COST
06060233201640000,2019,94699,0,94699,COST
06060233201660000,2021,110005,155910,265915,COST
06060233201660000,2020,99090,144310,243400,MKT
06060233201660000,2019,99090,144310,243400,MKT
06060233201670000,2021,110005,323570,433575,COST
06060233201670000,2020,99090,225110,324200,MKT
06060233201670000,2019,99090,225110,324200,MKT
06060233201680000,2021,114358,256842,371200,MKT
06060233201680000,2020,103609,227091,330700,MKT
06060233201680000,2019,103609,227091,330700,MKT
06060233201700000,2021,110005,259595,369600,MKT
06060233201700000,2020,99090,208310,307400,MKT
06060233201700000,2019,99090,208310,307400,MKT
06060233201720000,2021,133665,284735,418400,MKT
06060233201720000,2020,123950,187250,311200,MKT
06060233201720000,2019,123950,187250,311200,MKT
06060233201740000,2021,148940,0,148940,COST
06060233201740000,2020,119605,0,119605,COST
06060233201740000,2019,119605,0,119605,COST
06060233201760000,2021,127141,132870,260011,COST
06060233201760000,2020,99719,90140,189859,COST
06060233201760000,2019,99719,90140,189859,COST
06060233201800000,2021,112255,20700,132955,COST
06060233201800000,2020,86425,21410,107835,COST
06060233201800000,2019,86425,21410,107835,COST
06060233201810000,2021,125973,58700,184673,COST
06060233201810000,2020,98667,37990,136657,OVR
06060233201810000,2019,98667,37990,136657,COST
06060233201820000,2021,118029,0,118029,COST
06060233201820000,2020,91552,0,91552,COST
06060233201820000,2019,91552,0,91552,COST
06060233202010000,2021,136577,0,136577,COST
06060233202010000,2020,127058,0,127058,COST
06060233202010000,2019,127058,0,127058,COST
06060233202030000,2021,147415,201850,349265,COST
06060233202030000,2020,138711,177489,316200,MKT
06060233202030000,2019,138711,177489,316200,MKT
06060233203010000,2021,867,0,867,COST
06060233203010000,2020,503,0,503,COST
06060233203010000,2019,503,0,503,COST
06060233205100000,2021,33259,0,33259,COST
06060233205100000,2020,17817,0,17817,COST
06060233205100000,2019,17817,0,17817,COST
06060233205200000,2021,12595,0,12595,COST
06060233205200000,2020,6881,0,6881,COST
06060233205200000,2019,6881,0,6881,COST
06060233301010000,2021,315363,0,315363,COST
06060233301010000,2020,283213,0,283213,COST
06060233301010000,2019,283213,0,283213,COST
06060233301101001,2021,26584,0,26584,COST
06060233301101001,2020,14352,0,14352,COST
06060233301101001,2019,14352,0,14352,COST
06060233301101002,2021,206865,256360,463225,COST
06060233301101002,2020,153801,169570,323371,COST
06060233301101002,2019,27101,0,27101,COST
06060233401020000,2021,189023,0,189023,COST
06060233401020000,2020,157283,0,157283,COST
06060233401020000,2019,157283,0,157283,COST
06060233401030000,2021,317636,12930,330566,COST
06060233401030000,2020,314902,13070,327972,COST
06060233401030000,2019,314902,13070,327972,COST
06060233401040000,2021,302544,345560,648104,COST
06060233401040000,2020,349445,286680,636125,COST
06060233401040000,2019,349445,286680,636125,COST
06060233401050000,2021,136242,0,136242,COST
06060233401050000,2020,126700,0,126700,COST
06060233401050000,2019,126700,0,126700,COST
06060233401060000,2021,340121,83120,423241,COST
06060233401060000,2020,340649,70780,411429,COST
06060233401060000,2019,340649,70780,411429,COST
06060233401070000,2021,156600,0,156600,COST
06060233401070000,2020,126700,0,126700,COST
06060233401070000,2019,126700,0,126700,COST
06060233401080000,2021,116372,0,116372,COST
06060233401080000,2020,105708,0,105708,COST
06060233401080000,2019,105708,0,105708,COST
06060233401090000,2021,139029,226271,365300,MKT
06060233401090000,2020,110506,180394,290900,MKT
06060233401090000,2019,110506,180394,290900,MKT
06060233401100000,2021,139656,0,139656,COST
06060233401100000,2020,111079,0,111079,COST
06060233401100000,2019,111079,0,111079,COST
06060233401110000,2021,139656,0,139656,COST
06060233401110000,2020,111079,0,111079,COST
06060233401110000,2019,111079,0,111079,COST
06060233401120000,2021,333713,0,333713,COST
06060233401120000,2020,333285,0,333285,COST
06060233401120000,2019,333285,0,333285,COST
06060233401130000,2021,262099,662620,924719,COST
06060233401130000,2020,252505,439908,692413,MRA
06060233401130000,2019,252505,439908,692413,MRA
06060233401140000,2021,256930,0,256930,COST
06060233401140000,2020,246792,0,246792,COST
06060233401140000,2019,246792,0,246792,COST
06060233401150000,2021,216595,0,216595,COST
06060233401150000,2020,202819,0,202819,COST
06060233401150000,2019,202819,0,202819,COST
06060233401160000,2021,216595,0,216595,COST
06060233401160000,2020,202819,0,202819,COST
06060233401160000,2019,202819,0,202819,COST
06060233401170000,2021,278598,144400,422998,COST
06060233401170000,2020,270854,120430,391284,COST
06060233401170000,2019,270854,120430,391284,COST
06060233401180000,2021,285043,45800,330843,COST
06060233401180000,2020,278066,37050,315116,COST
06060233401180000,2019,278066,37050,315116,COST
06060233401190000,2021,358759,336860,695619,COST
06060233401190000,2020,362184,283937,646121,MRA
06060233401190000,2019,362184,283937,646121,MRA
06060233401200000,2021,192440,0,192440,COST
06060233401200000,2020,160555,0,160555,COST
06060233401200000,2019,160555,0,160555,COST
06060233401210000,2021,444157,35730,479887,COST
06060233401210000,2020,376197,28970,405167,COST
06060233401210000,2019,376197,28970,405167,COST
06060233401220000,2021,148723,119040,267763,COST
06060233401220000,2020,119405,147795,267200,MKT
06060233401220000,2019,119405,147795,267200,MKT
06060233401240000,2021,253486,84490,337976,COST
06060233401240000,2020,197481,69460,266941,COST
06060233401240000,2019,197481,69460,266941,COST
06060233401320000,2021,154845,0,154845,COST
06060233401320000,2020,146774,0,146774,COST
06060233401320000,2019,146774,0,146774,COST
06060233401340000,2021,363056,574830,937886,COST
06060233401340000,2020,298401,478870,777271,COST
06060233401340000,2019,298401,461260,759661,COST
06060233401380000,2021,305357,239490,544847,COST
06060233401380000,2020,244586,201930,446516,COST
06060233401380000,2019,244586,201930,446516,COST
06060233401990000,2021,219261,0,219261,COST
06060233401990000,2020,167164,0,167164,COST
06060233401990000,2019,167164,0,167164,COST
06060233402020000,2021,190125,315890,506015,COST
06060233402020000,2020,158337,317563,475900,INCOME
06060233402020000,2019,158337,317563,475900,INCOME
06060233402030000,2021,126443,314460,440903,COST
06060233402030000,2020,99090,215410,314500,MKT
06060233402030000,2019,99090,215410,314500,MKT
06060233402040000,2021,110679,122010,232689,COST
06060233402040000,2020,99789,148111,247900,MKT
06060233402040000,2019,99789,148111,247900,MKT
06060233402050000,2021,111345,0,111345,COST
06060233402050000,2020,100478,0,100478,COST
06060233402050000,2019,100478,0,100478,COST
06060233402060000,2021,112001,82980,194981,COST
06060233402060000,2020,101159,54700,155859,COST
06060233402060000,2019,101159,54700,155859,COST
06060233402070000,2021,159603,118900,278503,COST
06060233402070000,2020,151968,146732,298700,MKT
06060233402070000,2019,151968,146732,298700,MKT
06060233402100000,2021,115770,192390,308160,COST
06060233402100000,2020,105080,179120,284200,MKT
06060233402100000,2019,105080,179120,284200,MKT
06060233402110000,2021,116967,0,116967,COST
06060233402110000,2020,106330,0,106330,COST
06060233402110000,2019,106330,0,106330,COST
06060233402120000,2021,118137,0,118137,COST
06060233402120000,2020,107553,0,107553,COST
06060233402120000,2019,107553,0,107553,COST
06060233402130000,2021,119282,0,119282,COST
06060233402130000,2020,108752,0,108752,COST
06060233402130000,2019,108752,0,108752,COST
06060233402140000,2021,159603,0,159603,COST
06060233402140000,2020,151968,0,151968,COST
06060233402140000,2019,151968,0,151968,COST
06060233402150000,2021,171520,354680,526200,COST
06060233402150000,2020,140667,201327,341994,OVR
06060233402150000,2019,140667,201327,341994,OVR
06060233402180000,2021,151068,1020,152088,COST
06060233402180000,2020,121571,1040,122611,COST
06060233402180000,2019,121571,1040,122611,COST
06060233402190000,2021,188864,0,188864,COST
06060233402190000,2020,157131,0,157131,COST
06060233402190000,2019,157131,0,157131,COST
06060233402200000,2021,241571,0,241571,COST
06060233402200000,2020,208492,0,208492,COST
06060233402200000,2019,208492,0,208492,COST
06060233402210000,2021,126443,197420,323863,COST
06060233402210000,2020,99090,185710,284800,MKT
06060233402210000,2019,99090,185710,284800,MKT
06060233402220000,2021,119819,158040,277859,COST
06060233402220000,2020,93150,156650,249800,MKT
06060233402220000,2019,93150,156650,249800,MKT
06060233402250000,2021,141199,0,141199,COST
06060233402250000,2020,112490,0,112490,COST
06060233402250000,2019,112490,0,112490,COST
06060233404010000,2021,262104,371220,633324,COST
06060233404010000,2020,240827,195110,435937,COST
06060233404010000,2019,240827,186980,427807,COST
06060233404020000,2021,300275,0,300275,COST
06060233404020000,2020,281548,0,281548,COST
06060233404020000,2019,281548,0,281548,COST
06060233404040000,2021,290915,94840,385755,COST
06060233404040000,2020,231341,81270,312611,COST
06060233404040000,2019,231341,81270,312611,COST
06060233404050000,2021,237752,0,237752,COST
06060233404050000,2020,183463,0,183463,COST
06060233404050000,2019,183463,0,183463,COST
06060233404060000,2021,228925,175370,404295,COST
06060233404060000,2020,175658,143120,318778,COST
06060233404060000,2019,175658,143120,318778,COST
06060233404070000,2021,225806,64910,290716,COST
06060233404070000,2020,172910,53460,226370,COST
06060233404070000,2019,172910,53460,226370,COST
06060233404086500,2021,121131,0,121131,COST
06060233404086500,2020,101093,0,101093,COST
06060233404086500,2019,101093,0,101093,COST
06060233405010000,2021,768718,513290,1282008,COST
06060233405010000,2020,706573,477370,1183943,COST
06060233405010000,2019,706573,477370,1183943,COST
06060233405020000,2021,93426,115870,209296,COST
06060233405020000,2020,132116,95330,227446,COST
06060233405020000,2019,132116,80400,212516,COST
06060233438020000,2021,279795,695780,975575,COST
06060233438020000,2020,142778,572230,715008,COST
06060233438020000,2019,142778,572230,715008,COST
06060233438040000,2021,202769,0,202769,COST
06060233438040000,2020,170496,0,170496,COST
06060233438040000,2019,170496,0,170496,COST
06060233442100000,2021,136536,785910,922446,COST
06060233442100000,2020,127014,432944,559958,OVR
06060233442100000,2019,127014,432944,559958,OVR
06060233442120000,2021,140896,0,140896,COST
06060233442120000,2020,131686,0,131686,COST
06060233442120000,2019,131686,0,131686,COST
06060233442150000,2021,245418,0,245418,COST
06060233442150000,2020,212312,0,212312,COST
06060233442150000,2019,212312,0,212312,COST
06060233443390000,2021,112255,163130,275385,COST
06060233443390000,2020,86425,156575,243000,MKT
06060233443390000,2019,86425,156575,243000,MKT
06060233443510000,2021,82782,0,82782,COST
06060233443510000,2020,71474,0,71474,COST
06060233443510000,2019,71474,0,71474,COST
06060234101010000,2021,278006,0,278006,COST
06060234101010000,2020,149850,0,149850,COST
06060234101010000,2019,149850,0,149850,COST
06060235101010000,2021,249249,0,249249,COST
06060235101010000,2020,134356,0,134356,COST
06060235101010000,2019,134356,0,134356,COST
06060236101010000,2021,256437,0,256437,COST
06060236101010000,2020,137876,0,137876,COST
06060236101010000,2019,137876,0,137876,COST
06060301101010000,2021,276686,0,276686,COST
06060301101010000,2020,148841,0,148841,COST
06060301101010000,2019,148841,0,148841,COST
06060302101010000,2021,260687,0,260687,COST
06060302101010000,2020,140056,0,140056,COST
06060302101010000,2019,140056,0,140056,COST
06060303101010000,2021,264501,0,264501,COST
06060303101010000,2020,142098,0,142098,COST
06060303101010000,2019,142098,0,142098,COST
06060304101010000,2021,306593,0,306593,COST
06060304101010000,2020,165177,0,165177,COST
06060304101010000,2019,165177,0,165177,COST
06060305110010000,2021,8260,0,8260,COST
06060305110010000,2020,4439,0,4439,COST
06060305110010000,2019,4439,0,4439,COST
06060305120010000,2021,8125,0,8125,COST
06060305120010000,2020,4365,0,4365,COST
06060305120010000,2019,4365,0,4365,COST
06060305130010000,2021,8125,0,8125,COST
06060305130010000,2020,4365,0,4365,COST
06060305130010000,2019,4365,0,4365,COST
06060305140010000,2021,8125,0,8125,COST
06060305140010000,2020,4365,0,4365,COST
06060305140010000,2019,4365,0,4365,COST
06060305160010000,2021,16575,0,16575,COST
06060305160010000,2020,8905,0,8905,COST
06060305160010000,2019,8905,0,8905,COST
06060305180010000,2021,16689,0,16689,COST
06060305180010000,2020,8966,0,8966,COST
06060305180010000,2019,8966,0,8966,COST
06060305210010000,2021,9345,0,9345,COST
06060305210010000,2020,5032,0,5032,COST
06060305210010000,2019,5032,0,5032,COST
06060305220010000,2021,9179,0,9179,COST
06060305220010000,2020,4942,0,4942,COST
06060305220010000,2019,4942,0,4942,COST
06060305230010000,2021,8125,0,8125,COST
06060305230010000,2020,4365,0,4365,COST
06060305230010000,2019,4365,0,4365,COST
06060305240010000,2021,8481,0,8481,COST
06060305240010000,2020,4560,0,4560,COST
06060305240010000,2019,4560,0,4560,COST
06060305260010000,2021,22873,0,22873,COST
06060305260010000,2020,12350,0,12350,COST
06060305260010000,2019,12350,0,12350,COST
06060305280010000,2021,18674,0,18674,COST
06060305280010000,2020,10054,0,10054,COST
06060305280010000,2019,10054,0,10054,COST
06060305310010000,2021,8125,0,8125,COST
06060305310010000,2020,4365,0,4365,COST
06060305310010000,2019,4365,0,4365,COST
06060305320010000,2021,8711,0,8711,COST
06060305320010000,2020,4686,0,4686,COST
06060305320010000,2019,4686,0,4686,COST
06060305330010000,2021,9627,0,9627,COST
06060305330010000,2020,5186,0,5186,COST
06060305330010000,2019,5186,0,5186,COST
06060305340010000,2021,8994,0,8994,COST
06060305340010000,2020,4840,0,4840,COST
06060305340010000,2019,4840,0,4840,COST
06060305350010000,2021,8812,0,8812,COST
06060305350010000,2020,4741,0,4741,COST
06060305350010000,2019,4741,0,4741,COST
06060305360010000,2021,8424,0,8424,COST
06060305360010000,2020,4528,0,4528,COST
06060305360010000,2019,4528,0,4528,COST
06060305370010000,2021,8373,0,8373,COST
06060305370010000,2020,4501,0,4501,COST
06060305370010000,2019,4501,0,4501,COST
06060305380010000,2021,10036,0,10036,COST
06060305380010000,2020,5410,0,5410,COST
06060305380010000,2019,5410,0,5410,COST
06060305410010000,2021,9486,0,9486,COST
06060305410010000,2020,5111,0,5111,COST
06060305410010000,2019,5111,0,5111,COST
06060305420010000,2021,10550,0,10550,COST
06060305420010000,2020,5693,0,5693,COST
06060305420010000,2019,5693,0,5693,COST
06060305430010000,2021,9211,0,9211,COST
06060305430010000,2020,4959,0,4959,COST
06060305430010000,2019,4959,0,4959,COST
06060305440010000,2021,8512,0,8512,COST
06060305440010000,2020,4578,0,4578,COST
06060305440010000,2019,4578,0,4578,COST
06060305450010000,2021,8125,0,8125,COST
06060305450010000,2020,4365,0,4365,COST
06060305450010000,2019,4365,0,4365,COST
06060305460010000,2021,8389,0,8389,COST
06060305460010000,2020,4509,0,4509,COST
06060305460010000,2019,4509,0,4509,COST
06060305470010000,2021,8125,0,8125,COST
06060305470010000,2020,4365,0,4365,COST
06060305470010000,2019,4365,0,4365,COST
06060305480010000,2021,8591,0,8591,COST
06060305480010000,2020,4620,0,4620,COST
06060305480010000,2019,4620,0,4620,COST
06060306101010000,2021,353186,0,353186,COST
06060306101010000,2020,190429,0,190429,COST
06060306101010000,2019,190429,0,190429,COST
06060307101010000,2021,288688,0,288688,COST
06060307101010000,2020,155146,0,155146,COST
06060307101010000,2019,155146,0,155146,COST
06060308101010000,2021,267015,0,267015,COST
06060308101010000,2020,143520,0,143520,COST
06060308101010000,2019,143520,0,143520,COST
06060309110010000,2021,8313,0,8313,COST
06060309110010000,2020,4469,0,4469,COST
06060309110010000,2019,4469,0,4469,COST
06060309120010000,2021,9035,0,9035,COST
06060309120010000,2020,4863,0,4863,COST
06060309120010000,2019,4863,0,4863,COST
06060309130010000,2021,9075,0,9075,COST
06060309130010000,2020,4885,0,4885,COST
06060309130010000,2019,4885,0,4885,COST
06060309140010000,2021,8722,0,8722,COST
06060309140010000,2020,4691,0,4691,COST
06060309140010000,2019,4691,0,4691,COST
06060309150010000,2021,10621,0,10621,COST
06060309150010000,2020,5730,0,5730,COST
06060309150010000,2019,5730,0,5730,COST
06060309160010000,2021,11034,0,11034,COST
06060309160010000,2020,5957,0,5957,COST
06060309160010000,2019,5957,0,5957,COST
06060309170010000,2021,9664,0,9664,COST
06060309170010000,2020,5207,0,5207,COST
06060309170010000,2019,5207,0,5207,COST
06060309180010000,2021,9143,0,9143,COST
06060309180010000,2020,4922,0,4922,COST
06060309180010000,2019,4922,0,4922,COST
06060309210010000,2021,8125,0,8125,COST
06060309210010000,2020,4365,0,4365,COST
06060309210010000,2019,4365,0,4365,COST
06060309220010000,2021,8125,0,8125,COST
06060309220010000,2020,4365,0,4365,COST
06060309220010000,2019,4365,0,4365,COST
06060309230010000,2021,8308,0,8308,COST
06060309230010000,2020,4465,0,4465,COST
06060309230010000,2019,4465,0,4465,COST
06060309240010000,2021,8125,0,8125,COST
06060309240010000,2020,4365,0,4365,COST
06060309240010000,2019,4365,0,4365,COST
06060309250010000,2021,9423,0,9423,COST
06060309250010000,2020,5076,0,5076,COST
06060309250010000,2019,5076,0,5076,COST
06060309260010000,2021,9958,0,9958,COST
06060309260010000,2020,5368,0,5368,COST
06060309260010000,2019,5368,0,5368,COST
06060309270010000,2021,8125,0,8125,COST
06060309270010000,2020,4365,0,4365,COST
06060309270010000,2019,4365,0,4365,COST
06060309280010000,2021,8316,0,8316,COST
06060309280010000,2020,4470,0,4470,COST
06060309280010000,2019,4470,0,4470,COST
06060309310010000,2021,8125,0,8125,COST
06060309310010000,2020,4365,0,4365,COST
06060309310010000,2019,4365,0,4365,COST
06060309320010000,2021,8125,0,8125,COST
06060309320010000,2020,4365,0,4365,COST
06060309320010000,2019,4365,0,4365,COST
06060309330010000,2021,8125,0,8125,COST
06060309330010000,2020,4365,0,4365,COST
06060309330010000,2019,4365,0,4365,COST
06060309340010000,2021,8125,0,8125,COST
06060309340010000,2020,4365,0,4365,COST
06060309340010000,2019,4365,0,4365,COST
06060309350010000,2021,8125,0,8125,COST
06060309350010000,2020,4365,0,4365,COST
06060309350010000,2019,4365,0,4365,COST
06060309360010000,2021,8125,0,8125,COST
06060309360010000,2020,4365,0,4365,COST
06060309360010000,2019,4365,0,4365,COST
06060309370010000,2021,9119,0,9119,COST
06060309370010000,2020,4908,0,4908,COST
06060309370010000,2019,4908,0,4908,COST
06060309380010000,2021,9316,0,9316,COST
06060309380010000,2020,5016,0,5016,COST
06060309380010000,2019,5016,0,5016,COST
06060309410010000,2021,8125,0,8125,COST
06060309410010000,2020,4365,0,4365,COST
06060309410010000,2019,4365,0,4365,COST
06060309420010000,2021,8125,0,8125,COST
06060309420010000,2020,4365,0,4365,COST
06060309420010000,2019,4365,0,4365,COST
06060309430010000,2021,8125,0,8125,COST
06060309430010000,2020,4365,0,4365,COST
06060309430010000,2019,4365,0,4365,COST
06060309440010000,2021,10947,0,10947,COST
06060309440010000,2020,5909,0,5909,COST
06060309440010000,2019,5909,0,5909,COST
06060309450010000,2021,9107,0,9107,COST
06060309450010000,2020,4903,0,4903,COST
06060309450010000,2019,4903,0,4903,COST
06060309460010000,2021,8125,0,8125,COST
06060309460010000,2020,4365,0,4365,COST
06060309460010000,2019,4365,0,4365,COST
06060309470010000,2021,8125,0,8125,COST
06060309470010000,2020,4365,0,4365,COST
06060309470010000,2019,4365,0,4365,COST
06060309480010000,2021,9460,0,9460,COST
06060309480010000,2020,5095,0,5095,COST
06060309480010000,2019,5095,0,5095,COST
06060310101010000,2021,261383,0,261383,COST
06060310101010000,2020,140724,0,140724,COST
06060310101010000,2019,140724,0,140724,COST
06060311101010000,2021,234369,0,234369,COST
06060311101010000,2020,126203,0,126203,COST
06060311101010000,2019,126203,0,126203,COST
06060312101010000,2021,258682,0,258682,COST
06060312101010000,2020,139069,0,139069,COST
06060312101010000,2019,139069,0,139069,COST
06060313101010000,2021,242837,0,242837,COST
06060313101010000,2020,131003,0,131003,COST
06060313101010000,2019,131003,0,131003,COST
06060314101010000,2021,253088,0,253088,COST
06060314101010000,2020,136045,0,136045,COST
06060314101010000,2019,136045,0,136045,COST
06060315101010000,2021,261866,0,261866,COST
06060315101010000,2020,140886,0,140886,COST
06060315101010000,2019,140886,0,140886,COST
06060316101010000,2021,262060,0,262060,COST
06060316101010000,2020,140806,0,140806,COST
06060316101010000,2019,140806,0,140806,COST
06060317101010000,2021,260000,0,260000,COST
06060317101010000,2020,139680,0,139680,COST
06060317101010000,2019,139680,0,139680,COST
06060318101010000,2021,284375,0,284375,COST
06060318101010000,2020,152775,0,152775,COST
06060318101010000,2019,152775,0,152775,COST
06060319101010000,2021,284538,0,284538,COST
06060319101010000,2020,152862,0,152862,COST
06060319101010000,2019,152862,0,152862,COST
06060320101010000,2021,257617,0,257617,COST
06060320101010000,2020,138427,0,138427,COST
06060320101010000,2019,138427,0,138427,COST
06060321101010000,2021,260000,0,260000,COST
06060321101010000,2020,139680,0,139680,COST
06060321101010000,2019,139680,0,139680,COST
06060322101010000,2021,260000,0,260000,COST
06060322101010000,2020,139680,0,139680,COST
06060322101010000,2019,139680,0,139680,COST
06060323101010000,2021,260000,0,260000,COST
06060323101010000,2020,139680,0,139680,COST
06060323101010000,2019,139680,0,139680,COST
06060324101010000,2021,268796,0,268796,COST
06060324101010000,2020,144580,0,144580,COST
06060324101010000,2019,144580,0,144580,COST
06060325101010000,2021,253452,0,253452,COST
06060325101010000,2020,136237,0,136237,COST
06060325101010000,2019,136237,0,136237,COST
06060326101010000,2021,252217,0,252217,COST
06060326101010000,2020,135587,0,135587,COST
06060326101010000,2019,135587,0,135587,COST
06060327101010000,2021,254403,0,254403,COST
06060327101010000,2020,136737,0,136737,COST
06060327101010000,2019,136737,0,136737,COST
06060328101010000,2021,260000,0,260000,COST
06060328101010000,2020,139680,0,139680,COST
06060328101010000,2019,139680,0,139680,COST
06060329101010000,2021,195000,0,195000,COST
06060329101010000,2020,104760,0,104760,COST
06060329101010000,2019,104760,0,104760,COST
06060329301010000,2021,65000,0,65000,COST
06060329301010000,2020,34920,0,34920,COST
06060329301010000,2019,34920,0,34920,COST
06060330101010000,2021,284375,0,284375,COST
06060330101010000,2020,152775,0,152775,COST
06060330101010000,2019,152775,0,152775,COST
06060331101010000,2021,276424,0,276424,COST
06060331101010000,2020,148631,0,148631,COST
06060331101010000,2019,148631,0,148631,COST
06060332101010000,2021,260000,0,260000,COST
06060332101010000,2020,139680,0,139680,COST
06060332101010000,2019,139680,0,139680,COST
06060333101010000,2021,260000,0,260000,COST
06060333101010000,2020,139680,0,139680,COST
06060333101010000,2019,139680,0,139680,COST
06060334101010000,2021,259476,0,259476,COST
06060334101010000,2020,139404,0,139404,COST
06060334101010000,2019,139404,0,139404,COST
06060335101010000,2021,225621,0,225621,COST
06060335101010000,2020,121601,0,121601,COST
06060335101010000,2019,121601,0,121601,COST
06060336101010000,2021,209412,0,209412,COST
06060336101010000,2020,113078,0,113078,COST
06060336101010000,2019,113078,0,113078,COST
06060401101010000,2021,251769,0,251769,COST
06060401101010000,2020,135414,0,135414,COST
06060401101010000,2019,135414,0,135414,COST
06060402101010000,2021,232536,0,232536,COST
06060402101010000,2020,125114,0,125114,COST
06060402101010000,2019,125114,0,125114,COST
06060403101010000,2021,244248,0,244248,COST
06060403101010000,2020,131291,0,131291,COST
06060403101010000,2019,131291,0,131291,COST
06060404101010000,2021,257067,0,257067,COST
06060404101010000,2020,138201,0,138201,COST
06060404101010000,2019,138201,0,138201,COST
06060405101010000,2021,339519,0,339519,COST
06060405101010000,2020,183271,0,183271,COST
06060405101010000,2019,183271,0,183271,COST
06060406101010000,2021,233745,0,233745,COST
06060406101010000,2020,125637,0,125637,COST
06060406101010000,2019,125637,0,125637,COST
06060407101010000,2021,119972,0,119972,COST
06060407101010000,2020,64593,0,64593,COST
06060407101010000,2019,64593,0,64593,COST
06060407201010000,2021,10185,0,10185,COST
06060407201010000,2020,5472,0,5472,COST
06060407201010000,2019,5472,0,5472,COST
06060407201200000,2021,65000,0,65000,COST
06060407201200000,2020,34920,0,34920,COST
06060407201200000,2019,34920,0,34920,COST
06060407201400000,2021,10205,0,10205,COST
06060407201400000,2020,5482,0,5482,COST
06060407201400000,2019,5482,0,5482,COST
06060407301010000,2021,10148,0,10148,COST
06060407301010000,2020,5452,0,5452,COST
06060407301010000,2019,5452,0,5452,COST
06060407301400000,2021,10168,0,10168,COST
06060407301400000,2020,5463,0,5463,COST
06060407301400000,2019,5463,0,5463,COST
06060408101010000,2021,291626,0,291626,COST
06060408101010000,2020,156971,0,156971,COST
06060408101010000,2019,156971,0,156971,COST
06060409101010000,2021,289456,0,289456,COST
06060409101010000,2020,155919,0,155919,COST
06060409101010000,2019,155919,0,155919,COST
06060410101010000,2021,295010,0,295010,COST
06060410101010000,2020,158999,0,158999,COST
06060410101010000,2019,158999,0,158999,COST
06060411101010000,2021,254924,0,254924,COST
06060411101010000,2020,137016,0,137016,COST
06060411101010000,2019,137016,0,137016,COST
06060412101010000,2021,260000,0,260000,COST
06060412101010000,2020,139680,0,139680,COST
06060412101010000,2019,139680,0,139680,COST
06060413101010000,2021,103587,0,103587,COST
06060413101010000,2020,55951,0,55951,COST
06060413101010000,2019,55951,0,55951,COST
06060413201010000,2021,129507,0,129507,COST
06060413201010000,2020,69580,0,69580,COST
06060413201010000,2019,69580,0,69580,COST
06060414101010000,2021,260468,0,260468,COST
06060414101010000,2020,139958,0,139958,COST
06060414101010000,2019,139958,0,139958,COST
06060415101010000,2021,240675,0,240675,COST
06060415101010000,2020,130250,0,130250,COST
06060415101010000,2019,130250,0,130250,COST
06060416101010000,2021,312547,0,312547,COST
06060416101010000,2020,168432,0,168432,COST
06060416101010000,2019,168432,0,168432,COST
06060417101010000,2021,257964,0,257964,COST
06060417101010000,2020,138609,0,138609,COST
06060417101010000,2019,138609,0,138609,COST
06060418101010000,2021,238402,0,238402,COST
06060418101010000,2020,128108,0,128108,COST
06060418101010000,2019,128108,0,128108,COST
06060419101010000,2021,217469,0,217469,COST
06060419101010000,2020,117021,0,117021,COST
06060419101010000,2019,117021,0,117021,COST
06060420101010000,2021,248178,0,248178,COST
06060420101010000,2020,133463,0,133463,COST
06060420101010000,2019,133463,0,133463,COST
06060421101010000,2021,248712,0,248712,COST
06060421101010000,2020,133770,0,133770,COST
06060421101010000,2019,133770,0,133770,COST
06060422101010000,2021,240452,0,240452,COST
06060422101010000,2020,129822,0,129822,COST
06060422101010000,2019,129822,0,129822,COST
06060423101010000,2021,131803,0,131803,COST
06060423101010000,2020,103932,0,103932,COST
06060423101010000,2019,103932,0,103932,COST
06060423110010000,2021,164408,0,164408,COST
06060423110010000,2020,88563,0,88563,COST
06060423110010000,2019,88563,0,88563,COST
06060423201010000,2021,72632,0,72632,COST
06060423201010000,2020,39263,0,39263,COST
06060423201010000,2019,39263,0,39263,COST
06060423201050000,2021,78,0,78,COST
06060423201050000,2020,72,0,72,COST
06060423201050000,2019,72,0,72,COST
06060423301010000,2021,11078,0,11078,COST
06060423301010000,2020,5978,0,5978,COST
06060423301010000,2019,5978,0,5978,COST
06060423303010000,2021,752,0,752,COST
06060423303010000,2020,701,0,701,COST
06060423303010000,2019,701,0,701,COST
06060424101010000,2021,239340,0,239340,COST
06060424101010000,2020,128832,0,128832,COST
06060424101010000,2019,128832,0,128832,COST
06060425101010000,2021,259593,0,259593,COST
06060425101010000,2020,139584,0,139584,COST
06060425101010000,2019,139584,0,139584,COST
06060426101010000,2021,261024,0,261024,COST
06060426101010000,2020,140553,0,140553,COST
06060426101010000,2019,140553,0,140553,COST
06060427101010000,2021,250172,0,250172,COST
06060427101010000,2020,134544,0,134544,COST
06060427101010000,2019,134544,0,134544,COST
06060428101010000,2021,235782,0,235782,COST
06060428101010000,2020,126945,0,126945,COST
06060428101010000,2019,126945,0,126945,COST
06060429101010000,2021,206034,0,206034,COST
06060429101010000,2020,111302,0,111302,COST
06060429101010000,2019,111302,0,111302,COST
06060430101010000,2021,216883,0,216883,COST
06060430101010000,2020,116710,0,116710,COST
06060430101010000,2019,116710,0,116710,COST
06060431101010000,2021,181801,0,181801,COST
06060431101010000,2020,98257,0,98257,COST
06060431101010000,2019,98257,0,98257,COST
06060432101010000,2021,116497,0,116497,COST
06060432101010000,2020,64188,0,64188,COST
06060432101010000,2019,64188,0,64188,COST
06060433101010000,2021,115818,0,115818,COST
06060433101010000,2020,63818,0,63818,COST
06060433101010000,2019,63818,0,63818,COST
06060434101010000,2021,236460,0,236460,COST
06060434101010000,2020,127387,0,127387,COST
06060434101010000,2019,127387,0,127387,COST
06060435101010000,2021,146651,0,146651,COST
06060435101010000,2020,80089,0,80089,COST
06060435101010000,2019,80089,0,80089,COST
06060436101010000,2021,184697,0,184697,COST
06060436101010000,2020,100082,0,100082,COST
06060436101010000,2019,100082,0,100082,COST
06069601101010000,2021,10703,0,10703,COST
06069601101010000,2020,9961,0,9961,COST
06069601101010000,2019,9961,0,9961,COST
06069601201010000,2021,12587,0,12587,COST
06069601201010000,2020,11707,0,11707,COST
06069601201010000,2019,11707,0,11707,COST
06069601301010000,2021,54105,0,54105,COST
06069601301010000,2020,56901,0,56901,COST
06069601301010000,2019,56901,0,56901,COST
06069601401010000,2021,43198,0,43198,COST
06069601401010000,2020,43268,0,43268,COST
06069601401010000,2019,43268,0,43268,COST
06069602101010000,2021,25878,0,25878,COST
06069602101010000,2020,24032,0,24032,COST
06069602101010000,2019,24032,0,24032,COST
06069602201010000,2021,27726,0,27726,COST
06069602201010000,2020,25781,0,25781,COST
06069602201010000,2019,25781,0,25781,COST
06069602401010000,2021,49639,0,49639,COST
06069602401010000,2020,46080,0,46080,COST
06069602401010000,2019,46080,0,46080,COST
06069603101010000,2021,56114,0,56114,COST
06069603101010000,2020,52197,0,52197,COST
06069603101010000,2019,52197,0,52197,COST
06069610101010000,2021,47128,0,47128,COST
06069610101010000,2020,41182,0,41182,COST
06069610101010000,2019,41182,0,41182,COST
06069611101010000,2021,78540,0,78540,COST
06069611101010000,2020,56899,0,56899,COST
06069611101010000,2019,56899,0,56899,COST
06069612101010000,2021,168825,3630,172455,COST
06069612101010000,2020,157307,3510,160817,COST
06069612101010000,2019,157307,3510,160817,COST
06069613101010000,2021,54849,0,54849,COST
06069613101010000,2020,51006,0,51006,COST
06069613101010000,2019,51006,0,51006,COST
06069613201010000,2021,7784,0,7784,COST
06069613201010000,2020,7237,0,7237,COST
06069613201010000,2019,7237,0,7237,COST
06069614101010000,2021,55254,0,55254,COST
06069614101010000,2020,51399,0,51399,COST
06069614101010000,2019,51399,0,51399,COST
06069615101010000,2021,63441,0,63441,COST
06069615101010000,2020,59045,0,59045,COST
06069615101010000,2019,59045,0,59045,COST
06069622201010000,2021,26053,0,26053,COST
06069622201010000,2020,20836,0,20836,COST
06069622201010000,2019,20836,0,20836,COST
06069622401010000,2021,51182,0,51182,COST
06069622401010000,2020,42490,0,42490,COST
06069622401010000,2019,42490,0,42490,COST
06069623101010000,2021,55906,0,55906,COST
06069623101010000,2020,52003,0,52003,COST
06069623101010000,2019,52003,0,52003,COST
06069624101010000,2021,28396,0,28396,COST
06069624101010000,2020,26428,0,26428,COST
06069624101010000,2019,26428,0,26428,COST
06069624201010000,2021,14004,0,14004,COST
06069624201010000,2020,13031,0,13031,COST
06069624201010000,2019,13031,0,13031,COST
06069624301010000,2021,16485,0,16485,COST
06069624301010000,2020,15348,0,15348,COST
06069624301010000,2019,15348,0,15348,COST
06069625101010000,2021,97265,0,97265,COST
06069625101010000,2020,70573,0,70573,COST
06069625101010000,2019,70573,0,70573,COST
06069626201010000,2021,164568,21940,186508,COST
06069626201010000,2020,103020,19400,122420,COST
06069626201010000,2019,103020,19400,122420,COST
06069627101010000,2021,112065,0,112065,COST
06069627101010000,2020,79410,0,79410,COST
06069627101010000,2019,79410,0,79410,COST
06069634101010000,2021,152189,0,152189,COST
06069634101010000,2020,94562,0,94562,COST
06069634101010000,2019,94562,0,94562,COST
06069635101010000,2021,147811,0,147811,COST
06069635101010000,2020,93564,0,93564,COST
06069635101010000,2019,93564,0,93564,COST
06069636101010000,2021,238852,0,238852,COST
06069636101010000,2020,133387,0,133387,COST
06069636101010000,2019,133387,0,133387,COST
06069701101030000,2021,145991,179410,325401,COST
06069701101030000,2020,117453,155630,273083,COST
06069701101030000,2019,117453,155630,273083,COST
06069701101040000,2021,106735,211565,318300,MKT
06069701101040000,2020,89062,179038,268100,MKT
06069701101040000,2019,89062,179038,268100,MKT
06069701103010000,2021,145368,290520,435888,COST
06069701103010000,2020,116873,246240,363113,COST
06069701103010000,2019,116873,246240,363113,COST
06069701103070000,2021,145107,610950,756057,COST
06069701103070000,2020,116630,500780,617410,COST
06069701103070000,2019,116630,500780,617410,COST
06069701103140000,2021,1269,0,1269,COST
06069701103140000,2020,1181,0,1181,COST
06069701103140000,2019,1181,0,1181,COST
06069701103210000,2021,145075,598540,743615,COST
06069701103210000,2020,116600,512690,629290,COST
06069701103210000,2019,116600,512690,629290,COST
06069701103280000,2021,145272,928690,1073962,COST
06069701103280000,2020,116784,788650,905434,COST
06069701103280000,2019,116784,788650,905434,COST
06069701103350000,2021,145729,1089980,1235709,COST
06069701103350000,2020,117209,910150,1027359,COST
06069701103350000,2019,1660,80060,81720,COST
06069701103420000,2021,1111,0,1111,COST
06069701103420000,2020,1034,0,1034,COST
06069701103420000,2019,1034,0,1034,COST
06069701103490000,2021,145266,655400,800666,COST
06069701103490000,2020,116778,565700,682478,COST
06069701103490000,2019,116778,565700,682478,COST
06069701103560000,2021,145446,454370,599816,COST
06069701103560000,2020,116946,374830,491776,COST
06069701103560000,2019,116946,374830,491776,COST
06069701103630000,2021,145069,381150,526219,COST
06069701103630000,2020,116595,328370,444965,COST
06069701103630000,2019,116595,328370,444965,COST
06069701103700000,2021,145053,493750,638803,COST
06069701103700000,2020,116580,423520,540100,COST
06069701103700000,2019,116580,423520,540100,COST
06069701103770000,2021,145113,629800,774913,COST
06069701103770000,2020,116636,527970,644606,COST
06069701103770000,2019,116636,527970,644606,COST
06069701103840000,2021,7945,467460,475405,COST
06069701103840000,2020,7767,399410,407177,COST
06069701103840000,2019,7767,399410,407177,COST
06069701103910000,2021,145115,348210,493325,COST
06069701103910000,2020,116638,289940,406578,COST
06069701103910000,2019,116638,289940,406578,COST
06069701201030000,2021,378997,249303,628300,MKT
06069701201030000,2020,268516,205684,474200,MKT
06069701201030000,2019,268516,205684,474200,MKT
06069701201040000,2021,381902,225398,607300,MKT
06069701201040000,2020,270307,180293,450600,MKT
06069701201040000,2019,270307,180293,450600,MKT
06069701201050000,2021,1144,0,1144,COST
06069701201050000,2020,1065,0,1065,COST
06069701201050000,2019,1065,0,1065,COST
06069701201070000,2021,380485,0,380485,COST
06069701201070000,2020,269434,0,269434,COST
06069701201070000,2019,1043,0,1043,COST
06069701201100000,2021,380485,0,380485,COST
06069701201100000,2020,269434,0,269434,COST
06069701210100000,2021,145053,232450,377503,COST
06069701210100000,2020,116580,195800,312380,COST
06069701210100000,2019,116580,195800,312380,COST
06069701302010000,2021,143740,452800,596540,COST
06069701302010000,2020,116591,216700,333291,COST
06069701302010000,2019,116591,199600,316191,COST
06069701302100000,2021,143738,129790,273528,COST
06069701302100000,2020,116590,61920,178510,COST
06069701302100000,2019,116590,61920,178510,COST
06069701302150000,2021,219779,175021,394800,MKT
06069701302150000,2020,180634,110010,290644,COST
06069701302150000,2019,180634,110010,290644,COST
06069701302200000,2021,8358,289580,297938,COST
06069701302200000,2020,8170,252120,260290,COST
06069701302200000,2019,8170,252120,260290,COST
06069701302250000,2021,210475,199525,410000,MKT
06069701302250000,2020,172740,143090,315830,COST
06069701302250000,2019,172740,143090,315830,COST
06069701302300000,2021,4033,150220,154253,COST
06069701302300000,2020,4156,74460,78616,COST
06069701302300000,2019,4156,74460,78616,COST
06069701302350000,2021,145162,498650,643812,COST
06069701302350000,2020,116682,418150,534832,COST
06069701302350000,2019,116682,418150,534832,COST
06069701302400000,2021,283002,398080,681082,COST
06069701302400000,2020,208210,344370,552580,COST
06069701302400000,2019,208210,344370,552580,COST
06069701302450000,2021,406,0,406,COST
06069701302450000,2020,378,0,378,COST
06069701302450000,2019,378,0,378,COST
06069701401010000,2021,144504,738600,883104,COST
06069701401010000,2020,116069,290170,406239,COST
06069701401010000,2019,116069,290170,406239,COST
06069701401100000,2021,144504,190080,334584,COST
06069701401100000,2020,116069,166730,282799,COST
06069701401100000,2019,116069,166730,282799,COST
06069701401200000,2021,3443,242250,245693,COST
06069701401200000,2020,3612,214840,218452,COST
06069701401200000,2019,3612,214840,218452,COST
06069701401300000,2021,28617,0,28617,COST
06069701401300000,2020,27845,0,27845,COST
06069701401300000,2019,27845,0,27845,COST
06069702101020000,2021,267388,641112,908500,INCOME
06069702101020000,2020,195047,538080,733127,COST
06069702101020000,2019,195047,538080,733127,COST
06069702101030000,2021,131112,333288,464400,INCOME
06069702101030000,2020,121874,237726,359600,INCOME
06069702101030000,2019,121874,237726,359600,INCOME
06069702101040000,2021,192635,213465,406100,MKT
06069702101040000,2020,148941,180959,329900,MKT
06069702101040000,2019,148941,175959,324900,MKT
06069702101050000,2021,103941,0,103941,COST
06069702101050000,2020,87029,0,87029,COST
06069702101050000,2019,87029,0,87029,COST
06069702101070000,2021,150506,26480,176986,COST
06069702101070000,2020,120135,27800,147935,COST
06069702101070000,2019,120135,27800,147935,COST
06069702101100000,2021,14273,9680,23953,COST
06069702101100000,2020,18375,10020,28395,COST
06069702101100000,2019,18375,10020,28395,COST
06069702101120000,2021,192675,425925,618600,MKT
06069702101120000,2020,148968,342840,491808,COST
06069702101120000,2019,148968,342840,491808,COST
06069702102017000,2021,396631,21300,417931,COST
06069702102017000,2020,360046,23100,383146,COST
06069702102017000,2019,360046,23100,383146,COST
06069702102020000,2021,163740,10010,173750,COST
06069702102020000,2020,129284,10580,139864,COST
06069702102020000,2019,129284,10580,139864,COST
06069702102030000,2021,156215,178085,334300,MKT
06069702102030000,2020,126951,72110,199061,COST
06069702102030000,2019,126951,72110,199061,COST
06069702102040000,2021,163029,9340,172369,COST
06069702102040000,2020,128795,9820,138615,COST
06069702102040000,2019,128795,9820,138615,COST
06069702102050000,2021,155997,494703,650700,MKT
06069702102050000,2020,123944,381156,505100,MKT
06069702102050000,2019,123944,381156,505100,MKT
06069702102060000,2021,160351,285049,445400,MKT
06069702102060000,2020,126951,235549,362500,MKT
06069702102060000,2019,126951,235549,362500,MKT
06069702103010000,2021,363216,171470,534686,COST
06069702103010000,2020,258752,132748,391500,MKT
06069702103010000,2019,258752,132748,391500,MKT
06069702103100000,2021,144508,216880,361388,COST
06069702103100000,2020,116073,186890,302963,COST
06069702103100000,2019,116073,186890,302963,COST
06069702103150000,2021,337022,755900,1092922,COST
06069702103150000,2020,264902,692100,957002,COST
06069702103150000,2019,264902,692100,957002,COST
06069702103200000,2021,176782,250218,427000,MKT
06069702103200000,2020,138208,203592,341800,MKT
06069702103200000,2019,138208,203592,341800,MKT
06069702103250000,2021,162407,205193,367600,MKT
06069702103250000,2020,132153,126070,258223,COST
06069702103250000,2019,132153,126070,258223,COST
06069702103300000,2021,354697,175640,530337,COST
06069702103300000,2020,253459,131041,384500,MKT
06069702103300000,2019,253459,131041,384500,MKT
06069702103350000,2021,378584,171420,550004,COST
06069702103350000,2020,268261,168939,437200,MKT
06069702103350000,2019,268261,168939,437200,MKT
06069702103400000,2021,378584,345316,723900,MKT
06069702103400000,2020,268261,307539,575800,MKT
06069702103400000,2019,268261,307539,575800,MKT
06069702103500000,2021,488916,374420,863336,COST
06069702103500000,2020,335188,251810,586998,COST
06069702103500000,2019,335188,251810,586998,COST
06069702104550100,2021,311420,0,311420,COST
06069702104550100,2020,226304,0,226304,COST
06069702104550100,2019,226304,0,226304,COST
06069702201010000,2021,142170,258510,400680,COST
06069702201010000,2020,114320,220450,334770,COST
06069702201010000,2019,114320,220450,334770,COST
06069702201030000,2021,200881,383630,584511,COST
06069702201030000,2020,154478,335930,490408,COST
06069702201030000,2019,154478,335930,490408,COST
06069702201090000,2021,362542,244258,606800,MKT
06069702201090000,2020,258334,199966,458300,MKT
06069702201090000,2019,258334,199966,458300,MKT
06069702201180000,2021,362542,0,362542,COST
06069702201180000,2020,258334,0,258334,COST
06069702201180000,2019,258334,0,258334,COST
06069702201260000,2021,372688,791090,1163778,COST
06069702201260000,2020,264619,657730,922349,COST
06069702201260000,2019,264619,657730,922349,COST
06069702201380000,2021,1007,3740,4747,COST
06069702201380000,2020,937,3620,4557,COST
06069702201380000,2019,937,3620,4557,COST
06069702201500000,2021,338232,956980,1295212,COST
06069702201500000,2020,285630,676740,962370,COST
06069702201500000,2019,285630,676740,962370,COST
06069702202010000,2021,169359,1166450,1335809,COST
06069702202010000,2020,143041,819580,962621,COST
06069702202010000,2019,143041,819580,962621,COST
06069702203100000,2021,553,0,553,COST
06069702203100000,2020,515,0,515,COST
06069702203100000,2019,515,0,515,COST
06069702301010000,2021,144052,490620,634672,COST
06069702301010000,2020,115649,419740,535389,COST
06069702301010000,2019,115649,419740,535389,COST
06069702301300000,2021,1376,0,1376,COST
06069702301300000,2020,1281,0,1281,COST
06069702301300000,2019,1281,0,1281,COST
06069702301330000,2021,144771,17120,161891,COST
06069702301330000,2020,116318,16800,133118,COST
06069702301330000,2019,116318,16800,133118,COST
06069702301400000,2021,228348,673852,902200,MKT
06069702301400000,2020,172719,637190,809909,COST
06069702301400000,2019,172719,637190,809909,COST
06069702301450000,2021,187905,544195,732100,MKT
06069702301450000,2020,145751,497160,642911,COST
06069702301450000,2019,145751,497160,642911,COST
06069702301500000,2021,168039,242240,410279,COST
06069702301500000,2020,141812,178840,320652,COST
06069702301500000,2019,141812,186440,328252,COST
06069702301550000,2021,42485,0,42485,COST
06069702301550000,2020,30007,0,30007,COST
06069702301550000,2019,30007,0,30007,COST
06069702301600000,2021,278,0,278,COST
06069702301600000,2020,259,0,259,COST
06069702301600000,2019,259,0,259,COST
06069702301670000,2021,168321,335580,503901,COST
06069702301670000,2020,116643,237060,353703,COST
06069702301670000,2019,4583,237060,241643,COST
06069702301690000,2021,297732,0,297732,COST
06069702301690000,2020,191071,0,191071,COST
06069702301720000,2021,491125,0,491125,COST
06069702301720000,2020,295458,0,295458,COST
06069702301870000,2021,171921,216679,388600,MKT
06069702301870000,2020,147952,185548,333500,OVR
06069702301870000,2019,147952,185548,333500,MKT
06069702301910000,2021,171166,54480,225646,COST
06069702301910000,2020,143033,29600,172633,COST
06069702301910000,2019,143033,29600,172633,COST
06069702301950000,2021,173087,0,173087,COST
06069702301950000,2020,135689,0,135689,COST
06069702301950000,2019,135689,0,135689,COST
06069702302010000,2021,144000,327460,471460,COST
06069702302010000,2020,115600,0,115600,COST
06069702302010000,2019,115600,0,115600,COST
06069702302020000,2021,224008,68660,292668,COST
06069702302020000,2020,169857,58320,228177,COST
06069702302020000,2019,169857,58320,228177,COST
06069702302030000,2021,176006,1200394,1376400,INCOME
06069702302030000,2020,137679,1213321,1351000,INCOME
06069702302030000,2019,137679,1213321,1351000,INCOME
06069702302040000,2021,175685,0,175685,COST
06069702302040000,2020,137461,0,137461,COST
06069702302040000,2019,137461,0,137461,COST
06069702302050000,2021,237339,539100,776439,COST
06069702302050000,2020,194844,495240,690084,COST
06069702302050000,2019,194844,495240,690084,COST
06069702302060000,2021,409502,1084498,1494000,INCOME
06069702302060000,2020,258398,1023502,1281900,INCOME
06069702302060000,2019,258398,1023502,1281900,INCOME
06069702302070000,2021,111638,121862,233500,MKT
06069702302070000,2020,89722,27110,116832,COST
06069702302070000,2019,89722,27110,116832,COST
06069702302080000,2021,152311,256889,409200,MKT
06069702302080000,2020,121389,216611,338000,MKT
06069702302080000,2019,121389,216611,338000,MKT
06069702302100000,2021,204275,0,204275,COST
06069702302100000,2020,156749,0,156749,COST
06069702302100000,2019,156749,0,156749,COST
06069702304010000,2021,198724,900443,1099167,OVR
06069702304010000,2020,163925,666200,830125,COST
06069702304010000,2019,163925,632475,796400,MKT
06069702402010000,2021,133165,500,133665,COST
06069702402010000,2020,99348,400,99748,COST
06069702402010000,2019,99348,400,99748,COST
06069702402020000,2021,133165,184835,318000,MKT
06069702402020000,2020,99348,130552,229900,MKT
06069702402020000,2019,99348,130552,229900,MKT
06069702402030000,2021,132490,501410,633900,INCOME
06069702402030000,2020,98909,462500,561409,COST
06069702402030000,2019,98909,336950,435859,COST
06069702402040000,2021,132490,3250,135740,COST
06069702402040000,2020,98909,3330,102239,COST
06069702402040000,2019,98909,3330,102239,COST
06069702402050000,2021,133165,35720,168885,COST
06069702402050000,2020,99348,12760,112108,COST
06069702402050000,2019,99348,12760,112108,COST
06069702402060000,2021,326055,649890,975945,COST
06069702402060000,2020,149104,600310,749414,COST
06069702402060000,2019,149104,600310,749414,COST
06069702402100000,2021,636215,53485,689700,INCOME
06069702402100000,2020,345584,281516,627100,INCOME
06069702402100000,2019,345584,281516,627100,INCOME
06069702402160000,2021,196188,4210,200398,COST
06069702402160000,2020,151331,4540,155871,COST
06069702402160000,2019,151331,4540,155871,COST
06069702403010000,2021,133165,94440,227605,COST
06069702403010000,2020,99348,95400,194748,COST
06069702403010000,2019,99348,95400,194748,COST
06069702403020000,2021,133165,1210,134375,COST
06069702403020000,2020,99348,1220,100568,COST
06069702403020000,2019,99348,1220,100568,COST
06069702403030000,2021,132998,227402,360400,MKT
06069702403030000,2020,98909,165550,264459,COST
06069702403030000,2019,98909,104420,203329,COST
06069702403040000,2021,133165,0,133165,COST
06069702403040000,2020,99348,0,99348,COST
06069702403040000,2019,99348,0,99348,COST
06069702403050000,2021,132896,560,133456,COST
06069702403050000,2020,99173,580,99753,COST
06069702403050000,2019,99173,580,99753,COST
06069702403060000,2021,133570,199530,333100,MKT
06069702403060000,2020,99348,135970,235318,COST
06069702403060000,2019,99348,135970,235318,COST
06069702403070000,2021,133165,207135,340300,MKT
06069702403070000,2020,99348,164552,263900,MKT
06069702403070000,2019,99348,164552,263900,MKT
06069702403080000,2021,133570,211830,345400,MKT
06069702403080000,2020,99348,102210,201558,COST
06069702403080000,2019,99348,102210,201558,COST
06069702403090000,2021,133342,113658,247000,MKT
06069702403090000,2020,99173,41160,140333,COST
06069702403090000,2019,99173,41160,140333,COST
06069702403100000,2021,133570,194830,328400,MKT
06069702403100000,2020,99348,75910,175258,COST
06069702403100000,2019,99348,75910,175258,COST
06069702404010000,2021,129036,203564,332600,MKT
06069702404010000,2020,96660,151340,248000,MKT
06069702404010000,2019,96660,151340,248000,MKT
06069702404020000,2021,129036,391964,521000,MKT
06069702404020000,2020,96660,329240,425900,MKT
06069702404020000,2019,96660,322040,418700,MKT
06069702404030000,2021,129036,244264,373300,MKT
06069702404030000,2020,96660,180640,277300,MKT
06069702404030000,2019,96660,180640,277300,MKT
06069702404040000,2021,128330,211070,339400,MKT
06069702404040000,2020,96199,158301,254500,MKT
06069702404040000,2019,96199,158301,254500,MKT
06069702404050000,2021,149305,182395,331700,MKT
06069702404050000,2020,109756,136144,245900,MKT
06069702404050000,2019,109756,136144,245900,MKT
06069702404060000,2021,151016,324184,475200,MKT
06069702404060000,2020,110851,247010,357861,OVR
06069702404060000,2019,110851,247010,357861,OVR
06069702404070000,2021,129737,2370,132107,COST
06069702404070000,2020,97117,2560,99677,COST
06069702404070000,2019,97117,2560,99677,COST
06069702404080000,2021,129737,265263,395000,MKT
06069702404080000,2020,97117,212283,309400,MKT
06069702404080000,2019,97117,212283,309400,MKT
06069702404090000,2021,129036,18290,147326,COST
06069702404090000,2020,96660,18120,114780,COST
06069702404090000,2019,96660,18120,114780,COST
06069702404100000,2021,129036,196264,325300,MKT
06069702404100000,2020,96660,142640,239300,MKT
06069702404100000,2019,96660,142640,239300,MKT
06069702405010000,2021,177717,169883,347600,MKT
06069702405010000,2020,133438,110840,244278,COST
06069702405010000,2019,133438,110840,244278,COST
06069702405020000,2021,183870,282530,466400,MKT
06069702405020000,2020,131580,217520,349100,MKT
06069702405020000,2019,131580,217520,349100,MKT
06069702405030000,2021,183870,1150,185020,COST
06069702405030000,2020,131580,1260,132840,COST
06069702405030000,2019,131580,1260,132840,COST
06069702405040000,2021,175320,130780,306100,MKT
06069702405040000,2020,131580,21530,153110,COST
06069702405040000,2019,131580,21530,153110,COST
06069702405050000,2021,175320,208480,383800,MKT
06069702405050000,2020,131580,188230,319810,COST
06069702405050000,2019,131580,188230,319810,COST
06069702405060000,2021,183870,297230,481100,MKT
06069702405060000,2020,131580,229620,361200,MKT
06069702405060000,2019,131580,229620,361200,MKT
06069702405070000,2021,183870,150800,334670,COST
06069702405070000,2020,131580,128380,259960,COST
06069702405070000,2019,131580,128380,259960,COST
06069702405080000,2021,183870,16240,200110,COST
06069702405080000,2020,131580,16500,148080,COST
06069702405080000,2019,131580,16500,148080,COST
06069702405120000,2021,274511,262189,536700,MKT
06069702405120000,2020,202758,246342,449100,MKT
06069702405120000,2019,202758,246342,449100,MKT
06069702405140000,2021,283002,237798,520800,MKT
06069702405140000,2020,208210,228490,436700,MKT
06069702405140000,2019,208210,228490,436700,MKT
06069702405160000,2021,378584,211416,590000,MKT
06069702405160000,2020,268261,164739,433000,OVR
06069702405160000,2019,268261,164739,433000,MKT
06069702405180000,2021,276802,343098,619900,INCOME
06069702405180000,2020,204232,407668,611900,INCOME
06069702405180000,2019,204232,407668,611900,INCOME
06069702405220000,2021,289228,7270,296498,COST
06069702405220000,2020,212193,7180,219373,COST
06069702405220000,2019,212193,14740,226933,COST
06069702406010000,2021,181257,231743,413000,MKT
06069702406010000,2020,129950,177250,307200,OVR
06069702406010000,2019,129950,177250,307200,MKT
06069702406020000,2021,172863,157137,330000,MKT
06069702406020000,2020,129675,0,129675,COST
06069702406020000,2019,129675,0,129675,COST
06069702406030000,2021,180816,610,181426,COST
06069702406030000,2020,129675,630,130305,COST
06069702406030000,2019,129675,630,130305,COST
06069702406040000,2021,180816,2280,183096,COST
06069702406040000,2020,129675,2090,131765,COST
06069702406040000,2019,129675,2090,131765,COST
06069702406050000,2021,180816,231284,412100,MKT
06069702406050000,2020,129675,189425,319100,MKT
06069702406050000,2019,129675,189425,319100,MKT
06069702406060000,2021,180816,198820,379636,COST
06069702406060000,2020,129675,163350,293025,COST
06069702406060000,2019,129675,163350,293025,COST
06069702406070000,2021,180816,205880,386696,COST
06069702406070000,2020,129675,226025,355700,INCOME
06069702406070000,2019,129675,226025,355700,INCOME
06069702406080000,2021,180816,780,181596,COST
06069702406080000,2020,129675,810,130485,COST
06069702406080000,2019,129675,810,130485,COST
06069702407010000,2021,175320,162180,337500,MKT
06069702407010000,2020,131580,104090,235670,COST
06069702407010000,2019,131580,104090,235670,COST
06069702407020000,2021,174973,277027,452000,MKT
06069702407020000,2020,131310,232570,363880,COST
06069702407020000,2019,131310,232570,363880,COST
06069702407030000,2021,174973,147627,322600,MKT
06069702407030000,2020,131310,55800,187110,COST
06069702407030000,2019,131310,12250,143560,COST
06069702407040000,2021,174973,161627,336600,MKT
06069702407040000,2020,131310,100970,232280,COST
06069702407040000,2019,131310,100690,232000,COST
06069702407050000,2021,183438,231862,415300,MKT
06069702407050000,2020,131310,185090,316400,MKT
06069702407050000,2019,131310,185090,316400,MKT
06069702407060000,2021,183438,249662,433100,MKT
06069702407060000,2020,131310,216290,347600,MKT
06069702407060000,2019,131310,216290,347600,MKT
06069702407070000,2021,174973,146227,321200,MKT
06069702407070000,2020,131310,84790,216100,COST
06069702407070000,2019,131310,84790,216100,COST
06069702407080000,2021,192635,257465,450100,MKT
06069702407080000,2020,137026,200874,337900,MKT
06069702407080000,2019,137026,200874,337900,MKT
06069702408010000,2021,201642,276840,478482,COST
06069702408010000,2020,142589,277511,420100,MKT
06069702408010000,2019,142589,277511,420100,MKT
06069702408020000,2021,201262,19120,220382,COST
06069702408020000,2020,142355,19240,161595,COST
06069702408020000,2019,142355,19240,161595,COST
06069702408030000,2021,300591,190830,491421,COST
06069702408030000,2020,220758,173430,394188,COST
06069702408030000,2019,220758,173430,394188,COST
06069702408040000,2021,200499,261301,461800,MKT
06069702408040000,2020,141885,193315,335200,MKT
06069702408040000,2019,141885,193315,335200,MKT
06069702408050000,2021,200116,717520,917636,COST
06069702408050000,2020,141649,606860,748509,COST
06069702408050000,2019,141649,606860,748509,COST
06069702408060000,2021,199731,227070,426801,COST
06069702408060000,2020,141412,213760,355172,COST
06069702408060000,2019,141412,213760,355172,COST
06069702408070000,2021,199731,314269,514000,MKT
06069702408070000,2020,141412,276488,417900,MKT
06069702408070000,2019,141412,276488,417900,MKT
06069702408080000,2021,187681,168719,356400,MKT
06069702408080000,2020,141174,124800,265974,COST
06069702408080000,2019,141174,124800,265974,COST
06069702408090000,2021,292223,1293220,1585443,COST
06069702408090000,2020,128564,1192750,1321314,COST
06069702408090000,2019,128564,1192750,1321314,COST
06069702408100000,2021,181257,226943,408200,MKT
06069702408100000,2020,129950,156650,286600,MKT
06069702408100000,2019,129950,156650,286600,MKT
06069702408110000,2021,302848,589952,892800,INCOME
06069702408110000,2020,211752,578648,790400,INCOME
06069702408110000,2019,211752,578648,790400,INCOME
06069702408120000,2021,186009,212691,398700,MKT
06069702408120000,2020,132912,164188,297100,MKT
06069702408120000,2019,132912,164188,297100,MKT
06069702408130000,2021,314276,50540,364816,COST
06069702408130000,2020,134221,48280,182501,COST
06069702408130000,2019,134221,48280,182501,COST
06069702408140000,2021,320402,498298,818700,INCOME
06069702408140000,2020,135763,556537,692300,INCOME
06069702408140000,2019,135763,556537,692300,INCOME
06069702408150000,2021,325452,468890,794342,COST
06069702408150000,2020,212704,408310,621014,COST
06069702408150000,2019,212704,408310,621014,COST
06069702408180000,2021,331449,1415051,1746500,INCOME
06069702408180000,2020,224744,1335056,1559800,INCOME
06069702408180000,2019,224744,1335056,1559800,INCOME
06069702409010000,2021,177237,0,177237,COST
06069702409010000,2020,127436,0,127436,COST
06069702409010000,2019,127436,0,127436,COST
06069702409020000,2021,143178,154822,298000,MKT
06069702409020000,2020,106740,31070,137810,COST
06069702409020000,2019,106740,31070,137810,COST
06069702409030000,2021,124716,24320,149036,COST
06069702409030000,2020,93835,24410,118245,COST
06069702409030000,2019,93835,24410,118245,COST
06069702409040000,2021,124716,194870,319586,COST
06069702409040000,2020,93835,169380,263215,COST
06069702409040000,2019,93835,169380,263215,COST
06069702409050000,2021,123975,17850,141825,COST
06069702409050000,2020,93350,17990,111340,COST
06069702409050000,2019,93350,17990,111340,COST
06069702409060000,2021,123975,275625,399600,MKT
06069702409060000,2020,93350,216150,309500,MKT
06069702409060000,2019,93350,216150,309500,MKT
06069703101010000,2021,323428,160770,484198,COST
06069703101010000,2020,269239,118560,387799,COST
06069703101010000,2019,269239,118560,387799,COST
06069703101300000,2021,145845,858140,1003985,COST
06069703101300000,2020,117317,728610,845927,COST
06069703101300000,2019,117317,728610,845927,COST
06069703101450000,2021,144252,564270,708522,COST
06069703101450000,2020,117068,380240,497308,COST
06069703101450000,2019,117068,380240,497308,COST
06069703101500000,2021,257696,132250,389946,COST
06069703101500000,2020,191898,141302,333200,MKT
06069703101500000,2019,191898,141302,333200,MKT
06069703101550000,2021,17389,850,18239,COST
06069703101550000,2020,16137,810,16947,COST
06069703101550000,2019,16137,810,16947,COST
06069703102020000,2021,211552,286948,498500,MKT
06069703102020000,2020,161601,243799,405400,MKT
06069703102020000,2019,161601,243799,405400,MKT
06069703102040000,2021,270960,218140,489100,MKT
06069703102040000,2020,200472,194528,395000,MKT
06069703102040000,2019,200472,194528,395000,MKT
06069703103010000,2021,47156,0,47156,COST
06069703103010000,2020,43725,0,43725,COST
06069703103010000,2019,43725,0,43725,COST
06069703201010000,2021,145162,315420,460582,COST
06069703201010000,2020,116682,280750,397432,COST
06069703201010000,2019,116682,280750,397432,COST
06069703201300000,2021,21843,0,21843,COST
06069703201300000,2020,23067,0,23067,COST
06069703201300000,2019,23067,0,23067,COST
06069703201600000,2021,145052,43330,188382,COST
06069703201600000,2020,116579,43670,160249,COST
06069703201600000,2019,116579,43670,160249,COST
06069703212010000,2021,25830,0,25830,COST
06069703212010000,2020,26980,0,26980,COST
06069703212010000,2019,26980,0,26980,COST
06069703301010000,2021,373580,158190,531770,COST
06069703301010000,2020,265170,130830,396000,MKT
06069703301010000,2019,265170,130830,396000,MKT
06069703301170000,2021,6235,799820,806055,COST
06069703301170000,2020,6199,673280,679479,COST
06069703301170000,2019,6199,673280,679479,COST
06069703301200000,2021,13813,0,13813,COST
06069703301200000,2020,14587,0,14587,COST
06069703301200000,2019,14587,0,14587,COST
06069703301300000,2021,19990,0,19990,COST
06069703301300000,2020,18551,0,18551,COST
06069703301300000,2019,18551,0,18551,COST
06069703401030000,2021,204628,384003,588631,OVR
06069703401030000,2020,137835,152965,290800,MKT
06069703401030000,2019,137835,159565,297400,MKT
06069703401200000,2021,168193,420300,588493,COST
06069703401200000,2020,116524,299670,416194,COST
06069703401200000,2019,116524,299670,416194,COST
06069703402010000,2021,464412,0,464412,COST
06069703402010000,2020,320510,0,320510,COST
06069703402010000,2019,320510,0,320510,COST
06069703402030000,2021,305513,171280,476793,COST
06069703402030000,2020,222561,149950,372511,COST
06069703402030000,2019,222561,149950,372511,COST
06069703402050000,2021,448834,273666,722500,MKT
06069703402050000,2020,311126,247010,558136,COST
06069703402050000,2019,311126,247010,558136,COST
06069703402350000,2021,145611,2052100,2197711,COST
06069703402350000,2020,117099,1748440,1865539,COST
06069703402350000,2019,117099,1748440,1865539,COST
06069703402400000,2021,2209,176660,178869,COST
06069703402400000,2020,2056,176890,178946,COST
06069703402400000,2019,2056,176890,178946,COST
06069703410200000,2021,554,0,554,COST
06069703410200000,2020,515,0,515,COST
06069703410200000,2019,515,0,515,COST
06069704101200000,2021,51554,6410,57964,COST
06069704101200000,2020,49070,7180,56250,COST
06069704101200000,2019,49070,7180,56250,COST
06069704106010000,2021,153036,328264,481300,MKT
06069704106010000,2020,118191,273709,391900,MKT
06069704106010000,2019,118191,273709,391900,MKT
06069704110010000,2021,1126,0,1126,COST
06069704110010000,2020,1048,0,1048,COST
06069704110010000,2019,1048,0,1048,COST
06069704124010000,2021,1148,0,1148,COST
06069704124010000,2020,1068,0,1068,COST
06069704124010000,2019,1068,0,1068,COST
06069704148010000,2021,145075,781870,926945,COST
06069704148010000,2020,114700,687150,801850,COST
06069704148010000,2019,114700,687150,801850,COST
06069704154010000,2021,1142,0,1142,COST
06069704154010000,2020,1063,0,1063,COST
06069704154010000,2019,1063,0,1063,COST
06069704178010000,2021,147005,808590,955595,COST
06069704178010000,2020,116497,716360,832857,COST
06069704178010000,2019,116497,716360,832857,COST
06069704201010000,2021,145052,486670,631722,COST
06069704201010000,2020,114679,415750,530429,COST
06069704201010000,2019,114679,415750,530429,COST
06069704201150000,2021,9688,0,9688,COST
06069704201150000,2020,10100,0,10100,COST
06069704201150000,2019,10100,0,10100,COST
06069704212010000,2021,145058,843630,988688,COST
06069704212010000,2020,114685,703910,818595,COST
06069704212010000,2019,114685,703910,818595,COST
06069704224010000,2021,9608,369360,378968,COST
06069704224010000,2020,10300,317230,327530,COST
06069704224010000,2019,10300,317230,327530,COST
06069704230010000,2021,145064,605710,750774,COST
06069704230010000,2020,114690,535520,650210,COST
06069704230010000,2019,114690,535520,650210,COST
06069704266010000,2021,145072,869000,1014072,COST
06069704266010000,2020,114697,737900,852597,COST
06069704266010000,2019,114697,737900,852597,COST
06069704301010000,2021,267626,752370,1019996,COST
06069704301010000,2020,168687,655790,824477,COST
06069704301010000,2019,168687,655790,824477,COST
06069704301200000,2021,289035,677820,966855,COST
06069704301200000,2020,228363,597060,825423,COST
06069704301200000,2019,228363,597060,825423,COST
06069704301300000,2021,1445,0,1445,COST
06069704301300000,2020,1345,0,1345,COST
06069704301300000,2019,1345,0,1345,COST
06069704301400000,2021,2071,0,2071,COST
06069704301400000,2020,1928,0,1928,COST
06069704301400000,2019,1928,0,1928,COST
06069704301500000,2021,1424,0,1424,COST
06069704301500000,2020,1325,0,1325,COST
06069704301500000,2019,1325,0,1325,COST
06069704372010000,2021,145056,430310,575366,COST
06069704372010000,2020,114683,400270,514953,OVR
06069704372010000,2019,114683,400270,514953,COST
06069704378010000,2021,145054,842680,987734,COST
06069704378010000,2020,114681,738260,852941,COST
06069704378010000,2019,114681,738260,852941,COST
06069704381010000,2021,145078,787200,932278,COST
06069704381010000,2020,114703,677350,792053,COST
06069704381010000,2019,114703,677350,792053,COST
06069704390010000,2021,145069,583740,728809,COST
06069704390010000,2020,114695,526060,640755,COST
06069704390010000,2019,114695,526060,640755,COST
06069704401010000,2021,145052,250090,395142,COST
06069704401010000,2020,114679,223870,338549,COST
06069704401010000,2019,114679,223870,338549,COST
06069704401030000,2021,117115,244360,361475,COST
06069704401030000,2020,111041,215110,326151,COST
06069704401030000,2019,111041,215110,326151,COST
06069705101010000,2021,60825,0,60825,COST
06069705101010000,2020,64047,0,64047,COST
06069705101010000,2019,64047,0,64047,COST
06069705201010000,2021,44449,630,45079,COST
06069705201010000,2020,46464,650,47114,COST
06069705201010000,2019,46464,650,47114,COST
06069705301010000,2021,44523,5420850,5465373,COST
06069705301010000,2020,46774,4689590,4736364,COST
06069705301010000,2019,46774,4689590,4736364,COST
06069705401100000,2021,1587,0,1587,COST
06069705401100000,2020,1477,0,1477,COST
06069705401100000,2019,1477,0,1477,COST
06069705401200000,2021,146242,527080,673322,COST
06069705401200000,2020,115786,120130,235916,COST
06069705401200000,2019,115786,120130,235916,COST
06069705401300000,2021,2186,0,2186,COST
06069705401300000,2020,2035,0,2035,COST
06069705401300000,2019,2035,0,2035,COST
06069705401400000,2021,2186,0,2186,COST
06069705401400000,2020,2035,0,2035,COST
06069705401400000,2019,2035,0,2035,COST
06069705401500000,2021,2186,0,2186,COST
06069705401500000,2020,2035,0,2035,COST
06069705401500000,2019,2035,0,2035,COST
06069706101010000,2021,12889,0,12889,COST
06069706101010000,2020,11999,0,11999,COST
06069706101010000,2019,11999,0,11999,COST
06069706201010000,2021,31984,0,31984,COST
06069706201010000,2020,29774,0,29774,COST
06069706201010000,2019,29774,0,29774,COST
06069707101010000,2021,15236,0,15236,COST
06069707101010000,2020,14171,0,14171,COST
06069707101010000,2019,14171,0,14171,COST
06069707101200000,2021,1004,0,1004,COST
06069707101200000,2020,1540,0,1540,COST
06069707101200000,2019,1540,0,1540,COST
