id,year,land,building,total,method
06069707101300000,2021,788,0,788,COST
06069707101300000,2020,52,0,52,COST
06069707101300000,2019,52,0,52,COST
06069707301010000,2021,67067,0,67067,COST
06069707301010000,2020,70289,0,70289,COST
06069707301010000,2019,70289,0,70289,COST
06069707401010000,2021,12429,0,12429,COST
06069707401010000,2020,11571,0,11571,COST
06069707401010000,2019,11571,0,11571,COST
06069708101010000,2021,12538,0,12538,COST
06069708101010000,2020,13200,0,13200,COST
06069708101010000,2019,13200,0,13200,COST
06069708101100000,2021,23250,1427750,1451000,COST
06069708101100000,2020,22017,1196220,1218237,COST
06069708101100000,2019,22017,1111310,1133327,COST
06069708201010000,2021,10680,0,10680,COST
06069708201010000,2020,10060,0,10060,COST
06069708201010000,2019,10060,0,10060,COST
06069708201100000,2021,34482,600360,634842,COST
06069708201100000,2020,32430,520950,553380,COST
06069708201100000,2019,32430,520950,553380,COST
06069708301010000,2021,22503,1640150,1662653,COST
06069708301010000,2020,21410,1399430,1420840,COST
06069708301010000,2019,21410,1501110,1522520,COST
06069709101010000,2021,505714,597320,1103034,COST
06069709101010000,2020,252927,526980,779907,COST
06069709101010000,2019,252927,526980,779907,COST
06069709101020000,2021,145202,20530,165732,COST
06069709101020000,2020,114819,19500,134319,COST
06069709101020000,2019,114819,19500,134319,COST
06069709101200000,2021,219852,345748,565600,MKT
06069709101200000,2020,148843,313057,461900,MKT
06069709101200000,2019,148843,196457,345300,MKT
06069709101450000,2021,19195,315170,334365,COST
06069709101450000,2020,18233,287740,305973,COST
06069709101450000,2019,18233,287740,305973,COST
06069709101650000,2021,474679,18530,493209,COST
06069709101650000,2020,242934,18530,261464,COST
06069709101650000,2019,242934,18530,261464,COST
06069709101700000,2021,146521,635590,782111,COST
06069709101700000,2020,116046,574830,690876,COST
06069709101700000,2019,116046,574830,690876,COST
06069709201036500,2021,143165,489790,632955,COST
06069709201036500,2020,73106,475510,548616,COST
06069709201036500,2019,73106,475510,548616,COST
06069709201060000,2021,147862,1669350,1817212,COST
06069709201060000,2020,117294,925600,1042894,COST
06069709201060000,2019,117294,216150,333444,COST
06069709202010000,2021,148332,788150,936482,COST
06069709202010000,2020,117732,692220,809952,COST
06069709202010000,2019,117732,692220,809952,COST
06069709350010000,2021,145322,745850,891172,COST
06069709350010000,2020,1282,0,1282,COST
06069709350010000,2019,1282,0,1282,COST
06069709401010000,2021,82908,0,82908,COST
06069709401010000,2020,51636,0,51636,COST
06069709401010000,2019,51636,0,51636,COST
06069709401200000,2021,71237,0,71237,COST
06069709401200000,2020,57993,0,57993,COST
06069709401200000,2019,57993,0,57993,COST
06069709401400000,2021,432603,491250,923853,COST
06069709401400000,2020,228997,417550,646547,COST
06069709401400000,2019,228997,417550,646547,COST
06069709402010000,2021,10821,110460,121281,COST
06069709402010000,2020,10457,99420,109877,COST
06069709402010000,2019,10457,99420,109877,COST
06069709402150000,2021,402830,2085020,2487850,COST
06069709402150000,2020,228610,520000,748610,COST
06069709402150000,2019,228610,528840,757450,COST
06069709402280000,2021,14015,606800,620815,COST
06069709402280000,2020,16376,546810,563186,COST
06069709402280000,2019,16376,546810,563186,COST
06069709402320000,2021,6908,1003220,1010128,COST
06069709402320000,2020,7469,898610,906079,COST
06069709402320000,2019,7469,898610,906079,COST
06069709402400000,2021,378600,454300,832900,MKT
06069709402400000,2020,210364,498936,709300,MKT
06069709402400000,2019,210364,498936,709300,MKT
06069709402550000,2021,449022,463010,912032,COST
06069709402550000,2020,234492,405180,639672,COST
06069709402550000,2019,234492,417400,651892,COST
06069709402580000,2021,378791,11950,390741,COST
06069709402580000,2020,210432,12220,222652,COST
06069709402650000,2021,378584,400916,779500,MKT
06069709402650000,2020,210359,449841,660200,MKT
06069709402650000,2019,210359,449841,660200,MKT
06069709402700000,2021,283074,0,283074,COST
06069709402700000,2020,174822,0,174822,COST
06069709402700000,2019,174822,0,174822,COST
06069709402750000,2021,283074,0,283074,COST
06069709402750000,2020,174822,0,174822,COST
06069709402750000,2019,174822,0,174822,COST
06069709402800000,2021,283074,989520,1272594,COST
06069709402800000,2020,174822,863470,1038292,COST
06069709402800000,2019,174822,863470,1038292,COST
06069709402850000,2021,283074,0,283074,COST
06069709402850000,2020,174822,0,174822,COST
06069709402850000,2019,174822,0,174822,COST
06069710101010000,2021,144236,165540,309776,COST
06069710101010000,2020,115820,142300,258120,OVR
06069710101010000,2019,115820,142300,258120,COST
06069710101030000,2021,711,0,711,COST
06069710101030000,2020,662,0,662,COST
06069710101030000,2019,662,0,662,COST
06069710101040000,2021,66655,161610,228265,COST
06069710101040000,2020,68489,138920,207409,COST
06069710101040000,2019,68489,138920,207409,COST
06069710101100000,2021,1967,0,1967,COST
06069710101100000,2020,1831,0,1831,COST
06069710101100000,2019,1831,0,1831,COST
06069710102010000,2021,79616,0,79616,COST
06069710102010000,2020,63259,0,63259,COST
06069710102010000,2019,63259,0,63259,COST
06069710102100000,2021,447236,432880,880116,COST
06069710102100000,2020,332239,305390,637629,COST
06069710102100000,2019,332239,305390,637629,COST
06069710103060000,2021,353242,186990,540232,COST
06069710103060000,2020,270529,147671,418200,MKT
06069710103060000,2019,270529,147671,418200,MKT
06069710103070000,2021,36727,0,36727,COST
06069710103070000,2020,32247,0,32247,COST
06069710103070000,2019,32247,0,32247,COST
06069710201010000,2021,365928,203410,569338,COST
06069710201010000,2020,205855,185200,391055,COST
06069710201010000,2019,205855,185200,391055,COST
06069710201150000,2021,1863,0,1863,COST
06069710201150000,2020,2283,0,2283,COST
06069710201150000,2019,2283,0,2283,COST
06069710201200000,2021,1170,0,1170,COST
06069710201200000,2020,98252,0,98252,COST
06069710201200000,2019,98252,0,98252,COST
06069710201330000,2021,1366,0,1366,COST
06069710201330000,2020,330725,0,330725,COST
06069710201330000,2019,330725,0,330725,COST
06069710201460000,2021,1319,0,1319,COST
06069710201460000,2020,1228,0,1228,COST
06069710201460000,2019,1228,0,1228,COST
06069710301010000,2021,192635,244765,437400,MKT
06069710301010000,2020,148941,209459,358400,MKT
06069710301010000,2019,148941,209459,358400,MKT
06069710301030000,2021,192635,614040,806675,COST
06069710301030000,2020,148941,218459,367400,MKT
06069710301030000,2019,148941,218459,367400,MKT
06069710301060000,2021,4617,218870,223487,COST
06069710301060000,2020,4697,194330,199027,COST
06069710301060000,2019,4697,194330,199027,COST
06069710301120000,2021,1044,0,1044,COST
06069710301120000,2020,969,0,969,COST
06069710301120000,2019,969,0,969,COST
06069710301200000,2021,283002,340698,623700,MKT
06069710301200000,2020,208210,316890,525100,MKT
06069710301200000,2019,208210,316890,525100,MKT
06069710301220000,2021,448947,656110,1105057,COST
06069710301220000,2020,311195,551550,862745,COST
06069710301220000,2019,311195,551550,862745,COST
06069710301260000,2021,4609,463960,468569,COST
06069710301260000,2020,4690,401600,406290,COST
06069710301260000,2019,4690,401600,406290,COST
06069710301300000,2021,378584,640116,1018700,MKT
06069710301300000,2020,268261,539980,808241,COST
06069710301300000,2019,268261,539980,808241,COST
06069710301330000,2021,283002,0,283002,COST
06069710301330000,2020,258,0,258,COST
06069710301330000,2019,258,0,258,COST
06069710301350000,2021,919,0,919,COST
06069710301350000,2020,856,0,856,COST
06069710301350000,2019,856,0,856,COST
06069710301400000,2021,1107,0,1107,COST
06069710301400000,2020,1030,0,1030,COST
06069710301400000,2019,1030,0,1030,COST
06069710301500000,2021,378584,606916,985500,MKT
06069710301500000,2020,268261,530010,798271,COST
06069710301500000,2019,268261,530010,798271,COST
06069710301550000,2021,378584,382716,761300,MKT
06069710301550000,2020,268261,322740,591001,COST
06069710301550000,2019,268261,322740,591001,COST
06069710301600000,2021,145052,1318540,1463592,COST
06069710301600000,2020,116579,1118180,1234759,COST
06069710301600000,2019,116579,1118180,1234759,COST
06069710301700000,2021,378584,192750,571334,COST
06069710301700000,2020,268261,198339,466600,MKT
06069710301700000,2019,268261,198339,466600,MKT
06069710301800000,2021,378584,646816,1025400,MKT
06069710301800000,2020,268261,533630,801891,COST
06069710301800000,2019,268261,533630,801891,COST
06069710401010000,2021,175960,262540,438500,MKT
06069710401010000,2020,137648,209052,346700,MKT
06069710401010000,2019,115632,145330,260962,COST
06069710401200000,2021,194027,806730,1000757,COST
06069710401200000,2020,150237,679590,829827,COST
06069710401200000,2019,150237,679590,829827,COST
06069710402020000,2021,228380,5940,234320,COST
06069710402020000,2020,172740,5780,178520,COST
06069710402020000,2019,172740,5780,178520,COST
06069710402040000,2021,168252,318790,487042,COST
06069710402040000,2020,142011,242110,384121,COST
06069710402040000,2019,142011,242110,384121,COST
06069710402300000,2021,6083,183560,189643,COST
06069710402300000,2020,6074,128890,134964,COST
06069710402300000,2019,6074,128890,134964,COST
06069710402400000,2021,168169,2237150,2405319,COST
06069710402400000,2020,141934,1615040,1756974,COST
06069710402400000,2019,141934,1615040,1756974,COST
06069710403100000,2021,696,0,696,COST
06069710403100000,2020,648,0,648,COST
06069710403100000,2019,648,0,648,COST
06069710403700000,2021,144499,268390,412889,COST
06069710403700000,2020,116064,233510,349574,COST
06069710403700000,2019,116064,157860,273924,COST
06069710412010000,2021,282902,0,282902,COST
06069710412010000,2020,182755,0,182755,COST
06069710412010000,2019,180,0,180,COST
06069710454010000,2021,944,0,944,COST
06069710454010000,2020,878,0,878,COST
06069710454010000,2019,878,0,878,COST
06069711101030000,2021,427800,412950,840750,COST
06069711101030000,2020,327279,352700,679979,COST
06069711101030000,2019,327279,352700,679979,COST
06069711101090000,2021,354797,1052603,1407400,INCOME
06069711101090000,2020,235069,1038831,1273900,INCOME
06069711101090000,2019,235069,1038831,1273900,INCOME
06069711101100000,2021,164267,42330,206597,COST
06069711101100000,2020,142471,42370,184841,COST
06069711101100000,2019,142471,42370,184841,COST
06069711101200000,2021,163798,440840,604638,COST
06069711101200000,2020,142035,376110,518145,COST
06069711101200000,2019,142035,376110,518145,COST
06069711101300000,2021,1921,0,1921,COST
06069711101300000,2020,1787,0,1787,COST
06069711101300000,2019,1787,0,1787,COST
06069711101350000,2021,195397,228003,423400,MKT
06069711101350000,2020,150799,178501,329300,MKT
06069711101350000,2019,150799,178501,329300,MKT
06069711101370000,2021,205242,266858,472100,MKT
06069711101370000,2020,157395,214605,372000,MKT
06069711101370000,2019,157395,214605,372000,MKT
06069711101400000,2021,445007,291210,736217,COST
06069711101400000,2020,272972,266410,539382,COST
06069711101400000,2019,272972,266410,539382,COST
06069711101440000,2021,379337,730363,1109700,INCOME
06069711101440000,2020,245675,751810,997485,COST
06069711101440000,2019,245675,751810,997485,COST
06069711101450000,2021,302743,8650,311393,COST
06069711101450000,2020,211703,8680,220383,COST
06069711101450000,2019,211703,8680,220383,COST
06069711101460000,2021,183503,156397,339900,INCOME
06069711101460000,2020,152143,170657,322800,INCOME
06069711101460000,2019,152143,170657,322800,INCOME
06069711101470000,2021,232093,214710,446803,COST
06069711101470000,2020,121931,178220,300151,COST
06069711101470000,2019,121931,158270,280201,COST
06069711101490000,2021,121258,394342,515600,MKT
06069711101490000,2020,99527,290273,389800,MKT
06069711101490000,2019,99527,290273,389800,MKT
06069711115010000,2021,239538,0,239538,COST
06069711115010000,2020,180067,0,180067,COST
06069711115010000,2019,180067,0,180067,COST
06069711115100000,2021,373550,3082050,3455600,INCOME
06069711115100000,2020,243196,2815904,3059100,INCOME
06069711115100000,2019,243196,2815904,3059100,INCOME
06069711115140000,2021,238604,678000,916604,COST
06069711115140000,2020,180925,638975,819900,INCOME
06069711115140000,2019,180925,638975,819900,INCOME
06069711115160000,2021,238604,446896,685500,INCOME
06069711115160000,2020,180925,387375,568300,INCOME
06069711115160000,2019,180925,387375,568300,INCOME
06069711115180000,2021,534707,717593,1252300,INCOME
06069711115180000,2020,308135,784765,1092900,INCOME
06069711115180000,2019,308135,784765,1092900,INCOME
06069711115220000,2021,373550,279650,653200,INCOME
06069711115220000,2020,243196,459904,703100,INCOME
06069711115220000,2019,243196,459904,703100,INCOME
06069711118010000,2021,201148,2150,203298,COST
06069711118010000,2020,154657,2250,156907,COST
06069711118010000,2019,154657,2250,156907,COST
06069711120010000,2021,277999,484880,762879,COST
06069711120010000,2020,205000,372730,577730,COST
06069711120010000,2019,205000,214980,419980,COST
06069711120100000,2021,281524,552500,834024,COST
06069711120100000,2020,207262,438338,645600,MKT
06069711120100000,2019,207262,438338,645600,MKT
06069711120200000,2021,263133,0,263133,COST
06069711120200000,2020,195420,0,195420,COST
06069711120200000,2019,195420,0,195420,COST
06069711120300000,2021,273567,0,273567,COST
06069711120300000,2020,202151,0,202151,COST
06069711120300000,2019,202151,0,202151,COST
06069711201010000,2021,1435,0,1435,COST
06069711201010000,2020,1335,0,1335,COST
06069711201150000,2021,554,0,554,COST
06069711201150000,2020,515,0,515,COST
06069711201150000,2019,515,0,515,COST
06069711203010000,2021,84177,119570,203747,COST
06069711203010000,2020,77737,131563,209300,MKT
06069711203010000,2019,77737,131563,209300,MKT
06069711203040000,2021,110644,680,111324,COST
06069711203040000,2020,98059,690,98749,COST
06069711203040000,2019,98059,690,98749,COST
06069711203080000,2021,118456,117230,235686,COST
06069711203080000,2020,103910,132190,236100,MKT
06069711203080000,2019,103910,132190,236100,MKT
06069711203100000,2021,89370,0,89370,COST
06069711203100000,2020,74886,0,74886,COST
06069711203100000,2019,74886,0,74886,COST
06069711204020000,2021,66894,93320,160214,COST
06069711204020000,2020,58551,164049,222600,MKT
06069711204020000,2019,58551,164049,222600,MKT
06069711204060000,2021,89370,272530,361900,MKT
06069711204060000,2020,74886,215414,290300,MKT
06069711204060000,2019,74886,215414,290300,MKT
06069711204100000,2021,106000,81750,187750,COST
06069711204100000,2020,86567,124033,210600,MKT
06069711204100000,2019,86567,124033,210600,MKT
06069711204130000,2021,98224,4740,102964,COST
06069711204130000,2020,81142,4810,85952,COST
06069711204130000,2019,81142,4810,85952,COST
06069711204150000,2021,71552,115370,186922,COST
06069711204150000,2020,61996,111560,173556,COST
06069711204150000,2019,61996,111560,173556,COST
06069711204180000,2021,66894,130430,197324,COST
06069711204180000,2020,58551,144549,203100,MKT
06069711204180000,2019,58551,144549,203100,MKT
06069711204190000,2021,66894,43490,110384,COST
06069711204190000,2020,58551,41190,99741,COST
06069711204190000,2019,58551,41190,99741,COST
06069711205020000,2021,66894,134280,201174,COST
06069711205020000,2020,58551,160449,219000,MKT
06069711205020000,2019,58551,160449,219000,MKT
06069711205040000,2021,66894,87620,154514,COST
06069711205040000,2020,58551,125549,184100,MKT
06069711205040000,2019,58551,125549,184100,MKT
06069711205060000,2021,66894,219250,286144,COST
06069711205060000,2020,58551,198649,257200,MKT
06069711205060000,2019,58551,198649,257200,MKT
06069711205080000,2021,66894,172406,239300,MKT
06069711205080000,2020,58551,138780,197331,COST
06069711205080000,2019,58551,138780,197331,COST
06069711205100000,2021,66894,0,66894,COST
06069711205100000,2020,58551,0,58551,COST
06069711205100000,2019,58551,0,58551,COST
06069711205120000,2021,66894,18500,85394,COST
06069711205120000,2020,58551,17080,75631,COST
06069711205120000,2019,58551,17080,75631,COST
06069711205140000,2021,66894,0,66894,COST
06069711205140000,2020,58551,0,58551,COST
06069711205140000,2019,58551,0,58551,COST
06069711205160000,2021,66894,149480,216374,COST
06069711205160000,2020,58551,162049,220600,MKT
06069711205160000,2019,58551,162049,220600,MKT
06069711205180000,2021,66894,225706,292600,MKT
06069711205180000,2020,58551,173670,232221,COST
06069711205180000,2019,58551,173670,232221,COST
06069711205200000,2021,66894,110006,176900,INCOME
06069711205200000,2020,58551,107849,166400,INCOME
06069711205200000,2019,58551,107849,166400,INCOME
06069711205240000,2021,89370,7220,96590,COST
06069711205240000,2020,74886,7240,82126,COST
06069711205240000,2019,74886,7240,82126,COST
06069711206100000,2021,108899,22010,130909,COST
06069711206100000,2020,88575,21410,109985,COST
06069711206100000,2019,88575,21410,109985,COST
06069711206120000,2021,112967,262933,375900,MKT
06069711206120000,2020,88759,192590,281349,COST
06069711206120000,2019,88759,192590,281349,COST
06069711206160000,2021,89370,549990,639360,COST
06069711206160000,2020,74886,290814,365700,INCOME
06069711206160000,2019,74886,290814,365700,INCOME
06069711206200000,2021,119633,224550,344183,COST
06069711206200000,2020,95937,158363,254300,INCOME
06069711206200000,2019,95937,158363,254300,INCOME
06069711210010000,2021,101565,567250,668815,COST
06069711210010000,2020,91181,338810,429991,OVR
06069711210010000,2019,91181,338810,429991,COST
06069711210070000,2021,115349,228310,343659,COST
06069711210070000,2020,101590,192610,294200,MKT
06069711210070000,2019,101590,192610,294200,MKT
06069711210120000,2021,137445,16290,153735,COST
06069711210120000,2020,117898,16120,134018,COST
06069711210120000,2019,117898,16120,134018,COST
06069711211010000,2021,66894,131390,198284,COST
06069711211010000,2020,58551,149349,207900,MKT
06069711211010000,2019,58551,149349,207900,MKT
06069711211030000,2021,66894,114460,181354,COST
06069711211030000,2020,58551,141349,199900,MKT
06069711211030000,2019,58551,141349,199900,MKT
06069711211100000,2021,119633,154567,274200,MKT
06069711211100000,2020,95937,128463,224400,MKT
06069711211100000,2019,95937,128463,224400,MKT
06069711211150000,2021,89370,344990,434360,COST
06069711211150000,2020,74886,227010,301896,COST
06069711211150000,2019,74886,181540,256426,COST
06069711211180000,2021,89370,230530,319900,MKT
06069711211180000,2020,74886,200114,275000,MKT
06069711211180000,2019,74886,200114,275000,MKT
06069711211190000,2021,52888,84190,137078,COST
06069711211190000,2020,47959,121641,169600,MKT
06069711211190000,2019,47959,121641,169600,MKT
06069711211200000,2021,77415,117930,195345,COST
06069711211200000,2020,66286,110510,176796,COST
06069711211200000,2019,66286,110510,176796,COST
06069711212010000,2021,66894,322640,389534,COST
06069711212010000,2020,58551,275460,334011,COST
06069711212010000,2019,58551,275460,334011,COST
06069711212020000,2021,66894,132770,199664,COST
06069711212020000,2020,58551,156949,215500,MKT
06069711212020000,2019,58551,156949,215500,MKT
06069711212030000,2021,66894,200,67094,COST
06069711212030000,2020,58551,210,58761,COST
06069711212030000,2019,58551,210,58761,COST
06069711212040000,2021,87952,114500,202452,COST
06069711212040000,2020,73875,139925,213800,MKT
06069711212040000,2019,73875,139925,213800,MKT
06069711212050000,2021,69111,89670,158781,COST
06069711212050000,2020,60195,127305,187500,MKT
06069711212050000,2019,60195,127305,187500,MKT
06069711212060000,2021,66894,124630,191524,COST
06069711212060000,2020,58551,179449,238000,MKT
06069711212060000,2019,58551,179449,238000,MKT
06069711212070000,2021,89370,115120,204490,COST
06069711212070000,2020,74886,152814,227700,MKT
06069711212070000,2019,74886,152814,227700,MKT
06069711212080000,2021,89370,178830,268200,MKT
06069711212080000,2020,74886,143614,218500,MKT
06069711212080000,2019,74886,143614,218500,MKT
06069711212090000,2021,66894,6100,72994,COST
06069711212090000,2020,58551,6150,64701,COST
06069711212090000,2019,58551,6150,64701,COST
06069711220010000,2021,31,0,31,COST
06069711220010000,2020,29,0,29,COST
06069711220010000,2019,42,0,42,COST
06069711220060000,2021,141680,420,142100,COST
06069711220060000,2020,120977,480,121457,COST
06069711220060000,2019,120977,480,121457,COST
06069711221010000,2021,99846,264740,364586,COST
06069711221010000,2020,82279,251221,333500,MKT
06069711221010000,2019,82279,251221,333500,MKT
06069711221050000,2021,168162,3810,171972,COST
06069711221050000,2020,128116,3800,131916,COST
06069711221050000,2019,128116,3800,131916,COST
06069711222020000,2021,66894,96330,163224,COST
06069711222020000,2020,58551,141549,200100,MKT
06069711222020000,2019,58551,141549,200100,MKT
06069711222030000,2021,66894,108480,175374,COST
06069711222030000,2020,58551,139849,198400,MKT
06069711222030000,2019,58551,139849,198400,MKT
06069711222040000,2021,66894,147270,214164,COST
06069711222040000,2020,58551,168249,226800,MKT
06069711222040000,2019,58551,168249,226800,MKT
06069711222050000,2021,66894,94580,161474,COST
06069711222050000,2020,58551,130849,189400,MKT
06069711222050000,2019,58551,130849,189400,MKT
06069711222070000,2021,148149,0,148149,COST
06069711222070000,2020,118495,0,118495,COST
06069711222070000,2019,118495,0,118495,COST
06069711222080000,2021,121793,217607,339400,MKT
06069711222080000,2020,97407,198993,296400,MKT
06069711222080000,2019,97407,198993,296400,MKT
06069711222100000,2021,92897,252103,345000,MKT
06069711222100000,2020,77389,179690,257079,COST
06069711222100000,2019,77389,179690,257079,COST
06069711222140000,2021,81405,96380,177785,COST
06069711222140000,2020,69177,81900,151077,COST
06069711222140000,2019,69177,81900,151077,COST
06069711222150000,2021,100246,191354,291600,MKT
06069711222150000,2020,84328,157572,241900,MKT
06069711222150000,2019,84328,157572,241900,MKT
06069711222180000,2021,208937,0,208937,COST
06069711222180000,2020,159860,0,159860,COST
06069711222180000,2019,159860,0,159860,COST
06069711222250000,2021,218159,14800,232959,COST
06069711222250000,2020,165987,15000,180987,COST
06069711222250000,2019,165987,15000,180987,COST
06069711222280000,2021,134702,253098,387800,MKT
06069711222280000,2020,109072,180528,289600,MKT
06069711222280000,2019,109072,180528,289600,MKT
06069711280010000,2021,325996,273040,599036,COST
06069711280010000,2020,222558,249290,471848,COST
06069711280010000,2019,222558,249290,471848,COST
06069711296010000,2021,854792,1636608,2491400,INCOME
06069711296010000,2020,419939,1593900,2013839,COST
06069711296010000,2019,419939,1593900,2013839,COST
06069711296150000,2021,862402,738598,1601000,INCOME
06069711296150000,2020,422402,1226898,1649300,INCOME
06069711296150000,2019,422402,1226898,1649300,INCOME
06069711296180000,2021,257154,10370,267524,COST
06069711296180000,2020,191547,10740,202287,COST
06069711296180000,2019,191547,10740,202287,COST
06069711296200000,2021,145976,236124,382100,MKT
06069711296200000,2020,116980,192220,309200,MKT
06069711296200000,2019,116980,192220,309200,MKT
06069711296250000,2021,1022,0,1022,COST
06069711296250000,2020,951,0,951,COST
06069711296250000,2019,951,0,951,COST
06069711297010000,2021,161388,415312,576700,MKT
06069711297010000,2020,127666,344760,472426,COST
06069711297010000,2019,127666,344760,472426,COST
06069711297020000,2021,107644,250,107894,COST
06069711297020000,2020,89722,260,89982,COST
06069711297020000,2019,89722,260,89982,COST
06069711297030000,2021,167362,209610,376972,COST
06069711297030000,2020,141183,149970,291153,COST
06069711297030000,2019,142732,125710,268442,COST
06069711297040000,2021,192635,518200,710835,COST
06069711297040000,2020,148941,447550,596491,COST
06069711297040000,2019,148941,447550,596491,COST
06069711297050000,2021,144000,336000,480000,MKT
06069711297050000,2020,115600,271700,387300,MKT
06069711297050000,2019,115600,271700,387300,MKT
06069711297060000,2021,144000,257400,401400,MKT
06069711297060000,2020,115600,207400,323000,MKT
06069711297060000,2019,115600,207400,323000,MKT
06069711297070000,2021,170457,302643,473100,MKT
06069711297070000,2020,146854,275346,422200,OVR
06069711297070000,2019,146854,275346,422200,MKT
06069711298010000,2021,184447,117253,301700,MKT
06069711298010000,2020,150720,46640,197360,COST
06069711298010000,2019,150720,38830,189550,COST
06069711298020000,2021,150418,160,150578,COST
06069711298020000,2020,110091,170,110261,COST
06069711298020000,2019,110091,170,110261,COST
06069711301010000,2021,575250,587880,1163130,COST
06069711301010000,2020,255927,351460,607387,COST
06069711301010000,2019,255927,351460,607387,COST
06069711301020000,2021,193510,274890,468400,INCOME
06069711301020000,2020,157568,268932,426500,INCOME
06069711301020000,2019,157568,268932,426500,INCOME
06069711301030000,2021,74035,110,74145,COST
06069711301030000,2020,64764,110,64874,COST
06069711301030000,2019,64764,110,64874,COST
06069711301040000,2021,79100,268500,347600,MKT
06069711301040000,2020,68606,218794,287400,MKT
06069711301040000,2019,68606,218794,287400,MKT
06069711301050000,2021,353740,0,353740,COST
06069711301050000,2020,270862,0,270862,COST
06069711301050000,2019,270862,0,270862,COST
06069711301100000,2021,291,0,291,COST
06069711301150000,2021,13086,0,13086,COST
06069711301150000,2020,14615,0,14615,COST
06069711301150000,2019,14615,0,14615,COST
06069711301250000,2021,145202,159600,304802,COST
06069711301250000,2020,116440,142450,258890,COST
06069711301250000,2019,116440,142450,258890,COST
06069711301450000,2021,1273167,144110,1417277,COST
06069711301450000,2020,653251,129240,782491,COST
06069711301450000,2019,653251,129240,782491,COST
06069711356010000,2021,102794,359106,461900,INCOME
06069711356010000,2020,84338,209762,294100,INCOME
06069711356010000,2019,84338,209762,294100,INCOME
06069711356020000,2021,68776,15360,84136,COST
06069711356020000,2020,59947,15430,75377,COST
06069711356020000,2019,59947,15430,75377,COST
06069711356060000,2021,92005,311290,403295,COST
06069711356060000,2020,76757,263400,340157,COST
06069711356060000,2019,76757,263400,340157,COST
06069711356080000,2021,92005,286940,378945,COST
06069711356080000,2020,76757,239990,316747,COST
06069711356080000,2019,76757,239990,316747,COST
06069711356100000,2021,92005,15680,107685,COST
06069711356100000,2020,76757,15180,91937,COST
06069711356100000,2019,76757,15180,91937,COST
06069711356140000,2021,92005,410,92415,COST
06069711356140000,2020,76757,430,77187,COST
06069711356140000,2019,76757,430,77187,COST
06069711356160000,2021,68776,0,68776,COST
06069711356160000,2020,59947,0,59947,COST
06069711356160000,2019,59947,0,59947,COST
06069711357030000,2021,66894,78840,145734,COST
06069711357030000,2020,58551,118949,177500,MKT
06069711357030000,2019,58551,118949,177500,MKT
06069711357040000,2021,66894,107780,174674,COST
06069711357040000,2020,58551,139149,197700,MKT
06069711357040000,2019,58551,139149,197700,MKT
06069711357050000,2021,66894,92110,159004,COST
06069711357050000,2020,58551,80200,138751,COST
06069711357050000,2019,58551,80200,138751,COST
06069711357060000,2021,66894,135230,202124,COST
06069711357060000,2020,58551,117190,175741,COST
06069711357060000,2019,58551,117190,175741,COST
06069711357100000,2021,100545,188455,289000,MKT
06069711357100000,2020,82768,155432,238200,MKT
06069711357100000,2019,82768,155432,238200,MKT
06069711357110000,2021,66894,43750,110644,COST
06069711357110000,2020,58551,36790,95341,COST
06069711357110000,2019,58551,36790,95341,COST
06069711358100000,2021,251116,0,251116,COST
06069711358100000,2020,180108,0,180108,COST
06069711358100000,2019,180108,0,180108,COST
06069711401050000,2021,298626,901890,1200516,COST
06069711401050000,2020,209799,848900,1058699,COST
06069711401050000,2019,209799,730290,940089,COST
06069711401070000,2021,189200,207300,396500,MKT
06069711401070000,2020,154734,158920,313654,COST
06069711401070000,2019,154734,158920,313654,COST
06069711401080000,2021,212100,325100,537200,INCOME
06069711401080000,2020,167400,320600,488000,INCOME
06069711401080000,2019,167400,320600,488000,INCOME
06069711401090000,2021,176052,37110,213162,COST
06069711401090000,2020,137711,37400,175111,COST
06069711401090000,2019,137711,37400,175111,COST
06069711401100000,2021,110110,0,110110,COST
06069711401100000,2020,108613,0,108613,COST
06069711401100000,2019,108613,0,108613,COST
06069711401150000,2021,232217,284383,516600,INCOME
06069711401150000,2020,121969,0,121969,COST
06069711401150000,2019,121969,0,121969,COST
06069711401160000,2021,150278,151122,301400,MKT
06069711401160000,2020,121969,47690,169659,COST
06069711401160000,2019,121969,47690,169659,COST
06069711401170000,2021,192635,21780,214415,COST
06069711401170000,2020,148941,21540,170481,COST
06069711401170000,2019,148941,21540,170481,COST
06069711401190000,2021,213408,50330,263738,COST
06069711401190000,2020,168080,46780,214860,COST
06069711401190000,2019,168080,46780,214860,COST
06069711401200000,2021,2980,0,2980,COST
06069711401200000,2020,2773,0,2773,COST
06069711401200000,2019,2773,0,2773,COST
06069711401250000,2021,616779,0,616779,COST
06069711401250000,2020,338581,0,338581,COST
06069711401250000,2019,338581,0,338581,COST
06069711401280000,2021,36145,19780,55925,COST
06069711401280000,2020,52077,19390,71467,COST
06069711401280000,2019,52077,0,52077,COST
06069711401310000,2021,145798,321502,467300,MKT
06069711401310000,2020,116856,257244,374100,MKT
06069711401310000,2019,116856,257244,374100,MKT
06069711401320000,2021,237006,237494,474500,MKT
06069711401320000,2020,178409,208491,386900,MKT
06069711401320000,2019,178409,208491,386900,MKT
06069711401330000,2021,158935,11100,170035,COST
06069711401330000,2020,125974,11260,137234,COST
06069711401330000,2019,125974,11260,137234,COST
06069711401340000,2021,211730,10130,221860,COST
06069711401340000,2020,161719,10180,171899,COST
06069711401340000,2019,161719,10180,171899,COST
06069711401350000,2021,192756,41160,233916,COST
06069711401350000,2020,149023,42030,191053,COST
06069711401350000,2019,149023,42030,191053,COST
06069711401360000,2021,335140,239860,575000,MKT
06069711401360000,2020,241244,216056,457300,MKT
06069711401360000,2019,241244,216056,457300,MKT
06069711401380000,2021,210161,350839,561000,MKT
06069711401380000,2020,160675,282925,443600,MKT
06069711401380000,2019,160675,282925,443600,MKT
06069711401390000,2021,144302,482398,626700,MKT
06069711401390000,2020,115811,347289,463100,MKT
06069711401390000,2019,115811,347289,463100,MKT
06069711402010000,2021,343643,540240,883883,COST
06069711402010000,2020,246565,461280,707845,COST
06069711402010000,2019,246565,461280,707845,COST
06069711402030000,2021,192635,0,192635,COST
06069711402030000,2020,148941,0,148941,COST
06069711402030000,2019,148941,0,148941,COST
06069711402050000,2021,192675,332230,524905,COST
06069711402050000,2020,148968,297210,446178,COST
06069711402050000,2019,148968,297210,446178,COST
06069711402060000,2021,228380,229020,457400,MKT
06069711402060000,2020,172740,188060,360800,MKT
06069711402060000,2019,172740,188060,360800,MKT
06069711402070000,2021,284092,248408,532500,MKT
06069711402070000,2020,208908,217692,426600,MKT
06069711402070000,2019,208908,217692,426600,MKT
06069711402080000,2021,159356,255230,414586,COST
06069711402080000,2020,126265,221150,347415,COST
06069711402080000,2019,126265,221150,347415,COST
06069711402090000,2021,185243,229157,414400,MKT
06069711402090000,2020,143951,188549,332500,MKT
06069711402090000,2019,143951,188549,332500,MKT
06069711402100000,2021,160194,237806,398000,MKT
06069711402100000,2020,126843,186957,313800,MKT
06069711402100000,2019,126843,186957,313800,MKT
06069711402110000,2021,192635,255065,447700,MKT
06069711402110000,2020,148941,201359,350300,MKT
06069711402110000,2019,148941,201359,350300,MKT
06069711402200000,2021,228380,20510,248890,COST
06069711402200000,2020,172740,20730,193470,COST
06069711402200000,2019,172740,20730,193470,COST
06069711402220000,2021,274535,875965,1150500,MKT
06069711402220000,2020,202774,729426,932200,MKT
06069711402220000,2019,202774,729426,932200,MKT
06069711402250000,2021,162672,616160,778832,COST
06069711402250000,2020,128550,530320,658870,COST
06069711402250000,2019,128550,519460,648010,COST
06069711402270000,2021,199731,412200,611931,COST
06069711402270000,2020,153708,356920,510628,COST
06069711402270000,2019,153708,356920,510628,COST
06069711402290000,2021,183004,0,183004,COST
06069711402290000,2020,142435,0,142435,COST
06069711402290000,2019,142435,0,142435,COST
06069711403010000,2021,377517,160,377677,COST
06069711403010000,2020,267603,150,267753,COST
06069711403010000,2019,267603,150,267753,COST
06069711403020000,2021,192998,520902,713900,MKT
06069711403020000,2020,149186,425714,574900,MKT
06069711403020000,2019,149186,425714,574900,MKT
06069711403030000,2021,192998,613202,806200,MKT
06069711403030000,2020,149186,548014,697200,MKT
06069711403030000,2019,149186,548014,697200,MKT
06069711403040000,2021,203340,266460,469800,MKT
06069711403040000,2020,156124,225576,381700,MKT
06069711403040000,2019,156124,225576,381700,MKT
06069711403060000,2021,187528,466872,654400,MKT
06069711403060000,2020,145496,402404,547900,MKT
06069711403060000,2019,145496,402404,547900,MKT
06069711403080000,2021,187528,407472,595000,MKT
06069711403080000,2020,145496,346604,492100,MKT
06069711403080000,2019,145496,346604,492100,MKT
06069712101010000,2021,145052,313280,458332,COST
06069712101010000,2020,116579,218690,335269,COST
06069712101010000,2019,116579,218690,335269,COST
06069712101050000,2021,145063,517590,662653,COST
06069712101050000,2020,116589,421870,538459,COST
06069712101050000,2019,116589,421870,538459,COST
06069712101150000,2021,145063,264550,409613,COST
06069712101150000,2020,116589,227370,343959,COST
06069712101150000,2019,116589,227370,343959,COST
06069712101250000,2021,145062,401550,546612,COST
06069712101250000,2020,116588,346580,463168,COST
06069712101250000,2019,116588,346580,463168,COST
06069712101350000,2021,15461,214650,230111,COST
06069712101350000,2020,19478,193130,212608,COST
06069712101350000,2019,19478,135620,155098,COST
06069712101550000,2021,163774,462760,626534,COST
06069712101550000,2020,142013,398280,540293,COST
06069712101550000,2019,142013,398280,540293,COST
06069712101650000,2021,145067,457010,602077,COST
06069712101650000,2020,116593,380700,497293,COST
06069712101650000,2019,116593,380700,497293,COST
06069712101750000,2021,145063,415550,560613,COST
06069712101750000,2020,116590,342180,458770,COST
06069712101750000,2019,116590,342180,458770,COST
06069712201020000,2021,145072,674020,819092,COST
06069712201020000,2020,116597,595310,711907,COST
06069712201020000,2019,116597,595310,711907,COST
06069712201120000,2021,1121,0,1121,COST
06069712201120000,2020,1043,0,1043,COST
06069712201120000,2019,1043,0,1043,COST
06069712201240000,2021,1124,22550,23674,COST
06069712201240000,2020,1046,23130,24176,COST
06069712201240000,2019,1046,23130,24176,COST
06069712201480000,2021,163787,768880,932667,COST
06069712201480000,2020,142025,636110,778135,COST
06069712201480000,2019,142025,636110,778135,COST
06069712201600000,2021,163784,459500,623284,COST
06069712201600000,2020,142022,392550,534572,COST
06069712201600000,2019,142022,392550,534572,COST
06069712201840000,2021,145058,918620,1063678,COST
06069712201840000,2020,116584,792630,909214,COST
06069712201840000,2019,116584,792630,909214,COST
06069712236010000,2021,163783,664800,828583,COST
06069712236010000,2020,142021,568660,710681,COST
06069712236010000,2019,142021,568660,710681,COST
06069712260010000,2021,2951,374040,376991,COST
06069712260010000,2020,3155,317210,320365,COST
06069712260010000,2019,3155,317210,320365,COST
06069712301010000,2021,145072,570000,715072,COST
06069712301010000,2020,116598,501460,618058,COST
06069712301010000,2019,116598,501460,618058,COST
06069712312010000,2021,145078,459450,604528,COST
06069712312010000,2020,116603,394680,511283,COST
06069712312010000,2019,116603,394680,511283,COST
06069712324010000,2021,145072,359690,504762,COST
06069712324010000,2020,116597,299940,416537,COST
06069712324010000,2019,116597,299940,416537,COST
06069712336010000,2021,145077,697650,842727,COST
06069712336010000,2020,116602,577050,693652,COST
06069712336010000,2019,116602,577050,693652,COST
06069712348010000,2021,145072,1301570,1446642,COST
06069712348010000,2020,116597,1064780,1181377,COST
06069712348010000,2019,116597,1013080,1129677,COST
06069712360010000,2021,145077,514690,659767,COST
06069712360010000,2020,116602,430790,547392,COST
06069712360010000,2019,116602,430790,547392,COST
06069712372010000,2021,1126,0,1126,COST
06069712372010000,2020,1048,0,1048,COST
06069712372010000,2019,1048,0,1048,COST
06069712381010000,2021,145077,573710,718787,COST
06069712381010000,2020,116602,489390,605992,COST
06069712381010000,2019,116602,489390,605992,COST
06069712401010000,2021,145068,530910,675978,COST
06069712401010000,2020,116594,460710,577304,COST
06069712401010000,2019,116594,460710,577304,COST
06069712406010000,2021,145067,262040,407107,COST
06069712406010000,2020,116593,220150,336743,COST
06069712406010000,2019,116593,220150,336743,COST
06069712412010000,2021,145064,1355820,1500884,COST
06069712412010000,2020,116591,1125680,1242271,COST
06069712412010000,2019,116591,1125680,1242271,COST
06069712436010000,2021,145065,179030,324095,COST
06069712436010000,2020,116592,155570,272162,COST
06069712436010000,2019,116592,155570,272162,COST
06069712448010000,2021,145069,723110,868179,COST
06069712448010000,2020,116595,610580,727175,COST
06069712448010000,2019,116595,610580,727175,COST
06069712460010000,2021,163787,507910,671697,COST
06069712460010000,2020,142025,397030,539055,COST
06069712460010000,2019,142025,397030,539055,COST
06069712472010000,2021,163791,478900,642691,COST
06069712472010000,2020,142029,325090,467119,COST
06069712472010000,2019,142029,325090,467119,COST
06069712481010000,2021,326454,912470,1238924,COST
06069712481010000,2020,283008,783940,1066948,COST
06069712481010000,2019,283008,783940,1066948,COST
06069713101010000,2021,257696,0,257696,COST
06069713101010000,2020,235587,0,235587,COST
06069713101010000,2019,235587,0,235587,COST
06069713101020000,2021,101068,305740,406808,COST
06069713101020000,2020,117589,264330,381919,COST
06069713101020000,2019,117589,264330,381919,COST
06069713101030000,2021,297458,296880,594338,COST
06069713101030000,2020,217442,252640,470082,COST
06069713101030000,2019,217442,252640,470082,COST
06069713101200000,2021,57,0,57,COST
06069713101200000,2020,53,0,53,COST
06069713101200000,2019,53,0,53,COST
06069713201010000,2021,165498,319002,484500,MKT
06069713201010000,2020,130493,259507,390000,MKT
06069713201010000,2019,130493,259507,390000,MKT
06069713201200000,2021,65484,0,65484,COST
06069713201200000,2020,57052,0,57052,COST
06069713201200000,2019,57052,0,57052,COST
06069713201250000,2021,144000,369190,513190,COST
06069713201250000,2020,115600,392700,508300,MKT
06069713201250000,2019,115600,392700,508300,MKT
06069713201350000,2021,72465,0,72465,COST
06069713201350000,2020,63618,0,63618,COST
06069713201350000,2019,63618,0,63618,COST
06069713201400000,2021,7825,619030,626855,COST
06069713201400000,2020,7518,521760,529278,COST
06069713201400000,2019,7518,521760,529278,COST
06069713201500000,2021,8737,0,8737,COST
06069713201500000,2020,7650,0,7650,COST
06069713201500000,2019,7650,0,7650,COST
06069714101100000,2021,16446,0,16446,COST
06069714101100000,2020,22638,0,22638,COST
06069714101100000,2019,22638,0,22638,COST
06069714101150000,2021,15234,0,15234,COST
06069714101150000,2020,22186,0,22186,COST
06069714101150000,2019,22186,0,22186,COST
06069714101200000,2021,28276,0,28276,COST
06069714101200000,2020,40171,0,40171,COST
06069714101200000,2019,40171,0,40171,COST
06069714101300000,2021,17216,0,17216,COST
06069714101300000,2020,23509,0,23509,COST
06069714101300000,2019,23509,0,23509,COST
06069714101400000,2021,17209,0,17209,COST
06069714101400000,2020,23503,0,23503,COST
06069714101400000,2019,23503,0,23503,COST
06069714201010000,2021,111273,268030,379303,COST
06069714201010000,2020,144212,228920,373132,COST
06069714201010000,2019,144212,228920,373132,COST
06069714401030000,2021,122645,578500,701145,COST
06069714401030000,2020,106929,503830,610759,COST
06069714401030000,2019,106929,586290,693219,COST
06069714401300000,2021,163837,0,163837,COST
06069714401300000,2020,222677,0,222677,COST
06069714401300000,2019,222677,0,222677,COST
06069715101010000,2021,7282,0,7282,COST
06069715101010000,2020,6782,0,6782,COST
06069715101010000,2019,6782,0,6782,COST
06069715101250000,2021,2790,0,2790,COST
06069715101250000,2020,2601,0,2601,COST
06069715101250000,2019,2601,0,2601,COST
06069715201010000,2021,40619,237400,278019,COST
06069715201010000,2020,40031,180160,220191,COST
06069715201010000,2019,40031,180160,220191,COST
06069715201150000,2021,192635,0,192635,COST
06069715201150000,2020,148941,0,148941,COST
06069715201150000,2019,148941,0,148941,COST
06069715201200000,2021,145060,288290,433350,COST
06069715201200000,2020,116586,247780,364366,COST
06069715201200000,2019,1038,21280,22318,COST
06069715201300000,2021,1107,0,1107,COST
06069715201300000,2020,1030,0,1030,COST
06069715201300000,2019,1030,0,1030,COST
06069715202010000,2021,212261,338339,550600,MKT
06069715202010000,2020,162073,0,162073,COST
06069715202010000,2019,162073,0,162073,COST
06069715202050000,2021,212261,224639,436900,MKT
06069715202050000,2020,162073,177627,339700,MKT
06069715202050000,2019,162073,177627,339700,MKT
06069715202100000,2021,378584,8180,386764,COST
06069715202100000,2020,268261,7940,276201,COST
06069715202100000,2019,268261,7940,276201,COST
06069715202150000,2021,212261,0,212261,COST
06069715202150000,2020,162073,0,162073,COST
06069715202150000,2019,162073,0,162073,COST
06069715202200000,2021,212261,0,212261,COST
06069715202200000,2020,162073,0,162073,COST
06069715202200000,2019,162073,0,162073,COST
06069715301010000,2021,5944,615140,621084,COST
06069715301010000,2020,5938,483860,489798,COST
06069715301010000,2019,7069,483860,490929,COST
06069715301020000,2021,974,0,974,COST
06069715301020000,2020,909,0,909,COST
06069715301100000,2021,1564,0,1564,COST
06069715301100000,2020,287598,12170,299768,COST
06069715301100000,2019,287689,12170,299859,COST
06069715301110000,2021,71,0,71,COST
06069715301110000,2020,66,0,66,COST
06069715401010000,2021,375834,11740,387574,COST
06069715401010000,2020,812,0,812,COST
06069715401030000,2021,25581,675570,701151,COST
06069715401030000,2020,24221,501670,525891,COST
06069715401030000,2019,24902,296670,321572,COST
06069716101010000,2021,102059,158800,260859,COST
06069716101010000,2020,110778,136780,247558,COST
06069716101010000,2019,110778,136780,247558,COST
06069716101240000,2021,19050,256690,275740,COST
06069716101240000,2020,27786,119670,147456,COST
06069716101240000,2019,27786,119670,147456,COST
06069716101280000,2021,144000,0,144000,COST
06069716101280000,2020,115600,0,115600,COST
06069716101280000,2019,115600,0,115600,COST
06069716101300000,2021,185953,198547,384500,MKT
06069716101300000,2020,151990,198220,350210,COST
06069716101300000,2019,151990,198220,350210,COST
06069716101550000,2021,423074,0,423074,COST
06069716101550000,2020,295516,0,295516,COST
06069716101550000,2019,14818,0,14818,COST
06069716101850000,2021,298785,0,298785,COST
06069716101850000,2020,218287,0,218287,COST
06069716101850000,2019,6685,0,6685,COST
06069716201010000,2021,50848,0,50848,COST
06069716201010000,2020,47330,0,47330,COST
06069716201010000,2019,47330,0,47330,COST
06069716401010000,2021,378584,94810,473394,COST
06069716401010000,2020,268261,83010,351271,COST
06069716401010000,2019,268261,83010,351271,COST
06069716401200000,2021,40333,0,40333,COST
06069716401200000,2020,42134,0,42134,COST
06069716401200000,2019,42134,0,42134,COST
06069717112010000,2021,145069,844210,989279,COST
06069717112010000,2020,114695,743970,858665,COST
06069717112010000,2019,114695,755840,870535,COST
06069717112150000,2021,1129,0,1129,COST
06069717112150000,2020,1051,0,1051,COST
06069717112150000,2019,1051,0,1051,COST
06069717112290000,2021,1152,0,1152,COST
06069717112290000,2020,1072,0,1072,COST
06069717112290000,2019,1072,0,1072,COST
06069717112440000,2021,1111,0,1111,COST
06069717112440000,2020,1034,0,1034,COST
06069717112440000,2019,1034,0,1034,COST
06069717112570000,2021,145126,825410,970536,COST
06069717112570000,2020,114748,723500,838248,COST
06069717112570000,2019,114748,723500,838248,COST
06069717112700000,2021,104630,0,104630,COST
06069717112700000,2020,109756,0,109756,COST
06069717112700000,2019,109756,0,109756,COST
06069717201010000,2021,10199,0,10199,COST
06069717201010000,2020,9489,0,9489,COST
06069717201010000,2019,9489,0,9489,COST
06069717310010000,2021,1207,0,1207,COST
06069717310010000,2020,1123,0,1123,COST
06069717310010000,2019,1123,0,1123,COST
06069717320010000,2021,1190,0,1190,COST
06069717320010000,2020,1107,0,1107,COST
06069717320010000,2019,1107,0,1107,COST
06069717330010000,2021,1190,0,1190,COST
06069717330010000,2020,1107,0,1107,COST
06069717330010000,2019,1107,0,1107,COST
06069717340010000,2021,145135,1104900,1250035,COST
06069717340010000,2020,114756,965930,1080686,COST
06069717340010000,2019,114756,965930,1080686,COST
06069717410010000,2021,1152,0,1152,COST
06069717410010000,2020,1072,0,1072,COST
06069717410010000,2019,1072,0,1072,COST
06069717420010000,2021,1151,0,1151,COST
06069717420010000,2020,1071,0,1071,COST
06069717420010000,2019,1071,0,1071,COST
06069717430010000,2021,1152,0,1152,COST
06069717430010000,2020,1071,0,1071,COST
06069717430010000,2019,1071,0,1071,COST
06069717440010000,2021,1151,0,1151,COST
06069717440010000,2020,1071,0,1071,COST
06069717440010000,2019,1071,0,1071,COST
06069717450010000,2021,1212,0,1212,COST
06069717450010000,2020,1128,0,1128,COST
06069717450010000,2019,1128,0,1128,COST
06069718101010000,2021,7329,0,7329,COST
06069718101010000,2020,6826,0,6826,COST
06069718101010000,2019,6826,0,6826,COST
06069718201010000,2021,49532,0,49532,COST
06069718201010000,2020,51851,0,51851,COST
06069718201010000,2019,51851,0,51851,COST
06069718301010000,2021,16490,0,16490,COST
06069718301010000,2020,15343,0,15343,COST
06069718301010000,2019,15343,0,15343,COST
06069718401010000,2021,10287,0,10287,COST
06069718401010000,2020,9570,0,9570,COST
06069718401010000,2019,9570,0,9570,COST
06069718420010000,2021,145129,720830,865959,COST
06069718420010000,2020,114751,623130,737881,COST
06069718420010000,2019,114751,623130,737881,COST
06069718430010000,2021,1190,0,1190,COST
06069718430010000,2020,1107,0,1107,COST
06069718430010000,2019,1107,0,1107,COST
06069718440010000,2021,145140,672800,817940,COST
06069718440010000,2020,1113,0,1113,COST
06069718440010000,2019,1113,0,1113,COST
06069719101010000,2021,50546,0,50546,COST
06069719101010000,2020,47008,0,47008,COST
06069719101010000,2019,47008,0,47008,COST
06069720201010000,2021,48830,0,48830,COST
06069720201010000,2020,45445,0,45445,COST
06069720201010000,2019,45445,0,45445,COST
06069721201010000,2021,228441,336170,564611,COST
06069721201010000,2020,228928,247560,476488,COST
06069721201010000,2019,228928,247560,476488,COST
06069722301010000,2021,328310,5390,333700,COST
06069722301010000,2020,365964,5220,371184,COST
06069722301010000,2019,365964,5220,371184,COST
06069722401010000,2021,218804,459096,677900,MKT
06069722401010000,2020,166415,386485,552900,MKT
06069722401010000,2019,166415,386485,552900,MKT
06069722401030000,2021,201718,347982,549700,MKT
06069722401030000,2020,155039,296861,451900,MKT
06069722401030000,2019,155039,296861,451900,MKT
06069722401050000,2021,286793,658710,945503,COST
06069722401050000,2020,210636,549310,759946,COST
06069722401050000,2019,210636,549310,759946,COST
06069722402010000,2021,199885,527115,727000,MKT
06069722402010000,2020,153811,435289,589100,MKT
06069722402010000,2019,153811,435289,589100,MKT
06069722402030000,2021,189651,323449,513100,MKT
06069722402030000,2020,146930,254270,401200,OVR
06069722402030000,2019,146930,254270,401200,MKT
06069722402050000,2021,178096,419304,597400,MKT
06069722402050000,2020,139102,350098,489200,MKT
06069722402050000,2019,139102,350098,489200,MKT
06069722402070000,2021,222954,392146,615100,MKT
06069722402070000,2020,169161,350339,519500,MKT
06069722402070000,2019,169161,350339,519500,MKT
06069722402090000,2021,208357,421843,630200,MKT
06069722402090000,2020,159474,365926,525400,MKT
06069722402090000,2019,159474,365926,525400,MKT
06069722402110000,2021,171957,325543,497500,MKT
06069722402110000,2020,134917,254083,389000,MKT
06069722402110000,2019,134917,254083,389000,MKT
06069722402130000,2021,182613,285387,468000,MKT
06069722402130000,2020,142170,209830,352000,MKT
06069722402130000,2019,142170,209830,352000,MKT
06069722402150000,2021,187696,398004,585700,MKT
06069722402150000,2020,145610,317990,463600,MKT
06069722402150000,2019,145610,302790,448400,MKT
06069722402190000,2021,248585,635715,884300,MKT
06069722402190000,2020,203982,615518,819500,MKT
06069722402190000,2019,203982,615518,819500,MKT
06069722402210000,2021,225783,371090,596873,COST
06069722402210000,2020,187587,343713,531300,MKT
06069722402210000,2019,187587,343713,531300,MKT
06069722402230000,2021,276441,423559,700000,MKT
06069722402230000,2020,223750,371850,595600,MKT
06069722402230000,2019,223750,371850,595600,MKT
06069722402250000,2021,183308,474192,657500,MKT
06069722402250000,2020,142641,360759,503400,MKT
06069722402250000,2019,142641,360759,503400,MKT
06069722402270000,2021,273965,358035,632000,MKT
06069722402270000,2020,202407,292793,495200,MKT
06069722402270000,2019,202407,292793,495200,MKT
06069722402290000,2021,235971,278029,514000,MKT
06069722402290000,2020,177730,219870,397600,MKT
06069722402290000,2019,177730,219870,397600,MKT
06069722402310000,2021,212755,422445,635200,MKT
06069722402310000,2020,162401,363499,525900,MKT
06069722402310000,2019,162401,363499,525900,MKT
06069722402330000,2021,208684,646330,855014,COST
06069722402330000,2020,159691,358109,517800,MKT
06069722402330000,2019,159691,360509,520200,MKT
06069722402350000,2021,204499,593370,797869,COST
06069722402350000,2020,156899,518140,675039,COST
06069722402350000,2019,156899,518140,675039,COST
06069722402370000,2021,211836,685280,897116,COST
06069722402370000,2020,161790,593880,755670,COST
06069722402370000,2019,161790,593880,755670,COST
06069722402390000,2021,216577,519523,736100,MKT
06069722402390000,2020,180908,452692,633600,MKT
06069722402390000,2019,180908,452692,633600,MKT
06069722402410000,2021,213463,373937,587400,MKT
06069722402410000,2020,178641,265759,444400,MKT
06069722402410000,2019,178641,265759,444400,MKT
06069722402430000,2021,245013,0,245013,COST
06069722402430000,2020,201426,0,201426,COST
06069722402430000,2019,201426,0,201426,COST
06069722402450000,2021,220121,246079,466200,MKT
06069722402450000,2020,167287,215613,382900,MKT
06069722402450000,2019,167287,215613,382900,MKT
06069722402470000,2021,205056,461044,666100,MKT
06069722402470000,2020,157271,382329,539600,MKT
06069722402470000,2019,157271,382329,539600,MKT
06069722402490000,2021,214194,0,214194,COST
06069722402490000,2020,163357,0,163357,COST
06069722402490000,2019,163357,0,163357,COST
06069722402510000,2021,225120,433480,658600,MKT
06069722402510000,2020,170591,375009,545600,MKT
06069722402510000,2019,170591,375009,545600,MKT
06069722402536500,2021,124548,0,124548,COST
06069722402536500,2020,87259,0,87259,COST
06069722402536500,2019,87259,0,87259,COST
06069723101010000,2021,299489,373011,672500,MKT
06069723101010000,2020,218735,337065,555800,MKT
06069723101010000,2019,218735,337065,555800,MKT
06069723101020000,2021,283002,0,283002,COST
06069723101020000,2020,208210,0,208210,COST
06069723101020000,2019,208210,0,208210,COST
06069723101040000,2021,144692,223940,368632,COST
06069723101040000,2020,116244,192090,308334,COST
06069723101040000,2019,116244,192090,308334,COST
06069723101060000,2021,645,0,645,COST
06069723101060000,2020,601,0,601,COST
06069723101060000,2019,601,0,601,COST
06069723101080000,2021,9254,0,9254,COST
06069723101080000,2020,12471,0,12471,COST
06069723101080000,2019,12471,0,12471,COST
06069723101100000,2021,377948,0,377948,COST
06069723101100000,2020,267868,0,267868,COST
06069723101100000,2019,267868,0,267868,COST
06069723101110000,2021,144000,340500,484500,MKT
06069723101110000,2020,115600,273700,389300,MKT
06069723101110000,2019,115600,273700,389300,MKT
06069723102010000,2021,414685,343215,757900,MKT
06069723102010000,2020,290407,339300,629707,COST
06069723102010000,2019,290407,296730,587137,COST
06069723102060000,2021,397833,291040,688873,COST
06069723102060000,2020,280102,200600,480702,COST
06069723102060000,2019,280102,54470,334572,COST
06069723102080000,2021,418584,246040,664624,COST
06069723102080000,2020,292783,245317,538100,MKT
06069723102080000,2019,292783,245317,538100,MKT
06069723103010000,2021,621,0,621,COST
06069723103010000,2020,578,0,578,COST
06069723103010000,2019,578,0,578,COST
06069723106010000,2021,583,0,583,COST
06069723106010000,2020,543,0,543,COST
06069723106010000,2019,543,0,543,COST
06069723124010000,2021,557,0,557,COST
06069723124010000,2020,519,0,519,COST
06069723124010000,2019,519,0,519,COST
06069723130010000,2021,8315,0,8315,COST
06069723130010000,2020,11097,0,11097,COST
06069723130010000,2019,11097,0,11097,COST
06069723201010000,2021,381855,272130,653985,COST
06069723201010000,2020,270278,200050,470328,COST
06069723201010000,2019,270278,200050,470328,COST
06069723201020000,2021,283002,355530,638532,COST
06069723201020000,2020,208210,297200,505410,COST
06069723201020000,2019,208210,297200,505410,COST
06069723201030000,2021,272192,385008,657200,INCOME
06069723201030000,2020,201266,426334,627600,INCOME
06069723201030000,2019,201266,426334,627600,INCOME
06069723201070000,2021,378807,451093,829900,MKT
06069723201070000,2020,268398,393950,662348,COST
06069723201070000,2019,268398,393950,662348,COST
06069723201090000,2021,378743,403000,781743,COST
06069723201090000,2020,268359,352120,620479,COST
06069723201090000,2019,268359,352120,620479,COST
06069723201150000,2021,3185,0,3185,COST
06069723201150000,2020,2955,0,2955,COST
06069723201150000,2019,2955,0,2955,COST
06069723201190000,2021,378918,327840,706758,COST
06069723201190000,2020,268467,258833,527300,MKT
06069723201190000,2019,268467,258833,527300,MKT
06069723201220000,2021,378902,272330,651232,COST
06069723201220000,2020,268457,235980,504437,COST
06069723201220000,2019,268457,235980,504437,COST
06069723201240000,2021,379029,310250,689279,COST
06069723201240000,2020,268536,259650,528186,COST
06069723201240000,2019,268536,259650,528186,COST
06069723201260000,2021,379013,216570,595583,COST
06069723201260000,2020,268526,211374,479900,MKT
06069723201260000,2019,268526,211374,479900,MKT
06069723201280000,2021,379029,198171,577200,MKT
06069723201280000,2020,268536,164764,433300,MKT
06069723201280000,2019,268536,164764,433300,MKT
06069723201300000,2021,379045,318955,698000,MKT
06069723201300000,2020,268545,274820,543365,COST
06069723201300000,2019,268545,274820,543365,COST
06069723205450000,2021,378934,34610,413544,COST
06069723205450000,2020,268477,34750,303227,COST
06069723205450000,2019,268477,34750,303227,COST
06069723205600000,2021,378950,0,378950,COST
06069723205600000,2020,268487,0,268487,COST
06069723205600000,2019,268487,0,268487,COST
06069723205700000,2021,554,0,554,COST
06069723205700000,2020,516,0,516,COST
06069723205700000,2019,516,0,516,COST
06069723205750000,2021,144499,121970,266469,COST
06069723205750000,2020,116064,107450,223514,COST
06069723205750000,2019,116064,107450,223514,COST
06069723206010000,2021,351600,19860,371460,COST
06069723206010000,2020,251530,20420,271950,COST
06069723206010000,2019,251530,20420,271950,COST
06069723301010000,2021,258129,913460,1171589,COST
06069723301010000,2020,170578,841190,1011768,COST
06069723301010000,2019,170578,841190,1011768,COST
06069723301020000,2021,112038,0,112038,COST
06069723301020000,2020,92904,0,92904,COST
06069723301020000,2019,92904,0,92904,COST
06069723303010000,2021,186855,354245,541100,MKT
06069723303010000,2020,145041,305259,450300,OVR
06069723303010000,2019,145041,305259,450300,MKT
06069723303030000,2021,203752,295548,499300,MKT
06069723303030000,2020,156400,236800,393200,MKT
06069723303030000,2019,156400,236800,393200,MKT
06069723303050000,2021,201452,369448,570900,MKT
06069723303050000,2020,154861,312039,466900,MKT
06069723303050000,2019,154861,273839,428700,MKT
06069723303070000,2021,204350,277250,481600,MKT
06069723303070000,2020,156799,210601,367400,MKT
06069723303070000,2019,156799,130060,286859,COST
06069723303090000,2021,208828,613000,821828,COST
06069723303090000,2020,159788,511420,671208,COST
06069723303090000,2019,159788,511420,671208,COST
06069723303110000,2021,233044,296756,529800,MKT
06069723303110000,2020,175808,237992,413800,MKT
06069723303110000,2019,175808,237992,413800,MKT
06069723303130000,2021,195278,377522,572800,MKT
06069723303130000,2020,150720,319880,470600,MKT
06069723303130000,2019,150720,319880,470600,MKT
06069723303150000,2021,170146,365954,536100,MKT
06069723303150000,2020,133678,313622,447300,MKT
06069723303150000,2019,133678,313622,447300,MKT
06069723303170000,2021,188239,460061,648300,MKT
06069723303170000,2020,145977,356623,502600,MKT
06069723303170000,2019,145977,356623,502600,MKT
06069723303190000,2021,182002,462798,644800,MKT
06069723303190000,2020,141756,432944,574700,MKT
06069723303190000,2019,141756,432944,574700,MKT
06069723303210000,2021,186939,320361,507300,MKT
06069723303210000,2020,145098,258802,403900,MKT
06069723303210000,2019,145098,258802,403900,MKT
06069723303230000,2021,204051,338149,542200,MKT
06069723303230000,2020,156600,285200,441800,MKT
06069723303230000,2019,156600,285200,441800,MKT
06069723303250000,2021,200728,330872,531600,MKT
06069723303250000,2020,154376,274424,428800,MKT
06069723303250000,2019,154376,274424,428800,MKT
06069723303270000,2021,218635,573208,791843,OVR
06069723303270000,2020,166303,608430,774733,COST
06069723303270000,2019,166303,617997,784300,MKT
06069723304010000,2021,221827,343773,565600,MKT
06069723304010000,2020,168416,300084,468500,MKT
06069723304010000,2019,168416,300084,468500,MKT
06069723304030000,2021,210769,425431,636200,MKT
06069723304030000,2020,161080,424720,585800,OVR
06069723304030000,2019,161080,424720,585800,MKT
06069723304050000,2021,187065,355035,542100,MKT
06069723304050000,2020,145184,330616,475800,MKT
06069723304050000,2019,145184,330616,475800,MKT
06069723304070000,2021,204313,523387,727700,MKT
06069723304070000,2020,156774,466126,622900,OVR
06069723304070000,2019,156774,466126,622900,MKT
06069723304090000,2021,178276,621024,799300,MKT
06069723304090000,2020,139225,570075,709300,MKT
06069723304090000,2019,139225,462675,601900,MKT
06069723304110000,2021,197209,352491,549700,MKT
06069723304110000,2020,152017,284383,436400,MKT
06069723304110000,2019,152017,284383,436400,MKT
06069723304130000,2021,205685,457515,663200,MKT
06069723304130000,2020,157691,413309,571000,MKT
06069723304130000,2019,157691,413309,571000,MKT
06069723304150000,2021,181345,339355,520700,MKT
06069723304150000,2020,141309,279491,420800,MKT
06069723304150000,2019,141309,279491,420800,MKT
06069723304170000,2021,191457,0,191457,COST
06069723304170000,2020,148148,0,148148,COST
06069723304170000,2019,148148,0,148148,COST
06069723304190000,2021,205648,279352,485000,MKT
06069723304190000,2020,157667,220233,377900,MKT
06069723304190000,2019,157667,220233,377900,MKT
06069723304210000,2021,212013,331087,543100,MKT
06069723304210000,2020,161908,278592,440500,MKT
06069723304210000,2019,161908,278592,440500,MKT
06069723304230000,2021,211339,349661,561000,MKT
06069723304230000,2020,161459,312141,473600,MKT
06069723304230000,2019,161459,312141,473600,MKT
06069723304250000,2021,216137,394350,610487,COST
06069723304250000,2020,164647,369453,534100,MKT
06069723304250000,2019,164647,369453,534100,MKT
06069723304270000,2021,198185,388715,586900,MKT
06069723304270000,2020,152671,334829,487500,MKT
06069723304270000,2019,152671,0,152671,COST
06069723304290000,2021,189238,0,189238,COST
06069723304290000,2020,146651,0,146651,COST
06069723304290000,2019,146651,0,146651,COST
06069723304310000,2021,255355,308945,564300,MKT
06069723304310000,2020,190379,267821,458200,MKT
06069723304310000,2019,190379,267821,458200,MKT
06069723304330000,2021,231263,333237,564500,MKT
06069723304330000,2020,174638,280962,455600,MKT
06069723304330000,2019,174638,280962,455600,MKT
06069723304350000,2021,179307,339493,518800,MKT
06069723304350000,2020,139926,287174,427100,MKT
06069723304350000,2019,139926,287174,427100,MKT
06069723304370000,2021,232826,251674,484500,MKT
06069723304370000,2020,175665,202635,378300,MKT
06069723304370000,2019,175665,202635,378300,MKT
06069723304390000,2021,186770,401530,588300,MKT
06069723304390000,2020,144984,318516,463500,MKT
06069723304390000,2019,144984,318516,463500,MKT
06069723304410000,2021,182483,429917,612400,MKT
06069723304410000,2020,142081,373519,515600,MKT
06069723304410000,2019,142081,373519,515600,MKT
06069723401010000,2021,146804,1382730,1529534,COST
06069723401010000,2020,208087,1151850,1359937,COST
06069723401010000,2019,208087,1151850,1359937,COST
06069724101010000,2021,148406,150910,299316,COST
06069724101010000,2020,4151,0,4151,COST
06069724101010000,2019,4151,0,4151,COST
06069724102110000,2021,323541,327559,651100,MKT
06069724102110000,2020,233956,293344,527300,MKT
06069724102110000,2019,233956,293344,527300,MKT
06069724102140000,2021,283050,24720,307770,COST
06069724102140000,2020,208240,0,208240,COST
06069724102140000,2019,208240,0,208240,COST
06069724103010000,2021,148404,278970,427374,COST
06069724103010000,2020,31587,0,31587,COST
06069724103010000,2019,31587,0,31587,COST
06069724201010000,2021,393949,517951,911900,MKT
06069724201010000,2020,277718,434850,712568,COST
06069724201010000,2019,277718,434850,712568,COST
06069724201030000,2021,619,0,619,COST
06069724201030000,2020,576,0,576,COST
06069724201030000,2019,576,0,576,COST
06069724201050000,2021,619,0,619,COST
06069724201050000,2020,576,0,576,COST
06069724201050000,2019,576,0,576,COST
06069724201070000,2021,387251,0,387251,COST
06069724201070000,2020,273602,0,273602,COST
06069724201070000,2019,273602,0,273602,COST
06069724201150000,2021,384947,354840,739787,COST
06069724201150000,2020,272183,305130,577313,COST
06069724201150000,2019,272183,305130,577313,COST
06069724202010000,2021,560,0,560,COST
06069724202010000,2020,521,0,521,COST
06069724202010000,2019,521,0,521,COST
06069724202200000,2021,385490,956840,1342330,COST
06069724202200000,2020,272518,803800,1076318,COST
06069724202200000,2019,272518,679770,952288,COST
06069724203010000,2021,565,0,565,COST
06069724203010000,2020,526,0,526,COST
06069724203010000,2019,526,0,526,COST
06069724203030000,2021,144532,557630,702162,COST
06069724203030000,2020,116095,471960,588055,COST
06069724203030000,2019,116095,471960,588055,COST
06069724203040000,2021,144702,607790,752492,COST
06069724203040000,2020,116253,523470,639723,COST
06069724203040000,2019,116253,523470,639723,COST
06069724203070000,2021,295475,218325,513800,MKT
06069724203070000,2020,216179,183121,399300,MKT
06069724203070000,2019,216179,183121,399300,MKT
06069724203090000,2021,295475,925020,1220495,COST
06069724203090000,2020,216179,586350,802529,COST
06069724203090000,2019,216179,913810,1129989,COST
06069724203110000,2021,301109,0,301109,COST
06069724203110000,2020,219765,0,219765,COST
06069724203110000,2019,219765,0,219765,COST
06069724203150000,2021,301109,0,301109,COST
06069724203150000,2020,219765,0,219765,COST
06069724203150000,2019,219765,0,219765,COST
06069724203170000,2021,588,0,588,COST
06069724203170000,2020,547,0,547,COST
06069724203170000,2019,547,0,547,COST
06069724203250000,2021,839,0,839,COST
06069724203250000,2020,780,0,780,COST
06069724203250000,2019,780,0,780,COST
06069724301010000,2021,144607,319620,464227,COST
06069724301010000,2020,116165,275980,392145,COST
06069724301010000,2019,116165,275980,392145,COST
06069724302010000,2021,283002,827880,1110882,COST
06069724302010000,2020,208210,680830,889040,COST
06069724302010000,2019,208210,680830,889040,COST
06069724302020000,2021,373936,443264,817200,MKT
06069724302020000,2020,265390,380140,645530,COST
06069724302020000,2019,265390,380140,645530,COST
06069724302060000,2021,558,0,558,COST
06069724302060000,2020,519,0,519,COST
06069724302060000,2019,519,0,519,COST
06069724302080000,2021,410068,0,410068,COST
06069724302080000,2020,287589,0,287589,COST
06069724302080000,2019,287589,0,287589,COST
06069724302100000,2021,393211,0,393211,COST
06069724302100000,2020,277265,0,277265,COST
06069724302100000,2019,277265,0,277265,COST
06069724302120000,2021,383780,602230,986010,COST
06069724302120000,2020,271464,443840,715304,COST
06069724302120000,2019,271464,423170,694634,COST
06069724302140000,2021,390513,415687,806200,MKT
06069724302140000,2020,275608,369190,644798,COST
06069724302140000,2019,275608,369190,644798,COST
06069724302160000,2021,386881,525019,911900,MKT
06069724302160000,2020,273374,478490,751864,OVR
06069724302160000,2019,273374,478490,751864,COST
06069724305100000,2021,29390,0,29390,COST
06069724305100000,2020,38576,0,38576,COST
06069724305100000,2019,38576,0,38576,COST
06069724401200000,2021,15177,784160,799337,COST
06069724401200000,2020,14502,654330,668832,COST
06069724401200000,2019,14502,654330,668832,COST
06069724401500000,2021,41284,379490,420774,COST
06069724401500000,2020,44217,91250,135467,COST
06069724401500000,2019,44217,91250,135467,COST
06069724402010000,2021,17742,557170,574912,COST
06069724402010000,2020,20824,467420,488244,COST
06069724402010000,2019,20824,467420,488244,COST
06069725101010000,2021,486338,0,486338,COST
06069725101010000,2020,249345,0,249345,COST
06069725101010000,2019,249345,0,249345,COST
06069725101020000,2021,144210,218270,362480,COST
06069725101020000,2020,117028,99200,216228,COST
06069725101020000,2019,117028,99200,216228,COST
06069725101150000,2021,26677,0,26677,COST
06069725101150000,2020,27835,0,27835,COST
06069725101150000,2019,27835,0,27835,COST
06069725201030000,2021,98531,134670,233201,COST
06069725201030000,2020,140286,118130,258416,COST
06069725201030000,2019,140286,118130,258416,COST
06069725301010000,2021,192635,527965,720600,MKT
06069725301010000,2020,148941,454759,603700,MKT
06069725301010000,2019,148941,454759,603700,MKT
06069725301040000,2021,192635,487465,680100,MKT
06069725301040000,2020,148941,417559,566500,MKT
06069725301040000,2019,148941,417559,566500,MKT
06069725301060000,2021,196267,446533,642800,MKT
06069725301060000,2020,151384,377416,528800,MKT
06069725301060000,2019,151384,377416,528800,MKT
06069725301080000,2021,173,0,173,COST
06069725301080000,2020,161,0,161,COST
06069725301080000,2019,161,0,161,COST
06069725305100000,2021,5988,0,5988,COST
06069725305100000,2020,5628,0,5628,COST
06069725305100000,2019,5628,0,5628,COST
06069725401100000,2021,144011,200040,344051,COST
06069725401100000,2020,115610,168740,284350,COST
06069725401100000,2019,115610,168740,284350,COST
06069725402010000,2021,430308,209480,639788,COST
06069725402010000,2020,299912,89610,389522,COST
06069725402010000,2019,299912,38490,338402,COST
06069725402100000,2021,359487,417360,776847,COST
06069725402100000,2020,256437,350260,606697,COST
06069725402100000,2019,256437,350260,606697,COST
06069725402400000,2021,272693,539820,812513,COST
06069725402400000,2020,201589,458060,659649,COST
06069725402400000,2019,201589,458060,659649,COST
06069725402440000,2021,236,0,236,COST
06069725402440000,2020,220,0,220,COST
06069725402440000,2019,220,0,220,COST
06069725402500000,2021,144439,364960,509399,COST
06069725402500000,2020,116009,309920,425929,COST
06069725402500000,2019,116009,309920,425929,COST
06069725402550000,2021,308,0,308,COST
06069725402550000,2020,287,0,287,COST
06069725402550000,2019,287,0,287,COST
06069725402600000,2021,260434,489966,750400,MKT
06069725402600000,2020,193673,293860,487533,COST
06069725402600000,2019,193673,0,193673,COST
06069725402620000,2021,245103,408897,654000,MKT
06069725402620000,2020,183705,359195,542900,MKT
06069725402620000,2019,183705,359195,542900,MKT
06069725402640000,2021,241590,634480,876070,COST
06069725402640000,2020,181410,467690,649100,COST
06069725402640000,2019,181410,399090,580500,MKT
06069725402680000,2021,378886,279114,658000,MKT
06069725402680000,2020,268447,210653,479100,MKT
06069725402680000,2019,268447,210653,479100,MKT
06069725402720000,2021,259070,514630,773700,MKT
06069725402720000,2020,192789,415611,608400,MKT
06069725402720000,2019,192789,415611,608400,MKT
06069725402740000,2021,196621,0,196621,COST
06069725402740000,2020,151622,0,151622,COST
06069725402740000,2019,151622,0,151622,COST
06069725402750000,2021,215411,311389,526800,MKT
06069725402750000,2020,164165,233435,397600,MKT
06069725402750000,2019,164165,233435,397600,MKT
06069725402850000,2021,870,0,870,COST
06069725402850000,2020,809,0,809,COST
06069725402850000,2019,809,0,809,COST
06069725402950000,2021,144861,1124820,1269681,COST
06069725402950000,2020,116401,948870,1065271,COST
06069725402950000,2019,116401,516000,632401,COST
06069725402996500,2021,134631,0,134631,COST
06069725402996500,2020,93380,0,93380,COST
06069725402996500,2019,93380,0,93380,COST
06069725403010000,2021,163839,723700,887539,COST
06069725403010000,2020,142074,558060,700134,COST
06069725403010000,2019,142074,558060,700134,COST
06069725403100000,2021,2782,208540,211322,COST
06069725403100000,2020,2994,177140,180134,COST
06069725403100000,2019,2994,177140,180134,COST
06069725435010000,2021,381773,0,381773,COST
06069725435010000,2020,196704,0,196704,COST
06069725435010000,2019,196704,0,196704,COST
06069725435060000,2021,253584,572390,825974,COST
06069725435060000,2020,174914,499980,674894,COST
06069725435060000,2019,174914,499980,674894,COST
06069726101010000,2021,176418,233482,409900,MKT
06069726101010000,2020,137960,173040,311000,MKT
06069726101010000,2019,137960,173040,311000,MKT
06069726101020000,2021,242894,140806,383700,MKT
06069726101020000,2020,200293,71610,271903,COST
06069726101020000,2019,200293,71610,271903,COST
06069726101030000,2021,283002,340350,623352,COST
06069726101030000,2020,208210,314290,522500,MKT
06069726101030000,2019,208210,314290,522500,MKT
06069726102010000,2021,395812,584088,979900,MKT
06069726102010000,2020,305861,450250,756111,COST
06069726102010000,2019,305861,450250,756111,COST
06069726102040000,2021,149878,288320,438198,COST
06069726102040000,2020,119699,228700,348399,COST
06069726102040000,2019,119699,228700,348399,COST
06069726102100000,2021,425457,313160,738617,COST
06069726102100000,2020,325717,245883,571600,MKT
06069726102100000,2019,325717,245883,571600,MKT
06069726103040000,2021,289073,990670,1279743,COST
06069726103040000,2020,232198,835730,1067928,COST
06069726103040000,2019,232198,835730,1067928,COST
06069726103150000,2021,145128,412330,557458,COST
06069726103150000,2020,116650,355790,472440,COST
06069726103150000,2019,116650,355790,472440,COST
06069726103200000,2021,427674,383380,811054,COST
06069726103200000,2020,327195,326420,653615,COST
06069726103200000,2019,327195,326420,653615,COST
06069726103310000,2021,427674,526350,954024,COST
06069726103310000,2020,327195,444760,771955,COST
06069726103310000,2019,327195,444760,771955,COST
06069726103450000,2021,442105,381880,823985,COST
06069726103450000,2020,336789,322220,659009,COST
06069726103450000,2019,327279,322220,649499,COST
06069726103550000,2021,427800,1094120,1521920,COST
06069726103550000,2020,327279,923660,1250939,COST
06069726103550000,2019,327279,923660,1250939,COST
06069726103600000,2021,163849,711400,875249,COST
06069726103600000,2020,142083,613610,755693,COST
06069726103600000,2019,142083,613610,755693,COST
06069726201070000,2021,123603,243897,367500,MKT
06069726201070000,2020,101202,174398,275600,MKT
06069726201070000,2019,101202,174398,275600,MKT
06069726202010000,2021,465525,342930,808455,COST
06069726202010000,2020,352274,289910,642184,COST
06069726202010000,2019,352274,289910,642184,COST
06069726205010000,2021,299269,283130,582399,COST
06069726205010000,2020,218595,250305,468900,MKT
06069726205010000,2019,218595,250305,468900,MKT
06069726205020000,2021,309643,341440,651083,COST
06069726205020000,2020,225179,313121,538300,MKT
06069726205020000,2019,225179,313121,538300,MKT
06069726205030000,2021,305128,595060,900188,COST
06069726205030000,2020,222317,264083,486400,MKT
06069726205030000,2019,222317,264083,486400,MKT
06069726205040000,2021,323995,514805,838800,MKT
06069726205040000,2020,234242,393258,627500,MKT
06069726205040000,2019,234242,393258,627500,MKT
06069726209010000,2021,283002,216398,499400,MKT
06069726209010000,2020,208210,173290,381500,MKT
06069726209010000,2019,208210,173290,381500,MKT
06069726209020000,2021,284612,499190,783802,COST
06069726209020000,2020,209241,426740,635981,COST
06069726209020000,2019,209241,426740,635981,COST
06069726209030000,2021,284612,178888,463500,MKT
06069726209030000,2020,209241,163759,373000,MKT
06069726209030000,2019,209241,163759,373000,MKT
06069726209040000,2021,283002,332080,615082,COST
06069726209040000,2020,208210,283660,491870,COST
06069726209040000,2019,208210,283660,491870,COST
06069726209050000,2021,283002,380798,663800,MKT
06069726209050000,2020,208210,328890,537100,MKT
06069726209050000,2019,208210,328890,537100,MKT
06069726209060000,2021,283761,730339,1014100,MKT
06069726209060000,2020,208696,716604,925300,MKT
06069726209060000,2019,208696,716604,925300,MKT
06069726209070000,2021,283074,381826,664900,MKT
06069726209070000,2020,208256,359644,567900,MKT
06069726209070000,2019,208256,359644,567900,MKT
06069726209080000,2021,283050,336100,619150,COST
06069726209080000,2020,208240,284260,492500,OVR
06069726209080000,2019,208240,284260,492500,MKT
06069726209090000,2021,286699,332301,619000,MKT
06069726209090000,2020,210577,302723,513300,MKT
06069726209090000,2019,210577,302723,513300,MKT
06069726209100000,2021,318369,424431,742800,MKT
06069726209100000,2020,230696,369204,599900,MKT
06069726209100000,2019,230696,369204,599900,MKT
06069726213010000,2021,283002,465398,748400,MKT
06069726213010000,2020,208210,417390,625600,MKT
06069726213010000,2019,208210,417390,625600,MKT
06069726213020000,2021,283002,582460,865462,COST
06069726213020000,2020,208210,451390,659600,MKT
06069726213020000,2019,208210,451390,659600,MKT
06069726213030000,2021,283002,380270,663272,COST
06069726213030000,2020,208210,285390,493600,MKT
06069726213030000,2019,208210,0,208210,COST
06069726213040000,2021,283002,671950,954952,COST
06069726213040000,2020,208210,569010,777220,COST
06069726213040000,2019,208210,569010,777220,COST
06069726213050000,2021,283002,0,283002,COST
06069726213050000,2020,208210,0,208210,COST
06069726213050000,2019,208210,0,208210,COST
06069726213060000,2021,284942,489580,774522,COST
06069726213060000,2020,209452,426248,635700,MKT
06069726213060000,2019,209452,426248,635700,MKT
06069726213070000,2021,283074,306926,590000,MKT
06069726213070000,2020,208256,280644,488900,MKT
06069726213070000,2019,208256,280644,488900,MKT
06069726213080000,2021,284635,356660,641295,COST
06069726213080000,2020,209256,327644,536900,MKT
06069726213080000,2019,209256,327644,536900,MKT
06069726213090000,2021,454845,293080,747925,COST
06069726213090000,2020,314752,261648,576400,MKT
06069726213090000,2019,314752,261648,576400,MKT
06069726305010000,2021,311065,467940,779005,COST
06069726305010000,2020,226080,395780,621860,COST
06069726305010000,2019,226080,395780,621860,COST
06069726305020000,2021,292090,0,292090,COST
06069726305020000,2020,214021,0,214021,COST
06069726305020000,2019,214021,0,214021,COST
06069726305030000,2021,294285,342115,636400,MKT
06069726305030000,2020,215421,297579,513000,MKT
06069726305030000,2019,215421,297579,513000,MKT
06069726305040000,2021,287886,230910,518796,COST
06069726305040000,2020,211336,202764,414100,MKT
06069726305040000,2019,211336,202764,414100,MKT
06069726305050000,2021,326679,0,326679,COST
06069726305050000,2020,235931,0,235931,COST
06069726305050000,2019,235931,0,235931,COST
06069726305060000,2021,300082,438818,738900,MKT
06069726305060000,2020,219111,444890,664001,COST
06069726305060000,2019,219111,444890,664001,COST
06069726305070000,2021,283050,0,283050,COST
06069726305070000,2020,208240,0,208240,COST
06069726305070000,2019,208240,0,208240,COST
06069726305080000,2021,283002,343800,626802,COST
06069726305080000,2020,208210,305390,513600,MKT
06069726305080000,2019,208210,305390,513600,MKT
06069726305090000,2021,283501,711650,995151,COST
06069726305090000,2020,208529,589470,797999,COST
06069726305090000,2019,208529,589470,797999,COST
06069726305100000,2021,383077,517923,901000,MKT
06069726305100000,2020,271031,373369,644400,MKT
06069726305100000,2019,271031,373369,644400,MKT
06069726305110000,2021,368333,178110,546443,COST
06069726305110000,2020,261924,163976,425900,MKT
06069726305110000,2019,261924,163976,425900,MKT
06069726305126500,2021,134072,0,134072,COST
06069726305126500,2020,93042,0,93042,COST
06069726305126500,2019,93042,0,93042,COST
06069726305136500,2021,102089,0,102089,COST
06069726305136500,2020,73384,0,73384,COST
06069726305136500,2019,73384,0,73384,COST
06069726305150000,2021,144000,260400,404400,MKT
06069726305150000,2020,115600,229000,344600,OVR
06069726305150000,2019,115600,229000,344600,MKT
06069726309010000,2021,294825,0,294825,COST
06069726309010000,2020,215765,0,215765,COST
06069726309010000,2019,215765,0,215765,COST
06069726309020000,2021,322967,259520,582487,COST
06069726309020000,2020,233595,234405,468000,MKT
06069726309020000,2019,233595,234405,468000,MKT
06069726309030000,2021,351882,458218,810100,MKT
06069726309030000,2020,251706,356894,608600,MKT
06069726309030000,2019,251706,356894,608600,MKT
06069726309040000,2021,394970,427230,822200,MKT
06069726309040000,2020,278345,350555,628900,MKT
06069726309040000,2019,278345,304980,583325,COST
06069726309050000,2021,376222,642378,1018600,MKT
06069726309050000,2020,266803,552380,819183,COST
06069726309050000,2019,266803,413910,680713,COST
06069726309060000,2021,381037,558820,939857,COST
06069726309060000,2020,269774,421026,690800,MKT
06069726309060000,2019,269774,421026,690800,MKT
06069726309070000,2021,369617,523683,893300,MKT
06069726309070000,2020,262719,414481,677200,MKT
06069726309070000,2019,262719,414481,677200,MKT
06069726401010000,2021,145080,862630,1007710,COST
06069726401010000,2020,116605,724920,841525,COST
06069726401010000,2019,116605,724920,841525,COST
06069726401100000,2021,145080,846770,991850,COST
06069726401100000,2020,116605,723770,840375,COST
06069726401100000,2019,116605,723770,840375,COST
06069726401200000,2021,1136,0,1136,COST
06069726401200000,2020,1057,0,1057,COST
06069726401200000,2019,1057,0,1057,COST
06069726401250000,2021,1136,0,1136,COST
06069726401250000,2020,1057,0,1057,COST
06069726401250000,2019,1057,0,1057,COST
06069726401350000,2021,1124,0,1124,COST
06069726401350000,2020,1046,0,1046,COST
06069726401350000,2019,1046,0,1046,COST
06069726401450000,2021,1107,0,1107,COST
06069726401450000,2020,1030,0,1030,COST
06069726401450000,2019,1030,0,1030,COST
06069727101010000,2021,247923,158010,405933,COST
06069727101010000,2020,259758,114900,374658,COST
06069727101010000,2019,259758,114900,374658,COST
06069727102010000,2021,1108,0,1108,COST
06069727102010000,2020,1031,0,1031,COST
06069727102010000,2019,22200,0,22200,COST
06069727102100000,2021,1110,0,1110,COST
06069727102100000,2020,1033,0,1033,COST
06069727102100000,2019,23756,0,23756,COST
06069727301010000,2021,230192,15000,245192,COST
06069727301010000,2020,173933,15010,188943,COST
06069727301010000,2019,173933,15010,188943,COST
06069727302010000,2021,210697,235903,446600,MKT
06069727302010000,2020,161032,188068,349100,MKT
06069727302010000,2019,161032,188068,349100,MKT
06069727302050000,2021,186295,204105,390400,MKT
06069727302050000,2020,152279,152060,304339,COST
06069727302050000,2019,152279,152060,304339,COST
06069727302070000,2021,208412,1072330,1280742,COST
06069727302070000,2020,116579,986080,1102659,COST
06069727302070000,2019,1030,0,1030,COST
06069727401010000,2021,91521,57760,149281,COST
06069727401010000,2020,102453,52930,155383,COST
06069727401010000,2019,102453,52930,155383,COST
06069727401100000,2021,1112,0,1112,COST
06069727401100000,2020,22888,0,22888,COST
06069727401100000,2019,22888,0,22888,COST
06069727401200000,2021,211232,209268,420500,MKT
06069727401200000,2020,161388,142912,304300,MKT
06069727401200000,2019,161388,142912,304300,MKT
06069727401300000,2021,1665,0,1665,COST
06069727401300000,2020,34613,0,34613,COST
06069727401300000,2019,34613,0,34613,COST
06069727466010000,2021,131261,0,131261,COST
06069727466050000,2021,133837,216163,350000,MKT
06069727466050000,2020,149565,173535,323100,MKT
06069727466050000,2019,149565,173535,323100,MKT
06069728101010000,2021,285553,0,285553,COST
06069728101010000,2020,306081,0,306081,COST
06069728101010000,2019,306081,0,306081,COST
06069729101010000,2021,19271,2522550,2541821,COST
06069729101010000,2020,18743,2145450,2164193,COST
06069729101010000,2019,16475,1928780,1945255,COST
06069730101010000,2021,63742,0,63742,COST
06069730101010000,2020,53767,0,53767,COST
06069730101010000,2019,53767,0,53767,COST
06069731101010000,2021,146063,0,146063,COST
06069731101010000,2020,89726,0,89726,COST
06069731101010000,2019,89726,0,89726,COST
06069732101010000,2021,209156,256240,465396,COST
06069732101010000,2020,217247,194760,412007,COST
06069732101010000,2019,219499,411430,630929,COST
06069733401010000,2021,103787,0,103787,COST
06069733401010000,2020,102476,0,102476,COST
06069733401010000,2019,102476,0,102476,COST
06069733401300000,2021,908,0,908,COST
06069733401300000,2020,845,0,845,COST
06069733401300000,2019,845,0,845,COST
06069734101010000,2021,228476,537224,765700,MKT
06069734101010000,2020,172803,502520,675323,COST
06069734101010000,2019,172803,502520,675323,COST
06069734101030000,2021,228380,791520,1019900,MKT
06069734101030000,2020,172740,663460,836200,MKT
06069734101030000,2019,172740,663460,836200,MKT
06069734101050000,2021,259338,233662,493000,MKT
06069734101050000,2020,192963,181437,374400,MKT
06069734101050000,2019,192963,181437,374400,MKT
06069734101070000,2021,379584,476730,856314,COST
06069734101070000,2020,268878,0,268878,COST
06069734101070000,2019,2875,0,2875,COST
06069734101100000,2021,8070,339110,347180,COST
06069734101100000,2020,7904,291790,299694,COST
06069734101100000,2019,7904,291790,299694,COST
06069734101150000,2021,7644,345960,353604,COST
06069734101150000,2020,7507,303420,310927,COST
06069734101150000,2019,7507,303420,310927,COST
06069734101170000,2021,157288,657812,815100,MKT
06069734101170000,2020,124837,548563,673400,MKT
06069734101170000,2019,124837,548563,673400,MKT
06069734101200000,2021,379362,391438,770800,MKT
06069734101200000,2020,268741,364870,633611,COST
06069734101200000,2019,268741,364870,633611,COST
06069734101250000,2021,379520,216780,596300,MKT
06069734101250000,2020,268839,168861,437700,MKT
06069734101250000,2019,268839,168861,437700,MKT
06069734101300000,2021,17257,0,17257,COST
06069734101300000,2020,23180,0,23180,COST
06069734101300000,2019,23180,0,23180,COST
06069734101350000,2021,33800,0,33800,COST
06069734101350000,2020,47120,0,47120,COST
06069734101350000,2019,47120,0,47120,COST
06069734101400000,2021,379378,277522,656900,MKT
06069734101400000,2020,268751,264649,533400,MKT
06069734101400000,2019,268751,264649,533400,MKT
06069734101450000,2021,322826,219840,542666,COST
06069734101450000,2020,268721,115790,384511,COST
06069734101450000,2019,268721,115790,384511,COST
06069734101500000,2021,145057,671950,817007,COST
06069734101500000,2020,116583,577620,694203,COST
06069734101500000,2019,116583,577620,694203,COST
06069734101550000,2021,9468,0,9468,COST
06069734101550000,2020,12939,0,12939,COST
06069734101550000,2019,12939,0,12939,COST
06069734101600000,2021,20288,668600,688888,COST
06069734101600000,2020,27337,559500,586837,COST
06069734101600000,2019,27337,559500,586837,COST
06069734101650000,2021,379378,0,379378,COST
06069734101650000,2020,268751,0,268751,COST
06069734101650000,2019,268751,0,268751,COST
06069734201010000,2021,92843,0,92843,COST
06069734201010000,2020,121064,0,121064,COST
06069734201010000,2019,121064,0,121064,COST
06069734201200000,2021,314459,406800,721259,COST
06069734201200000,2020,236091,370900,606991,COST
06069734201200000,2019,236091,370900,606991,COST
06069734201220000,2021,219683,0,219683,COST
06069734201220000,2020,166997,0,166997,COST
06069734201220000,2019,166997,0,166997,COST
06069734201240000,2021,227932,4360,232292,COST
06069734201240000,2020,172445,4750,177195,COST
06069734201240000,2019,172445,4750,177195,COST
06069734201260000,2021,145459,309910,455369,COST
06069734201260000,2020,116957,271700,388657,COST
06069734201260000,2019,116957,271700,388657,COST
06069734201300000,2021,265094,760306,1025400,MKT
06069734201300000,2020,196687,620113,816800,MKT
06069734201300000,2019,196687,564913,761600,MKT
06069734201450000,2021,378584,622570,1001154,COST
06069734201450000,2020,268261,534500,802761,COST
06069734201450000,2019,268261,534500,802761,COST
06069734301010000,2021,163974,1403080,1567054,COST
06069734301010000,2020,134615,1264720,1399335,COST
06069734301010000,2019,134615,1264720,1399335,COST
06069734302010000,2021,1107,0,1107,COST
06069734302010000,2020,1030,0,1030,COST
06069734302010000,2019,1030,0,1030,COST
06069734302050000,2021,53,0,53,COST
06069734302050000,2020,49,0,49,COST
06069734302050000,2019,49,0,49,COST
06069734312010000,2021,145080,635460,780540,COST
06069734312010000,2020,116605,533980,650585,COST
06069734312010000,2019,116605,533980,650585,COST
06069734322010000,2021,145294,177050,322344,COST
06069734322010000,2020,116804,154020,270824,COST
06069734322010000,2019,116804,154020,270824,COST
06069734342010000,2021,417128,224672,641800,MKT
06069734342010000,2020,291896,174204,466100,MKT
06069734342010000,2019,291896,174204,466100,MKT
06069734342070000,2021,343079,228921,572000,MKT
06069734342070000,2020,246213,196887,443100,MKT
06069734342070000,2019,246213,196887,443100,MKT
06069734401200000,2021,7586,0,7586,COST
06069734401200000,2020,7061,0,7061,COST
06069734401200000,2019,7061,0,7061,COST
06069735101010000,2021,5663,0,5663,COST
06069735101010000,2020,5258,0,5258,COST
06069735101010000,2019,5258,0,5258,COST
06069735101150000,2021,4301,0,4301,COST
06069735101150000,2020,3995,0,3995,COST
06069735101150000,2019,3995,0,3995,COST
06069735101250000,2021,1107,0,1107,COST
06069735101250000,2020,1030,0,1030,COST
06069735101250000,2019,1030,0,1030,COST
06069735101350000,2021,1110,0,1110,COST
06069735101350000,2020,1033,0,1033,COST
06069735101350000,2019,1033,0,1033,COST
06069735102300000,2021,145056,499110,644166,COST
06069735102300000,2020,116583,424990,541573,COST
06069735102300000,2019,116583,424990,541573,COST
06069735103010000,2021,145052,569870,714922,COST
06069735103010000,2020,116579,473810,590389,COST
06069735103010000,2019,116579,473810,590389,COST
06069735103100000,2021,1107,0,1107,COST
06069735103100000,2020,1030,0,1030,COST
06069735103100000,2019,1030,0,1030,COST
06069735103200000,2021,1107,0,1107,COST
06069735103200000,2020,1031,0,1031,COST
06069735103200000,2019,1031,0,1031,COST
06069735201010000,2021,433005,1274140,1707145,COST
06069735201010000,2020,347736,1080830,1428566,COST
06069735201010000,2019,347736,1080830,1428566,COST
06069735201020000,2021,35806,858240,894046,COST
06069735201020000,2020,33703,740010,773713,COST
06069735201020000,2019,33703,740010,773713,COST
06069735202100000,2021,228380,241520,469900,MKT
06069735202100000,2020,172740,200860,373600,MKT
06069735202100000,2019,172740,200860,373600,MKT
06069735202150000,2021,8714,129230,137944,COST
06069735202150000,2020,9289,111020,120309,COST
06069735202150000,2019,9289,111020,120309,COST
06069735402250000,2021,5223,900,6123,COST
06069735402250000,2020,4850,960,5810,COST
06069735402250000,2019,4850,960,5810,COST
06069735402300000,2021,3003,0,3003,COST
06069735402300000,2020,2793,0,2793,COST
06069735402300000,2019,2793,0,2793,COST
06069735402350000,2021,145234,358780,504014,COST
06069735402350000,2020,116748,277500,394248,COST
06069735402350000,2019,116748,277500,394248,COST
06069735402400000,2021,145059,430870,575929,COST
06069735402400000,2020,116586,364330,480916,COST
06069735402400000,2019,116586,364330,480916,COST
06069735403100000,2021,207395,777070,984465,COST
06069735403100000,2020,116973,655640,772613,COST
06069735403100000,2019,116973,655640,772613,COST
06069735403200000,2021,207365,825420,1032785,COST
06069735403200000,2020,116945,683640,800585,OVR
06069735403200000,2019,116945,683640,800585,COST
06069735403300000,2021,206982,276940,483922,COST
06069735403300000,2020,116588,238290,354878,COST
06069735403300000,2019,116588,238290,354878,COST
06069736101010000,2021,3987,86360,90347,COST
06069736101010000,2020,4118,74030,78148,COST
06069736101010000,2019,4118,74030,78148,COST
06069736101020000,2021,192635,0,192635,COST
06069736101020000,2020,148941,0,148941,COST
06069736101020000,2019,148941,0,148941,COST
06069736101030000,2021,192635,783465,976100,MKT
06069736101030000,2020,148941,726190,875131,COST
06069736101030000,2019,148941,726190,875131,COST
06069736101050000,2021,192635,436165,628800,MKT
06069736101050000,2020,148941,274859,423800,MKT
06069736101050000,2019,148941,274859,423800,MKT
06069736101070000,2021,192635,539765,732400,MKT
06069736101070000,2020,148941,432659,581600,MKT
06069736101070000,2019,148941,351259,500200,MKT
06069736101090000,2021,192635,458965,651600,MKT
06069736101090000,2020,148941,352759,501700,MKT
06069736101090000,2019,148941,352759,501700,MKT
06069736101110000,2021,192635,576065,768700,MKT
06069736101110000,2020,148941,569870,718811,COST
06069736101110000,2019,148941,569870,718811,COST
06069736101130000,2021,325208,1287340,1612548,COST
06069736101130000,2020,172107,1085990,1258097,COST
06069736101130000,2019,172107,532993,705100,MKT
06069736101170000,2021,393964,374560,768524,COST
06069736101170000,2020,203394,218706,422100,MKT
06069736101170000,2019,203394,218706,422100,MKT
06069736101180000,2021,288604,2090550,2379154,COST
06069736101180000,2020,211795,353305,565100,MKT
06069736101180000,2019,211795,353305,565100,MKT
06069736101190000,2021,193481,377519,571000,MKT
06069736101190000,2020,149511,324089,473600,MKT
06069736101190000,2019,149511,324089,473600,MKT
06069736101200000,2021,198029,0,198029,COST
06069736101200000,2020,152567,0,152567,COST
06069736101200000,2019,152567,0,152567,COST
06069736101210000,2021,253373,433527,686900,MKT
06069736101210000,2020,189091,388509,577600,MKT
06069736101210000,2019,189091,388509,577600,MKT
06069736101220000,2021,240314,550886,791200,MKT
06069736101220000,2020,180575,455825,636400,MKT
06069736101220000,2019,180575,455825,636400,MKT
06069736101240000,2021,218159,278941,497100,MKT
06069736101240000,2020,165987,223313,389300,MKT
06069736101240000,2019,165987,223313,389300,MKT
06069736101250000,2021,197522,0,197522,COST
06069736101250000,2020,152227,0,152227,COST
06069736101250000,2019,152227,0,152227,COST
06069736102010000,2021,207958,0,207958,COST
06069736102010000,2020,159207,0,159207,COST
06069736102010000,2019,159207,0,159207,COST
06069736102040000,2021,207958,366242,574200,MKT
06069736102040000,2020,159207,322493,481700,MKT
06069736102040000,2019,159207,322493,481700,MKT
06069736102060000,2021,212120,488680,700800,MKT
06069736102060000,2020,161979,430721,592700,OVR
06069736102060000,2019,161979,430721,592700,MKT
06069736102080000,2021,202663,0,202663,COST
06069736102080000,2020,155671,0,155671,COST
06069736102080000,2019,155671,0,155671,COST
06069736120010000,2021,600351,0,600351,COST
06069736120010000,2020,293540,0,293540,COST
06069736120010000,2019,293540,0,293540,COST
06069736130010000,2021,351646,541730,893376,COST
06069736130010000,2020,293540,278480,572020,COST
06069736130010000,2019,293540,278480,572020,COST
06069736140010000,2021,294555,614445,909000,MKT
06069736140010000,2020,215593,565007,780600,MKT
06069736140010000,2019,215593,565007,780600,MKT
06069736201020000,2021,541398,362202,903600,MKT
06069736201020000,2020,268271,488220,756491,OVR
06069736201020000,2019,268271,488220,756491,COST
06069736201100000,2021,541375,510130,1051505,COST
06069736201100000,2020,268261,280,268541,COST
06069736201100000,2019,268261,280,268541,COST
06069736201400000,2021,35142,830920,866062,COST
06069736201400000,2020,29701,710100,739801,COST
06069736201400000,2019,29701,710100,739801,COST
06069736205010000,2021,206972,202360,409332,COST
06069736205010000,2020,116579,174630,291209,COST
06069736205010000,2019,116579,174630,291209,COST
06069736301100000,2021,205353,371047,576400,MKT
06069736301100000,2020,157469,308631,466100,MKT
06069736301100000,2019,157469,308631,466100,MKT
06069736301120000,2021,192635,487765,680400,MKT
06069736301120000,2020,148941,384959,533900,MKT
06069736301120000,2019,148941,384959,533900,MKT
06069736302010000,2021,133391,0,133391,COST
06069736302010000,2020,72366,0,72366,COST
06069736302010000,2019,72366,0,72366,COST
06069736402170000,2021,236093,0,236093,COST
06069736402170000,2020,177810,0,177810,COST
06069736402170000,2019,177810,0,177810,COST
06069736402200000,2021,231232,337168,568400,MKT
06069736402200000,2020,174617,298983,473600,MKT
06069736402200000,2019,174617,298983,473600,MKT
06069736402220000,2021,203902,353698,557600,MKT
06069736402220000,2020,156500,283500,440000,MKT
06069736402220000,2019,156500,283500,440000,MKT
06069736402250000,2021,263370,419530,682900,MKT
06069736402250000,2020,195573,399727,595300,MKT
06069736402250000,2019,195573,399727,595300,MKT
06069736402280000,2021,246546,285154,531700,MKT
06069736402280000,2020,184647,240553,425200,MKT
06069736402280000,2019,184647,240553,425200,MKT
06069736402300000,2021,200613,0,200613,COST
06069736402300000,2020,154299,0,154299,COST
06069736402300000,2019,154299,0,154299,COST
06069736402330000,2021,192635,560465,753100,MKT
06069736402330000,2020,148941,478959,627900,MKT
06069736402330000,2019,148941,478959,627900,MKT
06069736402350000,2021,192635,412565,605200,MKT
06069736402350000,2020,148941,318459,467400,MKT
06069736402350000,2019,148941,318459,467400,MKT
06069736402370000,2021,192635,314565,507200,MKT
06069736402370000,2020,148941,245659,394600,MKT
06069736402370000,2019,148941,245659,394600,MKT
06069801101010000,2021,181014,218486,399500,MKT
06069801101010000,2020,79317,187830,267147,COST
06069801101010000,2019,79317,187830,267147,COST
06069801101020000,2021,172236,160364,332600,MKT
06069801101020000,2020,76023,131300,207323,COST
06069801101020000,2019,76023,131300,207323,COST
06069801101030000,2021,171751,191649,363400,MKT
06069801101030000,2020,75840,179190,255030,COST
06069801101030000,2019,75840,179190,255030,COST
06069801101040000,2021,171751,17620,189371,COST
06069801101040000,2020,75840,18200,94040,COST
06069801101040000,2019,75840,18200,94040,COST
06069801101050000,2021,172236,365464,537700,MKT
06069801101050000,2020,84728,288300,373028,COST
06069801101050000,2019,84728,288300,373028,COST
06069801101060000,2021,171751,216349,388100,MKT
06069801101060000,2020,75840,211450,287290,OVR
06069801101060000,2019,75840,211450,287290,COST
06069801101070000,2021,171751,252649,424400,MKT
06069801101070000,2020,84453,127820,212273,COST
06069801101070000,2019,84453,127820,212273,COST
06069801101080000,2021,171751,0,171751,COST
06069801101080000,2020,84453,71490,155943,COST
06069801101080000,2019,84453,71490,155943,COST
06069801101090000,2021,170528,21360,191888,COST
06069801101090000,2020,75379,21270,96649,COST
06069801101090000,2019,75379,21270,96649,COST
06069801101100000,2021,211466,0,211466,COST
06069801101100000,2020,90572,0,90572,COST
06069801101100000,2019,90572,0,90572,COST
06069801101110000,2021,194444,215056,409500,MKT
06069801101110000,2020,84312,164430,248742,COST
06069801101110000,2019,84312,164430,248742,COST
06069801101120000,2021,170157,154143,324300,MKT
06069801101120000,2020,75239,134510,209749,COST
06069801101120000,2019,75239,134510,209749,COST
06069801101130000,2021,171751,12630,184381,COST
06069801101130000,2020,75840,12780,88620,COST
06069801101130000,2019,75840,12780,88620,COST
06069801101140000,2021,214746,220054,434800,MKT
06069801101140000,2020,109263,163940,273203,COST
06069801101140000,2019,109263,163940,273203,COST
06069801101150000,2021,220043,74440,294483,COST
06069801101150000,2020,93697,44830,138527,COST
06069801101150000,2019,93697,44830,138527,COST
06069801101160000,2021,169288,0,169288,COST
06069801101160000,2020,74911,0,74911,COST
06069801101160000,2019,74911,0,74911,COST
06069801101170000,2021,180238,192562,372800,MKT
06069801101170000,2020,79027,97720,176747,COST
06069801101170000,2019,79027,97720,176747,COST
06069801101180000,2021,180238,13420,193658,COST
06069801101180000,2020,79027,13770,92797,COST
06069801101180000,2019,79027,13770,92797,COST
06069801101190000,2021,170528,40820,211348,COST
06069801101190000,2020,75379,40610,115989,COST
06069801101190000,2019,75379,40610,115989,COST
06069801101200000,2021,170528,0,170528,COST
06069801101200000,2020,75379,0,75379,COST
06069801101200000,2019,75379,0,75379,COST
06069801101210000,2021,161474,184926,346400,MKT
06069801101210000,2020,71950,148810,220760,COST
06069801101210000,2019,71950,148810,220760,COST
06069801101220000,2021,179903,250,180153,COST
06069801101220000,2020,78902,260,79162,COST
06069801101220000,2019,78902,260,79162,COST
06069801101230000,2021,170528,1150,171678,COST
06069801101230000,2020,75379,1220,76599,COST
06069801101230000,2019,75379,1220,76599,COST
06069801101240000,2021,389858,206310,596168,COST
06069801101240000,2020,314916,202510,517426,COST
06069801101240000,2019,314916,202510,517426,COST
06069801101300000,2021,387972,0,387972,COST
06069801101300000,2020,313160,0,313160,COST
06069801101300000,2019,313160,0,313160,COST
06069801101356500,2021,187197,0,187197,COST
06069801101356500,2020,111971,0,111971,COST
06069801101356500,2019,111971,0,111971,COST
06069801101400000,2021,4428,980,5408,COST
06069801101400000,2020,33448,950,34398,COST
06069801101400000,2019,33448,950,34398,COST
06069801102010000,2021,219578,190622,410200,MKT
06069801102010000,2020,93528,183350,276878,COST
06069801102010000,2019,93528,183350,276878,COST
06069801102020000,2021,219500,221200,440700,MKT
06069801102020000,2020,112056,200270,312326,COST
06069801102020000,2019,112056,200270,312326,COST
06069801102030000,2021,35551,259870,295421,COST
06069801102030000,2020,37594,257260,294854,COST
06069801102030000,2019,37594,257260,294854,COST
06069801102040000,2021,267033,305767,572800,MKT
06069801102040000,2020,203578,272522,476100,MKT
06069801102040000,2019,203578,272522,476100,MKT
06069801102050000,2021,379111,879820,1258931,COST
06069801102050000,2020,245306,824190,1069496,COST
06069801102050000,2019,245306,732190,977496,COST
06069801102060000,2021,241511,322630,564141,COST
06069801102060000,2020,181315,320180,501495,COST
06069801102060000,2019,181315,218330,399645,COST
06069801102070000,2021,220890,160310,381200,MKT
06069801102070000,2020,94005,64760,158765,COST
06069801102070000,2019,94005,64760,158765,COST
06069801102080000,2021,219578,146122,365700,MKT
06069801102080000,2020,93528,132500,226028,COST
06069801102080000,2019,93528,132500,226028,COST
06069801102090000,2021,219578,195322,414900,MKT
06069801102090000,2020,112102,200570,312672,COST
06069801102090000,2019,112102,192670,304772,COST
06069801102100000,2021,219500,290200,509700,MKT
06069801102100000,2020,112056,229660,341716,COST
06069801102100000,2019,112056,213120,325176,COST
06069801102110000,2021,219500,527000,746500,MKT
06069801102110000,2020,112056,504080,616136,OVR
06069801102110000,2019,112056,504080,616136,COST
06069801102120000,2021,219500,281490,500990,COST
06069801102120000,2020,93500,176040,269540,COST
06069801102120000,2019,93500,176040,269540,COST
06069801102130000,2021,219500,18880,238380,COST
06069801102130000,2020,93500,19360,112860,COST
06069801102130000,2019,93500,19360,112860,COST
06069801102140000,2021,220120,190180,410300,MKT
06069801102140000,2020,93725,161570,255295,COST
06069801102140000,2019,93725,161570,255295,COST
06069801102150000,2021,221120,187180,408300,MKT
06069801102150000,2020,94089,117990,212079,COST
06069801102150000,2019,94089,173060,267149,COST
06069801103010000,2021,219500,261100,480600,MKT
06069801103010000,2020,112056,203430,315486,OVR
06069801103010000,2019,112056,203430,315486,COST
06069801103020000,2021,219500,180500,400000,MKT
06069801103020000,2020,112056,124560,236616,COST
06069801103020000,2019,112056,124560,236616,COST
06069801103030000,2021,219500,181200,400700,MKT
06069801103030000,2020,112056,116730,228786,COST
06069801103030000,2019,112056,116730,228786,COST
06069801103040000,2021,219500,9080,228580,COST
06069801103040000,2020,93500,9040,102540,COST
06069801103040000,2019,93500,9040,102540,COST
06069801103060000,2021,220890,12300,233190,COST
06069801103060000,2020,94005,12450,106455,COST
06069801103060000,2019,94005,12450,106455,COST
06069801103070000,2021,220967,206833,427800,MKT
06069801103070000,2020,112920,193640,306560,COST
06069801103070000,2019,112920,193640,306560,COST
06069801103080000,2021,220890,290,221180,COST
06069801103080000,2020,94005,300,94305,COST
06069801103080000,2019,94005,300,94305,COST
06069801103090000,2021,219500,790,220290,COST
06069801103090000,2020,93500,900,94400,COST
06069801103090000,2019,93500,900,94400,COST
06069801103100000,2021,219500,167100,386600,MKT
06069801103100000,2020,93500,116900,210400,COST
06069801103100000,2019,93500,116900,210400,COST
06069801103110000,2021,219500,258500,478000,MKT
06069801103110000,2020,93500,228390,321890,COST
06069801103110000,2019,93500,228390,321890,COST
06069801103120000,2021,219500,30930,250430,COST
06069801103120000,2020,93500,30600,124100,COST
06069801103120000,2019,93500,30600,124100,COST
06069801108010000,2021,172357,155143,327500,MKT
06069801108010000,2020,76069,66040,142109,COST
06069801108010000,2019,76069,66040,142109,COST
06069801108020000,2021,168662,12300,180962,COST
06069801108020000,2020,74675,12450,87125,COST
06069801108020000,2019,74675,12450,87125,COST
06069801108030000,2021,168031,207069,375100,MKT
06069801108030000,2020,74436,173690,248126,COST
06069801108030000,2019,74436,173690,248126,COST
06069801108040000,2021,180238,143290,323528,COST
06069801108040000,2020,79027,108080,187107,COST
06069801108040000,2019,79027,108080,187107,COST
06069801108050000,2021,171386,5170,176556,COST
06069801108050000,2020,75703,5710,81413,COST
06069801108050000,2019,75703,5710,81413,COST
06069801108060000,2021,168662,157638,326300,MKT
06069801108060000,2020,74675,106460,181135,COST
06069801108060000,2019,74675,106460,181135,COST
06069801108070000,2021,168662,23220,191882,COST
06069801108070000,2020,74675,23240,97915,COST
06069801108070000,2019,74675,23240,97915,COST
06069801108080000,2021,181345,209655,391000,MKT
06069801108080000,2020,79441,153490,232931,COST
06069801108080000,2019,79441,153490,232931,COST
06069801120010000,2021,171751,127649,299400,MKT
06069801120010000,2020,75840,58060,133900,COST
06069801120010000,2019,75840,58060,133900,COST
06069801120020000,2021,172478,138400,310878,COST
06069801120020000,2020,84865,139050,223915,COST
06069801120020000,2019,84865,139050,223915,COST
06069801120030000,2021,172478,336122,508600,MKT
06069801120030000,2020,84865,106140,191005,COST
06069801120030000,2019,84865,38540,123405,COST
06069801120040000,2021,190494,295306,485800,MKT
06069801120040000,2020,95164,247380,342544,COST
06069801120040000,2019,95164,247380,342544,COST
06069801120050000,2021,172478,332222,504700,MKT
06069801120050000,2020,84865,209270,294135,COST
06069801120050000,2019,84865,176490,261355,COST
06069801120060000,2021,175330,0,175330,COST
06069801120060000,2020,77187,0,77187,COST
06069801120060000,2019,77187,0,77187,COST
06069801120070000,2021,172478,204322,376800,MKT
06069801120070000,2020,76114,0,76114,COST
06069801120070000,2019,76114,0,76114,COST
06069801120080000,2021,188462,1600,190062,COST
06069801120080000,2020,82094,1650,83744,COST
06069801120080000,2019,82094,1650,83744,COST
06069801201010000,2021,1489,0,1489,COST
06069801201010000,2020,1386,0,1386,COST
06069801201010000,2019,1386,0,1386,COST
06069801201020000,2021,220043,191657,411700,MKT
06069801201020000,2020,162863,199837,362700,MKT
06069801201020000,2019,162863,199837,362700,MKT
06069801201040000,2021,31060,138470,169530,COST
06069801201040000,2020,36052,134190,170242,COST
06069801201040000,2019,36052,134190,170242,COST
06069801201100000,2021,559,0,559,COST
06069801201100000,2020,520,0,520,COST
06069801201100000,2019,520,0,520,COST
06069801201110000,2021,1594,0,1594,COST
06069801201110000,2020,1483,0,1483,COST
06069801201110000,2019,1483,0,1483,COST
06069801201120000,2021,8033,0,8033,COST
06069801201120000,2020,447480,0,447480,COST
06069801201120000,2019,447480,0,447480,COST
06069801201130000,2021,506905,368320,875225,COST
06069801201130000,2020,426231,360310,786541,COST
06069801201130000,2019,426231,360310,786541,COST
06069801201200000,2021,366561,728810,1095371,COST
06069801201200000,2020,293321,719890,1013211,COST
06069801201200000,2019,293321,719890,1013211,COST
06069801201300000,2021,387972,0,387972,COST
06069801201300000,2020,313160,0,313160,COST
06069801201300000,2019,313160,0,313160,COST
06069801201350000,2021,387972,371728,759700,MKT
06069801201350000,2020,313160,330140,643300,OVR
06069801201350000,2019,313160,330140,643300,MKT
06069801201450000,2021,450086,527790,977876,COST
06069801201450000,2020,371639,518190,889829,OVR
06069801201450000,2019,371639,518190,889829,COST
06069801201500000,2021,450086,1180760,1630846,COST
06069801201500000,2020,371639,1144400,1516039,COST
06069801201500000,2019,371639,1144400,1516039,COST
06069801301010000,2021,280523,217077,497600,MKT
06069801301010000,2020,215480,228620,444100,MKT
06069801301010000,2019,215480,228620,444100,MKT
06069801301020000,2021,280523,0,280523,COST
06069801301020000,2020,215480,0,215480,COST
06069801301020000,2019,215480,0,215480,COST
06069801301030000,2021,280523,262877,543400,MKT
06069801301030000,2020,215480,253220,468700,MKT
06069801301030000,2019,215480,253220,468700,MKT
06069801301040000,2021,280523,244277,524800,MKT
06069801301040000,2020,215480,209520,425000,MKT
06069801301040000,2019,215480,209520,425000,MKT
06069801301050000,2021,280523,392477,673000,MKT
06069801301050000,2020,215480,375720,591200,MKT
06069801301050000,2019,215480,375720,591200,MKT
06069801301060000,2021,280523,237577,518100,MKT
06069801301060000,2020,215480,239020,454500,MKT
06069801301060000,2019,215480,239020,454500,MKT
06069801301070000,2021,280523,0,280523,COST
06069801301070000,2020,215480,0,215480,COST
06069801301070000,2019,215480,0,215480,COST
06069801301080000,2021,280523,351140,631663,COST
06069801301080000,2020,215480,343870,559350,COST
06069801301080000,2019,215480,343870,559350,COST
06069801301090000,2021,280523,294877,575400,MKT
06069801301090000,2020,215480,265620,481100,MKT
06069801301090000,2019,215480,265620,481100,MKT
06069801301100000,2021,280523,0,280523,COST
06069801301100000,2020,215480,0,215480,COST
06069801301100000,2019,215480,0,215480,COST
06069801301120000,2021,280523,241577,522100,MKT
06069801301120000,2020,215480,205220,420700,MKT
06069801301120000,2019,215480,205220,420700,MKT
06069801301130000,2021,280523,258877,539400,MKT
06069801301130000,2020,215480,280420,495900,MKT
06069801301130000,2019,215480,280420,495900,MKT
06069801301140000,2021,280523,189277,469800,MKT
06069801301140000,2020,215480,181020,396500,MKT
06069801301140000,2019,215480,181020,396500,MKT
06069801301150000,2021,280523,299777,580300,MKT
06069801301150000,2020,215480,290320,505800,MKT
06069801301150000,2019,215480,290320,505800,MKT
06069801301160000,2021,280523,409777,690300,MKT
06069801301160000,2020,215480,388220,603700,MKT
06069801301160000,2019,215480,388220,603700,MKT
06069801301170000,2021,280523,792510,1073033,COST
06069801301170000,2020,215480,771970,987450,COST
06069801301170000,2019,215480,735470,950950,COST
06069801301180000,2021,280523,291877,572400,MKT
06069801301180000,2020,215480,263620,479100,MKT
06069801301180000,2019,215480,263620,479100,MKT
06069801301190000,2021,329077,300650,629727,COST
06069801301190000,2020,259020,291050,550070,COST
06069801301190000,2019,259020,291050,550070,COST
06069801301220000,2021,3521,301420,304941,COST
06069801301220000,2020,313160,300710,613870,COST
06069801301220000,2019,313160,300710,613870,COST
06069801301250000,2021,2069,0,2069,COST
06069801301250000,2020,313160,0,313160,COST
06069801301250000,2019,313160,0,313160,COST
06069801302010000,2021,189,0,189,COST
06069801302010000,2020,175,0,175,COST
06069801302010000,2019,175,0,175,COST
06069801302020000,2021,194,0,194,COST
06069801302020000,2020,180,0,180,COST
06069801302020000,2019,180,0,180,COST
06069801302030000,2021,308945,315155,624100,MKT
06069801302030000,2020,240838,345462,586300,MKT
06069801302030000,2019,240838,345462,586300,MKT
06069801302040000,2021,270681,287619,558300,MKT
06069801302040000,2020,206787,268813,475600,MKT
06069801302040000,2019,206787,268813,475600,MKT
06069801302050000,2021,249735,206765,456500,MKT
06069801302050000,2020,188451,219749,408200,MKT
06069801302050000,2019,188451,219749,408200,MKT
06069801302060000,2021,298690,245110,543800,MKT
06069801302060000,2020,231646,222654,454300,MKT
06069801302060000,2019,231646,222654,454300,MKT
06069801302070000,2021,265559,271441,537000,MKT
06069801302070000,2020,202283,250917,453200,MKT
06069801302070000,2019,202283,250917,453200,MKT
06069801302080000,2021,304560,309140,613700,MKT
06069801302080000,2020,236902,286298,523200,MKT
06069801302080000,2019,236902,286298,523200,MKT
06069801303016500,2021,33833,0,33833,COST
06069801303016500,2020,22580,0,22580,COST
06069801303016500,2019,22580,0,22580,COST
06069801304010000,2021,220005,988880,1208885,COST
06069801304010000,2020,162870,984550,1147420,COST
06069801304010000,2019,162870,984550,1147420,COST
06069801401010000,2021,617364,0,617364,COST
06069801401010000,2020,534992,0,534992,COST
06069801401010000,2019,534992,0,534992,COST
06069801401020000,2021,78441,0,78441,COST
06069801401020000,2020,59532,0,59532,COST
06069801401020000,2019,59532,0,59532,COST
06069801401030000,2021,528880,209020,737900,COST
06069801401030000,2020,447602,202670,650272,COST
06069801401030000,2019,447602,202670,650272,COST
06069801401040000,2021,389804,230200,620004,COST
06069801401040000,2020,314865,229020,543885,COST
06069801401040000,2019,314865,229020,543885,COST
06069801401050000,2021,389804,562040,951844,COST
06069801401050000,2020,314865,613540,928405,COST
06069801401050000,2019,314865,321360,636225,COST
06069801401060000,2021,305029,886870,1191899,COST
06069801401060000,2020,237323,847440,1084763,OVR
06069801401060000,2019,237323,847440,1084763,COST
06069801401070000,2021,450128,250210,700338,COST
06069801401070000,2020,371679,244620,616299,COST
06069801401070000,2019,371679,0,371679,COST
06069801401080000,2021,458182,0,458182,COST
06069801401080000,2020,379356,0,379356,COST
06069801401080000,2019,379356,0,379356,COST
06069801401100000,2021,389067,1283400,1672467,COST
06069801401100000,2020,314179,1311740,1625919,OVR
06069801401100000,2019,314179,1311740,1625919,COST
06069801401110000,2021,389340,0,389340,COST
06069801401110000,2020,314434,0,314434,COST
06069801401110000,2019,314434,0,314434,COST
06069801401120000,2021,389368,220580,609948,COST
06069801401120000,2020,314459,223041,537500,MKT
06069801401120000,2019,314459,223041,537500,MKT
06069801401130000,2021,387972,348770,736742,COST
06069801401130000,2020,313160,332200,645360,COST
06069801401130000,2019,313160,332200,645360,COST
06069801401140000,2021,303575,248480,552055,COST
06069801401140000,2020,236018,282482,518500,MKT
06069801401140000,2019,236018,282482,518500,MKT
06069801401150000,2021,447413,170530,617943,COST
06069801401150000,2020,369095,170620,539715,COST
06069801401150000,2019,369095,170620,539715,COST
06069801401180000,2021,389613,458390,848003,COST
06069801401180000,2020,314687,406490,721177,OVR
06069801401180000,2019,314687,406490,721177,COST
06069801401190000,2021,304517,303383,607900,MKT
06069801401190000,2020,236863,268737,505600,MKT
06069801401190000,2019,236863,268737,505600,MKT
06069801401210000,2021,304432,0,304432,COST
06069801401210000,2020,236787,0,236787,COST
06069801401210000,2019,236787,0,236787,COST
06069801401250000,2021,387972,0,387972,COST
06069801401250000,2020,313160,0,313160,COST
06069801401250000,2019,313160,0,313160,COST
06069801401270000,2021,380509,333030,713539,COST
06069801401270000,2020,306226,298374,604600,MKT
06069801401270000,2019,306226,298374,604600,MKT
06069801401290000,2021,366805,207700,574505,COST
06069801401290000,2020,293546,193390,486936,OVR
06069801401290000,2019,293546,193390,486936,COST
06069801401300000,2021,366287,181520,547807,COST
06069801401300000,2020,293068,169932,463000,MKT
06069801401300000,2019,293068,169932,463000,MKT
06069801401310000,2021,366073,332327,698400,MKT
06069801401310000,2020,292871,312370,605241,COST
06069801401310000,2019,292871,220729,513600,MKT
06069801420010000,2021,285313,318687,604000,MKT
06069801420010000,2020,219727,338873,558600,MKT
06069801420010000,2019,219727,338873,558600,MKT
06069801420020000,2021,294974,0,294974,COST
06069801420020000,2020,228326,0,228326,COST
06069801420020000,2019,228326,0,228326,COST
06069801420030000,2021,294883,0,294883,COST
06069801420030000,2020,228245,0,228245,COST
06069801420030000,2019,228245,0,228245,COST
06069801420040000,2021,285024,221476,506500,MKT
06069801420040000,2020,219470,220930,440400,MKT
06069801420040000,2019,219470,220930,440400,MKT
06069801420050000,2021,285024,464676,749700,MKT
06069801420050000,2020,219470,472160,691630,COST
06069801420050000,2019,219470,221630,441100,MKT
06069801420060000,2021,294883,248217,543100,MKT
06069801420060000,2020,228245,230455,458700,MKT
06069801420060000,2019,228245,230455,458700,MKT
06069801420070000,2021,294974,273126,568100,MKT
06069801420070000,2020,228326,220374,448700,MKT
06069801420070000,2019,228326,220374,448700,MKT
06069801420080000,2021,285313,210787,496100,MKT
06069801420080000,2020,219727,197473,417200,MKT
06069801420080000,2019,219727,197473,417200,MKT
06069801445010000,2021,280225,391120,671345,COST
06069801445010000,2020,215216,373120,588336,COST
06069801445010000,2019,215216,373120,588336,COST
06069801445020000,2021,290100,406840,696940,COST
06069801445020000,2020,223982,402810,626792,COST
06069801445020000,2019,223982,402810,626792,COST
06069801445030000,2021,289586,234914,524500,MKT
06069801445030000,2020,223525,224375,447900,MKT
06069801445030000,2019,223525,224375,447900,MKT
06069801445040000,2021,279927,284773,564700,MKT
06069801445040000,2020,214951,242649,457600,MKT
06069801445040000,2019,214951,242649,457600,MKT
06069802101020000,2021,510725,319810,830535,COST
06069802101020000,2020,473706,307820,781526,COST
06069802101020000,2019,473706,307730,781436,COST
06069802101026500,2021,1144,0,1144,COST
06069802101026500,2020,1064,0,1064,COST
06069802101026500,2019,1064,0,1064,COST
06069802101030000,2021,347417,176070,523487,COST
06069802101030000,2020,275731,172550,448281,COST
06069802101030000,2019,275731,172550,448281,COST
06069802101040000,2021,219500,851320,1070820,COST
06069802101040000,2020,162400,830910,993310,COST
06069802101040000,2019,162400,830910,993310,COST
06069802101050000,2021,202833,196267,399100,MKT
06069802101050000,2020,148268,202532,350800,MKT
06069802101050000,2019,148268,202532,350800,MKT
06069802101060000,2021,1129,0,1129,COST
06069802101060000,2020,1050,0,1050,COST
06069802101060000,2019,1050,0,1050,COST
06069802101070000,2021,276907,282093,559000,MKT
06069802101070000,2020,212280,233120,445400,MKT
06069802101070000,2019,212280,233120,445400,MKT
06069802101080000,2021,447709,249180,696889,COST
06069802101080000,2020,369376,242440,611816,COST
06069802101080000,2019,369376,242440,611816,COST
06069802101080900,2021,342964,240790,583754,COST
06069802101080900,2020,271661,228639,500300,MKT
06069802101080900,2019,271661,228639,500300,MKT
06069802101090000,2021,219500,337100,556600,MKT
06069802101090000,2020,162400,318300,480700,MKT
06069802101090000,2019,162400,318300,480700,MKT
06069802101100000,2021,27288,0,27288,COST
06069802101100000,2020,31043,0,31043,COST
06069802101100000,2019,31043,0,31043,COST
06069802101110000,2021,390592,113060,503652,COST
06069802101110000,2020,315599,110810,426409,COST
06069802101110000,2019,315599,110810,426409,COST
06069802101150000,2021,303832,269868,573700,MKT
06069802101150000,2020,236249,248651,484900,MKT
06069802101150000,2019,236249,248651,484900,MKT
06069802101200000,2021,48068,0,48068,COST
06069802101200000,2020,62917,0,62917,COST
06069802101200000,2019,62917,0,62917,COST
06069802185010000,2021,240589,409411,650000,MKT
06069802185010000,2020,220706,376494,597200,MKT
06069802185010000,2019,220706,376494,597200,MKT
06069802185040000,2021,240589,0,240589,COST
06069802185040000,2020,220706,0,220706,COST
06069802185040000,2019,220706,0,220706,COST
06069802185070000,2021,240589,0,240589,COST
06069802185070000,2020,220706,0,220706,COST
06069802185070000,2019,220706,0,220706,COST
06069802185100000,2021,240589,0,240589,COST
06069802185100000,2020,220706,0,220706,COST
06069802185100000,2019,220706,0,220706,COST
06069802185130000,2021,13009,565490,578499,COST
06069802185130000,2020,17344,554710,572054,COST
06069802185130000,2019,17344,531210,548554,COST
06069802201010000,2021,4434,0,4434,COST
06069802201010000,2020,4126,0,4126,COST
06069802201010000,2019,4126,0,4126,COST
06069802201030000,2021,2117,263440,265557,COST
06069802201030000,2020,2377,259400,261777,COST
06069802201030000,2019,2377,259400,261777,COST
06069802201040000,2021,3889,168090,171979,COST
06069802201040000,2020,4024,164850,168874,COST
06069802201040000,2019,4024,147570,151594,COST
06069802201050000,2021,517,0,517,COST
06069802201050000,2020,480,0,480,COST
06069802201050000,2019,480,0,480,COST
06069802201070000,2021,2991,630780,633771,COST
06069802201070000,2020,3189,604740,607929,COST
06069802201070000,2019,3189,604740,607929,COST
06069802201090000,2021,2069,0,2069,COST
06069802201090000,2020,1920,0,1920,COST
06069802201090000,2019,1920,0,1920,COST
06069802201120000,2021,578583,442540,1021123,COST
06069802201120000,2020,496437,441710,938147,COST
06069802201120000,2019,496437,441710,938147,COST
06069802201130000,2021,168787,0,168787,COST
06069802201130000,2020,119964,0,119964,COST
06069802201130000,2019,119964,0,119964,COST
06069802201150000,2021,376748,445052,821800,INCOME
06069802201150000,2020,302739,444661,747400,INCOME
06069802201150000,2019,302739,444661,747400,INCOME
06069802201200000,2021,898,0,898,COST
06069802201200000,2020,836,0,836,COST
06069802201200000,2019,836,0,836,COST
06069802301010000,2021,360341,0,360341,COST
06069802301010000,2020,87,0,87,COST
06069802301010000,2019,87,0,87,COST
06069802301040000,2021,307168,0,307168,COST
06069802301040000,2020,55,0,55,COST
06069802301040000,2019,55,0,55,COST
06069802301070000,2021,307168,0,307168,COST
06069802301070000,2020,55,0,55,COST
06069802301070000,2019,55,0,55,COST
06069802301100000,2021,308180,0,308180,COST
06069802301100000,2020,56,0,56,COST
06069802301100000,2019,56,0,56,COST
06069802301130000,2021,308180,0,308180,COST
06069802301130000,2020,56,0,56,COST
06069802301130000,2019,56,0,56,COST
06069802301160000,2021,308180,0,308180,COST
06069802301160000,2020,56,0,56,COST
06069802301160000,2019,56,0,56,COST
06069802301190000,2021,308180,0,308180,COST
06069802301190000,2020,56,0,56,COST
06069802301190000,2019,56,0,56,COST
06069802301220000,2021,307168,0,307168,COST
06069802301220000,2020,55,0,55,COST
06069802301220000,2019,55,0,55,COST
06069802301250000,2021,307168,0,307168,COST
06069802301250000,2020,55,0,55,COST
06069802301250000,2019,55,0,55,COST
06069802301280000,2021,307168,0,307168,COST
06069802301280000,2020,55,0,55,COST
06069802301280000,2019,55,0,55,COST
06069802301310000,2021,306149,0,306149,COST
06069802301310000,2020,55,0,55,COST
06069802301310000,2019,55,0,55,COST
06069802301340000,2021,318943,1307100,1626043,COST
06069802301340000,2020,261517,0,261517,COST
06069802301340000,2019,61,0,61,COST
06069802301370000,2021,300958,0,300958,COST
06069802301370000,2020,52,0,52,COST
06069802301370000,2019,52,0,52,COST
06069802301406500,2021,342200,0,342200,COST
06069802301406500,2020,227110,0,227110,COST
06069802301406500,2019,227110,0,227110,COST
06069802301600000,2021,387972,200310,588282,COST
06069802301600000,2020,313160,194790,507950,COST
06069802301600000,2019,313160,194790,507950,COST
06069802301800000,2021,36087,472320,508407,COST
06069802301800000,2020,48442,466990,515432,COST
06069802301800000,2019,48442,466990,515432,COST
06069802302010000,2021,254565,1022935,1277500,MKT
06069802302010000,2020,246556,0,246556,COST
06069802302010000,2019,53,0,53,COST
06069802302040000,2021,274152,0,274152,COST
06069802302040000,2020,268553,0,268553,COST
06069802302040000,2019,65,0,65,COST
06069802302070000,2021,274914,0,274914,COST
06069802302070000,2020,66,0,66,COST
06069802302070000,2019,66,0,66,COST
06069802302100000,2021,279408,0,279408,COST
06069802302100000,2020,69,0,69,COST
06069802302100000,2019,69,0,69,COST
06069802302130000,2021,290099,1013701,1303800,MKT
06069802302130000,2020,286640,265680,552320,COST
06069802302130000,2019,286640,0,286640,COST
06069802302160000,2021,269497,348000,617497,COST
06069802302160000,2020,263302,0,263302,COST
06069802302160000,2019,263302,0,263302,COST
06069802302190000,2021,252805,388680,641485,COST
06069802302190000,2020,52,0,52,COST
06069802302190000,2019,52,0,52,COST
06069802302220000,2021,313156,0,313156,COST
06069802302220000,2020,58,0,58,COST
06069802302220000,2019,58,0,58,COST
06069802303010000,2021,348609,0,348609,COST
06069802303010000,2020,79,0,79,COST
06069802303010000,2019,79,0,79,COST
06069802303040000,2021,327279,962170,1289449,COST
06069802303040000,2020,269413,989787,1259200,MKT
06069802303040000,2019,269413,0,269413,COST
06069802303070000,2021,327279,0,327279,COST
06069802303070000,2020,269413,0,269413,COST
06069802303070000,2019,269413,0,269413,COST
06069802303100000,2021,327279,0,327279,COST
06069802303100000,2020,269413,0,269413,COST
06069802303100000,2019,269413,0,269413,COST
06069802303130000,2021,328182,0,328182,COST
06069802303130000,2020,270270,0,270270,COST
06069802303130000,2019,270270,0,270270,COST
06069802303160000,2021,329080,0,329080,COST
06069802303160000,2020,67,0,67,COST
06069802303160000,2019,67,0,67,COST
06069802304010000,2021,323622,0,323622,COST
06069802304010000,2020,265946,0,265946,COST
06069802304010000,2019,265946,0,265946,COST
06069802304040000,2021,323622,0,323622,COST
06069802304040000,2020,265946,0,265946,COST
06069802304040000,2019,64,0,64,COST
06069802304070000,2021,324544,0,324544,COST
06069802304070000,2020,266819,0,266819,COST
06069802304070000,2019,266819,0,266819,COST
06069802304100000,2021,311183,880820,1192003,COST
06069802304100000,2020,254196,261950,516146,COST
06069802304100000,2019,57,0,57,COST
06069802304130000,2021,311183,0,311183,COST
06069802304130000,2020,57,0,57,COST
06069802304130000,2019,57,0,57,COST
06069802304160000,2021,311183,0,311183,COST
06069802304160000,2020,57,0,57,COST
06069802304160000,2019,57,0,57,COST
06069802304190000,2021,311183,0,311183,COST
06069802304190000,2020,254196,0,254196,COST
06069802304190000,2019,254196,0,254196,COST
06069802304220000,2021,311183,0,311183,COST
06069802304220000,2020,57,0,57,COST
06069802304220000,2019,57,0,57,COST
06069802304256500,2021,120293,0,120293,COST
06069802304256500,2020,68044,0,68044,COST
06069802304256500,2019,68044,0,68044,COST
06069802304280000,2021,307168,0,307168,COST
06069802304280000,2020,55,0,55,COST
06069802304280000,2019,55,0,55,COST
06069802304310000,2021,307168,0,307168,COST
06069802304310000,2020,55,0,55,COST
06069802304310000,2019,55,0,55,COST
06069802304340000,2021,307168,0,307168,COST
06069802304340000,2020,250418,0,250418,COST
06069802304340000,2019,250418,0,250418,COST
06069802304370000,2021,306149,0,306149,COST
06069802304370000,2020,55,0,55,COST
06069802304370000,2019,55,0,55,COST
06069802304400000,2021,306149,0,306149,COST
06069802304400000,2020,55,0,55,COST
06069802304400000,2019,55,0,55,COST
06069802304430000,2021,306149,0,306149,COST
06069802304430000,2020,55,0,55,COST
06069802304430000,2019,55,0,55,COST
06069802304460000,2021,257165,0,257165,COST
06069802304460000,2020,55,0,55,COST
06069802304460000,2019,55,0,55,COST
06069802304490000,2021,310188,0,310188,COST
06069802304490000,2020,57,0,57,COST
06069802304490000,2019,57,0,57,COST
06069802304520000,2021,313156,0,313156,COST
06069802304520000,2020,256055,0,256055,COST
06069802304520000,2019,256055,0,256055,COST
06069802305010000,2021,299900,0,299900,COST
06069802305010000,2020,52,0,52,COST
06069802305010000,2019,52,0,52,COST
06069802305040000,2021,300958,0,300958,COST
06069802305040000,2020,52,0,52,COST
06069802305040000,2019,52,0,52,COST
06069802305070000,2021,305123,0,305123,COST
06069802305070000,2020,54,0,54,COST
06069802305070000,2019,54,0,54,COST
06069802305100000,2021,254565,0,254565,COST
06069802305100000,2020,53,0,53,COST
06069802305100000,2019,53,0,53,COST
06069802305130000,2021,300958,0,300958,COST
06069802305130000,2020,52,0,52,COST
06069802305130000,2019,52,0,52,COST
06069802401200000,2021,387972,713940,1101912,COST
06069802401200000,2020,357002,683040,1040042,COST
06069802401200000,2019,357002,683040,1040042,COST
06069802401250000,2021,387972,648110,1036082,COST
06069802401250000,2020,357002,636960,993962,COST
06069802401250000,2019,357002,636960,993962,COST
06069802401300000,2021,387972,0,387972,COST
06069802401300000,2020,357002,0,357002,COST
06069802401300000,2019,357002,0,357002,COST
06069802401350000,2021,388027,780680,1168707,COST
06069802401350000,2020,357060,772390,1129450,COST
06069802401350000,2019,357060,772390,1129450,COST
06069802401400000,2021,387972,973720,1361692,COST
06069802401400000,2020,357002,945470,1302472,COST
06069802401400000,2019,357002,945470,1302472,COST
06069802402010000,2021,254804,0,254804,COST
06069802402010000,2020,212503,0,212503,COST
06069802402010000,2019,212503,0,212503,COST
06069802402030000,2021,242779,716800,959579,COST
06069802402030000,2020,200984,692080,893064,COST
06069802402030000,2019,200984,690120,891104,COST
06069802402050000,2021,238423,968877,1207300,MKT
06069802402050000,2020,196832,793468,990300,MKT
06069802402050000,2019,196832,793468,990300,MKT
06069802402070000,2021,240940,462160,703100,MKT
06069802402070000,2020,199229,401950,601179,COST
06069802402070000,2019,199229,401950,601179,COST
06069802402090000,2021,233841,681959,915800,MKT
06069802402090000,2020,192477,652323,844800,MKT
06069802402090000,2019,192477,652323,844800,MKT
06069802402110000,2021,240441,520659,761100,MKT
06069802402110000,2020,198753,532247,731000,MKT
06069802402110000,2019,198753,532247,731000,MKT
06069802402130000,2021,254159,411241,665400,MKT
06069802402130000,2020,211883,431517,643400,MKT
06069802402130000,2019,211883,431517,643400,MKT
06069802402150000,2021,261584,674016,935600,MKT
06069802402150000,2020,219035,602110,821145,COST
06069802402150000,2019,219035,602110,821145,COST
06069802402170000,2021,255765,796635,1052400,MKT
06069802402170000,2020,213427,0,213427,COST
06069802402170000,2019,213427,0,213427,COST
06069802402190000,2021,249827,0,249827,COST
06069802402190000,2020,207725,0,207725,COST
06069802402190000,2019,207725,0,207725,COST
06069802402210000,2021,228776,0,228776,COST
06069802402210000,2020,187679,0,187679,COST
06069802402210000,2019,187679,0,187679,COST
06069802402230000,2021,229790,664910,894700,MKT
06069802402230000,2020,188638,618362,807000,MKT
06069802402230000,2019,188638,618362,807000,MKT
06069802402250000,2021,228541,0,228541,COST
06069802402250000,2020,187456,0,187456,COST
06069802402250000,2019,187456,0,187456,COST
06069802402270000,2021,227833,538167,766000,MKT
06069802402270000,2020,186787,567713,754500,MKT
06069802402270000,2019,186787,567713,754500,MKT
06069802402290000,2021,227041,892250,1119291,COST
06069802402290000,2020,186039,923720,1109759,OVR
06069802402290000,2019,186039,923720,1109759,COST
06069802402310000,2021,235560,687740,923300,MKT
06069802402310000,2020,194109,651640,845749,COST
06069802402310000,2019,194109,464990,659099,COST
06069802402330000,2021,234142,665458,899600,MKT
06069802402330000,2020,192762,0,192762,COST
06069802402330000,2019,192762,0,192762,COST
06069802402350000,2021,271992,909408,1181400,MKT
06069802402350000,2020,229112,796488,1025600,MKT
06069802402350000,2019,229112,796488,1025600,MKT
06069802402370000,2021,259422,907178,1166600,MKT
06069802402370000,2020,216949,796151,1013100,MKT
06069802402370000,2019,216949,0,216949,COST
06069802402390000,2021,279237,0,279237,COST
06069802402390000,2020,236162,0,236162,COST
06069802402390000,2019,236162,0,236162,COST
06069802402410000,2021,312061,1043950,1356011,COST
06069802402410000,2020,268445,1028110,1296555,COST
06069802402410000,2019,268445,1028110,1296555,COST
06069802402430000,2021,300811,643689,944500,MKT
06069802402430000,2020,257319,613640,870959,COST
06069802402430000,2019,257319,613640,870959,COST
06069802402450000,2021,317784,1335016,1652800,MKT
06069802402450000,2020,274129,1301680,1575809,COST
06069802402450000,2019,274129,1301680,1575809,COST
06069802402470000,2021,238786,773414,1012200,MKT
06069802402470000,2020,197177,745723,942900,MKT
06069802402470000,2019,197177,745723,942900,MKT
06069802402490000,2021,236521,545379,781900,MKT
06069802402490000,2020,195023,492577,687600,MKT
06069802402490000,2019,195023,492677,687700,MKT
06069802402510000,2021,236448,972570,1209018,COST
06069802402510000,2020,194953,949320,1144273,COST
06069802402510000,2019,194953,949320,1144273,COST
06069802402530000,2021,237183,0,237183,COST
06069802402530000,2020,195652,0,195652,COST
06069802402530000,2019,195652,0,195652,COST
06069802402550000,2021,237476,793220,1030696,COST
06069802402550000,2020,195930,768160,964090,COST
06069802402550000,2019,195930,768160,964090,COST
06069802402570000,2021,236742,775658,1012400,MKT
06069802402570000,2020,195233,743267,938500,MKT
06069802402570000,2019,195233,743267,938500,MKT
06069802402590000,2021,244316,0,244316,COST
06069802402590000,2020,202451,0,202451,COST
06069802402590000,2019,202451,0,202451,COST
06069802402610000,2021,244524,0,244524,COST
06069802402610000,2020,202650,0,202650,COST
06069802402610000,2019,202650,0,202650,COST
06069802402630000,2021,242920,861980,1104900,MKT
06069802402630000,2020,201118,826782,1027900,MKT
06069802402630000,2019,201118,826782,1027900,MKT
06069802402650000,2021,241083,0,241083,COST
06069802402650000,2020,199365,0,199365,COST
06069802402650000,2019,199365,0,199365,COST
06069802402670000,2021,239652,692748,932400,MKT
06069802402670000,2020,198002,241120,439122,COST
06069802402670000,2019,198002,0,198002,COST
06069802402690000,2021,245560,764640,1010200,MKT
06069802402690000,2020,203640,666620,870260,COST
06069802402690000,2019,203640,666620,870260,COST
06069802402710000,2021,2346,0,2346,COST
06069802402710000,2020,2183,0,2183,COST
06069802402710000,2019,2183,0,2183,COST
06069802404200000,2021,325896,353710,679606,COST
06069802404200000,2020,300633,343740,644373,COST
06069802404200000,2019,300633,343740,644373,COST
06069803101010000,2021,4964,458260,463224,COST
06069803101010000,2020,5025,451410,456435,COST
06069803101010000,2019,5025,451410,456435,COST
06069803101100000,2021,3497,22660,26157,COST
06069803101100000,2020,3661,22820,26481,COST
06069803101100000,2019,3661,22820,26481,COST
06069803101150000,2021,1988,57430,59418,COST
06069803101150000,2020,2257,57090,59347,COST
06069803101150000,2019,2257,57090,59347,COST
06069803101200000,2021,387972,331080,719052,COST
06069803101200000,2020,313160,322600,635760,COST
06069803101200000,2019,313160,322600,635760,COST
06069803101300000,2021,387972,248730,636702,COST
06069803101300000,2020,313160,244910,558070,COST
06069803101300000,2019,313160,244910,558070,COST
06069803101330000,2021,388136,189450,577586,COST
06069803101330000,2020,313313,187930,501243,COST
06069803101330000,2019,313313,187930,501243,COST
06069803101350000,2021,456147,620260,1076407,COST
06069803101350000,2020,377414,410970,788384,COST
06069803101350000,2019,377414,364810,742224,COST
06069803101380000,2021,388246,318510,706756,COST
06069803101380000,2020,313415,307600,621015,OVR
06069803101380000,2019,313415,307600,621015,COST
06069803101400000,2021,21776,0,21776,COST
06069803101400000,2020,18864,0,18864,COST
06069803101400000,2019,28233,0,28233,COST
06069803101500000,2021,21413,0,21413,COST
06069803101500000,2020,18517,0,18517,COST
06069803101500000,2019,27959,0,27959,COST
06069803101600000,2021,480617,340583,821200,MKT
06069803101600000,2020,400849,333710,734559,OVR
06069803101600000,2019,400849,333710,734559,COST
06069803101650000,2021,388109,479260,867369,COST
06069803101650000,2020,313287,349610,662897,OVR
06069803101650000,2019,313287,349610,662897,COST
06069803101700000,2021,495832,306080,801912,COST
06069803101700000,2020,415514,293180,708694,COST
06069803101700000,2019,415514,293180,708694,COST
06069803101750000,2021,388109,109280,497389,COST
06069803101750000,2020,313287,111110,424397,COST
06069803101750000,2019,313287,71150,384437,COST
06069803101800000,2021,388109,0,388109,COST
06069803101800000,2020,313287,0,313287,COST
06069803101800000,2019,313287,0,313287,COST
06069803201020000,2021,219500,561300,780800,COST
06069803201020000,2020,162400,548910,711310,COST
06069803201020000,2019,162400,548910,711310,COST
06069803201080000,2021,607984,247390,855374,COST
06069803201080000,2020,417945,241500,659445,COST
06069803201080000,2019,417945,241500,659445,COST
06069803201160000,2021,498347,228580,726927,COST
06069803201160000,2020,417945,220820,638765,COST
06069803201160000,2019,417945,220820,638765,COST
06069803201180000,2021,390998,215790,606788,COST
06069803201180000,2020,315978,208200,524178,COST
06069803201180000,2019,315978,208200,524178,COST
06069803201210000,2021,390998,358990,749988,COST
06069803201210000,2020,315978,352390,668368,COST
06069803201210000,2019,315978,352390,668368,COST
06069803201250000,2021,485640,306000,791640,COST
06069803201250000,2020,405683,298250,703933,COST
06069803201250000,2019,405683,298250,703933,COST
06069803201300000,2021,393234,0,393234,COST
06069803201300000,2020,318061,0,318061,COST
06069803201300000,2019,318061,0,318061,COST
06069803201350000,2021,386870,395210,782080,COST
06069803201350000,2020,312135,386800,698935,COST
06069803201350000,2019,312135,386800,698935,COST
06069803201370000,2021,265,0,265,COST
06069803201370000,2020,247,0,247,COST
06069803201370000,2019,247,0,247,COST
06069803201400000,2021,562392,334730,897122,COST
06069803201400000,2020,480455,325400,805855,COST
06069803201400000,2019,480455,325400,805855,COST
06069803201450000,2021,323808,279292,603100,MKT
06069803201450000,2020,254244,312856,567100,MKT
06069803201450000,2019,254244,312856,567100,MKT
06069803201500000,2021,440434,144520,584954,COST
06069803201500000,2020,362466,244040,606506,COST
06069803201500000,2019,362466,244040,606506,COST
06069803201550000,2021,219500,270600,490100,MKT
06069803201550000,2020,162400,278800,441200,MKT
06069803201550000,2019,162400,278800,441200,MKT
06069803201560000,2021,439342,0,439342,COST
06069803201560000,2020,361430,0,361430,COST
06069803201560000,2019,361430,0,361430,COST
06069803201600000,2021,416403,496540,912943,COST
06069803201600000,2020,339762,482390,822152,COST
06069803201600000,2019,339762,479880,819642,COST
06069803201640000,2021,324799,0,324799,COST
06069803201640000,2020,255141,0,255141,COST
06069803201640000,2019,255141,0,255141,COST
06069803201680000,2021,324799,675170,999969,COST
06069803201680000,2020,255141,648000,903141,COST
06069803201680000,2019,255141,448510,703651,COST
06069803202010000,2021,357590,0,357590,COST
06069803202010000,2020,285061,0,285061,COST
06069803202010000,2019,285061,0,285061,COST
06069803202020000,2021,1113,0,1113,COST
06069803202020000,2020,1036,0,1036,COST
06069803202020000,2019,1036,0,1036,COST
06069803202030000,2021,357685,741550,1099235,COST
06069803202030000,2020,285148,730000,1015148,COST
06069803202030000,2019,285148,730000,1015148,COST
06069803202050000,2021,357781,313040,670821,COST
06069803202050000,2020,285236,305760,590996,COST
06069803202050000,2019,285236,305760,590996,COST
06069803202070000,2021,357876,358924,716800,MKT
06069803202070000,2020,285324,296676,582000,MKT
06069803202070000,2019,285324,296676,582000,MKT
06069803202090000,2021,358131,436869,795000,MKT
06069803202090000,2020,285558,338760,624318,COST
06069803202090000,2019,285558,235640,521198,COST
06069803202100000,2021,364448,577710,942158,COST
06069803202100000,2020,291373,553310,844683,COST
06069803202100000,2019,291373,547380,838753,COST
06069803202120000,2021,364448,385460,749908,COST
06069803202120000,2020,291373,375080,666453,COST
06069803202120000,2019,291373,375080,666453,COST
06069803202140000,2021,364448,418700,783148,COST
06069803202140000,2020,291373,439327,730700,MKT
06069803202140000,2019,291373,439327,730700,MKT
06069803202160000,2021,364448,208430,572878,COST
06069803202160000,2020,291373,207927,499300,MKT
06069803202160000,2019,291373,207927,499300,MKT
06069803202180000,2021,348589,508650,857239,COST
06069803202180000,2020,276804,500990,777794,COST
06069803202180000,2019,276804,500990,777794,COST
06069803301010000,2021,413830,27290,441120,COST
06069803301010000,2020,337343,27230,364573,COST
06069803301010000,2019,337343,27230,364573,COST
06069803301050000,2021,358512,309330,667842,COST
06069803301050000,2020,285908,298330,584238,COST
06069803301050000,2019,285908,298330,584238,COST
06069803301100000,2021,358480,327540,686020,COST
06069803301100000,2020,285879,314350,600229,COST
06069803301100000,2019,285879,314350,600229,COST
06069803301150000,2021,463108,704510,1167618,COST
06069803301150000,2020,342025,675690,1017715,COST
06069803301150000,2019,342025,655390,997415,COST
06069803301200000,2021,463108,364740,827848,COST
06069803301200000,2020,342025,356310,698335,COST
06069803301200000,2019,342025,356310,698335,COST
06069803302010000,2021,303532,416000,719532,COST
06069803302010000,2020,235980,405070,641050,OVR
06069803302010000,2019,235980,405070,641050,COST
06069803302050000,2021,303532,505668,809200,MKT
06069803302050000,2020,235980,499420,735400,MKT
06069803302050000,2019,235980,499420,735400,MKT
06069803302100000,2021,303532,454968,758500,MKT
06069803302100000,2020,235980,451190,687170,COST
06069803302100000,2019,235980,451190,687170,COST
06069803302150000,2021,451660,0,451660,COST
06069803302150000,2020,332296,0,332296,COST
06069803302150000,2019,332296,0,332296,COST
06069803302200000,2021,531288,203480,734768,COST
06069803302200000,2020,400704,197040,597744,COST
06069803302200000,2019,400704,197040,597744,COST
06069803303016500,2021,168237,0,168237,COST
06069803303016500,2020,114084,0,114084,COST
06069803303016500,2019,114084,0,114084,COST
