id,year,land,building,total,method
06079818106110000,2021,236160,0,236160,COST
06079818106110000,2020,179700,0,179700,COST
06079818106110000,2019,179700,0,179700,COST
06079818106136500,2021,274533,0,274533,COST
06079818106136500,2020,84520,0,84520,COST
06079818106136500,2019,84520,0,84520,COST
06079818106150000,2021,236160,0,236160,COST
06079818106150000,2020,179700,0,179700,COST
06079818106150000,2019,179700,0,179700,COST
06079818107010000,2021,244047,1021853,1265900,INCOME
06079818107010000,2020,183638,873462,1057100,INCOME
06079818107010000,2019,183638,873462,1057100,INCOME
06079818107030000,2021,213408,266592,480000,INCOME
06079818107030000,2020,168080,256820,424900,INCOME
06079818107030000,2019,168080,256820,424900,INCOME
06079818107050000,2021,213408,266592,480000,INCOME
06079818107050000,2020,168080,310020,478100,INCOME
06079818107050000,2019,168080,310020,478100,INCOME
06079818107070000,2021,213408,266592,480000,INCOME
06079818107070000,2020,168080,256820,424900,INCOME
06079818107070000,2019,168080,256820,424900,INCOME
06079818107090000,2021,219873,851427,1071300,INCOME
06079818107090000,2020,171423,756977,928400,INCOME
06079818107090000,2019,171423,756977,928400,INCOME
06079818201010000,2021,315303,851160,1166463,COST
06079818201010000,2020,358881,811950,1170831,COST
06079818201010000,2019,358881,811950,1170831,COST
06079818201020000,2021,391979,2553821,2945800,INCOME
06079818201020000,2020,414315,2266785,2681100,INCOME
06079818201020000,2019,414315,2266785,2681100,INCOME
06079818201030000,2021,256465,900635,1157100,INCOME
06079818201030000,2020,189752,852948,1042700,INCOME
06079818201030000,2019,189752,852948,1042700,INCOME
06079818201040000,2021,260176,696224,956400,INCOME
06079818201040000,2020,191559,609741,801300,INCOME
06079818201040000,2019,191559,609741,801300,INCOME
06079818201050000,2021,252367,556933,809300,INCOME
06079818201050000,2020,187746,534454,722200,INCOME
06079818201050000,2019,187746,534454,722200,INCOME
06079818201060000,2021,253660,609240,862900,INCOME
06079818201060000,2020,188380,526820,715200,INCOME
06079818201060000,2019,188380,526820,715200,INCOME
06079818201070000,2021,249297,547303,796600,INCOME
06079818201070000,2020,186236,492164,678400,INCOME
06079818201070000,2019,186236,492164,678400,INCOME
06079818201080000,2021,247396,1386804,1634200,INCOME
06079818201080000,2020,185297,1419903,1605200,INCOME
06079818201080000,2019,185297,1419903,1605200,INCOME
06079818202010900,2021,240063,738937,979000,INCOME
06079818202010900,2020,181654,660946,842600,INCOME
06079818202010900,2019,181654,660946,842600,INCOME
06079818202017000,2021,240184,33400,273584,COST
06079818202017000,2020,181715,32420,214135,COST
06079818202017000,2019,181715,32420,214135,COST
06079818202027000,2021,340889,25580,366469,COST
06079818202027000,2020,377841,25730,403571,COST
06079818202027000,2019,377841,25730,403571,COST
06079818202030000,2021,240063,630537,870600,INCOME
06079818202030000,2020,181654,592246,773900,INCOME
06079818202030000,2019,181654,592246,773900,INCOME
06079818202050000,2021,240063,1002337,1242400,INCOME
06079818202050000,2020,181654,934446,1116100,INCOME
06079818202050000,2019,181654,934446,1116100,INCOME
06079818202060000,2021,240063,136837,376900,INCOME
06079818202060000,2020,181654,151546,333200,INCOME
06079818202060000,2019,181654,151546,333200,INCOME
06079818202070000,2021,380889,0,380889,COST
06079818202070000,2020,246338,0,246338,COST
06079818202070000,2019,246338,0,246338,COST
06079818202090000,2021,419213,412620,831833,COST
06079818202090000,2020,383137,367170,750307,COST
06079818202090000,2019,383137,367170,750307,COST
06079818202100000,2021,434435,117060,551495,COST
06079818202100000,2020,398789,106890,505679,COST
06079818202100000,2019,398789,106890,505679,COST
06079818202130000,2021,625270,1114410,1739680,COST
06079818202130000,2020,341649,1079720,1421369,COST
06079818202130000,2019,341649,1079720,1421369,COST
06079818202150000,2021,430871,1158050,1588921,COST
06079818202150000,2020,267219,1090860,1358079,COST
06079818202150000,2019,267219,1090860,1358079,COST
06079818202200000,2021,404960,135930,540890,COST
06079818202200000,2020,368544,127130,495674,COST
06079818202200000,2019,368544,127130,495674,COST
06079818203010000,2021,669,0,669,COST
06079818203010000,2020,623,0,623,COST
06079818203010000,2019,623,0,623,COST
06079818203040000,2021,392359,899230,1291589,COST
06079818203040000,2020,326720,774520,1101240,OVR
06079818203040000,2019,326720,774520,1101240,COST
06079818203050000,2021,295810,218040,513850,COST
06079818203050000,2020,284925,195040,479965,COST
06079818203050000,2019,284925,195040,479965,COST
06079818203070000,2021,197058,614960,812018,COST
06079818203100000,2021,404871,241580,646451,COST
06079818203100000,2020,368453,217790,586243,COST
06079818203100000,2019,368453,217790,586243,COST
06079818222010000,2021,568,0,568,COST
06079818222010000,2020,528,0,528,COST
06079818222010000,2019,528,0,528,COST
06079818301250000,2021,195900,181100,377000,MKT
06079818301250000,2020,163100,152900,316000,MKT
06079818301250000,2019,163100,152900,316000,MKT
06079818302010000,2021,419351,1085500,1504851,COST
06079818302010000,2020,383279,979660,1362939,COST
06079818302010000,2019,383279,676790,1060069,COST
06079818302100000,2021,416424,0,416424,COST
06079818302100000,2020,380277,0,380277,COST
06079818302100000,2019,380277,0,380277,COST
06079818302200000,2021,388612,802370,1190982,COST
06079818302200000,2020,351884,717550,1069434,COST
06079818302200000,2019,351884,717550,1069434,COST
06079818302300000,2021,385190,771290,1156480,COST
06079818302300000,2020,348408,0,348408,COST
06079818302300000,2019,348408,0,348408,COST
06079818303010900,2021,438520,584040,1022560,COST
06079818303010900,2020,403000,527330,930330,COST
06079818303010900,2019,403000,527330,930330,COST
06079818303040000,2021,345295,234890,580185,COST
06079818303040000,2020,296280,128730,425010,COST
06079818303040000,2019,296280,128730,425010,COST
06079818303080000,2021,322000,552130,874130,COST
06079818303080000,2020,284925,510800,795725,COST
06079818303080000,2019,284925,510800,795725,COST
06079818303100000,2021,423137,205610,628747,COST
06079818303100000,2020,387165,185130,572295,COST
06079818303100000,2019,387165,185130,572295,COST
06079818303120000,2021,195900,261400,457300,MKT
06079818303120000,2020,163100,218400,381500,MKT
06079818303120000,2019,163100,218400,381500,MKT
06079818303140000,2021,195965,251535,447500,MKT
06079818303140000,2020,163160,214140,377300,MKT
06079818303140000,2019,163160,214140,377300,MKT
06079818303160000,2021,195965,233435,429400,MKT
06079818303160000,2020,163160,201640,364800,MKT
06079818303160000,2019,163160,201640,364800,MKT
06079818303180000,2021,224672,36910,261582,COST
06079818303180000,2020,190223,37260,227483,COST
06079818303180000,2019,190223,37260,227483,COST
06079818303200000,2021,280597,98560,379157,COST
06079818303200000,2020,238378,64420,302798,COST
06079818303200000,2019,238378,64420,302798,COST
06079818303240000,2021,196250,138850,335100,MKT
06079818303240000,2020,163883,51630,215513,COST
06079818303240000,2019,163883,51630,215513,COST
06079818303350000,2021,322896,422760,745656,COST
06079818303350000,2020,285815,382840,668655,COST
06079818303350000,2019,285815,385080,670895,COST
06079818303400000,2021,219669,140031,359700,MKT
06079818303400000,2020,184436,85290,269726,COST
06079818303400000,2019,184436,85290,269726,COST
06079818303450000,2021,345595,182420,528015,COST
06079818303450000,2020,308466,104890,413356,OVR
06079818303450000,2019,308466,104890,413356,COST
06079818304010000,2021,226423,234277,460700,MKT
06079818304010000,2020,191888,218212,410100,MKT
06079818304010000,2019,191888,218212,410100,MKT
06079818305010000,2021,406720,147770,554490,COST
06079818305010000,2020,370343,134160,504503,COST
06079818305010000,2019,370343,134160,504503,COST
06079818305030000,2021,199895,104820,304715,COST
06079818305030000,2020,166838,140662,307500,MKT
06079818305030000,2019,166838,140662,307500,MKT
06079818305050000,2021,195965,615035,811000,MKT
06079818305050000,2020,163160,505640,668800,MKT
06079818305050000,2019,163160,479940,643100,MKT
06079818305070000,2021,195965,0,195965,COST
06079818305070000,2020,163160,0,163160,COST
06079818305070000,2019,163160,0,163160,COST
06079818305100000,2021,195965,403235,599200,MKT
06079818305100000,2020,163160,372040,535200,MKT
06079818305100000,2019,163160,372040,535200,MKT
06079818305120000,2021,195965,700135,896100,MKT
06079818305120000,2020,163160,670940,834100,MKT
06079818305120000,2019,163160,670940,834100,MKT
06079818305150000,2021,378853,514000,892853,COST
06079818305150000,2020,341980,471160,813140,COST
06079818305150000,2019,341980,471160,813140,COST
06079818305170000,2021,222042,0,222042,COST
06079818305170000,2020,187725,0,187725,COST
06079818305170000,2019,187725,0,187725,COST
06079818305200000,2021,589,1330,1919,COST
06079818305200000,2020,549,1250,1799,COST
06079818305200000,2019,549,1250,1799,COST
06079818305250000,2021,1412,0,1412,COST
06079818305250000,2020,1315,0,1315,COST
06079818305250000,2019,1315,0,1315,COST
06079818310010000,2021,266002,194598,460600,MKT
06079818310010000,2020,229926,190174,420100,MKT
06079818310010000,2019,190688,200612,391300,MKT
06079818310020000,2021,262973,160527,423500,MKT
06079818310020000,2020,226989,121030,348019,COST
06079818310020000,2019,226989,121030,348019,COST
06079818310030000,2021,263008,168892,431900,MKT
06079818310030000,2020,227024,128530,355554,COST
06079818310030000,2019,227024,128530,355554,COST
06079818401010000,2021,326752,397880,724632,COST
06079818401010000,2020,289649,364320,653969,COST
06079818401010000,2019,289649,364320,653969,COST
06079818401050000,2021,323154,370920,694074,COST
06079818401050000,2020,286072,333150,619222,COST
06079818401050000,2019,286072,333150,619222,COST
06079818401090000,2021,335072,832860,1167932,COST
06079818401090000,2020,297942,752270,1050212,COST
06079818401090000,2019,297942,752270,1050212,COST
06079818401130000,2021,337819,1433330,1771149,COST
06079818401130000,2020,300686,1276560,1577246,COST
06079818401130000,2019,300686,709240,1009926,COST
06079818402010000,2021,6619,380650,387269,COST
06079818402010000,2020,8226,347200,355426,COST
06079818402010000,2019,8226,347200,355426,COST
06079818402200000,2021,6035,0,6035,COST
06079818402200000,2020,7764,0,7764,COST
06079818402200000,2019,7764,0,7764,COST
06079818403010000,2021,282555,0,282555,COST
06079818403010000,2020,45549,0,45549,COST
06079818403010000,2019,45549,0,45549,COST
06079818403040000,2021,258697,0,258697,COST
06079818403070000,2021,246317,0,246317,COST
06079818403100000,2021,235240,0,235240,COST
06079818403130000,2021,218935,0,218935,COST
06079818403160000,2021,222493,0,222493,COST
06079818403190000,2021,261611,0,261611,COST
06079818404010000,2021,240053,0,240053,COST
06079818404040000,2021,232985,0,232985,COST
06079818404070000,2021,222992,0,222992,COST
06079818404100000,2021,231610,0,231610,COST
06079818404130000,2021,218935,0,218935,COST
06079818404160000,2021,210330,0,210330,COST
06079819101010000,2021,1162,0,1162,COST
06079819101010000,2020,1805,0,1805,COST
06079819101010000,2019,1805,0,1805,COST
06079819101301001,2021,75438,0,75438,COST
06079819101301001,2020,101806,0,101806,COST
06079819101301001,2019,101806,0,101806,COST
06079819101301002,2021,59035,0,59035,COST
06079819101301002,2020,67947,0,67947,COST
06079819101301002,2019,67947,0,67947,COST
06079819101401001,2021,4238,0,4238,COST
06079819101401001,2020,4667,0,4667,COST
06079819101401001,2019,4667,0,4667,COST
06079819101401002,2021,6276,0,6276,COST
06079819101401002,2020,5809,0,5809,COST
06079819101401002,2019,5809,0,5809,COST
06079819102010000,2021,344898,0,344898,COST
06079819102050000,2021,302640,0,302640,COST
06079819102100000,2021,316956,0,316956,COST
06079819102150000,2021,230685,0,230685,COST
06079819102200000,2021,222493,0,222493,COST
06079819102250000,2021,220474,0,220474,COST
06079819102300000,2021,217897,0,217897,COST
06079819102350000,2021,221488,0,221488,COST
06079819102401001,2021,220982,0,220982,COST
06079819102401002,2021,250320,0,250320,COST
06079819102456500,2021,142458,0,142458,COST
06079819102466500,2021,64287,0,64287,COST
06079819201010000,2021,27294,0,27294,COST
06079819201010000,2020,36937,0,36937,COST
06079819201010000,2019,36937,0,36937,COST
06079819202101001,2021,1315,0,1315,COST
06079819202101001,2020,1796,0,1796,COST
06079819202101001,2019,1796,0,1796,COST
06079819202101002,2021,34405,217960,252365,COST
06079819202101002,2020,46038,196430,242468,COST
06079819202101002,2019,46038,196430,242468,COST
06079819202200000,2021,416620,347110,763730,COST
06079819202200000,2020,380478,305140,685618,COST
06079819202200000,2019,380478,305140,685618,COST
06079819301101001,2021,5406,0,5406,COST
06079819301101001,2020,6636,0,6636,COST
06079819301101001,2019,6636,0,6636,COST
06079819301101002,2021,26325,0,26325,COST
06079819301101002,2020,35248,0,35248,COST
06079819301101002,2019,35248,0,35248,COST
06079819480010000,2021,100549,792550,893099,COST
06079819480010000,2020,128133,708700,836833,COST
06079819480010000,2019,128133,708700,836833,COST
06079820101010000,2021,319378,310422,629800,MKT
06079820101010000,2020,296969,246731,543700,MKT
06079820101010000,2019,296969,246731,543700,MKT
06079820101020000,2021,2752,335480,338232,COST
06079820101020000,2020,2965,313370,316335,COST
06079820101020000,2019,2965,313370,316335,COST
06079820101020900,2021,283446,260930,544376,COST
06079820101020900,2020,256273,244927,501200,MKT
06079820101020900,2019,256273,244927,501200,MKT
06079820101030000,2021,419213,345940,765153,COST
06079820101030000,2020,415514,323360,738874,COST
06079820101030000,2019,415514,323360,738874,COST
06079820101030900,2021,283446,3380,286826,COST
06079820101030900,2020,256273,3560,259833,COST
06079820101030900,2019,256273,3560,259833,COST
06079820101040000,2021,283446,318954,602400,MKT
06079820101040000,2020,256273,256527,512800,MKT
06079820101040000,2019,256273,256527,512800,MKT
06079820101060000,2021,210731,1061390,1272121,COST
06079820101060000,2020,177031,1027490,1204521,COST
06079820101060000,2019,177031,715380,892411,COST
06079820101070000,2021,12062,169100,181162,COST
06079820101070000,2020,11626,156150,167776,COST
06079820101070000,2019,11626,156150,167776,COST
06079820101080000,2021,14172,414670,428842,COST
06079820101080000,2020,13551,378450,392001,COST
06079820101080000,2019,13551,378450,392001,COST
06079820102010000,2021,224622,243740,468362,COST
06079820102010000,2020,192292,227310,419602,COST
06079820102010000,2019,192292,227310,419602,COST
06079820102020000,2021,225745,241355,467100,MKT
06079820102020000,2020,193479,203321,396800,MKT
06079820102020000,2019,193479,203321,396800,MKT
06079820102030000,2021,264130,365620,629750,COST
06079820102030000,2020,229935,211610,441545,COST
06079820102030000,2019,229935,211610,441545,COST
06079820102040000,2021,305008,321692,626700,MKT
06079820102040000,2020,280557,191843,472400,MKT
06079820102040000,2019,280557,182643,463200,MKT
06079820103010000,2021,270486,252314,522800,MKT
06079820103010000,2020,241882,220118,462000,MKT
06079820103010000,2019,241882,220118,462000,MKT
06079820103020000,2021,270990,239710,510700,MKT
06079820103020000,2020,242439,217261,459700,MKT
06079820103020000,2019,242439,217261,459700,MKT
06079820103030000,2021,384035,227520,611555,COST
06079820103030000,2020,372892,212070,584962,COST
06079820103030000,2019,372892,212070,584962,COST
06079820103040000,2021,339166,203070,542236,COST
06079820103040000,2020,319853,189910,509763,COST
06079820103040000,2019,319853,189910,509763,COST
06079820104010000,2021,235642,228558,464200,MKT
06079820104010000,2020,204007,201993,406000,MKT
06079820104010000,2019,204007,201993,406000,MKT
06079820104020000,2021,235642,445758,681400,MKT
06079820104020000,2020,204007,404420,608427,COST
06079820104020000,2019,204007,404420,608427,COST
06079820105010000,2021,299553,308547,608100,MKT
06079820105010000,2020,274374,261126,535500,MKT
06079820105010000,2019,274374,261126,535500,MKT
06079820105020000,2021,309710,314790,624500,MKT
06079820105020000,2020,285908,320070,605978,COST
06079820105020000,2019,285908,222692,508600,MKT
06079820105040000,2021,262616,256784,519400,MKT
06079820105040000,2020,233221,211279,444500,MKT
06079820105040000,2019,233221,211279,444500,MKT
06079820105050000,2021,263790,263210,527000,MKT
06079820105050000,2020,234509,229191,463700,MKT
06079820105050000,2019,234509,229191,463700,MKT
06079820110010000,2021,246317,309483,555800,MKT
06079820110010000,2020,215480,286520,502000,MKT
06079820110010000,2019,215480,286520,502000,MKT
06079820110050000,2021,246317,256383,502700,MKT
06079820110050000,2020,215480,236720,452200,MKT
06079820110050000,2019,215480,236720,452200,MKT
06079820110100000,2021,246317,258883,505200,MKT
06079820110100000,2020,215480,240920,456400,MKT
06079820110100000,2019,215480,240920,456400,MKT
06079820111010000,2021,246317,259883,506200,MKT
06079820111010000,2020,215480,249920,465400,MKT
06079820111010000,2019,215480,249920,465400,MKT
06079820111030000,2021,246317,0,246317,COST
06079820111030000,2020,215480,0,215480,COST
06079820111030000,2019,215480,0,215480,COST
06079820111050000,2021,246317,282483,528800,MKT
06079820111050000,2020,215480,254620,470100,MKT
06079820111050000,2019,215480,254620,470100,MKT
06079820111070000,2021,246317,403283,649600,MKT
06079820111070000,2020,215480,336720,552200,MKT
06079820111070000,2019,215480,318420,533900,MKT
06079820111090000,2021,246317,359783,606100,MKT
06079820111090000,2020,215480,320020,535500,MKT
06079820111090000,2019,215480,320020,535500,MKT
06079820111110000,2021,290654,477946,768600,MKT
06079820111110000,2020,241337,419963,661300,MKT
06079820111110000,2019,241337,419963,661300,MKT
06079820111136500,2021,94841,0,94841,COST
06079820111136500,2020,87884,0,87884,COST
06079820111136500,2019,87884,0,87884,COST
06079820112010000,2021,246317,0,246317,COST
06079820112010000,2020,215480,0,215480,COST
06079820112010000,2019,215480,0,215480,COST
06079820112030000,2021,251885,0,251885,COST
06079820112030000,2020,221511,0,221511,COST
06079820112030000,2019,221511,0,221511,COST
06079820112050000,2021,251885,517515,769400,MKT
06079820112050000,2020,221511,484189,705700,MKT
06079820112050000,2019,221511,473089,694600,MKT
06079820112070000,2021,250320,0,250320,COST
06079820112070000,2020,219812,0,219812,COST
06079820112070000,2019,219812,0,219812,COST
06079820113010000,2021,250320,386680,637000,MKT
06079820113010000,2020,219812,335288,555100,MKT
06079820113010000,2019,219812,335288,555100,MKT
06079820113030000,2021,250320,533280,783600,MKT
06079820113030000,2020,219812,455288,675100,MKT
06079820113030000,2019,219812,455288,675100,MKT
06079820113050000,2021,246317,410883,657200,MKT
06079820113050000,2020,215480,414620,630100,MKT
06079820113050000,2019,215480,411220,626700,MKT
06079820113070000,2021,254197,887130,1141327,COST
06079820113070000,2020,224024,820940,1044964,COST
06079820113070000,2019,224024,820940,1044964,COST
06079820113090000,2021,246317,528683,775000,MKT
06079820113090000,2020,215480,446320,661800,MKT
06079820113090000,2019,215480,446320,661800,MKT
06079820113110000,2021,246317,0,246317,COST
06079820113110000,2020,215480,0,215480,COST
06079820113110000,2019,215480,0,215480,COST
06079820113150000,2021,256542,394458,651000,MKT
06079820113150000,2020,226579,359521,586100,MKT
06079820113150000,2019,226579,359521,586100,MKT
06079820113170000,2021,256054,452346,708400,MKT
06079820113170000,2020,226046,444854,670900,MKT
06079820113170000,2019,226046,444854,670900,MKT
06079820114010000,2021,246317,434583,680900,MKT
06079820114010000,2020,215480,425320,640800,OVR
06079820114010000,2019,215480,425320,640800,MKT
06079820114030000,2021,246317,390783,637100,MKT
06079820114030000,2020,215480,302820,518300,OVR
06079820114030000,2019,215480,298720,514200,MKT
06079820114050000,2021,246317,270283,516600,MKT
06079820114050000,2020,215480,213420,428900,MKT
06079820114050000,2019,215480,213420,428900,MKT
06079820114070000,2021,246317,442483,688800,MKT
06079820114070000,2020,215480,393520,609000,MKT
06079820114070000,2019,215480,393520,609000,MKT
06079820114090000,2021,246317,278183,524500,MKT
06079820114090000,2020,215480,251020,466500,MKT
06079820114090000,2019,215480,251020,466500,MKT
06079820114110000,2021,246317,383983,630300,MKT
06079820114110000,2020,215480,338120,553600,MKT
06079820114110000,2019,215480,338120,553600,MKT
06079820114130000,2021,246723,413677,660400,MKT
06079820114130000,2020,215919,352381,568300,MKT
06079820114130000,2019,215919,352381,568300,MKT
06079820114150000,2021,246317,279583,525900,MKT
06079820114150000,2020,215480,259320,474800,MKT
06079820114150000,2019,215480,259320,474800,MKT
06079820114170000,2021,246317,652470,898787,COST
06079820114170000,2020,215480,526970,742450,COST
06079820114170000,2019,215480,526970,742450,COST
06079820114190000,2021,246317,388390,634707,COST
06079820114190000,2020,215480,341020,556500,MKT
06079820114190000,2019,215480,341020,556500,MKT
06079820114210000,2021,246317,354483,600800,MKT
06079820114210000,2020,215480,241120,456600,MKT
06079820114210000,2019,215480,241120,456600,MKT
06079820114230000,2021,247128,411472,658600,MKT
06079820114230000,2020,216356,394744,611100,MKT
06079820114230000,2019,216356,394744,611100,MKT
06079820120010000,2021,354108,384500,738608,COST
06079820120010000,2020,337343,358180,695523,COST
06079820120010000,2019,337343,358180,695523,COST
06079820120090000,2021,480509,908190,1388699,COST
06079820120090000,2020,491782,835660,1327442,COST
06079820120090000,2019,491782,835660,1327442,COST
06079820120100000,2021,515071,414350,929421,COST
06079820120100000,2020,600124,375470,975594,COST
06079820120100000,2019,600124,375470,975594,COST
06079820120110000,2021,419213,269610,688823,COST
06079820120110000,2020,465376,256030,721406,COST
06079820120110000,2019,465376,256030,721406,COST
06079820120130000,2021,9492,201380,210872,COST
06079820120130000,2020,12368,187880,200248,COST
06079820120130000,2019,12368,187880,200248,COST
06079820201010000,2021,12627,0,12627,COST
06079820201010000,2020,12127,0,12127,COST
06079820201010000,2019,12127,0,12127,COST
06079820201020000,2021,197069,352450,549519,COST
06079820201020000,2020,163488,328040,491528,COST
06079820201020000,2019,163488,328040,491528,COST
06079820201150000,2021,195900,334100,530000,MKT
06079820201150000,2020,162400,292400,454800,MKT
06079820201150000,2019,162400,292400,454800,MKT
06079820201500000,2021,1501,0,1501,COST
06079820201500000,2020,1396,0,1396,COST
06079820201500000,2019,1396,0,1396,COST
06079820201606500,2021,573,0,573,COST
06079820201606500,2020,533,0,533,COST
06079820201606500,2019,533,0,533,COST
06079820201630000,2021,210,0,210,COST
06079820201630000,2020,196,0,196,COST
06079820201630000,2019,196,0,196,COST
06079820201650000,2021,196545,1239250,1435795,COST
06079820201650000,2020,163061,1050670,1213731,COST
06079820201650000,2019,163061,1035670,1198731,COST
06079820201700000,2021,2260,0,2260,COST
06079820201700000,2020,2103,0,2103,COST
06079820201700000,2019,2103,0,2103,COST
06079820203010000,2021,254,0,254,COST
06079820203010000,2020,236,0,236,COST
06079820203010000,2019,236,0,236,COST
06079820203030000,2021,248,0,248,COST
06079820203030000,2020,231,0,231,COST
06079820203030000,2019,231,0,231,COST
06079820203050000,2021,339,0,339,COST
06079820203050000,2020,316,0,316,COST
06079820203050000,2019,316,0,316,COST
06079820301170000,2021,195900,181700,377600,MKT
06079820301170000,2020,162400,135940,298340,COST
06079820301170000,2019,162400,135940,298340,COST
06079820401010000,2021,19313,0,19313,COST
06079820401010000,2020,22882,0,22882,COST
06079820401010000,2019,22882,0,22882,COST
06079820412010000,2021,299662,252238,551900,MKT
06079820412010000,2020,274498,197302,471800,MKT
06079820412010000,2019,274498,197302,471800,MKT
06079820412030000,2021,1866,240340,242206,COST
06079820412030000,2020,2144,229680,231824,COST
06079820412030000,2019,2144,229680,231824,COST
06079820412050000,2021,4946,0,4946,COST
06079820412050000,2020,6385,0,6385,COST
06079820412050000,2019,6385,0,6385,COST
06079820412070000,2021,299662,0,299662,COST
06079820412070000,2020,274498,0,274498,COST
06079820412070000,2019,274498,0,274498,COST
06079821101010000,2021,404871,504270,909141,COST
06079821101010000,2020,398031,469640,867671,COST
06079821101010000,2019,398031,412030,810061,COST
06079821101020000,2021,195900,140490,336390,COST
06079821101020000,2020,162400,131380,293780,COST
06079821101020000,2019,162400,131380,293780,COST
06079821101050000,2021,196967,230450,427417,COST
06079821101050000,2020,163393,222390,385783,COST
06079821101050000,2019,163393,222390,385783,COST
06079821101450000,2021,421211,0,421211,COST
06079821101450000,2020,417962,0,417962,COST
06079821101450000,2019,417962,0,417962,COST
06079821101550000,2021,420978,333570,754548,COST
06079821101550000,2020,417676,248460,666136,COST
06079821101550000,2019,417676,248460,666136,COST
06079821102030000,2021,421280,234800,656080,COST
06079821102030000,2020,418046,225160,643206,COST
06079821102030000,2019,418046,225160,643206,COST
06079821102060000,2021,7544,264600,272144,COST
06079821102060000,2020,7415,245500,252915,COST
06079821102060000,2019,7415,245500,252915,COST
06079821102070000,2021,2107,372060,374167,COST
06079821102070000,2020,2368,338790,341158,COST
06079821102070000,2019,2368,338790,341158,COST
06079821102100000,2021,4101,528650,532751,COST
06079821102100000,2020,4219,426800,431019,COST
06079821102100000,2019,162871,420330,583201,COST
06079821102140000,2021,421239,0,421239,COST
06079821102140000,2020,417996,0,417996,COST
06079821102140000,2019,523,0,523,COST
06079821102200000,2021,17625,262590,280215,COST
06079821102200000,2020,17724,251990,269714,COST
06079821102200000,2019,17724,251990,269714,COST
06079821102250000,2021,3550,0,3550,COST
06079821102250000,2020,3272,0,3272,COST
06079821102250000,2019,3272,0,3272,COST
06079821102300000,2021,458448,720280,1178728,COST
06079821102300000,2020,464053,657370,1121423,COST
06079821102300000,2019,464053,0,464053,COST
06079821201040000,2021,421143,473600,894743,COST
06079821201040000,2020,417878,444060,861938,COST
06079821201040000,2019,417878,444060,861938,COST
06079821201050000,2021,421965,0,421965,COST
06079821201050000,2020,418885,0,418885,COST
06079821201050000,2019,418885,0,418885,COST
06079821201060000,2021,422783,303660,726443,COST
06079821201060000,2020,419889,284250,704139,COST
06079821201060000,2019,419889,284250,704139,COST
06079821201070000,2021,407968,473940,881908,COST
06079821201070000,2020,401794,432830,834624,COST
06079821201070000,2019,401794,432830,834624,COST
06079821201080000,2021,423191,268760,691951,COST
06079821201080000,2020,420389,234900,655289,COST
06079821201080000,2019,420389,234900,655289,COST
06079821201090000,2021,566,0,566,COST
06079821201090000,2020,526,0,526,COST
06079821201090000,2019,526,0,526,COST
06079821201100000,2021,421417,264700,686117,COST
06079821201100000,2020,418214,251660,669874,COST
06079821201100000,2019,418214,251660,669874,COST
06079821201110000,2021,442847,197640,640487,COST
06079821201110000,2020,417205,107400,524605,COST
06079821201110000,2019,417205,107400,524605,COST
06079821201120000,2021,420042,268430,688472,COST
06079821201120000,2020,416530,256750,673280,COST
06079821201120000,2019,416530,256750,673280,COST
06079821201130000,2021,420868,407880,828748,COST
06079821201130000,2020,417542,390110,807652,COST
06079821201130000,2019,417542,390110,807652,COST
06079821201140000,2021,196408,324750,521158,COST
06079821201140000,2020,162873,316260,479133,COST
06079821201140000,2019,162873,316260,479133,COST
06079821201150000,2021,422647,830200,1252847,COST
06079821201150000,2020,419722,776410,1196132,COST
06079821201150000,2019,419722,776410,1196132,COST
06079821201160000,2021,422101,245390,667491,COST
06079821201160000,2020,419053,238270,657323,COST
06079821201160000,2019,419053,238270,657323,COST
06079821201170000,2021,421143,221840,642983,COST
06079821201170000,2020,417878,204640,622518,COST
06079821201170000,2019,417878,204640,622518,COST
06079821201180000,2021,420318,230930,651248,COST
06079821201180000,2020,416867,213490,630357,COST
06079821201180000,2019,416867,213490,630357,COST
06079821201190000,2021,419490,535670,955160,COST
06079821201190000,2020,415853,495180,911033,COST
06079821201190000,2019,415853,495180,911033,COST
06079821201200000,2021,61043,0,61043,COST
06079821201200000,2020,51005,0,51005,COST
06079821201200000,2019,51005,0,51005,COST
06079821301200000,2021,422647,158990,581637,COST
06079821301200000,2020,419722,147240,566962,COST
06079821301200000,2019,419722,147240,566962,COST
06079821301210000,2021,422647,241300,663947,COST
06079821301210000,2020,419722,223170,642892,COST
06079821301210000,2019,419722,223170,642892,COST
06079821301220000,2021,422647,1024610,1447257,COST
06079821301220000,2020,419722,936960,1356682,COST
06079821301220000,2019,419722,937690,1357412,COST
06079821301230000,2021,422511,444630,867141,COST
06079821301230000,2020,419555,417220,836775,COST
06079821301230000,2019,419555,417220,836775,COST
06079821301240000,2021,423191,649890,1073081,COST
06079821301240000,2020,420389,611650,1032039,COST
06079821301240000,2019,420389,611650,1032039,COST
06079821301250000,2021,423191,0,423191,COST
06079821301250000,2020,420389,0,420389,COST
06079821301250000,2019,420389,0,420389,COST
06079821301260000,2021,423191,263560,686751,COST
06079821301260000,2020,420389,251180,671569,COST
06079821301260000,2019,420389,251180,671569,COST
06079821301270000,2021,423327,223100,646427,COST
06079821301270000,2020,420556,207380,627936,COST
06079821301270000,2019,420556,207380,627936,COST
06079821301280000,2021,423734,399060,822794,COST
06079821301280000,2020,421055,373960,795015,COST
06079821301280000,2019,421055,363680,784735,COST
06079821301290000,2021,423734,187300,611034,COST
06079821301290000,2020,421055,174160,595215,COST
06079821301290000,2019,421055,174160,595215,COST
06079821301300000,2021,423734,294700,718434,COST
06079821301300000,2020,421055,268630,689685,COST
06079821301300000,2019,421055,268630,689685,COST
06079821301310000,2021,423734,546280,970014,COST
06079821301310000,2020,421055,499500,920555,COST
06079821301310000,2019,421055,499500,920555,COST
06079821301320000,2021,424275,317070,741345,COST
06079821301320000,2020,421720,294120,715840,COST
06079821301320000,2019,421720,294120,715840,COST
06079821301330000,2021,424275,1170350,1594625,COST
06079821301330000,2020,421720,1086320,1508040,COST
06079821301330000,2019,421720,1086320,1508040,COST
06079821301340000,2021,424275,737910,1162185,COST
06079821301340000,2020,421720,676260,1097980,COST
06079821301340000,2019,421720,463640,885360,COST
06079821301350000,2021,7356,205310,212666,COST
06079821301350000,2020,7238,190230,197468,COST
06079821301350000,2019,7238,190230,197468,COST
06079821401010000,2021,197070,163470,360540,COST
06079821401010000,2020,163489,152830,316319,COST
06079821401010000,2019,163489,152830,316319,COST
06079821401050000,2021,1107,3410,4517,COST
06079821401050000,2020,1030,3650,4680,COST
06079821401050000,2019,1030,3650,4680,COST
06079821401100000,2021,419213,338660,757873,COST
06079821401100000,2020,415514,332800,748314,COST
06079821401100000,2019,3753,325490,329243,COST
06079821401120000,2021,423096,656580,1079676,COST
06079821401120000,2020,420272,621080,1041352,COST
06079821401120000,2019,420272,621080,1041352,COST
06079821401150000,2021,1107,13850,14957,COST
06079821401150000,2020,1031,14330,15361,COST
06079821401150000,2019,1031,14330,15361,COST
06079821401180000,2021,429812,575288,1005100,MKT
06079821401180000,2020,428525,464230,892755,COST
06079821401180000,2019,428525,464230,892755,COST
06079821401200000,2021,433506,433580,867086,COST
06079821401200000,2020,433078,399090,832168,COST
06079821401200000,2019,433078,399090,832168,COST
06079821401250000,2021,196952,1431100,1628052,COST
06079821401250000,2020,163379,1315490,1478869,COST
06079821401250000,2019,163379,1315490,1478869,COST
06079821401300000,2021,1107,15250,16357,COST
06079821401300000,2020,1030,15770,16800,COST
06079821401300000,2019,1030,15770,16800,COST
06079821401350000,2021,1107,0,1107,COST
06079821401350000,2020,1030,0,1030,COST
06079821401350000,2019,1030,0,1030,COST
06079822101010000,2021,10375,205460,215835,COST
06079822101010000,2020,10060,199290,209350,COST
06079822101010000,2019,10060,199290,209350,COST
06079822101020000,2021,4797,339680,344477,COST
06079822101020000,2020,4867,328800,333667,COST
06079822101020000,2019,4867,328800,333667,COST
06079822101060000,2021,4703,125560,130263,COST
06079822101060000,2020,4783,123760,128543,COST
06079822101060000,2019,4783,123760,128543,COST
06079822101080000,2021,219500,190600,410100,MKT
06079822101080000,2020,162400,198500,360900,MKT
06079822101080000,2019,162400,198500,360900,MKT
06079822101120000,2021,30424,0,30424,COST
06079822101120000,2020,28235,0,28235,COST
06079822101120000,2019,28235,0,28235,COST
06079822201010000,2021,2248,197830,200078,COST
06079822201010000,2020,2092,201640,203732,COST
06079822201010000,2019,2092,201640,203732,COST
06079822201050000,2021,1124,0,1124,COST
06079822201050000,2020,1046,0,1046,COST
06079822201050000,2019,1046,0,1046,COST
06079822201080000,2021,220569,245500,466069,COST
06079822201080000,2020,163395,238040,401435,COST
06079822201080000,2019,163395,238040,401435,COST
06079822201100000,2021,3092,0,3092,COST
06079822201100000,2020,2878,0,2878,COST
06079822201100000,2019,2878,0,2878,COST
06079822201150000,2021,251564,0,251564,COST
06079822201150000,2020,190043,0,190043,COST
06079822201150000,2019,190043,0,190043,COST
06079822201300000,2021,1144,0,1144,COST
06079822201300000,2020,1065,0,1065,COST
06079822201300000,2019,1065,0,1065,COST
06079822201350000,2021,18,0,18,COST
06079822201350000,2020,17,0,17,COST
06079822201350000,2019,17,0,17,COST
06079822301010000,2021,1103,0,1103,COST
06079822301010000,2020,1027,0,1027,COST
06079822301010000,2019,1027,0,1027,COST
06079822301020000,2021,1105,0,1105,COST
06079822301020000,2020,1029,0,1029,COST
06079822301020000,2019,1029,0,1029,COST
06079822301030000,2021,1107,0,1107,COST
06079822301030000,2020,1030,0,1030,COST
06079822301030000,2019,1030,0,1030,COST
06079822301040000,2021,1107,0,1107,COST
06079822301040000,2020,1030,0,1030,COST
06079822301040000,2019,1030,0,1030,COST
06079822301050000,2021,253369,237831,491200,MKT
06079822301050000,2020,191616,205680,397296,COST
06079822301050000,2019,191616,205680,397296,COST
06079822301060000,2021,1107,0,1107,COST
06079822301060000,2020,1031,0,1031,COST
06079822301060000,2019,1031,0,1031,COST
06079822301070000,2021,1108,0,1108,COST
06079822301070000,2020,1031,0,1031,COST
06079822301070000,2019,1031,0,1031,COST
06079822301080000,2021,1111,0,1111,COST
06079822301080000,2020,1034,0,1034,COST
06079822301080000,2019,1034,0,1034,COST
06079822401010000,2021,12072,0,12072,COST
06079822401010000,2020,11237,0,11237,COST
06079822401010000,2019,11237,0,11237,COST
06079822448010000,2021,11419,282750,294169,COST
06079822448010000,2020,11440,264150,275590,COST
06079822448010000,2019,11440,264150,275590,COST
06079823101010000,2021,1107,0,1107,COST
06079823101010000,2020,1030,0,1030,COST
06079823101010000,2019,6795,0,6795,COST
06079823101010900,2021,1221087,13446710,14667797,COST
06079823101010900,2020,516076,10218310,10734386,COST
06079823101010900,2019,516076,10218310,10734386,COST
06079823101020000,2021,673,17150,17823,COST
06079823101020000,2020,626,17420,18046,COST
06079823101020000,2019,626,17420,18046,COST
06079823101040000,2021,440207,526520,966727,COST
06079823101040000,2020,325923,511700,837623,COST
06079823101040000,2019,325923,511700,837623,COST
06079823101050000,2021,56,0,56,COST
06079823101050000,2020,52,0,52,COST
06079823101050000,2019,52,0,52,COST
06079823101060000,2021,5523,0,5523,COST
06079823101060000,2020,4972,0,4972,COST
06079823101060000,2019,4972,0,4972,COST
06079823101070000,2021,1107,0,1107,COST
06079823101070000,2020,1030,0,1030,COST
06079823101070000,2019,1030,0,1030,COST
06079823101100000,2021,1439,0,1439,COST
06079823101100000,2020,1339,0,1339,COST
06079823101100000,2019,1339,0,1339,COST
06079823101150000,2021,1402,0,1402,COST
06079823101150000,2020,1305,0,1305,COST
06079823101150000,2019,1305,0,1305,COST
06079823101160000,2020,319584,368916,688500,MKT
06079823101160000,2019,319584,358016,677600,MKT
06079823160010000,2021,286820,4162280,4449100,INCOME
06079823160010000,2020,374181,4077119,4451300,INCOME
06079823160010000,2019,374181,4077119,4451300,INCOME
06079823160050000,2021,183360,1808140,1991500,INCOME
06079823160050000,2020,237481,1757819,1995300,INCOME
06079823160050000,2019,237481,1757819,1995300,INCOME
06079823160070000,2021,180479,949821,1130300,INCOME
06079823160070000,2020,233690,663410,897100,INCOME
06079823160070000,2019,233690,663410,897100,INCOME
06079823164010000,2021,523977,2454823,2978800,INCOME
06079823164010000,2020,375618,2130782,2506400,INCOME
06079823164010000,2019,375618,2130782,2506400,INCOME
06079823164050000,2021,179027,37900,216927,COST
06079823164050000,2020,231783,40740,272523,COST
06079823164050000,2019,231783,40740,272523,COST
06079823164077000,2021,200097,15170,215267,COST
06079823164077000,2020,259528,14800,274328,COST
06079823164077000,2019,259528,14800,274328,COST
06079823166030000,2021,420657,4061543,4482200,INCOME
06079823166030000,2020,552195,3902205,4454400,INCOME
06079823166030000,2019,552195,3902205,4454400,INCOME
06079823166070000,2021,209470,2198830,2408300,INCOME
06079823166070000,2020,271885,1936115,2208000,INCOME
06079823166070000,2019,271885,1936115,2208000,INCOME
06079823166090000,2021,344218,6006682,6350900,INCOME
06079823166090000,2020,450388,5990912,6441300,INCOME
06079823166090000,2019,450388,5990912,6441300,INCOME
06079823166170000,2021,320402,6080498,6400900,INCOME
06079823166170000,2020,418741,5529359,5948100,INCOME
06079823166170000,2019,418741,5529359,5948100,INCOME
06079823166190000,2021,312217,1241183,1553400,INCOME
06079823166190000,2020,407873,1010027,1417900,INCOME
06079823166190000,2019,407873,1010027,1417900,INCOME
06079823166256500,2021,82372,0,82372,COST
06079823166256500,2020,107438,0,107438,COST
06079823166256500,2019,107438,0,107438,COST
06079823168010000,2021,43962,4700,48662,COST
06079823168010000,2020,56760,4010,60770,COST
06079823168010000,2019,56760,4010,60770,COST
06079823168030000,2021,198736,1592864,1791600,INCOME
06079823168030000,2020,257732,1397368,1655100,INCOME
06079823168030000,2019,257732,1397368,1655100,INCOME
06079823168050000,2021,194617,0,194617,COST
06079823168050000,2020,252305,0,252305,COST
06079823168050000,2019,252305,0,252305,COST
06079823168070000,2021,191842,1759870,1951712,COST
06079823168070000,2020,248649,1686951,1935600,INCOME
06079823168070000,2019,248649,1686951,1935600,INCOME
06079823168090000,2021,335410,2442850,2778260,COST
06079823168090000,2020,438680,2232730,2671410,COST
06079823168090000,2019,438680,2232730,2671410,COST
06079823168130000,2021,226223,1146200,1372423,COST
06079823168130000,2020,282574,1113080,1395654,COST
06079823168130000,2019,282574,1113080,1395654,COST
06079823168170000,2021,275819,1728981,2004800,INCOME
06079823168170000,2020,359602,1478498,1838100,INCOME
06079823168170000,2019,359602,1478498,1838100,INCOME
06079823168190000,2021,251779,1450921,1702700,INCOME
06079823168190000,2020,327774,1239126,1566900,INCOME
06079823168190000,2019,327774,1239126,1566900,INCOME
06079823201050000,2021,499,0,499,COST
06079823201050000,2020,461,0,461,COST
06079823201050000,2019,461,0,461,COST
06079823201150000,2021,27233,0,27233,COST
06079823201150000,2020,34389,0,34389,COST
06079823201150000,2019,34389,0,34389,COST
06079823201200000,2021,14,0,14,COST
06079823201200000,2020,16,0,16,COST
06079823201200000,2019,16,0,16,COST
06079823201300000,2021,273670,71170,344840,COST
06079823201300000,2020,198602,71810,270412,COST
06079823201300000,2019,198602,71810,270412,COST
06079823201400000,2021,220580,410330,630910,COST
06079823201400000,2020,163405,392860,556265,COST
06079823201400000,2019,163405,393100,556505,COST
06079823201550000,2021,220582,174950,395532,COST
06079823201550000,2020,163407,169890,333297,COST
06079823201550000,2019,163407,175540,338947,COST
06079823202016500,2021,323743,0,323743,COST
06079823202016500,2020,228771,0,228771,COST
06079823202016500,2019,228771,0,228771,COST
06079823202016501,2021,273023,0,273023,COST
06079823202016501,2020,193395,0,193395,COST
06079823202016501,2019,193395,0,193395,COST
06079823202030000,2021,411836,0,411836,COST
06079823202030000,2020,295012,0,295012,COST
06079823202030000,2019,295012,0,295012,COST
06079823202057000,2021,630248,69700,699948,COST
06079823202057000,2020,455918,74570,530488,COST
06079823202057000,2019,455918,74570,530488,COST
06079823202087000,2021,432139,0,432139,COST
06079823202087000,2020,309345,0,309345,COST
06079823202087000,2019,309345,0,309345,COST
06079823202107000,2021,406529,85490,492019,COST
06079823202107000,2020,291264,98460,389724,COST
06079823202107000,2019,291264,98460,389724,COST
06079823202127000,2021,561955,0,561955,COST
06079823202127000,2020,400782,0,400782,COST
06079823202127000,2019,400782,0,400782,COST
06079823203020000,2021,155556,462944,618500,MKT
06079823203020000,2020,117079,402821,519900,MKT
06079823203020000,2019,117079,402821,519900,MKT
06079823203040000,2021,155556,446544,602100,MKT
06079823203040000,2020,117079,390321,507400,MKT
06079823203040000,2019,117079,390321,507400,MKT
06079823203060000,2021,152230,512570,664800,MKT
06079823203060000,2020,114610,468490,583100,MKT
06079823203060000,2019,114610,468490,583100,MKT
06079823203080000,2021,142380,455420,597800,MKT
06079823203080000,2020,107296,426504,533800,MKT
06079823203080000,2019,107296,426504,533800,MKT
06079823203100000,2021,178093,506207,684300,MKT
06079823203100000,2020,133784,485716,619500,MKT
06079823203100000,2019,133784,485716,619500,MKT
06079823203120000,2021,196437,415563,612000,MKT
06079823203120000,2020,147360,413940,561300,MKT
06079823203120000,2019,147360,413940,561300,MKT
06079823203140000,2021,203431,556569,760000,MKT
06079823203140000,2020,152531,428769,581300,MKT
06079823203140000,2019,152531,428769,581300,MKT
06079823203160000,2021,118158,395742,513900,MKT
06079823203160000,2020,86149,350151,436300,MKT
06079823203160000,2019,86149,350151,436300,MKT
06079823203180000,2021,114235,503165,617400,MKT
06079823203180000,2020,83328,426172,509500,MKT
06079823203180000,2019,83328,426172,509500,MKT
06079823203200000,2021,130749,434351,565100,MKT
06079823203200000,2020,98650,398850,497500,MKT
06079823203200000,2019,98650,398850,497500,MKT
06079823203220000,2021,137424,437476,574900,MKT
06079823203220000,2020,103613,370787,474400,MKT
06079823203220000,2019,103613,370787,474400,MKT
06079823203240000,2021,139852,321848,461700,MKT
06079823203240000,2020,105417,307683,413100,MKT
06079823203240000,2019,105417,307683,413100,MKT
06079823203260000,2021,139817,427483,567300,MKT
06079823203260000,2020,105391,388009,493400,MKT
06079823203260000,2019,105391,388009,493400,MKT
06079823203280000,2021,142948,426252,569200,MKT
06079823203280000,2020,107718,388782,496500,MKT
06079823203280000,2019,107718,388782,496500,MKT
06079823203300000,2021,140826,430874,571700,MKT
06079823203300000,2020,106141,391859,498000,MKT
06079823203300000,2019,106141,391859,498000,MKT
06079823203320000,2021,139886,358614,498500,MKT
06079823203320000,2020,105443,333757,439200,MKT
06079823203320000,2019,105443,333757,439200,MKT
06079823203340000,2021,153821,345179,499000,MKT
06079823203340000,2020,115791,338509,454300,MKT
06079823203340000,2019,115791,338509,454300,MKT
06079823203400000,2021,127544,489356,616900,MKT
06079823203400000,2020,92891,426409,519300,MKT
06079823203400000,2019,92891,426409,519300,MKT
06079823203420000,2021,118775,356725,475500,MKT
06079823203420000,2020,86592,335308,421900,MKT
06079823203420000,2019,86592,335308,421900,MKT
06079823203440000,2021,116513,353687,470200,MKT
06079823203440000,2020,84966,342834,427800,MKT
06079823203440000,2019,84966,342834,427800,MKT
06079823203460000,2021,154056,728240,882296,COST
06079823203460000,2020,111901,802520,914421,COST
06079823203460000,2019,111901,0,111901,COST
06079823203480000,2021,116774,376526,493300,MKT
06079823203480000,2020,85154,370246,455400,MKT
06079823203480000,2019,85154,370246,455400,MKT
06079823203500000,2021,118775,329225,448000,MKT
06079823203500000,2020,86592,310108,396700,MKT
06079823203500000,2019,86592,310108,396700,MKT
06079823203520000,2021,127238,287262,414500,MKT
06079823203520000,2020,92672,265228,357900,MKT
06079823203520000,2019,92672,265228,357900,MKT
06079823203540000,2021,130037,494763,624800,MKT
06079823203540000,2020,94681,441319,536000,MKT
06079823203540000,2019,94681,441319,536000,MKT
06079823203560000,2021,130124,421876,552000,MKT
06079823203560000,2020,94743,407957,502700,MKT
06079823203560000,2019,94743,407957,502700,MKT
06079823203580000,2021,130998,357802,488800,MKT
06079823203580000,2020,95371,350229,445600,MKT
06079823203580000,2019,95371,350229,445600,MKT
06079823203606500,2021,21009,0,21009,COST
06079823203606500,2020,15431,0,15431,COST
06079823203606500,2019,15431,0,15431,COST
06079823204010000,2021,197765,387035,584800,MKT
06079823204010000,2020,148342,415758,564100,MKT
06079823204010000,2019,148342,415758,564100,MKT
06079823204030000,2021,189481,424619,614100,MKT
06079823204030000,2020,142214,440386,582600,MKT
06079823204030000,2019,142214,440386,582600,MKT
06079823204050000,2021,175427,502073,677500,MKT
06079823204050000,2020,131810,429490,561300,MKT
06079823204050000,2019,131810,410890,542700,MKT
06079823204070000,2021,167689,545011,712700,MKT
06079823204070000,2020,126076,491324,617400,MKT
06079823204070000,2019,126076,491324,617400,MKT
06079823204090000,2021,166115,461685,627800,MKT
06079823204090000,2020,124910,438690,563600,MKT
06079823204090000,2019,124910,438690,563600,MKT
06079823204110000,2021,174146,487954,662100,MKT
06079823204110000,2020,130861,415839,546700,MKT
06079823204110000,2019,130861,423639,554500,MKT
06079823204130000,2021,202875,670125,873000,MKT
06079823204130000,2020,152120,514001,666121,OVR
06079823204130000,2019,152120,514001,666121,OVR
06079823205020000,2021,148487,481813,630300,MKT
06079823205020000,2020,107912,433988,541900,MKT
06079823205020000,2019,107912,433988,541900,MKT
06079823205040000,2021,140248,517952,658200,MKT
06079823205040000,2020,102007,474293,576300,MKT
06079823205040000,2019,102007,474293,576300,MKT
06079823205060000,2021,144340,461160,605500,MKT
06079823205060000,2020,104940,434460,539400,MKT
06079823205060000,2019,104940,434460,539400,MKT
06079823205080000,2021,153766,536534,690300,MKT
06079823205080000,2020,111693,496207,607900,MKT
06079823205080000,2019,111693,496207,607900,MKT
06079823205100000,2021,151352,605148,756500,MKT
06079823205100000,2020,109965,593235,703200,MKT
06079823205100000,2019,109965,593235,703200,MKT
06079823205120000,2021,133424,554820,688244,COST
06079823205120000,2020,97112,536390,633502,COST
06079823205120000,2019,97112,536390,633502,COST
06079823205140000,2021,127279,397321,524600,MKT
06079823205140000,2020,92701,384099,476800,MKT
06079823205140000,2019,92701,384099,476800,MKT
06079823205160000,2021,137648,0,137648,COST
06079823205160000,2020,100142,0,100142,COST
06079823205160000,2019,100142,0,100142,COST
06079823205180000,2021,122624,455276,577900,MKT
06079823205180000,2020,89357,0,89357,COST
06079823205180000,2019,89357,0,89357,COST
06079823205200000,2021,151471,539829,691300,MKT
06079823205200000,2020,110050,491650,601700,MKT
06079823205200000,2019,110050,491650,601700,MKT
06079823206020000,2021,140576,438224,578800,MKT
06079823206020000,2020,105956,0,105956,COST
06079823206020000,2019,105956,0,105956,COST
06079823206040000,2021,135094,425306,560400,MKT
06079823206040000,2020,101881,384119,486000,MKT
06079823206040000,2019,101881,384119,486000,MKT
06079823206060000,2021,146669,516731,663400,MKT
06079823206060000,2020,110482,464518,575000,MKT
06079823206060000,2019,110482,464518,575000,MKT
06079823207020000,2021,170665,380135,550800,MKT
06079823207020000,2020,128282,364918,493200,MKT
06079823207020000,2019,128282,364918,493200,MKT
06079823207040000,2021,158658,397342,556000,MKT
06079823207040000,2020,119380,372920,492300,MKT
06079823207040000,2019,119380,372920,492300,MKT
06079823207060000,2021,165768,389632,555400,MKT
06079823207060000,2020,124652,389848,514500,MKT
06079823207060000,2019,124652,389848,514500,MKT
06079823207080000,2021,164248,503952,668200,MKT
06079823207080000,2020,123525,465875,589400,MKT
06079823207080000,2019,123525,465875,589400,MKT
06079823207100000,2021,152894,536306,689200,MKT
06079823207100000,2020,115103,494197,609300,MKT
06079823207100000,2019,115103,506397,621500,MKT
06079823207120000,2021,158302,452598,610900,MKT
06079823207120000,2020,119115,418985,538100,MKT
06079823207120000,2019,119115,455885,575000,MKT
06079823207140000,2021,154235,403365,557600,MKT
06079823207140000,2020,116098,376702,492800,MKT
06079823207140000,2019,116098,376702,492800,MKT
06079823207160000,2021,155649,435751,591400,MKT
06079823207160000,2020,117148,405052,522200,MKT
06079823207160000,2019,117148,405052,522200,MKT
06079823207180000,2021,167725,393275,561000,MKT
06079823207180000,2020,126103,408597,534700,MKT
06079823207180000,2019,126103,408597,534700,MKT
06079823207200000,2021,176514,493086,669600,MKT
06079823207200000,2020,132615,466685,599300,MKT
06079823207200000,2019,132615,466685,599300,MKT
06079823207220000,2021,175890,437010,612900,MKT
06079823207220000,2020,132153,434947,567100,MKT
06079823207220000,2019,132153,434947,567100,MKT
06079823207240000,2021,183811,461689,645500,MKT
06079823207240000,2020,138018,442082,580100,MKT
06079823207240000,2019,138018,442082,580100,MKT
06079823207260000,2021,233587,0,233587,COST
06079823207260000,2020,174800,0,174800,COST
06079823207260000,2019,174800,0,174800,COST
06079823207280000,2021,131295,415905,547200,MKT
06079823207280000,2020,95584,374016,469600,MKT
06079823207280000,2019,95584,374016,469600,MKT
06079823207300000,2021,147129,392471,539600,MKT
06079823207300000,2020,110823,371677,482500,MKT
06079823207300000,2019,110823,371677,482500,MKT
06079823207320000,2021,172543,480157,652700,MKT
06079823207320000,2020,129674,391926,521600,MKT
06079823207320000,2019,129674,419926,549600,MKT
06079823207330000,2021,169390,550010,719400,MKT
06079823207330000,2020,127337,454563,581900,MKT
06079823207330000,2019,127337,454563,581900,MKT
06079823207340000,2021,154812,409688,564500,MKT
06079823207340000,2020,116526,393974,510500,MKT
06079823207340000,2019,116526,396074,512600,MKT
06079823207380000,2021,136814,385186,522000,MKT
06079823207380000,2020,103160,374240,477400,MKT
06079823207380000,2019,103160,374240,477400,MKT
06079823207400000,2021,131987,399513,531500,MKT
06079823207400000,2020,99571,382529,482100,MKT
06079823207400000,2019,99571,382529,482100,MKT
06079823207420000,2021,129910,405690,535600,MKT
06079823207420000,2020,98026,363574,461600,MKT
06079823207420000,2019,98026,363574,461600,MKT
06079823207440000,2021,133223,372677,505900,MKT
06079823207440000,2020,100489,332911,433400,MKT
06079823207440000,2019,100489,332911,433400,MKT
06079823207460000,2021,150382,475618,626000,MKT
06079823207460000,2020,113238,441162,554400,MKT
06079823207460000,2019,113238,441162,554400,MKT
06079823207480000,2021,115749,369851,485600,MKT
06079823207480000,2020,84417,361383,445800,MKT
06079823207480000,2019,84417,361383,445800,MKT
06079823207500000,2021,107907,412893,520800,MKT
06079823207500000,2020,78776,372624,451400,MKT
06079823207500000,2019,78776,372624,451400,MKT
06079823207520000,2021,107907,353093,461000,MKT
06079823207520000,2020,78776,341324,420100,MKT
06079823207520000,2019,78776,341324,420100,MKT
06079823207540000,2021,107899,353101,461000,MKT
06079823207540000,2020,78770,341230,420000,MKT
06079823207540000,2019,78770,341230,420000,MKT
06079823207560000,2021,107079,417721,524800,MKT
06079823207560000,2020,78179,366021,444200,MKT
06079823207560000,2019,78179,366021,444200,MKT
06079823207580000,2021,107891,389909,497800,MKT
06079823207580000,2020,78764,361236,440000,MKT
06079823207580000,2019,78764,361236,440000,MKT
06079823207600000,2021,108456,419344,527800,MKT
06079823207600000,2020,96588,364612,461200,MKT
06079823207600000,2019,96588,364612,461200,MKT
06079823207620000,2021,111846,354954,466800,MKT
06079823207620000,2020,99564,363336,462900,MKT
06079823207620000,2019,99564,363336,462900,MKT
06079823207640000,2021,109808,304992,414800,MKT
06079823207640000,2020,80143,293557,373700,MKT
06079823207640000,2019,80143,293557,373700,MKT
06079823207660000,2021,114760,376940,491700,MKT
06079823207660000,2020,83705,355295,439000,MKT
06079823207660000,2019,83705,355295,439000,MKT
06079823209010000,2021,144923,436877,581800,MKT
06079823209010000,2020,105358,404742,510100,MKT
06079823209010000,2019,105358,406942,512300,MKT
06079823209020000,2021,136318,449682,586000,MKT
06079823209020000,2020,99188,422212,521400,MKT
06079823209020000,2019,99188,422212,521400,MKT
06079823209030000,2021,145498,462902,608400,MKT
06079823209030000,2020,105770,425630,531400,MKT
06079823209030000,2019,105770,425630,531400,MKT
06079823209040000,2021,136318,485782,622100,MKT
06079823209040000,2020,99188,433012,532200,MKT
06079823209040000,2019,99188,433012,532200,MKT
06079823209050000,2021,136318,476982,613300,MKT
06079823209050000,2020,99188,455612,554800,MKT
06079823209050000,2019,99188,455612,554800,MKT
06079823209060000,2021,143256,0,143256,COST
06079823209060000,2020,127079,0,127079,COST
06079823209060000,2019,127079,0,127079,COST
06079823209070000,2021,140977,493223,634200,MKT
06079823209070000,2020,125086,429014,554100,MKT
06079823209070000,2019,125086,429014,554100,MKT
06079823209080000,2021,136312,450288,586600,MKT
06079823209080000,2020,99184,423216,522400,MKT
06079823209080000,2019,99184,422216,521400,MKT
06079823209090000,2021,136306,499594,635900,MKT
06079823209090000,2020,99179,443621,542800,MKT
06079823209090000,2019,99179,443621,542800,MKT
06079823209100000,2021,135588,401712,537300,MKT
06079823209100000,2020,98665,386035,484700,MKT
06079823209100000,2019,98665,386035,484700,MKT
06079823209117000,2021,166590,10010,176600,COST
06079823209117000,2020,120872,10540,131412,COST
06079823209117000,2019,120872,10540,131412,COST
06079823209120000,2021,126418,337382,463800,MKT
06079823209120000,2020,92083,304917,397000,MKT
06079823209120000,2019,92083,304917,397000,MKT
06079823209130000,2021,94899,306401,401300,MKT
06079823209130000,2020,69405,299695,369100,MKT
06079823209130000,2019,69405,278295,347700,MKT
06079823209140000,2021,94899,283001,377900,MKT
06079823209140000,2020,69405,275095,344500,MKT
06079823209140000,2019,69405,275095,344500,MKT
06079823209150000,2021,94899,291901,386800,MKT
06079823209150000,2020,69405,276995,346400,MKT
06079823209150000,2019,69405,276995,346400,MKT
06079823209160000,2021,94899,285201,380100,MKT
06079823209160000,2020,69405,276395,345800,MKT
06079823209160000,2019,69405,276395,345800,MKT
06079823209170000,2021,94899,281801,376700,MKT
06079823209170000,2020,69405,276295,345700,MKT
06079823209170000,2019,69405,276295,345700,MKT
06079823209180000,2021,94899,292901,387800,MKT
06079823209180000,2020,84675,278725,363400,MKT
06079823209180000,2019,84675,278725,363400,MKT
06079823209190000,2021,94899,278901,373800,MKT
06079823209190000,2020,84675,270625,355300,MKT
06079823209190000,2019,84675,270625,355300,MKT
06079823209200000,2021,94899,284701,379600,MKT
06079823209200000,2020,69405,279195,348600,MKT
06079823209200000,2019,69405,279195,348600,MKT
06079823209210000,2021,94899,279101,374000,MKT
06079823209210000,2020,69405,271495,340900,MKT
06079823209210000,2019,69405,271495,340900,MKT
06079823209220000,2021,94899,281101,376000,MKT
06079823209220000,2020,69405,274295,343700,MKT
06079823209220000,2019,69405,274295,343700,MKT
06079823209230000,2021,94899,284201,379100,MKT
06079823209230000,2020,69405,281595,351000,MKT
06079823209230000,2019,69405,281595,351000,MKT
06079823209240000,2021,94899,277501,372400,MKT
06079823209240000,2020,69405,270595,340000,MKT
06079823209240000,2019,69405,270595,340000,MKT
06079823209250000,2021,109863,344937,454800,MKT
06079823209250000,2020,80183,317017,397200,MKT
06079823209250000,2019,80183,312417,392600,MKT
06079823209260000,2021,118833,273467,392300,MKT
06079823209260000,2020,86634,268266,354900,MKT
06079823209260000,2019,86634,268266,354900,MKT
06079823210010000,2021,145474,577560,723034,COST
06079823210010000,2020,105753,560460,666213,COST
06079823210010000,2019,105753,560460,666213,COST
06079823210030000,2021,142467,358433,500900,MKT
06079823210030000,2020,103597,339803,443400,MKT
06079823210030000,2019,103597,339803,443400,MKT
06079823210050000,2021,149324,444476,593800,MKT
06079823210050000,2020,108512,418688,527200,MKT
06079823210050000,2019,108512,418688,527200,MKT
06079823210060000,2021,148418,466730,615148,COST
06079823210060000,2020,107862,451860,559722,COST
06079823210060000,2019,107862,451860,559722,COST
06079823210080000,2021,142110,342490,484600,MKT
06079823210080000,2020,103341,336459,439800,MKT
06079823210080000,2019,103341,336459,439800,MKT
06079823210100000,2021,131453,295347,426800,MKT
06079823210100000,2020,95697,278103,373800,MKT
06079823210100000,2019,95697,278103,373800,MKT
06079823210120000,2021,126418,304982,431400,MKT
06079823210120000,2020,92083,295217,387300,MKT
06079823210120000,2019,92083,295217,387300,MKT
06079823210140000,2021,126418,540482,666900,MKT
06079823210140000,2020,92083,466917,559000,MKT
06079823210140000,2019,92083,466917,559000,MKT
06079823210160000,2021,126418,568282,694700,MKT
06079823210160000,2020,92083,505517,597600,MKT
06079823210160000,2019,92083,505517,597600,MKT
06079823210180000,2021,131453,329447,460900,MKT
06079823210180000,2020,95697,318603,414300,MKT
06079823210180000,2019,95697,318603,414300,MKT
06079823210200000,2021,131453,342647,474100,MKT
06079823210200000,2020,95697,335803,431500,MKT
06079823210200000,2019,95697,335803,431500,MKT
06079823210220000,2021,126418,422982,549400,MKT
06079823210220000,2020,92083,374717,466800,MKT
06079823210220000,2019,92083,374717,466800,MKT
06079823210240000,2021,126418,324282,450700,MKT
06079823210240000,2020,92083,312717,404800,MKT
06079823210240000,2019,92083,312717,404800,MKT
06079823210260000,2021,126418,399082,525500,MKT
06079823210260000,2020,92083,352417,444500,MKT
06079823210260000,2019,92083,352417,444500,MKT
06079823210280000,2021,131453,349947,481400,MKT
06079823210280000,2020,95697,324103,419800,MKT
06079823210280000,2019,95697,321903,417600,MKT
06079823210300000,2021,135333,347967,483300,MKT
06079823210300000,2020,98482,333818,432300,MKT
06079823210300000,2019,98482,333818,432300,MKT
06079823211010000,2021,124428,351272,475700,MKT
06079823211010000,2020,90654,336546,427200,MKT
06079823211010000,2019,90654,336546,427200,MKT
06079823211020000,2021,117153,339047,456200,MKT
06079823211020000,2020,85426,326874,412300,MKT
06079823211020000,2019,85426,326874,412300,MKT
06079823211030000,2021,125040,368860,493900,MKT
06079823211030000,2020,91093,358007,449100,MKT
06079823211030000,2019,91093,373607,464700,MKT
06079823211040000,2021,117153,353747,470900,MKT
06079823211040000,2020,85426,342374,427800,MKT
06079823211040000,2019,85426,342374,427800,MKT
06079823211050000,2021,117153,350947,468100,MKT
06079823211050000,2020,85426,343074,428500,MKT
06079823211050000,2019,85426,343074,428500,MKT
06079823211060000,2021,123118,387982,511100,MKT
06079823211060000,2020,109449,376051,485500,MKT
06079823211060000,2019,109449,376051,485500,MKT
06079823211070000,2021,121164,409736,530900,MKT
06079823211070000,2020,107737,372063,479800,MKT
06079823211070000,2019,107737,372063,479800,MKT
06079823211080000,2021,117153,326447,443600,MKT
06079823211080000,2020,85426,315874,401300,MKT
06079823211080000,2019,85426,315874,401300,MKT
06079823211090000,2021,117064,303436,420500,MKT
06079823211090000,2020,85362,296038,381400,MKT
06079823211090000,2019,85362,296038,381400,MKT
06079823211100000,2021,117153,0,117153,COST
06079823211100000,2020,85426,0,85426,COST
06079823211100000,2019,85426,0,85426,COST
06079823211110000,2021,142781,0,142781,COST
06079823211110000,2020,103822,0,103822,COST
06079823211110000,2019,103822,0,103822,COST
06079823211120000,2021,117064,0,117064,COST
06079823211120000,2020,85362,0,85362,COST
06079823211120000,2019,85362,0,85362,COST
06079823211130000,2021,116975,356925,473900,MKT
06079823211130000,2020,85298,358302,443600,MKT
06079823211130000,2019,85298,358302,443600,MKT
06079823211140000,2021,117064,536036,653100,MKT
06079823211140000,2020,85362,447238,532600,MKT
06079823211140000,2019,85362,437138,522500,MKT
06079823211150000,2021,117153,412447,529600,MKT
06079823211150000,2020,85426,366274,451700,MKT
06079823211150000,2019,85426,366274,451700,MKT
06079823211160000,2021,121257,430843,552100,MKT
06079823211160000,2020,107818,390982,498800,MKT
06079823211160000,2019,107818,390982,498800,MKT
06079823211170000,2021,123357,495043,618400,MKT
06079823211170000,2020,109659,430041,539700,MKT
06079823211170000,2019,109659,430041,539700,MKT
06079823211180000,2021,117472,410628,528100,MKT
06079823211180000,2020,85655,364645,450300,MKT
06079823211180000,2019,85655,364645,450300,MKT
06079823211190000,2021,117561,332839,450400,MKT
06079823211190000,2020,85719,323081,408800,MKT
06079823211190000,2019,85719,323081,408800,MKT
06079823211200000,2021,125573,389227,514800,MKT
06079823211200000,2020,91476,388224,479700,MKT
06079823211200000,2019,91476,388224,479700,MKT
06079823211210000,2021,117746,328554,446300,MKT
06079823211210000,2020,85852,320448,406300,MKT
06079823211210000,2019,85852,320448,406300,MKT
06079823211220000,2021,125123,346277,471400,MKT
06079823211220000,2020,91153,333347,424500,MKT
06079823211220000,2019,91153,333347,424500,MKT
06079823212010000,2021,151279,341421,492700,MKT
06079823212010000,2020,109912,343988,453900,MKT
06079823212010000,2019,109912,348288,458200,MKT
06079823212030000,2021,148395,362605,511000,MKT
06079823212030000,2020,107846,354954,462800,MKT
06079823212030000,2019,107846,354954,462800,MKT
06079823212050000,2021,162200,500600,662800,MKT
06079823212050000,2020,117731,432769,550500,MKT
06079823212050000,2019,117731,432769,550500,MKT
06079823212060000,2021,163869,746730,910599,COST
06079823212060000,2020,145088,296450,441538,COST
06079823212060000,2019,145088,0,145088,COST
06079823212080000,2021,150716,418084,568800,MKT
06079823212080000,2020,133600,387000,520600,MKT
06079823212080000,2019,133600,387000,520600,MKT
06079823212100000,2021,151171,432729,583900,MKT
06079823212100000,2020,109835,403065,512900,MKT
06079823212100000,2019,109835,403065,512900,MKT
06079823212120000,2021,151517,417083,568600,MKT
06079823212120000,2020,110082,398518,508600,MKT
06079823212120000,2019,110082,398518,508600,MKT
06079823212140000,2021,167133,468667,635800,MKT
06079823212140000,2020,121260,460240,581500,MKT
06079823212140000,2019,121260,460240,581500,MKT
06079823212160000,2021,176114,418386,594500,MKT
06079823212160000,2020,125213,417587,542800,MKT
06079823212160000,2019,125213,417587,542800,MKT
06079823212180000,2021,159000,775900,934900,MKT
06079823212180000,2020,113209,732550,845759,COST
06079823212180000,2019,113209,948160,1061369,COST
06079823212200000,2021,158201,574899,733100,MKT
06079823212200000,2020,112648,539952,652600,MKT
06079823212200000,2019,112648,539952,652600,MKT
06079823212220000,2021,159403,539397,698800,MKT
06079823212220000,2020,113492,515808,629300,MKT
06079823212220000,2019,113492,521308,634800,MKT
06079823212240000,2021,155756,656044,811800,MKT
06079823212240000,2020,110931,587369,698300,MKT
06079823212240000,2019,110931,587369,698300,MKT
06079823212260000,2021,171774,0,171774,COST
06079823212260000,2020,122170,0,122170,COST
06079823212260000,2019,122170,0,122170,COST
06079823212280000,2021,168244,411256,579500,MKT
06079823212280000,2020,119695,416505,536200,MKT
06079823212280000,2019,119695,416505,536200,MKT
06079823212300000,2021,167492,1114020,1281512,COST
06079823212300000,2020,119167,1094430,1213597,COST
06079823212300000,2019,119167,1094430,1213597,COST
06079823213010000,2021,139112,405888,545000,MKT
06079823213010000,2020,101192,359808,461000,MKT
06079823213010000,2019,101192,359808,461000,MKT
06079823213030000,2021,131453,506847,638300,MKT
06079823213030000,2020,95697,444903,540600,MKT
06079823213030000,2019,95697,444903,540600,MKT
06079823213050000,2021,140959,399741,540700,MKT
06079823213050000,2020,102516,403784,506300,MKT
06079823213050000,2019,102516,403784,506300,MKT
06079823213060000,2021,140959,450041,591000,MKT
06079823213060000,2020,102516,435184,537700,MKT
06079823213060000,2019,102516,435184,537700,MKT
06079823213080000,2021,145468,468532,614000,MKT
06079823213080000,2020,105749,432951,538700,MKT
06079823213080000,2019,105749,432951,538700,MKT
06079823213100000,2021,140959,346741,487700,MKT
06079823213100000,2020,102516,328984,431500,MKT
06079823213100000,2019,102516,328984,431500,MKT
06079823213120000,2021,147231,342169,489400,MKT
06079823213120000,2020,107012,318188,425200,MKT
06079823213120000,2019,107012,318188,425200,MKT
06079823213140000,2021,147231,430669,577900,MKT
06079823213140000,2020,107012,384788,491800,OVR
06079823213140000,2019,107012,384788,491800,MKT
06079823213160000,2021,140959,561200,702159,COST
06079823213160000,2020,102516,538650,641166,COST
06079823213160000,2019,102516,538650,641166,COST
06079823213180000,2021,145468,442732,588200,MKT
06079823213180000,2020,105749,407851,513600,MKT
06079823213180000,2019,105749,400751,506500,MKT
06079823213200000,2021,140959,418341,559300,MKT
06079823213200000,2020,102516,392884,495400,MKT
06079823213200000,2019,102516,392884,495400,MKT
06079823213220000,2021,140959,499241,640200,MKT
06079823213220000,2020,102516,439484,542000,MKT
06079823213220000,2019,102516,439484,542000,MKT
06079823213240000,2021,131453,347047,478500,MKT
06079823213240000,2020,95697,334903,430600,MKT
06079823213240000,2019,95697,332903,428600,MKT
06079823213260000,2021,139112,350288,489400,MKT
06079823213260000,2020,101192,343408,444600,MKT
06079823213260000,2019,101192,343408,444600,MKT
06079823214020000,2021,117309,298491,415800,MKT
06079823214020000,2020,85538,294362,379900,MKT
06079823214020000,2019,85538,296362,381900,MKT
06079823214040000,2021,111448,301152,412600,MKT
06079823214040000,2020,81323,289277,370600,MKT
06079823214040000,2019,81323,289277,370600,MKT
06079823214060000,2021,110851,312049,422900,MKT
06079823214060000,2020,80894,295306,376200,MKT
06079823214060000,2019,80894,295306,376200,MKT
06079823214080000,2021,110252,335848,446100,MKT
06079823214080000,2020,80463,319637,400100,MKT
06079823214080000,2019,80463,319637,400100,MKT
06079823214100000,2021,130330,317570,447900,MKT
06079823214100000,2020,98338,309762,408100,MKT
06079823214100000,2019,98338,309762,408100,MKT
06079823214126500,2021,67579,0,67579,COST
06079823214126500,2020,48824,0,48824,COST
06079823214126500,2019,48824,0,48824,COST
06079823214140000,2021,128840,306360,435200,MKT
06079823214140000,2020,97229,298871,396100,MKT
06079823214140000,2019,97229,298871,396100,MKT
06079823214160000,2021,109282,415918,525200,MKT
06079823214160000,2020,79765,358235,438000,MKT
06079823214160000,2019,79765,358235,438000,MKT
06079823214180000,2021,109474,354626,464100,MKT
06079823214180000,2020,79903,339197,419100,MKT
06079823214180000,2019,79903,339197,419100,MKT
06079823214200000,2021,109657,327543,437200,MKT
06079823214200000,2020,80035,322565,402600,MKT
06079823214200000,2019,80035,322565,402600,MKT
06079823214220000,2021,109840,324460,434300,MKT
06079823214220000,2020,80166,318134,398300,MKT
06079823214220000,2019,80166,318134,398300,MKT
06079823214240000,2021,110851,344149,455000,MKT
06079823214240000,2020,80894,332006,412900,MKT
06079823214240000,2019,80894,332006,412900,MKT
06079823214260000,2021,118276,344524,462800,MKT
06079823214260000,2020,86233,334967,421200,MKT
06079823214260000,2019,86233,334967,421200,MKT
06079823220010000,2021,10,0,10,COST
06079823220030000,2021,8,0,8,COST
06079823220050000,2021,8,0,8,COST
06079823220070000,2021,8,0,8,COST
06079823220090000,2021,8,0,8,COST
06079823220110000,2021,8,0,8,COST
06079823220130000,2021,8,0,8,COST
06079823221010000,2021,9,0,9,COST
06079823221030000,2021,5,0,5,COST
06079823221050000,2021,8,0,8,COST
06079823221070000,2021,8,0,8,COST
06079823221100000,2021,29,0,29,COST
06079823221130000,2021,4,0,4,COST
06079823221140000,2021,4,0,4,COST
06079823221150000,2021,4,0,4,COST
06079823221160000,2021,4,0,4,COST
06079823221170000,2021,4,0,4,COST
06079823221180000,2021,4,0,4,COST
06079823221200000,2021,12,0,12,COST
06079823221220000,2021,11,0,11,COST
06079823222010000,2021,9,0,9,COST
06079823222030000,2021,7,0,7,COST
06079823222060000,2021,25,0,25,COST
06079823222090000,2021,10,0,10,COST
06079823222110000,2021,10,0,10,COST
06079823222130000,2021,9,0,9,COST
06079823223010000,2021,9,0,9,COST
06079823223030000,2021,12,0,12,COST
06079823223050000,2021,12,0,12,COST
06079823223080000,2021,27,0,27,COST
06079823223110000,2021,14,0,14,COST
06079823223130000,2021,14,0,14,COST
06079823224010000,2021,15,0,15,COST
06079823224030000,2021,12,0,12,COST
06079823224050000,2021,4,0,4,COST
06079823224060000,2021,4,0,4,COST
06079823224070000,2021,4,0,4,COST
06079823224080000,2021,4,0,4,COST
06079823224090000,2021,4,0,4,COST
06079823224100000,2021,4,0,4,COST
06079823224130000,2021,48,0,48,COST
06079823224160000,2021,7,0,7,COST
06079823224180000,2021,7,0,7,COST
06079823224200000,2021,7,0,7,COST
06079823224220000,2021,7,0,7,COST
06079823224240000,2021,7,0,7,COST
06079823224260000,2021,7,0,7,COST
06079823225016500,2021,165730,0,165730,COST
06079823226010000,2021,9,0,9,COST
06079823226030000,2021,10,0,10,COST
06079823226050000,2021,10,0,10,COST
06079823226070000,2021,5,0,5,COST
06079823226090000,2021,5,0,5,COST
06079823227010000,2021,13,0,13,COST
06079823227030000,2021,13,0,13,COST
06079823228010000,2021,10,0,10,COST
06079823228030000,2021,9,0,9,COST
06079823228050000,2021,10,0,10,COST
06079823229010000,2021,12,0,12,COST
06079823229030000,2021,10,0,10,COST
06079823229050000,2021,13,0,13,COST
06079823229070000,2021,10,0,10,COST
06079823229090000,2021,10,0,10,COST
06079823301010000,2021,495832,0,495832,COST
06079823301010000,2020,415514,0,415514,COST
06079823301010000,2019,415514,0,415514,COST
06079823301040000,2021,495832,580580,1076412,COST
06079823301040000,2020,415514,566570,982084,COST
06079823301040000,2019,415514,566570,982084,COST
06079823301070000,2021,220552,932730,1153282,COST
06079823301070000,2020,163379,767410,930789,COST
06079823301070000,2019,163379,738730,902109,COST
06079823301100000,2021,2255,0,2255,COST
06079823301100000,2020,2098,0,2098,COST
06079823301100000,2019,2098,0,2098,COST
06079823301500000,2021,2257,0,2257,COST
06079823301500000,2020,2100,0,2100,COST
06079823301500000,2019,2100,0,2100,COST
06079823401010000,2021,2927087,5672310,8599397,COST
06079823401010000,2020,671998,5493140,6165138,COST
06079823401010000,2019,671998,5493140,6165138,COST
06079823401050000,2021,407754,0,407754,COST
06079823401050000,2020,292129,0,292129,COST
06079823401050000,2019,292129,0,292129,COST
06079823401107000,2021,334862,0,334862,COST
06079823401107000,2020,206930,0,206930,COST
06079823401107000,2019,206930,0,206930,COST
06079823401126500,2021,65520,0,65520,COST
06079823401126500,2020,47357,0,47357,COST
06079823401126500,2019,47357,0,47357,COST
06079823401150000,2021,350437,0,350437,COST
06079823401150000,2020,251603,0,251603,COST
06079823401150000,2019,251603,0,251603,COST
06079823402010000,2021,126817,518583,645400,MKT
06079823402010000,2020,90584,443616,534200,MKT
06079823402010000,2019,90584,443616,534200,MKT
06079823402030000,2021,120084,506216,626300,MKT
06079823402030000,2020,87533,435167,522700,MKT
06079823402030000,2019,87533,428167,515700,MKT
06079823402050000,2021,120084,540216,660300,MKT
06079823402050000,2020,87533,457467,545000,MKT
06079823402050000,2019,87533,457467,545000,MKT
06079823402070000,2021,120084,538316,658400,MKT
06079823402070000,2020,87533,485167,572700,MKT
06079823402070000,2019,87533,485167,572700,MKT
06079823402090000,2021,120084,539616,659700,MKT
06079823402090000,2020,87533,484167,571700,MKT
06079823402090000,2019,87533,484167,571700,MKT
06079823402110000,2021,120084,425616,545700,MKT
06079823402110000,2020,87533,380767,468300,MKT
06079823402110000,2019,87533,380767,468300,MKT
06079823402130000,2021,125144,508556,633700,MKT
06079823402130000,2020,91168,448732,539900,MKT
06079823402130000,2019,91168,448732,539900,MKT
06079823402150000,2021,121729,406071,527800,MKT
06079823402150000,2020,88714,379986,468700,MKT
06079823402150000,2019,88714,379986,468700,MKT
06079823402170000,2021,123069,475231,598300,MKT
06079823402170000,2020,89677,434323,524000,MKT
06079823402170000,2019,89677,434323,524000,MKT
06079823402190000,2021,123026,544174,667200,MKT
06079823402190000,2020,89647,453253,542900,MKT
06079823402190000,2019,89647,453253,542900,MKT
06079823402210000,2021,123005,486795,609800,MKT
06079823402210000,2020,89632,430068,519700,MKT
06079823402210000,2019,89632,430068,519700,MKT
06079823402230000,2021,122970,403330,526300,MKT
06079823402230000,2020,89606,376294,465900,MKT
06079823402230000,2019,89606,376294,465900,MKT
06079823402250000,2021,123526,515274,638800,MKT
06079823402250000,2020,90006,442094,532100,MKT
06079823402250000,2019,90006,442094,532100,MKT
06079823402270000,2021,124054,459146,583200,MKT
06079823402270000,2020,88638,433662,522300,MKT
06079823402270000,2019,88638,433662,522300,MKT
06079823403010000,2021,127880,502520,630400,MKT
06079823403010000,2020,91332,441768,533100,MKT
06079823403010000,2019,91332,441768,533100,MKT
06079823403030000,2021,118628,460672,579300,MKT
06079823403030000,2020,86486,420914,507400,MKT
06079823403030000,2019,86486,420914,507400,MKT
06079823403050000,2021,118628,398672,517300,MKT
06079823403050000,2020,86486,372214,458700,MKT
06079823403050000,2019,86486,372214,458700,MKT
06079823403070000,2021,118628,475972,594600,MKT
06079823403070000,2020,86486,417014,503500,MKT
06079823403070000,2019,86486,417014,503500,MKT
06079823403090000,2021,118628,412472,531100,MKT
06079823403090000,2020,86486,381214,467700,MKT
06079823403090000,2019,86486,381214,467700,MKT
06079823403110000,2021,118628,533972,652600,MKT
06079823403110000,2020,86486,451714,538200,MKT
06079823403110000,2019,86486,451714,538200,MKT
06079823403130000,2021,125510,405690,531200,MKT
06079823403130000,2020,91431,384769,476200,MKT
06079823403130000,2019,91431,384769,476200,MKT
06079823403150000,2021,126178,517522,643700,MKT
06079823403150000,2020,91911,459089,551000,MKT
06079823403150000,2019,91911,459089,551000,MKT
06079823403170000,2021,116782,522918,639700,MKT
06079823403170000,2020,85159,452841,538000,MKT
06079823403170000,2019,85159,450441,535600,MKT
06079823403190000,2021,116782,542818,659600,MKT
06079823403190000,2020,85159,450141,535300,MKT
06079823403190000,2019,85159,441041,526200,MKT
06079823403210000,2021,116782,408718,525500,MKT
06079823403210000,2020,85159,386741,471900,MKT
06079823403210000,2019,85159,386741,471900,MKT
06079823403230000,2021,116782,501918,618700,MKT
06079823403230000,2020,85159,424041,509200,MKT
06079823403230000,2019,85159,479841,565000,MKT
06079823403250000,2021,116782,524818,641600,MKT
06079823403250000,2020,85159,441141,526300,MKT
06079823403250000,2019,85159,441141,526300,MKT
06079823403270000,2021,127866,477034,604900,MKT
06079823403270000,2020,91322,422078,513400,MKT
06079823403270000,2019,91322,422078,513400,MKT
06079823404010000,2021,123624,467176,590800,MKT
06079823404010000,2020,90076,426224,516300,MKT
06079823404010000,2019,90076,426224,516300,MKT
06079823404030000,2021,119794,459506,579300,MKT
06079823404030000,2020,87325,435275,522600,MKT
06079823404030000,2019,87325,435275,522600,MKT
06079823404050000,2021,119925,452275,572200,MKT
06079823404050000,2020,87418,405982,493400,MKT
06079823404050000,2019,87418,405982,493400,MKT
06079823404070000,2021,120084,444216,564300,MKT
06079823404070000,2020,87533,397367,484900,MKT
06079823404070000,2019,87533,397367,484900,MKT
06079823404090000,2021,120084,465016,585100,MKT
06079823404090000,2020,87533,440467,528000,MKT
06079823404090000,2019,87533,440467,528000,MKT
06079823404110000,2021,120366,460934,581300,MKT
06079823404110000,2020,87735,436365,524100,MKT
06079823404110000,2019,87735,436365,524100,MKT
06079823404130000,2021,119780,476620,596400,MKT
06079823404130000,2020,87314,436786,524100,MKT
06079823404130000,2019,87314,303560,390874,COST
06079823404150000,2021,115636,522064,637700,MKT
06079823404150000,2020,84335,443865,528200,MKT
06079823404150000,2019,84335,449465,533800,MKT
06079823404170000,2021,117138,0,117138,COST
06079823404170000,2020,85416,0,85416,COST
06079823404170000,2019,85416,0,85416,COST
06079823404190000,2021,116588,0,116588,COST
06079823404190000,2020,85020,0,85020,COST
06079823404190000,2019,85020,0,85020,COST
06079823404210000,2021,117316,0,117316,COST
06079823404210000,2020,85544,0,85544,COST
06079823404210000,2019,85544,0,85544,COST
06079823404230000,2021,125862,0,125862,COST
06079823404230000,2020,91684,0,91684,COST
06079823404230000,2019,91684,0,91684,COST
06079823404250000,2021,128014,0,128014,COST
06079823404250000,2020,91426,0,91426,COST
06079823404250000,2019,91426,0,91426,COST
06079823404270000,2021,120063,0,120063,COST
06079823404270000,2020,85825,0,85825,COST
06079823404270000,2019,85825,0,85825,COST
06079823404290000,2021,120025,0,120025,COST
06079823404290000,2020,85799,0,85799,COST
06079823404290000,2019,85799,0,85799,COST
06079823404310000,2021,120003,0,120003,COST
06079823404310000,2020,85783,0,85783,COST
06079823404310000,2019,85783,0,85783,COST
06079823405016501,2021,61365,0,61365,COST
06079823405016501,2020,44395,0,44395,COST
06079823405016501,2019,44395,0,44395,COST
06079823405050000,2021,319932,0,319932,COST
06079823405050000,2020,197832,0,197832,COST
06079823405050000,2019,197832,0,197832,COST
06079823405106500,2021,80854,0,80854,COST
06079823405106500,2020,58267,0,58267,COST
06079823405106500,2019,58267,0,58267,COST
06079823405156500,2021,38139,0,38139,COST
06079823405156500,2020,27778,0,27778,COST
06079823405156500,2019,27778,0,27778,COST
06079823405206500,2021,90199,0,90199,COST
06079823405206500,2020,64901,0,64901,COST
06079823405206500,2019,64901,0,64901,COST
06079823405256500,2021,76482,0,76482,COST
06079823405256500,2020,55159,0,55159,COST
06079823405256500,2019,55159,0,55159,COST
06079823406010000,2021,123668,540332,664000,MKT
06079823406010000,2020,88365,0,88365,COST
06079823406010000,2019,88365,0,88365,COST
06079823406030000,2021,117893,643907,761800,MKT
06079823406030000,2020,85958,357642,443600,INCOME
06079823406030000,2019,85958,0,85958,COST
06079823406050000,2021,117893,643907,761800,MKT
06079823406050000,2020,85958,357642,443600,INCOME
06079823406050000,2019,85958,0,85958,COST
06079823406070000,2021,117893,667807,785700,MKT
06079823406070000,2020,85958,0,85958,COST
06079823406070000,2019,85958,0,85958,COST
06079823406090000,2021,117893,667807,785700,MKT
06079823406090000,2020,85958,0,85958,COST
06079823406090000,2019,85958,0,85958,COST
06079823406110000,2021,117893,667807,785700,MKT
06079823406110000,2020,85958,0,85958,COST
06079823406110000,2019,85958,0,85958,COST
06079823406130000,2021,117952,546348,664300,MKT
06079823406130000,2020,86000,457900,543900,MKT
06079823406130000,2019,86000,0,86000,COST
06079823406156500,2021,101443,0,101443,COST
06079823406156500,2020,61899,0,61899,COST
06079823406156500,2019,61899,0,61899,COST
06079823406170000,2021,116184,0,116184,COST
06079823406170000,2020,84729,0,84729,COST
06079823406170000,2019,84729,0,84729,COST
06079823406190000,2021,108890,422010,530900,MKT
06079823406190000,2020,79483,369517,449000,MKT
06079823406190000,2019,79483,363817,443300,MKT
06079823406210000,2021,108890,485210,594100,MKT
06079823406210000,2020,79483,409417,488900,MKT
06079823406210000,2019,79483,378030,457513,COST
06079823406230000,2021,108890,0,108890,COST
06079823406230000,2020,79483,0,79483,COST
06079823406230000,2019,79483,0,79483,COST
06079823406250000,2021,108890,0,108890,COST
06079823406250000,2020,79483,0,79483,COST
06079823406250000,2019,79483,0,79483,COST
06079823406270000,2021,108890,385610,494500,MKT
06079823406270000,2020,79483,364717,444200,MKT
06079823406270000,2019,79483,394817,474300,MKT
06079823406290000,2021,108890,0,108890,COST
06079823406290000,2020,79483,0,79483,COST
06079823406290000,2019,79483,0,79483,COST
06079823406310000,2021,117949,0,117949,COST
06079823406310000,2020,84335,0,84335,COST
06079823406310000,2019,84335,0,84335,COST
06079823407010000,2021,115138,431662,546800,MKT
06079823407010000,2020,83978,371122,455100,MKT
06079823407010000,2019,83978,371122,455100,MKT
06079823407030000,2021,109202,398398,507600,MKT
06079823407030000,2020,79708,356792,436500,MKT
06079823407030000,2019,79708,356792,436500,MKT
06079823407050000,2021,109202,457298,566500,MKT
06079823407050000,2020,79708,434792,514500,MKT
06079823407050000,2019,79708,434792,514500,MKT
06079823407070000,2021,109202,416498,525700,MKT
06079823407070000,2020,79708,375492,455200,MKT
06079823407070000,2019,79708,375492,455200,MKT
06079823407090000,2021,109202,283498,392700,MKT
06079823407090000,2020,79708,291492,371200,MKT
06079823407090000,2019,79708,291492,371200,MKT
06079823407110000,2021,109202,398398,507600,MKT
06079823407110000,2020,79708,356792,436500,MKT
06079823407110000,2019,79708,356792,436500,MKT
06079823407130000,2021,109202,412998,522200,MKT
06079823407130000,2020,79708,373592,453300,MKT
06079823407130000,2019,79708,373592,453300,MKT
06079823407150000,2021,127992,413608,541600,MKT
06079823407150000,2020,91411,367789,459200,MKT
06079823407150000,2019,91411,0,91411,COST
06079823407170000,2021,129831,334669,464500,MKT
06079823407170000,2020,92706,335594,428300,MKT
06079823407170000,2019,92706,335594,428300,MKT
06079823407190000,2021,110867,314433,425300,MKT
06079823407190000,2020,80906,314194,395100,MKT
06079823407190000,2019,80906,314194,395100,MKT
06079823407210000,2021,110867,368533,479400,MKT
06079823407210000,2020,80906,346194,427100,MKT
06079823407210000,2019,80906,346194,427100,MKT
06079823407230000,2021,110867,312933,423800,MKT
06079823407230000,2020,80906,315994,396900,MKT
06079823407230000,2019,80906,315994,396900,MKT
06079823407250000,2021,110867,398133,509000,MKT
06079823407250000,2020,80906,392894,473800,MKT
06079823407250000,2019,80906,392894,473800,MKT
06079823407270000,2021,110867,346533,457400,MKT
06079823407270000,2020,80906,330794,411700,MKT
06079823407270000,2019,80906,330794,411700,MKT
06079823407290000,2021,110867,309333,420200,MKT
06079823407290000,2020,80906,311994,392900,MKT
06079823407290000,2019,80906,311994,392900,MKT
06079823407310000,2021,116177,303223,419400,MKT
06079823407310000,2020,84724,297176,381900,MKT
06079823407310000,2019,84724,297176,381900,MKT
06079823408017000,2021,451662,0,451662,COST
06079823408017000,2020,112806,558480,671286,COST
06079823408017000,2019,109284,0,109284,COST
06079823408060000,2021,130926,513074,644000,INCOME
06079823408060000,2020,95319,480981,576300,INCOME
06079823408060000,2019,95319,480981,576300,INCOME
06079823408106500,2021,116025,0,116025,COST
06079823408106500,2020,83187,0,83187,COST
06079823408106500,2019,83187,0,83187,COST
06079823408126500,2021,128875,0,128875,COST
06079823408126500,2020,92263,0,92263,COST
06079823408126500,2019,92263,0,92263,COST
06079823409010000,2021,109402,307398,416800,MKT
06079823409010000,2020,79851,302849,382700,MKT
06079823409010000,2019,79851,302849,382700,MKT
06079823409030000,2021,100093,311507,411600,MKT
06079823409030000,2020,73149,303251,376400,MKT
06079823409030000,2019,73149,303251,376400,MKT
06079823409050000,2021,102104,311496,413600,MKT
06079823409050000,2020,74597,302803,377400,MKT
06079823409050000,2019,74597,302803,377400,MKT
06079823409070000,2021,102104,311496,413600,MKT
06079823409070000,2020,74597,302803,377400,MKT
06079823409070000,2019,74597,302803,377400,MKT
06079823409090000,2021,99909,311591,411500,MKT
06079823409090000,2020,73016,303184,376200,MKT
06079823409090000,2019,73016,303184,376200,MKT
06079823409110000,2021,99935,336965,436900,MKT
06079823409110000,2020,73035,312165,385200,MKT
06079823409110000,2019,73035,312165,385200,MKT
06079823409130000,2021,96642,337658,434300,MKT
06079823409130000,2020,70662,311538,382200,MKT
06079823409130000,2019,70662,311538,382200,MKT
06079823409150000,2021,96387,337513,433900,MKT
06079823409150000,2020,70478,307122,377600,MKT
06079823409150000,2019,70478,307122,377600,MKT
06079823409170000,2021,95278,333922,429200,MKT
06079823409170000,2020,69679,308121,377800,MKT
06079823409170000,2019,69679,308121,377800,MKT
06079823409190000,2021,95600,334500,430100,MKT
06079823409190000,2020,69911,308689,378600,MKT
06079823409190000,2019,69911,308689,378600,MKT
06079823409210000,2021,105475,311825,417300,MKT
06079823409210000,2020,77025,303075,380100,MKT
06079823409210000,2019,77025,303075,380100,MKT
06079823409230000,2021,105575,334125,439700,MKT
06079823409230000,2020,77097,308603,385700,MKT
06079823409230000,2019,77097,308603,385700,MKT
06079823409250000,2021,95656,333844,429500,MKT
06079823409250000,2020,69951,307549,377500,MKT
06079823409250000,2019,69951,307549,377500,MKT
06079823409270000,2021,97753,334347,432100,MKT
06079823409270000,2020,71462,308738,380200,MKT
06079823409270000,2019,71462,308738,380200,MKT
06079823409290000,2021,100277,320923,421200,MKT
06079823409290000,2020,73281,304019,377300,MKT
06079823409290000,2019,73281,304019,377300,MKT
06079823409310000,2021,100093,311507,411600,MKT
06079823409310000,2020,73149,303151,376300,MKT
06079823409310000,2019,73149,303151,376300,MKT
06079823409330000,2021,100093,315907,416000,MKT
06079823409330000,2020,73149,303151,376300,OVR
06079823409330000,2019,73149,303151,376300,MKT
06079823409350000,2021,100093,313007,413100,MKT
06079823409350000,2020,73149,304051,377200,MKT
06079823409350000,2019,73149,304051,377200,MKT
06079823409370000,2021,102104,311496,413600,MKT
06079823409370000,2020,74597,302803,377400,MKT
06079823409370000,2019,74597,302803,377400,MKT
06079823409390000,2021,102104,311496,413600,MKT
06079823409390000,2020,74597,302803,377400,MKT
06079823409390000,2019,74597,302803,377400,MKT
06079823409410000,2021,100093,311607,411700,MKT
06079823409410000,2020,73149,303251,376400,MKT
06079823409410000,2019,73149,303251,376400,MKT
06079823409430000,2021,109402,324998,434400,MKT
06079823409430000,2020,79851,308349,388200,MKT
06079823409430000,2019,79851,308349,388200,MKT
06079823410010000,2021,123631,361669,485300,MKT
06079823410010000,2020,90081,351819,441900,MKT
06079823410010000,2019,90081,351819,441900,MKT
06079823410030000,2021,114919,359181,474100,MKT
06079823410030000,2020,83820,351780,435600,MKT
06079823410030000,2019,83820,351780,435600,MKT
06079823410050000,2021,114904,361896,476800,MKT
06079823410050000,2020,83809,347791,431600,MKT
06079823410050000,2019,83809,347791,431600,MKT
06079823410070000,2021,114888,310412,425300,MKT
06079823410070000,2020,83798,295202,379000,MKT
06079823410070000,2019,83798,295202,379000,MKT
06079823410090000,2021,114873,363427,478300,MKT
06079823410090000,2020,83787,345613,429400,MKT
06079823410090000,2019,83787,345613,429400,MKT
06079823410110000,2021,114866,358234,473100,MKT
06079823410110000,2020,83782,350318,434100,MKT
06079823410110000,2019,83782,350318,434100,MKT
06079823410130000,2021,114851,305849,420700,MKT
06079823410130000,2020,83771,297329,381100,MKT
06079823410130000,2019,83771,297329,381100,MKT
06079823410150000,2021,114835,363065,477900,MKT
06079823410150000,2020,83760,351740,435500,MKT
06079823410150000,2019,83760,351740,435500,MKT
06079823410170000,2021,123995,427405,551400,MKT
06079823410170000,2020,90343,404257,494600,MKT
06079823410170000,2019,90343,404257,494600,MKT
06079823410190000,2021,126589,430711,557300,MKT
06079823410190000,2020,90423,421177,511600,MKT
06079823410190000,2019,90423,421177,511600,MKT
06079823410210000,2021,117132,417168,534300,MKT
06079823410210000,2020,83760,384140,467900,MKT
06079823410210000,2019,83760,384140,467900,MKT
06079823410230000,2021,117148,446152,563300,MKT
06079823410230000,2020,83771,427829,511600,MKT
06079823410230000,2019,83771,427829,511600,MKT
06079823410250000,2021,117163,449337,566500,MKT
06079823410250000,2020,83782,419318,503100,MKT
06079823410250000,2019,83782,266580,350362,COST
06079823410270000,2021,117179,429221,546400,MKT
06079823410270000,2020,83792,413508,497300,MKT
06079823410270000,2019,83792,413508,497300,MKT
06079823410290000,2021,117194,417206,534400,MKT
06079823410290000,2020,83803,384097,467900,MKT
06079823410290000,2019,83803,384097,467900,MKT
06079823410310000,2021,117202,446198,563400,MKT
06079823410310000,2020,83809,427991,511800,MKT
06079823410310000,2019,83809,427991,511800,MKT
06079823410330000,2021,117217,511383,628600,MKT
06079823410330000,2020,83820,456980,540800,MKT
06079823410330000,2019,83820,456980,540800,MKT
06079823410350000,2021,126104,463196,589300,MKT
06079823410350000,2020,90081,441119,531200,MKT
06079823410350000,2019,90081,441119,531200,MKT
06079823411010000,2021,149106,376094,525200,MKT
06079823411010000,2020,90262,383438,473700,MKT
06079823411010000,2019,90262,383438,473700,MKT
06079823411030000,2021,135407,335193,470600,MKT
06079823411030000,2020,83700,333100,416800,MKT
06079823411030000,2019,83700,333100,416800,MKT
06079823411050000,2021,135407,366793,502200,MKT
06079823411050000,2020,83700,365800,449500,MKT
06079823411050000,2019,83700,0,83700,COST
06079823411070000,2021,135407,390593,526000,MKT
06079823411070000,2020,83700,386500,470200,MKT
06079823411070000,2019,83700,0,83700,COST
06079823411090000,2021,135407,332593,468000,MKT
06079823411090000,2020,83700,325200,408900,MKT
06079823411090000,2019,83700,325200,408900,MKT
06079823411110000,2021,135407,356393,491800,MKT
06079823411110000,2020,83700,367500,451200,MKT
06079823411110000,2019,83700,367500,451200,MKT
06079823411130000,2021,135407,329093,464500,MKT
06079823411130000,2020,83700,323100,406800,MKT
06079823411130000,2019,83700,323100,406800,MKT
06079823411150000,2021,135407,363093,498500,MKT
06079823411150000,2020,83700,362600,446300,MKT
06079823411150000,2019,83700,362600,446300,MKT
06079823411170000,2021,135407,359193,494600,MKT
06079823411170000,2020,83700,371100,454800,MKT
06079823411170000,2019,83700,371100,454800,MKT
06079823411190000,2021,135407,336493,471900,MKT
06079823411190000,2020,83700,336300,420000,MKT
06079823411190000,2019,83700,331500,415200,MKT
06079823411210000,2021,135407,336493,471900,MKT
06079823411210000,2020,83700,336300,420000,MKT
06079823411210000,2019,83700,329600,413300,MKT
06079823411230000,2021,159781,372219,532000,MKT
06079823411230000,2020,102114,366686,468800,MKT
06079823411230000,2019,102114,0,102114,COST
06079823412010000,2021,149022,583778,732800,MKT
06079823412010000,2020,90212,559988,650200,MKT
06079823412010000,2019,90212,0,90212,COST
06079823412030000,2021,135354,466146,601500,MKT
06079823412030000,2020,83667,408733,492400,MKT
06079823412030000,2019,83667,233930,317597,COST
06079823412050000,2021,135354,596246,731600,MKT
06079823412050000,2020,83667,556333,640000,MKT
06079823412050000,2019,83667,207310,290977,COST
06079823412070000,2021,135345,470655,606000,MKT
06079823412070000,2020,83662,415538,499200,MKT
06079823412070000,2019,83662,0,83662,COST
06079823412090000,2021,135345,480455,615800,MKT
06079823412090000,2020,83662,478738,562400,MKT
06079823412090000,2019,83662,0,83662,COST
06079823412110000,2021,135345,448155,583500,MKT
06079823412110000,2020,83662,398238,481900,MKT
06079823412110000,2019,83662,233930,317592,COST
06079823412130000,2021,135336,483764,619100,MKT
06079823412130000,2020,83656,429544,513200,MKT
06079823412130000,2019,83656,335944,419600,MKT
06079823412150000,2021,135336,623164,758500,MKT
06079823412150000,2020,83656,593044,676700,MKT
06079823412150000,2019,83656,0,83656,COST
06079823412170000,2021,135327,657440,792767,COST
06079823412170000,2020,83651,627840,711491,COST
06079823412170000,2019,83651,322170,405821,COST
06079823412190000,2021,135327,520873,656200,MKT
06079823412190000,2020,83651,455549,539200,MKT
06079823412190000,2019,83651,0,83651,COST
06079823412210000,2021,159686,588114,747800,MKT
06079823412210000,2020,102054,460046,562100,MKT
06079823412210000,2019,102054,245720,347774,COST
06079823412237000,2021,413635,0,413635,COST
06079823412237000,2020,130386,845814,976200,INCOME
06079823412237000,2019,130386,0,130386,COST
06079823412317000,2021,221499,0,221499,COST
06079823412317000,2020,128010,0,128010,COST
06079823412317000,2019,105529,408540,514069,COST
06079824101010000,2021,140303,302897,443200,MKT
06079824101010000,2020,102046,288154,390200,MKT
06079824101010000,2019,102046,288154,390200,MKT
06079824101020000,2021,132436,359964,492400,MKT
06079824101020000,2020,96403,322297,418700,MKT
06079824101020000,2019,96403,322297,418700,MKT
06079824101030000,2021,130263,318137,448400,MKT
06079824101030000,2020,94844,272156,367000,MKT
06079824101030000,2019,94844,272156,367000,MKT
06079824101040000,2021,130263,353237,483500,MKT
06079824101040000,2020,94844,308856,403700,MKT
06079824101040000,2019,94844,308856,403700,MKT
06079824101050000,2021,130263,339037,469300,MKT
06079824101050000,2020,94844,293356,388200,MKT
06079824101050000,2019,94844,293356,388200,MKT
06079824101060000,2021,131716,306784,438500,MKT
06079824101060000,2020,95886,267714,363600,MKT
06079824101060000,2019,95886,267714,363600,MKT
06079824101070000,2021,127340,386160,513500,MKT
06079824101070000,2020,92745,323655,416400,MKT
06079824101070000,2019,92745,323655,416400,MKT
06079824101080000,2021,127340,402260,529600,MKT
06079824101080000,2020,92745,358755,451500,MKT
06079824101080000,2019,92745,358755,451500,MKT
06079824101090000,2021,126624,372476,499100,MKT
06079824101090000,2020,92231,346769,439000,MKT
06079824101090000,2019,92231,346769,439000,MKT
06079824101100000,2021,125855,371045,496900,MKT
06079824101100000,2020,91679,304321,396000,OVR
06079824101100000,2019,91679,304321,396000,MKT
06079824101110000,2021,143412,327888,471300,MKT
06079824101110000,2020,104275,265625,369900,MKT
06079824101110000,2019,104275,258025,362300,MKT
06079824101120000,2021,126288,373012,499300,MKT
06079824101120000,2020,91990,348610,440600,MKT
06079824101120000,2019,91990,348610,440600,MKT
06079824101130000,2021,117539,324961,442500,MKT
06079824101130000,2020,85703,298397,384100,MKT
06079824101130000,2019,85703,298397,384100,MKT
06079824101140000,2021,117539,341061,458600,MKT
06079824101140000,2020,85703,295497,381200,MKT
06079824101140000,2019,85703,295497,381200,MKT
06079824101150000,2021,117539,349961,467500,MKT
06079824101150000,2020,85703,268597,354300,OVR
06079824101150000,2019,85703,268597,354300,MKT
06079824101160000,2021,117539,322361,439900,MKT
06079824101160000,2020,85703,283497,369200,MKT
06079824101160000,2019,85703,283497,369200,MKT
06079824101170000,2021,117539,324061,441600,MKT
06079824101170000,2020,85703,311297,397000,MKT
06079824101170000,2019,85703,311297,397000,MKT
06079824101180000,2021,117539,394161,511700,MKT
06079824101180000,2020,85703,334197,419900,OVR
06079824101180000,2019,85703,334197,419900,MKT
06079824101190000,2021,117539,307461,425000,MKT
06079824101190000,2020,85703,262397,348100,MKT
06079824101190000,2019,85703,262397,348100,MKT
06079824101200000,2021,117539,319961,437500,MKT
06079824101200000,2020,85703,312597,398300,MKT
06079824101200000,2019,85703,304697,390400,MKT
06079824101210000,2021,117539,337661,455200,MKT
06079824101210000,2020,85703,265397,351100,MKT
06079824101210000,2019,85703,265397,351100,MKT
06079824101220000,2021,117539,430261,547800,MKT
06079824101220000,2020,85703,340497,426200,MKT
06079824101220000,2019,85703,340497,426200,MKT
06079824101230000,2021,117539,335261,452800,MKT
06079824101230000,2020,85703,322497,408200,MKT
06079824101230000,2019,85703,322497,408200,MKT
06079824101240000,2021,120517,261583,382100,MKT
06079824101240000,2020,87844,264056,351900,MKT
06079824101240000,2019,87844,264056,351900,MKT
06079824103010000,2021,122234,345266,467500,MKT
06079824103010000,2020,89077,304123,393200,MKT
06079824103010000,2019,89077,304123,393200,MKT
06079824103020000,2021,142328,292672,435000,MKT
06079824103020000,2020,103498,258602,362100,MKT
06079824103020000,2019,103498,258602,362100,MKT
06079824103030000,2021,139019,389981,529000,MKT
06079824103030000,2020,101126,357774,458900,MKT
06079824103030000,2019,101126,357774,458900,MKT
06079824103040000,2021,139019,327181,466200,MKT
06079824103040000,2020,101126,268274,369400,MKT
06079824103040000,2019,101126,268274,369400,MKT
06079824103050000,2021,139019,323381,462400,MKT
06079824103050000,2020,101126,263874,365000,MKT
06079824103050000,2019,101126,263874,365000,MKT
06079824103060000,2021,139019,332381,471400,MKT
06079824103060000,2020,101126,265374,366500,MKT
06079824103060000,2019,101126,265374,366500,MKT
06079824103070000,2021,139019,339081,478100,MKT
06079824103070000,2020,101126,354874,456000,MKT
06079824103070000,2019,101126,354874,456000,MKT
06079824103080000,2021,146353,351647,498000,MKT
06079824103080000,2020,106383,324817,431200,MKT
06079824103080000,2019,106383,306517,412900,MKT
06079824103090000,2021,146353,360247,506600,MKT
06079824103090000,2020,106383,298017,404400,MKT
06079824103090000,2019,106383,260217,366600,MKT
06079824103100000,2021,136483,301917,438400,MKT
06079824103100000,2020,99306,266394,365700,MKT
06079824103100000,2019,99306,266394,365700,MKT
06079824103110000,2021,136483,338917,475400,MKT
06079824103110000,2020,99306,295394,394700,MKT
06079824103110000,2019,99306,295394,394700,MKT
06079824103120000,2021,137334,336666,474000,MKT
06079824103120000,2020,99917,312283,412200,MKT
06079824103120000,2019,99917,312283,412200,MKT
06079824103130000,2021,137378,331022,468400,MKT
06079824103130000,2020,99948,284552,384500,MKT
06079824103130000,2019,99948,284552,384500,MKT
06079824103140000,2021,143545,384955,528500,MKT
06079824103140000,2020,104370,323030,427400,MKT
06079824103140000,2019,104370,323030,427400,MKT
06079824103150000,2021,158261,318939,477200,MKT
06079824103150000,2020,114912,314988,429900,MKT
06079824103150000,2019,114912,314988,429900,MKT
06079824103160000,2021,116893,327407,444300,MKT
06079824103160000,2020,85239,274261,359500,MKT
06079824103160000,2019,85239,274261,359500,MKT
06079824103170000,2021,116893,335907,452800,MKT
06079824103170000,2020,85239,309261,394500,MKT
06079824103170000,2019,85239,309261,394500,MKT
06079824103180000,2021,122234,313266,435500,MKT
06079824103180000,2020,89077,276123,365200,MKT
06079824103180000,2019,89077,276123,365200,MKT
06079824103190000,2021,122234,325866,448100,MKT
06079824103190000,2020,89077,279323,368400,MKT
06079824103190000,2019,89077,279323,368400,MKT
06079824103200000,2021,120733,348867,469600,MKT
06079824103200000,2020,87999,290801,378800,MKT
06079824103200000,2019,87999,290801,378800,MKT
06079824103210000,2021,153554,291946,445500,MKT
06079824103210000,2020,111541,289259,400800,MKT
06079824103210000,2019,111541,289259,400800,MKT
06079824103220000,2021,140518,425182,565700,MKT
06079824103220000,2020,102200,362000,464200,MKT
06079824103220000,2019,102200,362000,464200,MKT
06079824103230000,2021,136160,370640,506800,MKT
06079824103230000,2020,99075,278025,377100,OVR
06079824103230000,2019,99075,278025,377100,MKT
06079824103240000,2021,135836,286964,422800,MKT
06079824103240000,2020,98843,250757,349600,MKT
06079824103240000,2019,98843,250757,349600,MKT
06079824103250000,2021,134995,404005,539000,MKT
06079824103250000,2020,98239,383961,482200,MKT
06079824103250000,2019,98239,383961,482200,MKT
06079824103260000,2021,134995,334005,469000,MKT
06079824103260000,2020,98239,290961,389200,MKT
06079824103260000,2019,98239,290961,389200,MKT
06079824103270000,2021,144757,300743,445500,MKT
06079824103270000,2020,105239,273661,378900,MKT
06079824103270000,2019,105239,273661,378900,MKT
06079824103280000,2021,144757,344643,489400,MKT
06079824103280000,2020,105239,282661,387900,MKT
06079824103280000,2019,105239,282661,387900,MKT
06079824103290000,2021,131183,325617,456800,MKT
06079824103290000,2020,95504,295196,390700,MKT
06079824103290000,2019,95504,295196,390700,MKT
06079824103300000,2021,131183,348717,479900,MKT
06079824103300000,2020,95504,322996,418500,MKT
06079824103300000,2019,95504,322996,418500,MKT
06079824103310000,2021,115801,366099,481900,MKT
06079824103310000,2020,84454,343546,428000,MKT
06079824103310000,2019,84454,343546,428000,MKT
06079824103320000,2021,131183,320917,452100,MKT
06079824103320000,2020,95504,279096,374600,MKT
06079824103320000,2019,95504,279096,374600,MKT
06079824103330000,2021,131183,291417,422600,MKT
06079824103330000,2020,95504,269896,365400,MKT
06079824103330000,2019,95504,269896,365400,MKT
06079824103340000,2021,131183,294817,426000,MKT
06079824103340000,2020,95504,257996,353500,MKT
06079824103340000,2019,95504,257996,353500,MKT
06079824103350000,2021,132436,339364,471800,MKT
06079824103350000,2020,96403,306897,403300,OVR
06079824103350000,2019,96403,306897,403300,MKT
06079824103360000,2021,136673,311627,448300,MKT
06079824103360000,2020,99442,255558,355000,MKT
06079824103360000,2019,99442,255558,355000,MKT
06079824104010000,2021,121664,316836,438500,MKT
06079824104010000,2020,88668,274732,363400,MKT
06079824104010000,2019,88668,274732,363400,MKT
06079824104020000,2021,117893,294307,412200,MKT
06079824104020000,2020,85958,260942,346900,MKT
06079824104020000,2019,85958,260942,346900,MKT
06079824104030000,2021,117893,322507,440400,MKT
06079824104030000,2020,85958,291842,377800,MKT
06079824104030000,2019,85958,291842,377800,MKT
06079824104040000,2021,116349,354351,470700,MKT
06079824104040000,2020,84848,314152,399000,MKT
06079824104040000,2019,84848,314152,399000,MKT
06079824104050000,2021,117672,314028,431700,MKT
06079824104050000,2020,85799,282301,368100,MKT
06079824104050000,2019,85799,282301,368100,MKT
06079824104060000,2021,115568,310632,426200,MKT
06079824104060000,2020,84287,277413,361700,MKT
06079824104060000,2019,84287,277413,361700,MKT
06079824104070000,2021,115568,317132,432700,MKT
06079824104070000,2020,84287,297013,381300,MKT
06079824104070000,2019,84287,297013,381300,MKT
06079824104080000,2021,117893,301707,419600,MKT
06079824104080000,2020,85958,262642,348600,MKT
06079824104080000,2019,85958,262642,348600,MKT
06079824105010000,2021,147547,348053,495600,MKT
06079824105010000,2020,111134,352766,463900,OVR
06079824105010000,2019,111134,352766,463900,MKT
06079824105020000,2021,141100,304600,445700,MKT
06079824105020000,2020,106345,289655,396000,MKT
06079824105020000,2019,106345,289655,396000,MKT
06079824105030000,2021,141100,328000,469100,MKT
06079824105030000,2020,106345,335855,442200,MKT
06079824105030000,2019,106345,302455,408800,MKT
06079824105040000,2021,141100,316800,457900,MKT
06079824105040000,2020,106345,285555,391900,MKT
06079824105040000,2019,106345,285555,391900,MKT
06079824105050000,2021,141100,303300,444400,MKT
06079824105050000,2020,106345,271855,378200,MKT
06079824105050000,2019,106345,271855,378200,MKT
06079824105096500,2021,111559,0,111559,COST
06079824105096500,2020,80029,0,80029,COST
06079824105096500,2019,80029,0,80029,COST
06079824106010000,2021,180361,286139,466500,MKT
06079824106010000,2020,130716,297884,428600,MKT
06079824106010000,2019,130716,297884,428600,MKT
06079824106020000,2021,120460,322340,442800,MKT
06079824106020000,2020,87803,277297,365100,MKT
06079824106020000,2019,87803,277297,365100,MKT
06079824106037000,2021,555103,0,555103,COST
06079824106037000,2020,395964,0,395964,COST
06079824106037000,2019,395964,0,395964,COST
06079824106130000,2021,118935,260665,379600,MKT
06079824106130000,2020,86707,255193,341900,OVR
06079824106130000,2019,86707,255193,341900,MKT
06079824106140000,2021,119358,337942,457300,MKT
06079824106140000,2020,87011,274489,361500,MKT
06079824106140000,2019,87011,274489,361500,MKT
06079824106150000,2021,119358,310342,429700,MKT
06079824106150000,2020,87011,274289,361300,MKT
06079824106150000,2019,87011,274289,361300,MKT
06079824106160000,2021,119358,369842,489200,MKT
06079824106160000,2020,87011,312189,399200,MKT
06079824106160000,2019,87011,312189,399200,MKT
06079824107010000,2021,127102,311498,438600,MKT
06079824107010000,2020,92574,263826,356400,MKT
06079824107010000,2019,92574,258226,350800,MKT
06079824107020000,2021,127102,338698,465800,MKT
06079824107020000,2020,92574,295326,387900,MKT
06079824107020000,2019,92574,295326,387900,MKT
06079824107030000,2021,127102,321398,448500,MKT
06079824107030000,2020,92574,275326,367900,MKT
06079824107030000,2019,92574,275326,367900,MKT
06079824107040000,2021,127102,331598,458700,MKT
06079824107040000,2020,92574,282026,374600,MKT
06079824107040000,2019,92574,282026,374600,MKT
06079824107050000,2021,127102,301198,428300,MKT
06079824107050000,2020,92574,262926,355500,MKT
06079824107050000,2019,92574,262926,355500,MKT
06079824107060000,2021,127102,342098,469200,MKT
06079824107060000,2020,92574,275426,368000,MKT
06079824107060000,2019,92574,275426,368000,MKT
06079824107070000,2021,127102,313298,440400,MKT
06079824107070000,2020,92574,308426,401000,MKT
06079824107070000,2019,92574,308426,401000,MKT
06079824107080000,2021,143682,306118,449800,MKT
06079824107080000,2020,104469,263531,368000,MKT
06079824107080000,2019,104469,261331,365800,MKT
06079824107090000,2021,148973,332127,481100,MKT
06079824107090000,2020,108260,276640,384900,MKT
06079824107090000,2019,108260,276640,384900,MKT
06079824107100000,2021,138926,308574,447500,MKT
06079824107100000,2020,101059,259441,360500,MKT
06079824107100000,2019,101059,259441,360500,MKT
06079824107110000,2021,139792,307908,447700,MKT
06079824107110000,2020,101680,253520,355200,MKT
06079824107110000,2019,101680,253520,355200,MKT
06079824107120000,2021,139792,306308,446100,MKT
06079824107120000,2020,101680,268220,369900,MKT
06079824107120000,2019,101680,268220,369900,MKT
06079824107130000,2021,139397,345303,484700,MKT
06079824107130000,2020,101397,281803,383200,MKT
06079824107130000,2019,101397,281803,383200,MKT
06079824107140000,2021,137076,321924,459000,MKT
06079824107140000,2020,99732,275568,375300,MKT
06079824107140000,2019,99732,275568,375300,MKT
06079824107150000,2021,187443,322757,510200,MKT
06079824107150000,2020,140707,291793,432500,MKT
06079824107150000,2019,140707,291793,432500,MKT
06079824107160000,2021,141612,309088,450700,MKT
06079824107160000,2020,102984,282616,385600,MKT
06079824107160000,2019,102984,282616,385600,MKT
06079824107170000,2021,124268,323032,447300,MKT
06079824107170000,2020,90539,258261,348800,MKT
06079824107170000,2019,90539,258261,348800,MKT
06079824107180000,2021,127727,325573,453300,MKT
06079824107180000,2020,93023,278377,371400,MKT
06079824107180000,2019,93023,278377,371400,MKT
06079824107190000,2021,128072,312128,440200,MKT
06079824107190000,2020,93271,288929,382200,MKT
06079824107190000,2019,93271,288929,382200,MKT
06079824107200000,2021,128072,282728,410800,MKT
06079824107200000,2020,93271,253329,346600,MKT
06079824107200000,2019,93271,253329,346600,MKT
06079824107210000,2021,127279,251421,378700,MKT
06079824107210000,2020,92701,251699,344400,MKT
06079824107210000,2019,92701,251699,344400,MKT
06079824107220000,2021,136483,347917,484400,MKT
06079824107220000,2020,99306,284894,384200,MKT
06079824107220000,2019,99306,273494,372800,MKT
06079824107230000,2021,136483,313317,449800,MKT
06079824107230000,2020,99306,321194,420500,MKT
06079824107230000,2019,99306,321194,420500,MKT
06079824107240000,2021,127279,315421,442700,MKT
06079824107240000,2020,92701,263899,356600,MKT
06079824107240000,2019,92701,263899,356600,MKT
06079824107250000,2021,128072,288828,416900,MKT
06079824107250000,2020,93271,263929,357200,MKT
06079824107250000,2019,93271,263929,357200,MKT
06079824107260000,2021,128072,313328,441400,MKT
06079824107260000,2020,93271,286929,380200,MKT
06079824107260000,2019,93271,286929,380200,MKT
06079824107270000,2021,127639,299861,427500,MKT
06079824107270000,2020,92960,268040,361000,MKT
06079824107270000,2019,92960,268040,361000,MKT
06079824107280000,2021,125835,331665,457500,MKT
06079824107280000,2020,91664,289636,381300,MKT
06079824107280000,2019,91664,289636,381300,MKT
06079824107290000,2021,145805,329095,474900,MKT
06079824107290000,2020,105990,301210,407200,MKT
06079824107290000,2019,105990,301210,407200,MKT
06079824107300000,2021,141612,344188,485800,MKT
06079824107300000,2020,102984,322616,425600,MKT
06079824107300000,2019,102984,322616,425600,MKT
06079824107310000,2021,124254,369646,493900,MKT
06079824107310000,2020,90529,341471,432000,MKT
06079824107310000,2019,90529,341471,432000,MKT
06079824107320000,2021,127720,318580,446300,MKT
06079824107320000,2020,93018,258682,351700,MKT
06079824107320000,2019,93018,258682,351700,MKT
06079824107330000,2021,128072,341428,469500,MKT
06079824107330000,2020,93271,287229,380500,MKT
06079824107330000,2019,93271,278729,372000,MKT
06079824107340000,2021,128072,347328,475400,MKT
06079824107340000,2020,93271,327529,420800,MKT
06079824107340000,2019,93271,327529,420800,MKT
06079824107350000,2021,127279,323021,450300,MKT
06079824107350000,2020,92701,315699,408400,MKT
06079824107350000,2019,92701,315699,408400,MKT
06079824107360000,2021,136483,283917,420400,MKT
06079824107360000,2020,99306,256794,356100,MKT
06079824107360000,2019,99306,261394,360700,MKT
06079824107370000,2021,136483,269417,405900,MKT
06079824107370000,2020,99306,236994,336300,MKT
06079824107370000,2019,99306,236994,336300,MKT
06079824107380000,2021,127279,292721,420000,MKT
06079824107380000,2020,92701,253999,346700,MKT
06079824107380000,2019,92701,253999,346700,MKT
06079824107390000,2021,128072,323128,451200,MKT
06079824107390000,2020,93271,317429,410700,MKT
06079824107390000,2019,93271,317429,410700,MKT
06079824107400000,2021,128072,287128,415200,MKT
06079824107400000,2020,93271,263429,356700,MKT
06079824107400000,2019,93271,263429,356700,MKT
06079824107410000,2021,127625,303275,430900,MKT
06079824107410000,2020,92950,308350,401300,MKT
06079824107410000,2019,92950,316750,409700,MKT
06079824107420000,2021,125828,358772,484600,MKT
06079824107420000,2020,91659,294641,386300,MKT
06079824107420000,2019,91659,294641,386300,MKT
06079824107430000,2021,145758,331942,477700,MKT
06079824107430000,2020,105956,271944,377900,MKT
06079824107430000,2019,105956,271944,377900,MKT
06079824107440000,2021,158028,315072,473100,MKT
06079824107440000,2020,114745,296655,411400,MKT
06079824107440000,2019,114745,296655,411400,MKT
06079824107450000,2021,120934,316166,437100,MKT
06079824107450000,2020,88144,274256,362400,MKT
06079824107450000,2019,88144,274256,362400,MKT
06079824107460000,2021,125012,332788,457800,MKT
06079824107460000,2020,91073,290127,381200,MKT
06079824107460000,2019,91073,290127,381200,MKT
06079824107470000,2021,125372,320928,446300,MKT
06079824107470000,2020,91332,280568,371900,MKT
06079824107470000,2019,91332,280568,371900,MKT
06079824107480000,2021,125917,412983,538900,MKT
06079824107480000,2020,91723,327477,419200,MKT
06079824107480000,2019,91723,300177,391900,MKT
06079824107490000,2021,125917,312183,438100,MKT
06079824107490000,2020,91723,268077,359800,MKT
06079824107490000,2019,91723,268077,359800,MKT
06079824107500000,2021,133605,258895,392500,MKT
06079824107500000,2020,97242,252158,349400,MKT
06079824107500000,2019,97242,252158,349400,MKT
06079824107510000,2021,133605,330995,464600,MKT
06079824107510000,2020,97242,291058,388300,MKT
06079824107510000,2019,97242,291058,388300,MKT
06079824107520000,2021,124595,316005,440600,MKT
06079824107520000,2020,90774,331826,422600,OVR
06079824107520000,2019,90774,331826,422600,MKT
06079824107530000,2021,125372,306528,431900,MKT
06079824107530000,2020,91332,274968,366300,MKT
06079824107530000,2019,91332,274968,366300,MKT
06079824107540000,2021,125372,358028,483400,MKT
06079824107540000,2020,91332,298868,390200,MKT
06079824107540000,2019,91332,298868,390200,MKT
06079824107550000,2021,125372,276628,402000,MKT
06079824107550000,2020,91332,254968,346300,MKT
06079824107550000,2019,91332,254968,346300,MKT
06079824107560000,2021,132723,268677,401400,MKT
06079824107560000,2020,96609,243291,339900,MKT
06079824107560000,2019,96609,243291,339900,MKT
06079824107570000,2021,131144,285356,416500,MKT
06079824107570000,2020,95475,250925,346400,MKT
06079824107570000,2019,95475,250925,346400,MKT
06079824108010000,2021,122234,318666,440900,MKT
06079824108010000,2020,89077,286523,375600,MKT
06079824108010000,2019,89077,286523,375600,MKT
06079824108020000,2021,116109,380291,496400,MKT
06079824108020000,2020,84676,327724,412400,MKT
06079824108020000,2019,84676,327724,412400,MKT
06079824108030000,2021,116109,297291,413400,MKT
06079824108030000,2020,84676,272124,356800,MKT
06079824108030000,2019,84676,272124,356800,MKT
06079824108040000,2021,116109,329191,445300,MKT
06079824108040000,2020,84676,298724,383400,MKT
06079824108040000,2019,84676,298724,383400,MKT
06079824108050000,2021,131552,326448,458000,MKT
06079824108050000,2020,95768,274232,370000,MKT
06079824108050000,2019,95768,274232,370000,MKT
06079824108060000,2021,128861,349139,478000,MKT
06079824108060000,2020,93837,312163,406000,MKT
06079824108060000,2019,93837,312163,406000,MKT
06079824108070000,2021,131552,318548,450100,MKT
06079824108070000,2020,95768,326132,421900,MKT
06079824108070000,2019,95768,326132,421900,MKT
06079824108080000,2021,131552,307748,439300,MKT
06079824108080000,2020,95768,269332,365100,MKT
06079824108080000,2019,95768,269332,365100,MKT
06079824108090000,2021,128861,297939,426800,MKT
06079824108090000,2020,93837,262763,356600,MKT
06079824108090000,2019,93837,262763,356600,MKT
06079824108100000,2021,130939,282361,413300,MKT
06079824108100000,2020,95328,260172,355500,MKT
06079824108100000,2019,95328,253372,348700,MKT
06079824108110000,2021,121092,345208,466300,MKT
06079824108110000,2020,88257,324443,412700,MKT
06079824108110000,2019,88257,324443,412700,MKT
06079824108120000,2021,121092,327508,448600,MKT
06079824108120000,2020,88257,292443,380700,MKT
06079824108120000,2019,88257,292443,380700,MKT
06079824108130000,2021,121092,331108,452200,MKT
06079824108130000,2020,88257,299743,388000,MKT
06079824108130000,2019,88257,299743,388000,MKT
06079824109016500,2021,176318,0,176318,COST
06079824109016500,2020,100064,0,100064,COST
06079824109016500,2019,100064,0,100064,COST
06079824110010000,2021,1518819,0,1518819,COST
06079824110010000,2020,586823,0,586823,COST
06079824110010000,2019,586823,0,586823,COST
06079824130010000,2021,164308,340592,504900,MKT
06079824130010000,2020,94944,370056,465000,MKT
06079824130010000,2019,94944,348656,443600,MKT
06079824130030000,2021,178469,448531,627000,MKT
06079824130030000,2020,103006,406994,510000,MKT
06079824130030000,2019,103006,406994,510000,MKT
06079824130050000,2021,146033,367667,513700,MKT
06079824130050000,2020,84525,385275,469800,MKT
06079824130050000,2019,84525,385275,469800,MKT
06079824130070000,2021,158803,350597,509400,MKT
06079824130070000,2020,91807,318393,410200,MKT
06079824130070000,2019,91807,318393,410200,MKT
06079824130090000,2021,145588,492612,638200,MKT
06079824130090000,2020,84270,427630,511900,MKT
06079824130090000,2019,84270,427630,511900,MKT
06079824130110000,2021,145588,467312,612900,MKT
06079824130110000,2020,84270,404430,488700,MKT
06079824130110000,2019,84270,404430,488700,MKT
06079824130130000,2021,158803,416097,574900,MKT
06079824130130000,2020,91807,395793,487600,MKT
06079824130130000,2019,91807,359893,451700,MKT
06079824130150000,2021,146033,434067,580100,MKT
06079824130150000,2020,84525,406375,490900,MKT
06079824130150000,2019,84525,406375,490900,MKT
06079824130170000,2021,158803,408697,567500,MKT
06079824130170000,2020,91807,389093,480900,MKT
06079824130170000,2019,91807,389093,480900,MKT
06079824130190000,2021,145588,475212,620800,MKT
06079824130190000,2020,84270,438330,522600,MKT
06079824130190000,2019,84270,397630,481900,MKT
06079824131020000,2021,172621,336479,509100,MKT
06079824131020000,2020,99678,342722,442400,MKT
06079824131020000,2019,99678,342722,442400,MKT
06079824131040000,2021,163411,363589,527000,MKT
06079824131040000,2020,94433,357767,452200,MKT
06079824131040000,2019,94433,352267,446700,MKT
06079824131066500,2021,62131,0,62131,COST
06079824131066500,2020,35785,0,35785,COST
06079824131066500,2019,35785,0,35785,COST
06079824131080000,2021,226435,461665,688100,MKT
06079824131080000,2020,110641,405404,516045,OVR
06079824131080000,2019,110641,405404,516045,OVR
06079824131100000,2021,256205,553995,810200,MKT
06079824131100000,2020,124969,461931,586900,MKT
06079824131100000,2019,124969,461931,586900,MKT
06079824132020000,2021,189549,0,189549,COST
06079824132020000,2020,109308,0,109308,COST
06079824132020000,2019,109308,0,109308,COST
06079824132040000,2021,174373,511827,686200,MKT
06079824132040000,2020,100675,413325,514000,OVR
06079824132040000,2019,100675,413325,514000,OVR
06079824133020000,2021,216579,605121,821700,MKT
06079824133020000,2020,124660,478540,603200,MKT
06079824133020000,2019,124660,478540,603200,MKT
06079824133040000,2021,205908,623992,829900,MKT
06079824133040000,2020,118603,506597,625200,MKT
06079824133040000,2019,118603,211250,329853,COST
06079824136010000,2021,180162,332738,512900,MKT
06079824136010000,2020,103969,381231,485200,MKT
06079824136010000,2019,103969,381231,485200,MKT
06079824136030000,2021,178469,347131,525600,MKT
06079824136030000,2020,103006,360694,463700,MKT
06079824136030000,2019,103006,360694,463700,MKT
06079824136050000,2021,197311,335589,532900,MKT
06079824136050000,2020,113719,379381,493100,MKT
06079824136050000,2019,113719,379381,493100,MKT
06079824136070000,2021,186239,430061,616300,MKT
06079824136070000,2020,107426,407474,514900,MKT
06079824136070000,2019,107426,407474,514900,MKT
06079824136090000,2021,158907,332693,491600,MKT
06079824136090000,2020,91866,337834,429700,MKT
06079824136090000,2019,91866,337834,429700,MKT
06079824136110000,2021,154318,293282,447600,MKT
06079824136110000,2020,89251,307249,396500,MKT
06079824136110000,2019,89251,307249,396500,MKT
06079824136130000,2021,155350,398750,554100,MKT
06079824136130000,2020,89839,320261,410100,MKT
06079824136130000,2019,89839,320261,410100,MKT
06079824136150000,2021,155350,307550,462900,MKT
06079824136150000,2020,89839,325561,415400,MKT
06079824136150000,2019,89839,325561,415400,MKT
06079824136170000,2021,154318,567282,721600,MKT
06079824136170000,2020,89251,513349,602600,MKT
06079824136170000,2019,89251,513349,602600,MKT
06079824136190000,2021,158864,484436,643300,MKT
06079824136190000,2020,91842,438358,530200,MKT
06079824136190000,2019,91842,438358,530200,MKT
06079824136210000,2021,182124,471876,654000,MKT
06079824136210000,2020,105085,481815,586900,MKT
06079824136210000,2019,105085,481815,586900,MKT
06079824136230000,2021,158447,490453,648900,MKT
06079824136230000,2020,91604,415496,507100,MKT
06079824136230000,2019,91604,415496,507100,MKT
06079824136250000,2021,154327,604773,759100,MKT
06079824136250000,2020,89256,642650,731906,COST
06079824136250000,2019,89256,0,89256,COST
06079824136270000,2021,155350,589350,744700,MKT
06079824136270000,2020,89839,527161,617000,MKT
06079824136270000,2019,89839,425561,515400,MKT
06079824201010000,2021,4144,0,4144,COST
06079824201010000,2020,3857,0,3857,COST
06079824201010000,2019,3857,0,3857,COST
06079824201027000,2021,3533959,181260,3715219,COST
06079824201027000,2020,1750056,188970,1939026,COST
06079824201027000,2019,1750056,188970,1939026,COST
06079824201040000,2021,582,0,582,COST
06079824201040000,2020,542,0,542,COST
06079824201040000,2019,542,0,542,COST
06079824201067000,2021,2364168,172160,2536328,COST
06079824201067000,2020,1473207,178130,1651337,COST
06079824201067000,2019,1473207,178130,1651337,COST
06079824201100000,2021,834,0,834,COST
06079824201100000,2020,776,0,776,COST
06079824201100000,2019,776,0,776,COST
06079824201140000,2021,423,0,423,COST
06079824201140000,2020,394,0,394,COST
06079824201140000,2019,394,0,394,COST
06079824201166500,2021,109813,0,109813,COST
06079824201166500,2020,78794,0,78794,COST
06079824201166500,2019,78794,0,78794,COST
06079824201206500,2021,297179,0,297179,COST
06079824201206500,2020,210254,0,210254,COST
06079824201206500,2019,210254,0,210254,COST
06079824202010000,2021,132358,338442,470800,MKT
06079824202010000,2020,96347,301253,397600,MKT
06079824202010000,2019,96347,301253,397600,MKT
06079824202020000,2021,130323,324877,455200,MKT
06079824202020000,2020,94886,277814,372700,MKT
06079824202020000,2019,94886,277814,372700,MKT
06079824202030000,2021,131031,297169,428200,MKT
06079824202030000,2020,95395,239205,334600,MKT
06079824202030000,2019,95395,239205,334600,MKT
06079824202040000,2021,143892,298408,442300,MKT
06079824202040000,2020,104619,281981,386600,MKT
06079824202040000,2019,104619,281981,386600,MKT
06079824202050000,2021,145137,306463,451600,MKT
06079824202050000,2020,105511,278689,384200,MKT
06079824202050000,2019,105511,278689,384200,MKT
06079824202060000,2021,136382,296218,432600,MKT
06079824202060000,2020,99234,277366,376600,MKT
06079824202060000,2019,99234,277366,376600,MKT
06079824202070000,2021,116079,298621,414700,MKT
06079824202070000,2020,84654,230646,315300,MKT
06079824202070000,2019,84654,230646,315300,MKT
06079824202080000,2021,124345,304955,429300,MKT
06079824202080000,2020,90594,268606,359200,MKT
06079824202080000,2019,90594,268606,359200,MKT
06079824202090000,2021,124345,316155,440500,MKT
06079824202090000,2020,90594,258706,349300,MKT
06079824202090000,2019,90594,258706,349300,MKT
06079824202100000,2021,124345,333655,458000,MKT
06079824202100000,2020,90594,291306,381900,MKT
06079824202100000,2019,90594,291306,381900,MKT
06079824202110000,2021,124345,329155,453500,MKT
06079824202110000,2020,90594,275106,365700,MKT
06079824202110000,2019,90594,275106,365700,MKT
06079824202120000,2021,116826,380874,497700,MKT
06079824202120000,2020,85191,302009,387200,MKT
06079824202120000,2019,85191,302009,387200,MKT
06079824202130000,2021,134418,318782,453200,MKT
06079824202130000,2020,97825,290275,388100,MKT
06079824202130000,2019,97825,290275,388100,MKT
06079824202140000,2021,144292,304208,448500,MKT
06079824202140000,2020,104906,296094,401000,MKT
06079824202140000,2019,104906,296094,401000,MKT
06079824202150000,2021,131460,279240,410700,MKT
06079824202150000,2020,95702,253498,349200,MKT
06079824202150000,2019,95702,253498,349200,MKT
06079824202160000,2021,116281,364119,480400,MKT
06079824202160000,2020,84799,319301,404100,MKT
06079824202160000,2019,84799,319301,404100,MKT
06079824202170000,2021,120647,327153,447800,MKT
06079824202170000,2020,87937,287163,375100,MKT
06079824202170000,2019,87937,287163,375100,MKT
06079824202180000,2021,124345,292455,416800,MKT
06079824202180000,2020,90594,262406,353000,MKT
06079824202180000,2019,90594,262406,353000,MKT
06079824202190000,2021,130263,364037,494300,MKT
06079824202190000,2020,94844,293856,388700,MKT
06079824202190000,2019,94844,293856,388700,MKT
06079824202200000,2021,130263,347337,477600,MKT
06079824202200000,2020,94844,275956,370800,MKT
06079824202200000,2019,94844,275956,370800,MKT
06079824202210000,2021,130263,340737,471000,MKT
06079824202210000,2020,94844,273456,368300,MKT
06079824202210000,2019,94844,273456,368300,MKT
06079824202220000,2021,129684,388716,518400,MKT
06079824202220000,2020,94428,336572,431000,MKT
06079824202220000,2019,94428,336572,431000,MKT
06079824206010000,2021,130323,318277,448600,MKT
06079824206010000,2020,94886,273414,368300,MKT
06079824206010000,2019,94886,273414,368300,MKT
06079824206020000,2021,120517,266183,386700,MKT
06079824206020000,2020,87844,260356,348200,MKT
06079824206020000,2019,87844,260356,348200,MKT
06079824206030000,2021,120517,319183,439700,MKT
06079824206030000,2020,87844,286456,374300,MKT
06079824206030000,2019,87844,286456,374300,MKT
06079824206040000,2021,120517,295083,415600,MKT
06079824206040000,2020,87844,262156,350000,MKT
06079824206040000,2019,87844,262156,350000,MKT
06079824206050000,2021,117539,371461,489000,MKT
06079824206050000,2020,85703,355197,440900,MKT
06079824206050000,2019,85703,355197,440900,MKT
06079824206060000,2021,117539,325061,442600,MKT
06079824206060000,2020,85703,299697,385400,MKT
06079824206060000,2019,85703,299697,385400,MKT
06079824206070000,2021,117539,317961,435500,MKT
06079824206070000,2020,85703,316397,402100,MKT
06079824206070000,2019,85703,316397,402100,MKT
06079824206080000,2021,117539,333861,451400,MKT
06079824206080000,2020,85703,297997,383700,MKT
06079824206080000,2019,85703,297997,383700,MKT
06079824206090000,2021,117539,314161,431700,MKT
06079824206090000,2020,85703,271597,357300,MKT
06079824206090000,2019,85703,271597,357300,MKT
06079824206100000,2021,117539,336361,453900,MKT
06079824206100000,2020,85703,305897,391600,MKT
06079824206100000,2019,85703,305897,391600,MKT
06079824206110000,2021,117539,356261,473800,MKT
06079824206110000,2020,85703,339997,425700,MKT
06079824206110000,2019,85703,339997,425700,MKT
06079824206120000,2021,117539,301461,419000,MKT
06079824206120000,2020,85703,269597,355300,MKT
06079824206120000,2019,85703,269597,355300,MKT
06079824206130000,2021,117539,352461,470000,MKT
06079824206130000,2020,85703,344397,430100,MKT
06079824206130000,2019,85703,296297,382000,MKT
06079824206140000,2021,121092,311808,432900,MKT
06079824206140000,2020,88257,275343,363600,MKT
06079824206140000,2019,88257,275343,363600,MKT
06079824207010000,2021,153930,307470,461400,MKT
06079824207010000,2020,115872,275228,391100,MKT
06079824207010000,2019,115872,275228,391100,MKT
06079824207020000,2021,115681,309619,425300,MKT
06079824207020000,2020,84368,269132,353500,MKT
06079824207020000,2019,84368,269132,353500,MKT
06079824207030000,2021,115989,242911,358900,MKT
06079824207030000,2020,84589,243011,327600,MKT
06079824207030000,2019,84589,243011,327600,MKT
06079824207040000,2021,116408,259492,375900,MKT
06079824207040000,2020,84891,263009,347900,MKT
06079824207040000,2019,84891,263009,347900,MKT
06079824207050000,2021,115779,261621,377400,MKT
06079824207050000,2020,84438,251962,336400,MKT
06079824207050000,2019,84438,251962,336400,MKT
06079824207060000,2021,137265,247735,385000,MKT
06079824207060000,2020,99867,240133,340000,MKT
06079824207060000,2019,99867,240133,340000,MKT
06079824207070000,2021,126829,260771,387600,MKT
06079824207070000,2020,92378,235022,327400,MKT
06079824207070000,2019,92378,235022,327400,MKT
06079824207080000,2021,122517,294483,417000,MKT
06079824207080000,2020,89281,250919,340200,MKT
06079824207080000,2019,89281,250919,340200,MKT
06079824207090000,2021,121672,247328,369000,MKT
06079824207090000,2020,88673,241527,330200,MKT
06079824207090000,2019,88673,241527,330200,MKT
06079824207100000,2021,115674,254526,370200,MKT
06079824207100000,2020,84363,243437,327800,MKT
06079824207100000,2019,84363,243437,327800,MKT
06079824207110000,2021,126364,344136,470500,MKT
06079824207110000,2020,92044,346056,438100,MKT
06079824207110000,2019,92044,346056,438100,MKT
06079824207120000,2021,123153,270047,393200,MKT
06079824207120000,2020,89738,241162,330900,MKT
06079824207120000,2019,89738,241162,330900,MKT
06079824207130000,2021,116319,250881,367200,MKT
06079824207130000,2020,84826,248774,333600,MKT
06079824207130000,2019,84826,248774,333600,MKT
06079824207140000,2021,119111,315689,434800,MKT
06079824207140000,2020,86833,273267,360100,MKT
06079824207140000,2019,86833,273267,360100,MKT
06079824207150000,2021,145645,264055,409700,MKT
06079824207150000,2020,109721,232479,342200,MKT
06079824207150000,2019,109721,232479,342200,MKT
06079824207160000,2021,151428,299572,451000,MKT
06079824207160000,2020,114015,268385,382400,MKT
06079824207160000,2019,114015,268385,382400,MKT
06079824207170000,2021,122701,365099,487800,MKT
06079824207170000,2020,89413,319187,408600,MKT
06079824207170000,2019,89413,319187,408600,MKT
06079824207180000,2021,117265,295135,412400,MKT
06079824207180000,2020,85506,258994,344500,MKT
06079824207180000,2019,85506,254494,340000,MKT
06079824207190000,2021,116259,266341,382600,MKT
06079824207190000,2020,84783,241017,325800,MKT
06079824207190000,2019,84783,243917,328700,MKT
06079824208010000,2021,158159,423741,581900,MKT
06079824208010000,2020,114838,308370,423208,COST
06079824208010000,2019,114838,366562,481400,MKT
06079824208020000,2021,146353,252047,398400,MKT
06079824208020000,2020,106383,242917,349300,MKT
06079824208020000,2019,106383,242917,349300,MKT
06079824208030000,2021,147115,247985,395100,MKT
06079824208030000,2020,106929,237871,344800,MKT
06079824208030000,2019,106929,237871,344800,MKT
06079824208040000,2021,146370,324530,470900,MKT
06079824208040000,2020,106395,314105,420500,MKT
06079824208040000,2019,106395,314105,420500,MKT
06079824208050000,2021,146411,320889,467300,MKT
06079824208050000,2020,106425,285675,392100,MKT
06079824208050000,2019,106425,285675,392100,MKT
06079824208060000,2021,147138,248362,395500,MKT
06079824208060000,2020,106945,247955,354900,MKT
06079824208060000,2019,106945,247955,354900,MKT
06079824208070000,2021,148395,252205,400600,MKT
06079824208070000,2020,107846,240454,348300,MKT
06079824208070000,2019,107846,240454,348300,MKT
06079824208080000,2021,148395,275005,423400,MKT
06079824208080000,2020,107846,269554,377400,MKT
06079824208080000,2019,107846,269554,377400,MKT
06079824208090000,2021,148406,354694,503100,MKT
06079824208090000,2020,107854,310546,418400,MKT
06079824208090000,2019,107854,310546,418400,MKT
06079824208100000,2021,148406,245794,394200,MKT
06079824208100000,2020,107854,254346,362200,MKT
06079824208100000,2019,107854,254346,362200,MKT
06079824208110000,2021,148325,309275,457600,MKT
06079824208110000,2020,107796,274804,382600,MKT
06079824208110000,2019,107796,265504,373300,MKT
06079824208120000,2021,148279,392621,540900,MKT
06079824208120000,2020,107763,287037,394800,MKT
06079824208120000,2019,107763,287037,394800,MKT
06079824208130000,2021,148406,319894,468300,MKT
06079824208130000,2020,107854,283346,391200,MKT
06079824208130000,2019,107854,283346,391200,MKT
06079824208140000,2021,150122,310678,460800,MKT
06079824208140000,2020,109083,292617,401700,MKT
06079824208140000,2019,109083,292617,401700,MKT
06079824209010000,2021,150122,269178,419300,MKT
06079824209010000,2020,109083,258917,368000,MKT
06079824209010000,2019,109083,258917,368000,MKT
06079824209020000,2021,149030,324970,474000,MKT
06079824209020000,2020,108301,313399,421700,MKT
06079824209020000,2019,108301,313399,421700,MKT
06079824209030000,2021,175856,319744,495600,MKT
06079824209030000,2020,132127,289073,421200,MKT
06079824209030000,2019,132127,289073,421200,MKT
06079824209040000,2021,149835,316265,466100,MKT
06079824209040000,2020,112833,289067,401900,MKT
06079824209040000,2019,112833,289067,401900,MKT
06079824209040100,2021,27478,0,27478,COST
06079824209040100,2020,19034,0,19034,COST
06079824209040100,2019,19034,0,19034,COST
06079824209050000,2021,181292,365108,546400,MKT
06079824209050000,2020,136154,345046,481200,MKT
06079824209050000,2019,136154,345046,481200,MKT
06079824209060000,2021,180969,255631,436600,MKT
06079824209060000,2020,135914,246686,382600,MKT
06079824209060000,2019,135914,246686,382600,MKT
06079824209071000,2021,149707,159810,309517,COST
06079824209071000,2020,112737,159320,272057,COST
06079824209071000,2019,112737,159320,272057,COST
06079824209071001,2021,27386,0,27386,COST
06079824209071001,2020,18956,0,18956,COST
06079824209071001,2019,18956,0,18956,COST
06079824209080000,2021,180831,282269,463100,MKT
06079824209080000,2020,135812,243788,379600,MKT
06079824209080000,2019,135812,243788,379600,MKT
06079824209090000,2021,153246,248554,401800,MKT
06079824209090000,2020,111321,239979,351300,MKT
06079824209090000,2019,111321,239979,351300,MKT
06079824209100000,2021,153638,271762,425400,MKT
06079824209100000,2020,111601,264699,376300,MKT
06079824209100000,2019,111601,258099,369700,MKT
06079824209110000,2021,153638,304762,458400,MKT
06079824209110000,2020,111601,282199,393800,MKT
06079824209110000,2019,111601,282199,393800,MKT
06079824209120000,2021,154011,292489,446500,MKT
06079824209120000,2020,111869,245531,357400,MKT
06079824209120000,2019,111869,245531,357400,MKT
06079824209130000,2021,149663,283037,432700,MKT
06079824209130000,2020,108755,254045,362800,MKT
06079824209130000,2019,108755,254045,362800,MKT
06079824209140000,2021,150407,284893,435300,MKT
06079824209140000,2020,109288,252012,361300,MKT
06079824209140000,2019,109288,252012,361300,MKT
06079824209150000,2021,164701,333899,498600,MKT
06079824209150000,2020,119520,273680,393200,MKT
06079824209150000,2019,119520,273680,393200,MKT
06079824209620000,2021,144332,434368,578700,MKT
06079824209620000,2020,102382,379218,481600,MKT
06079824209620000,2019,102382,372918,475300,MKT
06079824209640000,2021,182468,313232,495700,MKT
06079824209640000,2020,137024,317376,454400,MKT
06079824209640000,2019,137024,317576,454600,MKT
06079824209660000,2021,182475,326825,509300,MKT
06079824209660000,2020,137029,324871,461900,MKT
06079824209660000,2019,137029,324871,461900,MKT
06079824209701001,2021,25312,0,25312,COST
06079824209701001,2020,17199,0,17199,COST
06079824209701001,2019,17199,0,17199,COST
06079824209701002,2021,158582,275860,434442,COST
06079824209701002,2020,119324,275260,394584,COST
06079824209701002,2019,119324,275260,394584,COST
06079824301010000,2021,2126,0,2126,COST
06079824301010000,2020,1978,0,1978,COST
06079824301010000,2019,1978,0,1978,COST
06079824301500000,2021,424,0,424,COST
06079824301500000,2020,394,0,394,COST
06079824301500000,2019,394,0,394,COST
06079824302050200,2021,344237,0,344237,COST
06079824302050200,2020,247215,0,247215,COST
06079824302050200,2019,247215,0,247215,COST
06079824302050201,2021,373208,0,373208,COST
06079824302050201,2020,267714,0,267714,COST
06079824302050201,2019,267714,0,267714,COST
06079824302150000,2021,39102,2570,41672,COST
06079824302150000,2020,41132,2480,43612,COST
06079824302150000,2019,41132,2480,43612,COST
06079824303010000,2021,195712,635988,831700,MKT
06079824303010000,2020,137418,582182,719600,MKT
06079824303010000,2019,137418,582182,719600,MKT
06079824303030000,2021,181912,368788,550700,MKT
06079824303030000,2020,127860,373340,501200,MKT
06079824303030000,2019,127860,373340,501200,MKT
06079824303050000,2021,181199,365501,546700,MKT
06079824303050000,2020,127366,365934,493300,MKT
06079824303050000,2019,127366,365934,493300,MKT
06079824303070000,2021,180474,339426,519900,MKT
06079824303070000,2020,126864,362336,489200,MKT
06079824303070000,2019,126864,362336,489200,MKT
06079824303090000,2021,182892,352408,535300,MKT
06079824303090000,2020,128539,359461,488000,MKT
06079824303090000,2019,128539,359461,488000,MKT
06079824303110000,2021,188110,546890,735000,MKT
06079824303110000,2020,132154,464146,596300,MKT
06079824303110000,2019,132154,460046,592200,MKT
06079824304010000,2021,171720,606080,777800,MKT
06079824304010000,2020,120795,583305,704100,MKT
06079824304010000,2019,120795,583305,704100,MKT
06079824304030000,2021,160051,331749,491800,MKT
06079824304030000,2020,112699,342301,455000,MKT
06079824304030000,2019,112699,342301,455000,MKT
06079824304050000,2021,163240,370060,533300,MKT
06079824304050000,2020,112691,368209,480900,MKT
06079824304050000,2019,112691,368209,480900,MKT
06079824304070000,2021,164564,302536,467100,MKT
06079824304070000,2020,113592,307708,421300,MKT
06079824304070000,2019,113592,305008,418600,MKT
06079824304090000,2021,164564,456636,621200,MKT
06079824304090000,2020,113592,427208,540800,MKT
06079824304090000,2019,113592,427208,540800,MKT
06079824304110000,2021,169357,372443,541800,MKT
06079824304110000,2020,116852,378948,495800,MKT
06079824304110000,2019,116852,378948,495800,MKT
06079824304150000,2021,169357,467543,636900,MKT
06079824304150000,2020,116852,436248,553100,MKT
06079824304150000,2019,116852,440348,557200,MKT
06079824304170000,2021,161182,373518,534700,MKT
06079824304170000,2020,111290,354710,466000,MKT
06079824304170000,2019,111290,354710,466000,MKT
06079824304190000,2021,161194,340106,501300,MKT
06079824304190000,2020,111298,337302,448600,MKT
06079824304190000,2019,111298,337302,448600,MKT
06079824304210000,2021,173948,412752,586700,MKT
06079824304210000,2020,119974,385726,505700,MKT
06079824304210000,2019,119974,379726,499700,MKT
06079824305010000,2021,173264,486536,659800,MKT
06079824305010000,2020,121866,474234,596100,MKT
06079824305010000,2019,121866,474234,596100,MKT
06079824305030000,2021,161767,347533,509300,MKT
06079824305030000,2020,113890,347110,461000,MKT
06079824305030000,2019,113890,347110,461000,MKT
06079824305050000,2021,161767,416033,577800,MKT
06079824305050000,2020,113890,409510,523400,MKT
06079824305050000,2019,113890,409510,523400,MKT
06079824305070000,2021,162974,374726,537700,MKT
06079824305070000,2020,114727,357073,471800,MKT
06079824305070000,2019,114727,357073,471800,MKT
06079824305090000,2021,162974,308926,471900,MKT
06079824305090000,2020,114727,312073,426800,MKT
06079824305090000,2019,114727,312073,426800,MKT
06079824305110000,2021,167529,633371,800900,MKT
06079824305110000,2020,117888,559912,677800,MKT
06079824305110000,2019,117888,559912,677800,MKT
06079824305150000,2021,161580,508920,670500,MKT
06079824305150000,2020,113760,476240,590000,MKT
06079824305150000,2019,113760,476240,590000,MKT
06079824305170000,2021,159716,286884,446600,MKT
06079824305170000,2020,112466,280934,393400,MKT
06079824305170000,2019,112466,280934,393400,MKT
06079824305190000,2021,159716,296584,456300,MKT
06079824305190000,2020,112466,301934,414400,OVR
06079824305190000,2019,112466,301934,414400,MKT
06079824305210000,2021,174469,457631,632100,MKT
06079824305210000,2020,122701,416399,539100,MKT
06079824305210000,2019,122701,416399,539100,MKT
06079824305230000,2021,170911,467889,638800,MKT
06079824305230000,2020,120234,422666,542900,MKT
06079824305230000,2019,120234,422666,542900,MKT
06079824305250000,2021,163770,410130,573900,MKT
06079824305250000,2020,115280,410920,526200,MKT
06079824305250000,2019,115280,410920,526200,MKT
06079824305270000,2021,163770,337830,501600,MKT
06079824305270000,2020,115280,331820,447100,MKT
06079824305270000,2019,115280,331820,447100,MKT
06079824305290000,2021,164583,390217,554800,MKT
06079824305290000,2020,115844,387656,503500,MKT
06079824305290000,2019,115844,387656,503500,MKT
06079824305310000,2021,164583,515117,679700,MKT
06079824305310000,2020,115844,473456,589300,MKT
06079824305310000,2019,115844,473456,589300,MKT
06079824305330000,2021,162788,465612,628400,MKT
06079824305330000,2020,114598,404102,518700,MKT
06079824305330000,2019,114598,404102,518700,MKT
06079824305350000,2021,162788,340312,503100,MKT
06079824305350000,2020,114598,339502,454100,MKT
06079824305350000,2019,114598,339502,454100,MKT
06079824305370000,2021,162788,468412,631200,MKT
06079824305370000,2020,114598,426002,540600,MKT
06079824305370000,2019,114598,426002,540600,MKT
06079824305390000,2021,162788,390312,553100,MKT
06079824305390000,2020,114598,391602,506200,MKT
06079824305390000,2019,114598,391602,506200,MKT
06079824305410000,2021,171244,518756,690000,MKT
06079824305410000,2020,120465,479435,599900,MKT
06079824305410000,2019,120465,479435,599900,MKT
06079824306010000,2021,197266,505934,703200,MKT
06079824306010000,2020,138493,440807,579300,MKT
06079824306010000,2019,138493,440807,579300,MKT
06079824306030000,2021,179786,514514,694300,MKT
06079824306030000,2020,126387,467513,593900,MKT
06079824306030000,2019,126387,467513,593900,MKT
06079824306050000,2021,179648,366752,546400,MKT
06079824306050000,2020,126291,395109,521400,MKT
06079824306050000,2019,126291,395109,521400,MKT
06079824306070000,2021,191591,612709,804300,MKT
06079824306070000,2020,134565,514535,649100,MKT
06079824306070000,2019,134565,514535,649100,MKT
06079824306090000,2021,174286,400014,574300,MKT
06079824306090000,2020,122574,409126,531700,MKT
06079824306090000,2019,122574,409126,531700,MKT
06079824306110000,2021,179490,653010,832500,MKT
06079824306110000,2020,126182,516218,642400,MKT
06079824306110000,2019,126182,514218,640400,MKT
06079824307010000,2021,183607,548093,731700,MKT
06079824307010000,2020,129035,477465,606500,MKT
06079824307010000,2019,129035,477465,606500,MKT
06079824307030000,2021,181502,619398,800900,MKT
06079824307030000,2020,127576,626624,754200,MKT
06079824307030000,2019,127576,626624,754200,MKT
06079824307050000,2021,180700,454700,635400,MKT
06079824307050000,2020,127020,425980,553000,MKT
06079824307050000,2019,127020,425980,553000,MKT
06079824307070000,2021,179894,496606,676500,MKT
06079824307070000,2020,126462,470138,596600,MKT
06079824307070000,2019,126462,470138,596600,MKT
06079824307090000,2021,179104,442496,621600,MKT
06079824307090000,2020,125914,445886,571800,MKT
06079824307090000,2019,125914,445886,571800,MKT
06079824307116500,2021,77107,0,77107,COST
06079824307116500,2020,53932,0,53932,COST
06079824307116500,2019,53932,0,53932,COST
06079824308010000,2021,145640,297660,443300,MKT
06079824308010000,2020,102688,284412,387100,MKT
06079824308010000,2019,102688,284412,387100,MKT
06079824308030000,2021,132080,295120,427200,MKT
06079824308030000,2020,93256,289844,383100,MKT
06079824308030000,2019,93256,289844,383100,MKT
06079824308050000,2021,132080,306120,438200,MKT
06079824308050000,2020,93256,297144,390400,MKT
06079824308050000,2019,93256,297144,390400,MKT
06079824308070000,2021,132080,306220,438300,MKT
06079824308070000,2020,93256,297144,390400,MKT
06079824308070000,2019,93256,297144,390400,MKT
06079824308090000,2021,132080,302520,434600,MKT
06079824308090000,2020,93256,283544,376800,MKT
06079824308090000,2019,93256,289244,382500,MKT
06079824308110000,2021,132080,308120,440200,MKT
06079824308110000,2020,93256,301044,394300,MKT
06079824308110000,2019,93256,296744,390000,MKT
06079824308130000,2021,132080,340220,472300,MKT
06079824308130000,2020,93256,334244,427500,MKT
06079824308130000,2019,93256,334244,427500,MKT
06079824308150000,2021,131328,279072,410400,MKT
06079824308150000,2020,92733,276067,368800,MKT
06079824308150000,2019,92733,276067,368800,MKT
06079824308170000,2021,145590,314710,460300,MKT
06079824308170000,2020,102654,305246,407900,MKT
06079824308170000,2019,102654,305246,407900,MKT
06079824308196500,2021,124154,0,124154,COST
06079824308196500,2020,86256,0,86256,COST
06079824308196500,2019,86256,0,86256,COST
06079824308210000,2021,145590,286810,432400,MKT
06079824308210000,2020,102654,266946,369600,MKT
06079824308210000,2019,102654,266946,369600,MKT
06079824308230000,2021,132080,344420,476500,MKT
06079824308230000,2020,93256,335644,428900,MKT
06079824308230000,2019,93256,331144,424400,MKT
06079824308250000,2021,133570,292430,426000,MKT
06079824308250000,2020,94293,274607,368900,MKT
06079824308250000,2019,94293,274607,368900,MKT
06079824308270000,2021,133570,285530,419100,MKT
06079824308270000,2020,94293,278907,373200,MKT
06079824308270000,2019,94293,278907,373200,MKT
06079824308290000,2021,133570,339830,473400,MKT
06079824308290000,2020,94293,329707,424000,MKT
06079824308290000,2019,94293,329707,424000,MKT
06079824308310000,2021,147702,293798,441500,MKT
06079824308310000,2020,104122,281378,385500,MKT
06079824308310000,2019,104122,281378,385500,MKT
06079824308330000,2021,147702,298298,446000,MKT
06079824308330000,2020,104122,288778,392900,MKT
06079824308330000,2019,104122,287778,391900,MKT
06079824308350000,2021,135042,303558,438600,MKT
06079824308350000,2020,95318,288782,384100,MKT
06079824308350000,2019,95318,288782,384100,MKT
06079824308370000,2021,133570,333930,467500,MKT
06079824308370000,2020,94293,341707,436000,MKT
06079824308370000,2019,94293,339107,433400,MKT
06079824308390000,2021,133570,293230,426800,MKT
06079824308390000,2020,94293,275307,369600,MKT
06079824308390000,2019,94293,275307,369600,MKT
06079824308410000,2021,133570,288330,421900,MKT
06079824308410000,2020,94293,283307,377600,MKT
06079824308410000,2019,94293,283307,377600,MKT
06079824308430000,2021,146265,291635,437900,MKT
06079824308430000,2020,103123,274877,378000,MKT
06079824308430000,2019,103123,274877,378000,MKT
06079824308450000,2021,145590,351410,497000,MKT
06079824308450000,2020,102654,347746,450400,MKT
06079824308450000,2019,102654,337846,440500,MKT
06079824308470000,2021,131328,294572,425900,MKT
06079824308470000,2020,92733,290367,383100,MKT
06079824308470000,2019,92733,290367,383100,MKT
06079824308490000,2021,132080,296520,428600,MKT
06079824308490000,2020,93256,289244,382500,MKT
06079824308490000,2019,93256,289244,382500,MKT
06079824308510000,2021,132080,296320,428400,MKT
06079824308510000,2020,93256,283144,376400,MKT
06079824308510000,2019,93256,283144,376400,MKT
06079824308530000,2021,132080,329820,461900,MKT
06079824308530000,2020,93256,338444,431700,MKT
06079824308530000,2019,93256,338444,431700,MKT
06079824308550000,2021,132080,296320,428400,MKT
06079824308550000,2020,93256,277544,370800,MKT
06079824308550000,2019,93256,284244,377500,MKT
06079824308570000,2021,132080,358420,490500,MKT
06079824308570000,2020,93256,341944,435200,MKT
06079824308570000,2019,93256,341944,435200,MKT
06079824308590000,2021,132080,306120,438200,MKT
06079824308590000,2020,93256,297144,390400,MKT
06079824308590000,2019,93256,297144,390400,MKT
06079824308610000,2021,145689,277911,423600,MKT
06079824308610000,2020,102722,271178,373900,MKT
06079824308610000,2019,102722,271178,373900,MKT
06079824309010000,2021,195360,303640,499000,MKT
06079824309010000,2020,137174,305626,442800,MKT
06079824309010000,2019,137174,305626,442800,MKT
06079824309030000,2021,178797,514103,692900,MKT
06079824309030000,2020,125702,480298,606000,MKT
06079824309030000,2019,125702,480298,606000,MKT
06079824309050000,2021,178648,616352,795000,MKT
06079824309050000,2020,125598,623702,749300,MKT
06079824309050000,2019,125598,623702,749300,MKT
06079824309070000,2021,178509,356210,534719,COST
06079824309070000,2020,125502,0,125502,COST
06079824309070000,2019,125502,0,125502,COST
06079824309090000,2021,178360,492940,671300,MKT
06079824309090000,2020,125399,447101,572500,MKT
06079824309090000,2019,125399,244800,370199,COST
06079824309110000,2021,178221,442979,621200,MKT
06079824309110000,2020,125302,449698,575000,MKT
06079824309110000,2019,125302,253050,378352,COST
06079824309130000,2021,202156,657144,859300,MKT
06079824309130000,2020,141877,589223,731100,MKT
06079824309130000,2019,141877,589223,731100,MKT
06079824310015001,2021,129046,402054,531100,MKT
06079824310015001,2020,91144,383956,475100,MKT
06079824310015001,2019,91144,383956,475100,MKT
06079824310035002,2021,113792,394308,508100,MKT
06079824310035002,2020,80513,377287,457800,MKT
06079824310035002,2019,80513,377287,457800,MKT
06079824310055001,2021,113792,387408,501200,MKT
06079824310055001,2020,80513,376187,456700,MKT
06079824310055001,2019,80513,376187,456700,MKT
06079824310075002,2021,113792,400808,514600,MKT
06079824310075002,2020,80513,382887,463400,MKT
06079824310075002,2019,80513,376187,456700,MKT
06079824310095001,2021,113792,393308,507100,MKT
06079824310095001,2020,80513,377087,457600,MKT
06079824310095001,2019,80513,377087,457600,MKT
06079824310115002,2021,113792,406708,520500,MKT
06079824310115002,2020,80513,383787,464300,MKT
06079824310115002,2019,80513,377087,457600,MKT
06079824310130000,2021,127600,413600,541200,MKT
06079824310130000,2020,90137,394663,484800,MKT
06079824310130000,2019,90137,387463,477600,MKT
06079824310150000,2021,113792,0,113792,COST
06079824310150000,2020,80513,0,80513,COST
06079824310150000,2019,80513,0,80513,COST
06079824310170000,2021,113792,0,113792,COST
06079824310170000,2020,80513,0,80513,COST
06079824310170000,2019,80513,0,80513,COST
06079824310190000,2021,113792,0,113792,COST
06079824310190000,2020,80513,0,80513,COST
06079824310190000,2019,80513,0,80513,COST
06079824310210000,2021,129603,0,129603,COST
06079824310210000,2020,91532,0,91532,COST
06079824310210000,2019,91532,0,91532,COST
06079824310235001,2021,116218,393382,509600,MKT
06079824310235001,2020,82205,377295,459500,MKT
06079824310235001,2019,82205,377295,459500,MKT
06079824310255002,2021,113792,393408,507200,MKT
06079824310255002,2020,80513,377287,457800,MKT
06079824310255002,2019,80513,377287,457800,MKT
06079824310275001,2021,113792,390208,504000,MKT
06079824310275001,2020,80513,374287,454800,MKT
06079824310275001,2019,80513,374287,454800,MKT
06079824310295002,2021,113792,390208,504000,MKT
06079824310295002,2020,80513,374287,454800,MKT
06079824310295002,2019,80513,374287,454800,MKT
06079824310315001,2021,113792,376908,490700,MKT
06079824310315001,2020,80513,367687,448200,MKT
06079824310315001,2019,80513,367687,448200,MKT
06079824310335002,2021,113792,376908,490700,MKT
06079824310335002,2020,80513,367687,448200,MKT
06079824310335002,2019,80513,367687,448200,MKT
06079824310355001,2021,113792,376008,489800,MKT
06079824310355001,2020,80513,367487,448000,MKT
06079824310355001,2019,80513,367487,448000,MKT
06079824310375002,2021,130476,387724,518200,MKT
06079824310375002,2020,92139,373961,466100,MKT
06079824310375002,2019,92139,373961,466100,MKT
06079824310395002,2021,130517,340583,471100,MKT
06079824310395002,2020,92168,344332,436500,MKT
06079824310395002,2019,92168,344332,436500,MKT
06079824310415001,2021,113904,351896,465800,MKT
06079824310415001,2020,80591,350009,430600,MKT
06079824310415001,2019,80591,350009,430600,MKT
06079824310435002,2021,113967,351833,465800,MKT
06079824310435002,2020,80635,349965,430600,MKT
06079824310435002,2019,80635,349965,430600,MKT
06079824310455001,2021,114031,350669,464700,MKT
06079824310455001,2020,80680,349020,429700,MKT
06079824310455001,2019,80680,344320,425000,MKT
06079824310475002,2021,114094,340606,454700,MKT
06079824310475002,2020,80724,344376,425100,MKT
06079824310475002,2019,80724,344376,425100,MKT
06079824310495001,2021,114142,351858,466000,MKT
06079824310495001,2020,80757,350043,430800,MKT
06079824310495001,2019,80757,350043,430800,MKT
06079824310515002,2021,114206,341494,455700,MKT
06079824310515002,2020,80802,344698,425500,MKT
06079824310515002,2019,80802,344698,425500,MKT
06079824310535001,2021,129603,351097,480700,MKT
06079824310535001,2020,91532,348568,440100,MKT
06079824310535001,2019,91532,350268,441800,MKT
06079824310556500,2021,29524,0,29524,COST
06079824310556500,2020,20933,0,20933,COST
06079824310556500,2019,20933,0,20933,COST
06079824310615002,2021,114538,321262,435800,MKT
06079824310615002,2020,81034,324166,405200,MKT
06079824310615002,2019,81034,324166,405200,MKT
06079824310635001,2021,114602,321198,435800,MKT
06079824310635001,2020,81078,324122,405200,MKT
06079824310635001,2019,81078,324122,405200,MKT
06079824310650000,2021,127543,432057,559600,MKT
06079824310650000,2020,90097,385203,475300,MKT
06079824310650000,2019,90097,385203,475300,MKT
06079824310675002,2021,114744,296756,411500,MKT
06079824310675002,2020,81177,304123,385300,MKT
06079824310675002,2019,81177,304123,385300,MKT
06079824310695001,2021,114807,296793,411600,MKT
06079824310695001,2020,81221,304079,385300,MKT
06079824310695001,2019,81221,304079,385300,MKT
06079824310715002,2021,114870,296830,411700,MKT
06079824310715002,2020,81265,304235,385500,MKT
06079824310715002,2019,81265,304235,385500,MKT
06079824310735001,2021,114917,296883,411800,MKT
06079824310735001,2020,81298,304202,385500,MKT
06079824310735001,2019,81298,304202,385500,MKT
06079824310755002,2021,114980,306520,421500,MKT
06079824310755002,2020,81342,308958,390300,MKT
06079824310755002,2019,81342,308958,390300,MKT
06079824310775001,2021,130476,305624,436100,MKT
06079824310775001,2020,92139,308961,401100,MKT
06079824310775001,2019,92139,308961,401100,MKT
06079824401020000,2021,2907750,13687340,16595090,COST
06079824401020000,2020,989147,12900690,13889837,COST
06079824401020000,2019,989147,12900690,13889837,COST
06079824401040000,2021,195900,238900,434800,MKT
06079824401040000,2020,162400,160040,322440,COST
06079824401040000,2019,162400,160040,322440,COST
06079824401980000,2021,2226,0,2226,COST
06079824401980000,2020,2072,0,2072,COST
06079824401980000,2019,2072,0,2072,COST
06079824401990000,2021,2668,0,2668,COST
06079824401990000,2020,2483,0,2483,COST
06079824401990000,2019,2483,0,2483,COST
06079824403010000,2021,248901,265699,514600,MKT
06079824403010000,2020,187253,222947,410200,MKT
06079824403010000,2019,187253,222947,410200,MKT
06079824403030000,2021,242793,248107,490900,MKT
06079824403030000,2020,181966,250134,432100,MKT
06079824403030000,2019,181966,250134,432100,MKT
06079824403070000,2021,247399,252601,500000,MKT
06079824403070000,2020,185952,246748,432700,MKT
06079824403070000,2019,185952,246748,432700,MKT
06079824404010000,2021,231373,240127,471500,MKT
06079824404010000,2020,172135,231465,403600,MKT
06079824404010000,2019,172135,231465,403600,MKT
06079824404030000,2021,229136,250250,479386,COST
06079824404030000,2020,170217,276383,446600,MKT
06079824404030000,2019,170217,276383,446600,MKT
06079824405010000,2021,299788,411312,711100,MKT
06079824405010000,2020,232042,346358,578400,MKT
06079824405010000,2019,232042,346358,578400,MKT
06079824405030000,2021,258975,489150,748125,COST
06079824405030000,2020,196018,404882,600900,MKT
06079824405030000,2019,196018,404882,600900,MKT
06079824405050000,2021,258975,837825,1096800,MKT
06079824405050000,2020,196018,617582,813600,MKT
06079824405050000,2019,196018,443060,639078,COST
06079824405450000,2021,212391,498609,711000,MKT
06079824405450000,2020,154486,458714,613200,MKT
06079824405450000,2019,154486,458714,613200,MKT
06079824405470000,2021,206201,461999,668200,MKT
06079824405470000,2020,150047,434353,584400,MKT
06079824405470000,2019,150047,434353,584400,MKT
06079824405490000,2021,208126,483074,691200,MKT
06079824405490000,2020,151428,446472,597900,MKT
06079824405490000,2019,151428,446472,597900,MKT
06079824405510000,2021,211921,429779,641700,MKT
06079824405510000,2020,154150,399650,553800,MKT
06079824405510000,2019,154150,399650,553800,MKT
06079824405530000,2021,205027,470673,675700,MKT
06079824405530000,2020,149204,440296,589500,MKT
06079824405530000,2019,149204,440296,589500,MKT
06079824405550000,2021,209282,665718,875000,MKT
06079824405550000,2020,152257,583843,736100,MKT
06079824405550000,2019,152257,583843,736100,MKT
06079824405570000,2021,212719,420581,633300,MKT
06079824405570000,2020,154722,409178,563900,MKT
06079824405570000,2019,154722,409178,563900,MKT
06079824405590000,2021,207656,552044,759700,MKT
06079824405590000,2020,151090,444810,595900,MKT
06079824405590000,2019,151090,444810,595900,MKT
06079824405610000,2021,240681,689319,930000,MKT
06079824405610000,2020,174754,601460,776214,MRA
06079824405610000,2019,174754,601460,776214,MRA
06079824405630000,2021,205095,385705,590800,MKT
06079824405630000,2020,149253,398247,547500,MKT
06079824405630000,2019,149253,398247,547500,MKT
06079824405650000,2021,202884,492016,694900,MKT
06079824405650000,2020,147667,465733,613400,MKT
06079824405650000,2019,147667,465733,613400,MKT
06079824405670000,2021,206338,517862,724200,MKT
06079824405670000,2020,147242,468158,615400,MKT
06079824405670000,2019,147242,468158,615400,MKT
06079824405690000,2021,206348,398852,605200,MKT
06079824405690000,2020,147249,379251,526500,MKT
06079824405690000,2019,147249,379251,526500,MKT
06079824405710000,2021,206338,411762,618100,MKT
06079824405710000,2020,147242,392658,539900,MKT
06079824405710000,2019,147242,392658,539900,MKT
06079824405730000,2021,206338,535362,741700,MKT
06079824405730000,2020,147242,500758,648000,MKT
06079824405730000,2019,147242,500758,648000,MKT
06079824405750000,2021,221816,375284,597100,MKT
06079824405750000,2020,158125,336275,494400,MKT
06079824405750000,2019,158125,336275,494400,MKT
06079824406017000,2021,414754,1770,416524,COST
06079824406017000,2020,298837,1710,300547,COST
06079824406017000,2019,298837,1710,300547,COST
06079824410010000,2021,217054,478646,695700,MKT
06079824410010000,2020,157830,455170,613000,MKT
06079824410010000,2019,157830,455170,613000,MKT
06079824410016500,2021,114874,0,114874,COST
06079824410016500,2020,82862,0,82862,COST
06079824410016500,2019,82862,0,82862,COST
06079824410030000,2021,209985,347415,557400,MKT
06079824410030000,2020,152761,334439,487200,MKT
06079824410030000,2019,152761,334439,487200,MKT
06079824410050000,2021,209272,467428,676700,MKT
06079824410050000,2020,152250,409850,562100,MKT
06079824410050000,2019,152250,409850,562100,MKT
06079824410070000,2021,200218,342882,543100,MKT
06079824410070000,2020,145754,323146,468900,MKT
06079824410070000,2019,145754,323146,468900,MKT
06079824410090000,2021,256869,374731,631600,MKT
06079824410090000,2020,192647,330953,523600,MKT
06079824410090000,2019,192647,330953,523600,MKT
06079824410176500,2021,206520,0,206520,COST
06079824410176500,2020,147739,0,147739,COST
06079824410176500,2019,147739,0,147739,COST
06079824410230000,2021,278751,389349,668100,MKT
06079824410230000,2020,208816,388584,597400,OVR
06079824410230000,2019,208816,388584,597400,MKT
06079824410250000,2021,220554,505846,726400,MKT
06079824410250000,2020,160338,419062,579400,MKT
06079824410250000,2019,160338,419062,579400,MKT
06079824410270000,2021,227296,548204,775500,MKT
06079824410270000,2020,165169,462131,627300,MKT
06079824410270000,2019,165169,462131,627300,MKT
06079824410290000,2021,226482,364218,590700,MKT
06079824410290000,2020,164586,311914,476500,MKT
06079824410290000,2019,164586,311914,476500,MKT
06079824410310000,2021,232414,476686,709100,MKT
06079824410310000,2020,168836,446164,615000,MKT
06079824410310000,2019,168836,446164,615000,MKT
06079824410330000,2021,233461,445539,679000,MKT
06079824410330000,2020,169585,398315,567900,MKT
06079824410330000,2019,169585,398315,567900,MKT
06079824410350000,2021,226657,436843,663500,MKT
06079824410350000,2020,164712,390788,555500,MKT
06079824410350000,2019,164712,390788,555500,MKT
06079824410370000,2021,226657,363343,590000,MKT
06079824410370000,2020,164712,316088,480800,MKT
06079824410370000,2019,164712,316088,480800,MKT
06079824410390000,2021,226657,424243,650900,MKT
06079824410390000,2020,164712,388588,553300,MKT
06079824410390000,2019,164712,388588,553300,MKT
06079824410410000,2021,272146,412954,685100,MKT
06079824410410000,2020,203938,367362,571300,MKT
06079824410410000,2019,203938,348662,552600,MKT
06079824410430000,2021,268456,686444,954900,MKT
06079824410430000,2020,201211,785220,986431,COST
06079824410430000,2019,201211,785220,986431,COST
06079824410530000,2021,261092,437608,698700,MKT
06079824410530000,2020,195769,411131,606900,MKT
06079824410530000,2019,195769,411131,606900,MKT
06079824410550000,2021,245927,390373,636300,MKT
06079824410550000,2020,184554,348646,533200,MKT
06079824410550000,2019,184554,348646,533200,MKT
06079824410570000,2021,244853,596647,841500,MKT
06079824410570000,2020,183759,531941,715700,MKT
06079824410570000,2019,183759,531941,715700,MKT
06079824410590000,2021,269443,688857,958300,MKT
06079824410590000,2020,201940,697160,899100,MKT
06079824410590000,2019,201940,697160,899100,MKT
06079824410610000,2021,228333,439567,667900,MKT
06079824410610000,2020,165912,398188,564100,MKT
06079824410610000,2019,165912,398188,564100,MKT
06079824410630000,2021,228333,452167,680500,MKT
06079824410630000,2020,165912,400888,566800,MKT
06079824410630000,2019,165912,400888,566800,MKT
06079824410650000,2021,228333,506267,734600,MKT
06079824410650000,2020,165912,454788,620700,MKT
06079824410650000,2019,165912,454788,620700,MKT
06079824410656500,2021,100779,0,100779,COST
06079824410656500,2020,72830,0,72830,COST
06079824410656500,2019,72830,0,72830,COST
06079824411010000,2021,211036,560564,771600,MKT
06079824411010000,2020,153515,455585,609100,OVR
06079824411010000,2019,153515,455585,609100,MKT
06079824411030000,2021,210118,364382,574500,MKT
06079824411030000,2020,152856,330644,483500,MKT
06079824411030000,2019,152856,330644,483500,MKT
06079824411050000,2021,210108,485992,696100,MKT
06079824411050000,2020,152850,447450,600300,MKT
06079824411050000,2019,152850,447450,600300,MKT
06079824411070000,2021,210099,394501,604600,MKT
06079824411070000,2020,152843,413157,566000,MKT
06079824411070000,2019,152843,413157,566000,MKT
06079824411090000,2021,210090,377610,587700,MKT
06079824411090000,2020,152836,360264,513100,MKT
06079824411090000,2019,152836,360264,513100,MKT
06079824411110000,2021,208183,451517,659700,MKT
06079824411110000,2020,151469,416631,568100,MKT
06079824411110000,2019,151469,411831,563300,MKT
06079824411130000,2021,208174,527926,736100,MKT
06079824411130000,2020,151462,498138,649600,MKT
06079824411130000,2019,151462,498138,649600,MKT
06079824411150000,2021,208164,310636,518800,MKT
06079824411150000,2020,151455,340145,491600,MKT
06079824411150000,2019,151455,340145,491600,MKT
06079824411170000,2021,208155,512045,720200,MKT
06079824411170000,2020,151448,405152,556600,MKT
06079824411170000,2019,151448,405152,556600,MKT
06079824411190000,2021,208145,330355,538500,MKT
06079824411190000,2020,151441,324659,476100,MKT
06079824411190000,2019,151441,324659,476100,MKT
06079824411210000,2021,216604,449996,666600,MKT
06079824411210000,2020,157507,421793,579300,MKT
06079824411210000,2019,157507,421793,579300,MKT
06079824412010000,2021,210847,405853,616700,MKT
06079824412010000,2020,153379,337421,490800,MKT
06079824412010000,2019,153379,337421,490800,MKT
06079824412030000,2021,207781,363119,570900,MKT
06079824412030000,2020,151180,337320,488500,MKT
06079824412030000,2019,151180,337320,488500,MKT
06079824412050000,2021,209282,419718,629000,MKT
06079824412050000,2020,152257,358143,510400,MKT
06079824412050000,2019,152257,358143,510400,MKT
06079824412070000,2021,209282,316018,525300,MKT
06079824412070000,2020,152257,299543,451800,MKT
06079824412070000,2019,152257,299543,451800,MKT
06079824412090000,2021,209291,371509,580800,MKT
06079824412090000,2020,152263,338837,491100,MKT
06079824412090000,2019,152263,348637,500900,MKT
06079824412110000,2021,210156,362944,573100,MKT
06079824412110000,2020,152884,346716,499600,MKT
06079824412110000,2019,152884,346716,499600,MKT
06079824413020000,2021,190050,325750,515800,MKT
06079824413020000,2020,138454,325646,464100,MKT
06079824413020000,2019,138454,325646,464100,MKT
06079824413040000,2021,190050,328850,518900,MKT
06079824413040000,2020,138454,334546,473000,MKT
06079824413040000,2019,138454,334546,473000,MKT
06079824413060000,2021,190050,416650,606700,MKT
06079824413060000,2020,138454,375246,513700,MKT
06079824413060000,2019,138454,375246,513700,MKT
06079824413080000,2021,190050,325350,515400,MKT
06079824413080000,2020,138454,312346,450800,MKT
06079824413080000,2019,138454,312346,450800,MKT
06079824413100000,2021,190050,416550,606600,MKT
06079824413100000,2020,138454,425846,564300,MKT
06079824413100000,2019,138454,378746,517200,MKT
06079824414020000,2021,215601,417699,633300,MKT
06079824414020000,2020,156788,376912,533700,MKT
06079824414020000,2019,156788,376912,533700,MKT
06079824414040000,2021,197252,424148,621400,MKT
06079824414040000,2020,143625,385875,529500,MKT
06079824414040000,2019,143625,385875,529500,MKT
06079824414060000,2021,203561,358939,562500,MKT
06079824414060000,2020,148153,363247,511400,MKT
06079824414060000,2019,148153,363247,511400,MKT
06079824414080000,2021,203561,368039,571600,MKT
06079824414080000,2020,148153,381547,529700,MKT
06079824414080000,2019,148153,381547,529700,MKT
06079824414100000,2021,203561,368839,572400,MKT
06079824414100000,2020,148153,348247,496400,MKT
06079824414100000,2019,148153,348247,496400,MKT
06079824414120000,2021,215601,513499,729100,MKT
06079824414120000,2020,156788,518612,675400,MKT
06079824414120000,2019,156788,518612,675400,MKT
06079824414140000,2021,203561,346939,550500,MKT
06079824414140000,2020,148153,330647,478800,MKT
06079824414140000,2019,148153,330647,478800,MKT
06079824414160000,2021,209672,529828,739500,MKT
06079824414160000,2020,152536,483564,636100,MKT
06079824414160000,2019,152536,483564,636100,MKT
06079824414180000,2021,215601,373499,589100,MKT
06079824414180000,2020,156788,369812,526600,MKT
06079824414180000,2019,156788,369812,526600,MKT
06079824414200000,2021,209691,427409,637100,MKT
06079824414200000,2020,152550,375050,527600,MKT
06079824414200000,2019,152550,375050,527600,MKT
06079824414220000,2021,204286,407414,611700,MKT
06079824414220000,2020,148673,378427,527100,MKT
06079824414220000,2019,148673,378427,527100,MKT
06079824414240000,2021,211536,445264,656800,MKT
06079824414240000,2020,153873,392727,546600,MKT
06079824414240000,2019,153873,392727,546600,MKT
06079824414320000,2021,314050,657450,971500,MKT
06079824414320000,2020,222778,713810,936588,COST
06079824414320000,2019,222778,713810,936588,COST
06079824414340000,2021,305440,316960,622400,MKT
06079824414340000,2020,216755,316545,533300,MKT
06079824414340000,2019,216755,316545,533300,MKT
06079824414360000,2021,231859,405041,636900,MKT
06079824414360000,2020,168438,409862,578300,MKT
06079824414360000,2019,168438,409862,578300,MKT
06079824414380000,2021,217072,368628,585700,MKT
06079824414380000,2020,157843,363457,521300,MKT
06079824414380000,2019,157843,363457,521300,MKT
06079824414400000,2021,217072,675628,892700,MKT
06079824414400000,2020,157843,669880,827723,COST
06079824414400000,2019,157843,669880,827723,COST
06079824414420000,2021,217072,471728,688800,MKT
06079824414420000,2020,157843,440757,598600,MKT
06079824414420000,2019,157843,440757,598600,MKT
06079824414440000,2021,217072,335628,552700,MKT
06079824414440000,2020,157843,338457,496300,MKT
06079824414440000,2019,157843,338457,496300,MKT
06079824414460000,2021,213811,319989,533800,MKT
06079824414460000,2020,155505,332295,487800,MKT
06079824414460000,2019,155505,332295,487800,MKT
06079824414480000,2021,212925,509975,722900,MKT
06079824414480000,2020,154869,480231,635100,MKT
06079824414480000,2019,154869,480231,635100,MKT
06079824415020000,2021,226395,434705,661100,MKT
06079824415020000,2020,164524,380576,545100,MKT
06079824415020000,2019,164524,380576,545100,MKT
06079824415040000,2021,207127,406873,614000,MKT
06079824415040000,2020,150711,364789,515500,MKT
06079824415040000,2019,150711,364789,515500,MKT
06079824415060000,2021,213755,344245,558000,MKT
06079824415060000,2020,155465,321535,477000,MKT
06079824415060000,2019,155465,321535,477000,MKT
06079824415080000,2021,209681,364319,574000,MKT
06079824415080000,2020,152543,330757,483300,MKT
06079824415080000,2019,152543,330757,483300,MKT
06079824415100000,2021,206191,307109,513300,MKT
06079824415100000,2020,150040,294460,444500,MKT
06079824415100000,2019,150040,294460,444500,MKT
06079824415120000,2021,218388,491312,709700,MKT
06079824415120000,2020,158786,467114,625900,MKT
06079824415120000,2019,158786,467114,625900,MKT
06079824415140000,2021,212381,422219,634600,MKT
06079824415140000,2020,154480,411520,566000,MKT
06079824415140000,2019,154480,411520,566000,MKT
06079824415160000,2021,218388,360112,578500,MKT
06079824415160000,2020,158786,333814,492600,MKT
06079824415160000,2019,158786,333814,492600,MKT
06079824415180000,2021,212381,398719,611100,MKT
06079824415180000,2020,154480,396320,550800,MKT
06079824415180000,2019,154480,396320,550800,MKT
06079824415200000,2021,212381,319219,531600,MKT
06079824415200000,2020,154480,341520,496000,MKT
06079824415200000,2019,154480,341520,496000,MKT
06079824415220000,2021,206191,355209,561400,MKT
06079824415220000,2020,150040,354760,504800,MKT
06079824415220000,2019,150040,354760,504800,MKT
06079824415240000,2021,212381,356119,568500,MKT
06079824415240000,2020,154480,352320,506800,MKT
06079824415240000,2019,154480,352320,506800,MKT
06079824416010000,2021,224235,450565,674800,MKT
06079824416010000,2020,162976,400524,563500,MKT
06079824416010000,2019,162976,400524,563500,MKT
06079824416020000,2021,210743,383357,594100,MKT
06079824416020000,2020,153305,374295,527600,MKT
06079824416020000,2019,153305,374295,527600,MKT
06079824416030000,2021,217484,383916,601400,MKT
06079824416030000,2020,158138,400462,558600,MKT
06079824416030000,2019,158138,400462,558600,MKT
06079824416040000,2021,210743,367557,578300,MKT
06079824416040000,2020,153305,351895,505200,MKT
06079824416040000,2019,153305,351895,505200,MKT
06079824416050000,2021,218279,321221,539500,MKT
06079824416050000,2020,158708,314892,473600,MKT
06079824416050000,2019,158708,314892,473600,MKT
06079824416060000,2021,218397,394803,613200,MKT
06079824416060000,2020,158793,363707,522500,MKT
06079824416060000,2019,158793,363707,522500,MKT
06079824416070000,2021,206210,354390,560600,MKT
06079824416070000,2020,150053,351347,501400,MKT
06079824416070000,2019,150053,351347,501400,MKT
06079824416080000,2021,236799,416001,652800,MKT
06079824416080000,2020,171975,382925,554900,MKT
06079824416080000,2019,171975,382925,554900,MKT
06079824416090000,2021,220914,518686,739600,MKT
06079824416090000,2020,160596,448404,609000,MKT
06079824416090000,2019,160596,448404,609000,MKT
06079824416100000,2021,212569,380031,592600,MKT
06079824416100000,2020,154614,353686,508300,MKT
06079824416100000,2019,154614,346786,501400,MKT
06079824416110000,2021,206191,383909,590100,MKT
06079824416110000,2020,150040,345360,495400,MKT
06079824416110000,2019,150040,345360,495400,MKT
06079824416120000,2021,199599,332901,532500,MKT
06079824416120000,2020,145309,331691,477000,MKT
06079824416120000,2019,145309,331691,477000,MKT
06079824417130000,2021,199268,379032,578300,MKT
06079824417130000,2020,145072,331828,476900,MKT
06079824417130000,2019,145072,331828,476900,MKT
06079824417140000,2021,204900,401600,606500,MKT
06079824417140000,2020,149113,348087,497200,MKT
06079824417140000,2019,149113,348087,497200,MKT
06079824417150000,2021,226911,389189,616100,MKT
06079824417150000,2020,164894,350706,515600,MKT
06079824417150000,2019,164894,350706,515600,MKT
06079824417160000,2021,238050,309650,547700,MKT
06079824417160000,2020,172871,297929,470800,MKT
06079824417160000,2019,172871,297929,470800,MKT
06079824417170000,2021,220310,356790,577100,MKT
06079824417170000,2020,160164,347936,508100,MKT
06079824417170000,2019,160164,347936,508100,MKT
06079824417180000,2021,228255,493545,721800,MKT
06079824417180000,2020,165856,452844,618700,MKT
06079824417180000,2019,165856,452844,618700,MKT
06079824417190000,2021,233953,402247,636200,MKT
06079824417190000,2020,169938,384062,554000,MKT
06079824417190000,2019,169938,384062,554000,MKT
06079824417200000,2021,222063,310637,532700,MKT
06079824417200000,2020,161420,279480,440900,MKT
06079824417200000,2019,161420,279480,440900,MKT
06079824417210000,2021,216218,422282,638500,MKT
06079824417210000,2020,157231,405769,563000,MKT
06079824417210000,2019,157231,405769,563000,MKT
06079824417220000,2021,224191,405209,629400,MKT
06079824417220000,2020,162945,359455,522400,MKT
06079824417220000,2019,162945,359455,522400,MKT
06079824417230000,2021,225287,356413,581700,MKT
06079824417230000,2020,163730,330670,494400,MKT
06079824417230000,2019,163730,330670,494400,MKT
06079824417240000,2021,233699,334101,567800,MKT
06079824417240000,2020,169756,319744,489500,MKT
06079824417240000,2019,169756,319744,489500,MKT
06079824418140000,2021,209339,503861,713200,MKT
06079824418140000,2020,152298,387902,540200,MKT
06079824418140000,2019,152298,387902,540200,MKT
06079824418146500,2021,71686,0,71686,COST
06079824418146500,2020,52056,0,52056,COST
06079824418146500,2019,52056,0,52056,COST
06079824418150000,2021,184158,313742,497900,MKT
06079824418150000,2020,134221,316779,451000,MKT
06079824418150000,2019,134221,316779,451000,MKT
06079824418160000,2021,190050,277650,467700,MKT
06079824418160000,2020,138454,307046,445500,MKT
06079824418160000,2019,138454,307046,445500,MKT
06079824418170000,2021,190050,320950,511000,MKT
06079824418170000,2020,138454,346146,484600,MKT
06079824418170000,2019,138454,346146,484600,MKT
06079824418180000,2021,184158,404942,589100,MKT
06079824418180000,2020,134221,348979,483200,MKT
06079824418180000,2019,134221,348979,483200,MKT
06079824419010000,2021,226938,388562,615500,MKT
06079824419010000,2020,164913,360187,525100,MKT
06079824419010000,2019,164913,360187,525100,MKT
06079824419016500,2021,170005,0,170005,COST
06079824419016500,2020,121952,0,121952,COST
06079824419016500,2019,121952,0,121952,COST
06079824419030000,2021,206925,355775,562700,MKT
06079824419030000,2020,150566,316634,467200,MKT
06079824419030000,2019,150566,316634,467200,MKT
06079824419050000,2021,208862,292138,501000,MKT
06079824419050000,2020,151956,312444,464400,MKT
06079824419050000,2019,151956,312444,464400,MKT
06079824419070000,2021,210790,276710,487500,MKT
06079824419070000,2020,153339,274061,427400,MKT
06079824419070000,2019,153339,274061,427400,MKT
06079824419090000,2021,218770,350130,568900,MKT
06079824419090000,2020,159060,311340,470400,MKT
06079824419090000,2019,159060,311340,470400,MKT
06079824419110000,2021,204178,295722,499900,MKT
06079824419110000,2020,148596,266204,414800,MKT
06079824419110000,2019,148596,266204,414800,MKT
06079824419130000,2021,204295,304905,509200,MKT
06079824419130000,2020,148680,302020,450700,MKT
06079824419130000,2019,148680,302020,450700,MKT
06079824419150000,2021,191059,333541,524600,MKT
06079824419150000,2020,139178,294622,433800,MKT
06079824419150000,2019,139178,294622,433800,MKT
06079824419170000,2021,206857,301843,508700,MKT
06079824419170000,2020,150518,244982,395500,MKT
06079824419170000,2019,150518,244982,395500,MKT
06079824419190000,2021,200298,316902,517200,MKT
06079824419190000,2020,145811,305589,451400,MKT
06079824419190000,2019,145811,305589,451400,MKT
06079824419210000,2021,194083,347117,541200,MKT
06079824419210000,2020,141350,313250,454600,MKT
06079824419210000,2019,141350,313250,454600,MKT
06079824419230000,2021,200298,272002,472300,MKT
06079824419230000,2020,145811,294189,440000,MKT
06079824419230000,2019,145811,294189,440000,MKT
06079824420010000,2021,220012,307488,527500,MKT
06079824420010000,2020,159950,288050,448000,OVR
06079824420010000,2019,159950,288050,448000,MKT
06079824420016500,2021,127471,0,127471,COST
06079824420016500,2020,91814,0,91814,COST
06079824420016500,2019,91814,0,91814,COST
06079824420030000,2021,230555,266845,497400,MKT
06079824420030000,2020,167504,247496,415000,MKT
06079824420030000,2019,167504,247496,415000,MKT
06079824420070000,2021,211375,252725,464100,MKT
06079824420070000,2020,153758,255942,409700,MKT
06079824420070000,2019,153758,255942,409700,MKT
06079824420090000,2021,232525,336175,568700,MKT
06079824420090000,2020,168915,290585,459500,MKT
06079824420090000,2019,168915,290585,459500,MKT
06079824420110000,2021,228880,326920,555800,MKT
06079824420110000,2020,166304,309896,476200,MKT
06079824420110000,2019,166304,309896,476200,MKT
06079824420130000,2021,233036,329364,562400,MKT
06079824420130000,2020,169281,307719,477000,MKT
06079824420130000,2019,169281,296619,465900,MKT
06079824420150000,2021,201303,338297,539600,MKT
06079824420150000,2020,146532,286568,433100,MKT
06079824420150000,2019,146532,286568,433100,MKT
06079824420170000,2021,231620,388080,619700,MKT
06079824420170000,2020,168266,349834,518100,MKT
06079824420170000,2019,168266,364134,532400,MKT
06079824420190000,2021,207733,327367,535100,MKT
06079824420190000,2020,151146,284154,435300,MKT
06079824420190000,2019,151146,284154,435300,MKT
06079824420210000,2021,208814,211686,420500,MKT
06079824420210000,2020,151921,253279,405200,MKT
06079824420210000,2019,151921,253279,405200,MKT
06079824420230000,2021,241502,364098,605600,MKT
06079824420230000,2020,175342,386958,562300,MKT
06079824420230000,2019,175342,386958,562300,MKT
06079824420250000,2021,248794,262006,510800,MKT
06079824420250000,2020,180561,281139,461700,MKT
06079824420250000,2019,180561,281139,461700,MKT
06079824420270000,2021,234368,257332,491700,MKT
06079824420270000,2020,170235,281565,451800,MKT
06079824420270000,2019,170235,281565,451800,MKT
06079824421010000,2021,212391,481809,694200,MKT
06079824421010000,2020,154486,428014,582500,MKT
06079824421010000,2019,154486,428014,582500,MKT
06079824421030000,2021,206201,355799,562000,MKT
06079824421030000,2020,150047,355953,506000,MKT
06079824421030000,2019,150047,355953,506000,MKT
06079824421050000,2021,205988,357712,563700,MKT
06079824421050000,2020,149894,379506,529400,MKT
06079824421050000,2019,149894,379506,529400,MKT
06079824421070000,2021,212184,334216,546400,MKT
06079824421070000,2020,154338,315462,469800,MKT
06079824421070000,2019,154338,315462,469800,MKT
06079824421096500,2021,158173,0,158173,COST
06079824421096500,2020,113580,0,113580,COST
06079824421096500,2019,113580,0,113580,COST
06079824421110000,2021,207060,413940,621000,MKT
06079824421110000,2020,150663,408537,559200,OVR
06079824421110000,2019,150663,408537,559200,MKT
06079824421130000,2021,212766,513734,726500,MKT
06079824421130000,2020,154755,451145,605900,MKT
06079824421130000,2019,154755,451145,605900,MKT
06079824421150000,2021,210336,647764,858100,MKT
06079824421150000,2020,153013,549987,703000,MKT
06079824421150000,2019,153013,549987,703000,MKT
06079824421170000,2021,209615,444385,654000,MKT
06079824421170000,2020,152495,400305,552800,MKT
06079824421170000,2019,152495,400305,552800,MKT
06079824421190000,2021,223134,419166,642300,MKT
06079824421190000,2020,162187,364613,526800,MKT
06079824421190000,2019,162187,364613,526800,MKT
06079824422010000,2021,228298,649202,877500,MKT
06079824422010000,2020,165887,539613,705500,MKT
06079824422010000,2019,165887,539613,705500,MKT
06079824422030000,2021,218279,370421,588700,MKT
06079824422030000,2020,158708,343792,502500,MKT
06079824422030000,2019,158708,343792,502500,MKT
06079824422050000,2021,208767,311633,520400,MKT
06079824422050000,2020,151887,316113,468000,MKT
06079824422050000,2019,151887,316113,468000,MKT
06079824422070000,2021,210781,420019,630800,MKT
06079824422070000,2020,153332,456468,609800,MKT
06079824422070000,2019,153332,456468,609800,MKT
06079824422090000,2021,206963,461937,668900,MKT
06079824422090000,2020,150594,436606,587200,MKT
06079824422090000,2019,150594,436606,587200,MKT
06079824422110000,2021,211026,414974,626000,MKT
06079824422110000,2020,153508,396892,550400,MKT
06079824422110000,2019,153508,358592,512100,MKT
06079824422130000,2021,211780,406420,618200,MKT
06079824422130000,2020,154049,393151,547200,MKT
06079824422130000,2019,154049,332751,486800,MKT
06079824422150000,2021,223178,522622,745800,MKT
06079824422150000,2020,162219,388381,550600,MKT
06079824422150000,2019,162219,388381,550600,MKT
06079824423010000,2021,227375,369825,597200,MKT
06079824423010000,2020,165226,349074,514300,MKT
06079824423010000,2019,165226,349074,514300,MKT
06079824423030000,2021,217430,471070,688500,MKT
06079824423030000,2020,158099,473001,631100,MKT
06079824423030000,2019,158099,473001,631100,MKT
06079824423050000,2021,219650,344250,563900,MKT
06079824423050000,2020,159691,348309,508000,MKT
06079824423050000,2019,159691,348309,508000,MKT
06079824423070000,2021,213765,253435,467200,MKT
06079824423070000,2020,155472,267328,422800,MKT
06079824423070000,2019,155472,267328,422800,MKT
06079824423090000,2021,219849,623251,843100,MKT
06079824423090000,2020,159833,563867,723700,MKT
06079824423090000,2019,159833,563867,723700,MKT
06079824424016500,2021,37690,0,37690,COST
06079824424016500,2020,26630,0,26630,COST
06079824424016500,2019,26630,0,26630,COST
06079824424030000,2021,170130,261170,431300,MKT
06079824424030000,2020,119692,267208,386900,MKT
06079824424030000,2019,119692,267008,386700,MKT
06079824424050000,2021,169942,452258,622200,MKT
06079824424050000,2020,119562,423538,543100,MKT
06079824424050000,2019,119562,423538,543100,MKT
06079824424070000,2021,169754,254646,424400,MKT
06079824424070000,2020,119431,272169,391600,MKT
06079824424070000,2019,119431,272169,391600,MKT
06079824424090000,2021,169565,301835,471400,MKT
06079824424090000,2020,119300,300400,419700,MKT
06079824424090000,2019,119300,300400,419700,MKT
06079824424110000,2021,169376,285624,455000,MKT
06079824424110000,2020,119169,292031,411200,MKT
06079824424110000,2019,119169,292031,411200,MKT
06079824424130000,2021,169187,403913,573100,MKT
06079824424130000,2020,119038,402362,521400,MKT
06079824424130000,2019,119038,402362,521400,MKT
06079824424150000,2021,168998,292902,461900,MKT
06079824424150000,2020,118907,294193,413100,MKT
06079824424150000,2019,118907,294193,413100,MKT
06079824424170000,2021,190806,307794,498600,MKT
06079824424170000,2020,134021,307579,441600,MKT
06079824424170000,2019,134021,307579,441600,MKT
06079824425016500,2021,86674,0,86674,COST
06079824425016500,2020,60523,0,60523,COST
06079824425016500,2019,60523,0,60523,COST
06079824425030000,2021,173285,399215,572500,MKT
06079824425030000,2020,121880,377420,499300,MKT
06079824425030000,2019,121880,377420,499300,MKT
06079824425050000,2021,167572,304128,471700,MKT
06079824425050000,2020,117918,311782,429700,MKT
06079824425050000,2019,117918,311782,429700,MKT
06079824425070000,2021,167603,314097,481700,MKT
06079824425070000,2020,117940,317760,435700,MKT
06079824425070000,2019,117940,317760,435700,MKT
06079824425090000,2021,167625,353975,521600,MKT
06079824425090000,2020,117954,349446,467400,MKT
06079824425090000,2019,117954,349446,467400,MKT
06079824425110000,2021,167657,343943,511600,MKT
06079824425110000,2020,117977,332323,450300,OVR
06079824425110000,2019,117977,332323,450300,MKT
06079824425130000,2021,167688,393412,561100,MKT
06079824425130000,2020,117999,401101,519100,OVR
06079824425130000,2019,117999,401101,519100,MKT
06079824425150000,2021,167710,407590,575300,MKT
06079824425150000,2020,118013,401087,519100,MKT
06079824425150000,2019,118013,401087,519100,MKT
06079824426010000,2021,180778,267822,448600,MKT
06079824426010000,2020,127075,278525,405600,MKT
06079824426010000,2019,127075,278525,405600,MKT
06079824426030000,2021,174794,466306,641100,MKT
06079824426030000,2020,122927,357573,480500,MKT
06079824426030000,2019,122927,357573,480500,MKT
06079824426050000,2021,174794,294406,469200,MKT
06079824426050000,2020,122927,299273,422200,MKT
06079824426050000,2019,122927,283773,406700,MKT
06079824426070000,2021,174794,286506,461300,MKT
06079824426070000,2020,122927,302773,425700,OVR
06079824426070000,2019,122927,302773,425700,MKT
06079824426090000,2021,174794,270206,445000,MKT
06079824426090000,2020,122927,262709,385636,OVR
06079824426090000,2019,122927,262709,385636,OVR
06079824426110000,2021,174794,373006,547800,MKT
06079824426110000,2020,122927,389673,512600,MKT
06079824426110000,2019,122927,389673,512600,MKT
06079824426130000,2021,174794,473106,647900,MKT
06079824426130000,2020,122927,440973,563900,MKT
06079824426130000,2019,122927,440973,563900,MKT
06079824426150000,2021,180778,400722,581500,MKT
06079824426150000,2020,127075,388525,515600,MKT
06079824426150000,2019,127075,388525,515600,MKT
06079824426170000,2021,180778,342822,523600,MKT
06079824426170000,2020,127075,338625,465700,MKT
06079824426170000,2019,127075,338625,465700,MKT
06079824426190000,2021,174794,280906,455700,MKT
06079824426190000,2020,122927,282973,405900,MKT
06079824426190000,2019,122927,282973,405900,MKT
06079824426210000,2021,174794,372906,547700,MKT
06079824426210000,2020,122927,375873,498800,MKT
06079824426210000,2019,122927,375873,498800,MKT
06079824426230000,2021,174794,269806,444600,MKT
06079824426230000,2020,122927,281673,404600,MKT
06079824426230000,2019,122927,281673,404600,MKT
06079824426250000,2021,174794,581906,756700,MKT
06079824426250000,2020,122927,535173,658100,MKT
06079824426250000,2019,122927,564973,687900,MKT
06079824426270000,2021,174794,319706,494500,MKT
06079824426270000,2020,122927,430773,553700,OVR
06079824426270000,2019,122927,430773,553700,MKT
06079824426290000,2021,174794,300006,474800,MKT
06079824426290000,2020,122927,301073,424000,MKT
06079824426290000,2019,122927,301073,424000,MKT
06079824426310000,2021,180778,353022,533800,MKT
06079824426310000,2020,127075,369525,496600,MKT
06079824426310000,2019,127075,369525,496600,MKT
06079824427010000,2021,180778,356522,537300,MKT
06079824427010000,2020,127075,391425,518500,MKT
06079824427010000,2019,127075,391425,518500,MKT
06079824427030000,2021,174794,413806,588600,MKT
06079824427030000,2020,122927,415473,538400,MKT
06079824427030000,2019,122927,415473,538400,MKT
06079824427050000,2021,174794,313006,487800,MKT
06079824427050000,2020,122927,315573,438500,MKT
06079824427050000,2019,122927,315573,438500,MKT
06079824427070000,2021,174794,424006,598800,MKT
06079824427070000,2020,122927,406573,529500,MKT
06079824427070000,2019,122927,406573,529500,MKT
06079824427090000,2021,174794,490306,665100,MKT
06079824427090000,2020,122927,458773,581700,MKT
06079824427090000,2019,122927,456173,579100,MKT
06079824427110000,2021,174794,395606,570400,MKT
06079824427110000,2020,122927,390573,513500,MKT
06079824427110000,2019,122927,390573,513500,MKT
06079824427130000,2021,174794,370106,544900,MKT
06079824427130000,2020,122927,376473,499400,MKT
06079824427130000,2019,122927,376473,499400,MKT
06079824427150000,2021,180778,524422,705200,MKT
06079824427150000,2020,127075,467525,594600,MKT
06079824427150000,2019,127075,467525,594600,MKT
06079824427170000,2021,180778,541522,722300,MKT
06079824427170000,2020,127075,476725,603800,MKT
06079824427170000,2019,127075,476725,603800,MKT
06079824427190000,2021,174794,395806,570600,MKT
06079824427190000,2020,122927,400273,523200,MKT
06079824427190000,2019,122927,0,122927,COST
06079824427210000,2021,174794,342506,517300,MKT
06079824427210000,2020,122927,352173,475100,MKT
06079824427210000,2019,122927,352173,475100,MKT
06079824427230000,2021,174794,293106,467900,MKT
06079824427230000,2020,122927,294973,417900,OVR
06079824427230000,2019,122927,294973,417900,MKT
06079824427250000,2021,174794,370806,545600,MKT
06079824427250000,2020,122927,394873,517800,MKT
06079824427250000,2019,122927,394873,517800,MKT
06079824427270000,2021,174794,314006,488800,MKT
06079824427270000,2020,122927,322973,445900,MKT
06079824427270000,2019,122927,322973,445900,MKT
06079824427290000,2021,174794,266106,440900,MKT
06079824427290000,2020,122927,268373,391300,MKT
06079824427290000,2019,122927,268373,391300,MKT
06079824427310000,2021,180778,397522,578300,MKT
06079824427310000,2020,127075,419125,546200,MKT
06079824427310000,2019,127075,419125,546200,MKT
06079824428010000,2021,180778,322222,503000,MKT
06079824428010000,2020,127075,318925,446000,MKT
06079824428010000,2019,127075,316525,443600,MKT
06079824428030000,2021,174794,430006,604800,MKT
06079824428030000,2020,122927,406273,529200,MKT
06079824428030000,2019,122927,406273,529200,MKT
06079824428050000,2021,174794,295006,469800,MKT
06079824428050000,2020,122927,295673,418600,MKT
06079824428050000,2019,122927,295673,418600,MKT
06079824428070000,2021,174794,433506,608300,MKT
06079824428070000,2020,122927,404473,527400,MKT
06079824428070000,2019,122927,404473,527400,MKT
06079824428090000,2021,174794,347606,522400,MKT
06079824428090000,2020,122927,345873,468800,MKT
06079824428090000,2019,122927,345873,468800,MKT
06079824428110000,2021,174794,410306,585100,MKT
06079824428110000,2020,122927,411773,534700,MKT
06079824428110000,2019,122927,411773,534700,MKT
06079824428130000,2021,174794,485206,660000,MKT
06079824428130000,2020,122927,439273,562200,MKT
06079824428130000,2019,122927,440173,563100,MKT
06079824428150000,2021,184367,410033,594400,MKT
06079824428150000,2020,129561,399339,528900,MKT
06079824428150000,2019,129561,399339,528900,MKT
06079824428170000,2021,185324,443276,628600,MKT
06079824428170000,2020,130225,414175,544400,MKT
06079824428170000,2019,130225,414175,544400,MKT
06079824428190000,2021,174794,336906,511700,MKT
06079824428190000,2020,122927,349073,472000,MKT
06079824428190000,2019,122927,349073,472000,MKT
06079824428210000,2021,174794,461506,636300,MKT
06079824428210000,2020,122927,409573,532500,MKT
06079824428210000,2019,122927,409573,532500,MKT
06079824428230000,2021,174794,454306,629100,MKT
06079824428230000,2020,122927,451173,574100,MKT
06079824428230000,2019,122927,451173,574100,MKT
06079824428250000,2021,174794,513206,688000,MKT
06079824428250000,2020,122927,406273,529200,MKT
06079824428250000,2019,122927,406273,529200,MKT
06079824428270000,2021,174794,491106,665900,MKT
06079824428270000,2020,122927,393673,516600,MKT
06079824428270000,2019,122927,393673,516600,MKT
06079824428290000,2021,174794,428306,603100,MKT
06079824428290000,2020,122927,397073,520000,OVR
06079824428290000,2019,122927,397073,520000,OVR
06079824428310000,2021,180778,414122,594900,MKT
06079824428310000,2020,127075,423725,550800,MKT
06079824428310000,2019,127075,423725,550800,MKT
06079824429010000,2021,180778,574122,754900,MKT
06079824429010000,2020,127075,513925,641000,MKT
06079824429010000,2019,127075,511925,639000,MKT
06079824429030000,2021,174794,411506,586300,MKT
06079824429030000,2020,122927,406973,529900,MKT
06079824429030000,2019,122927,406973,529900,MKT
06079824429050000,2021,174794,401606,576400,MKT
06079824429050000,2020,122927,410773,533700,OVR
06079824429050000,2019,122927,410773,533700,MKT
06079824429070000,2021,174794,414406,589200,MKT
06079824429070000,2020,122927,413873,536800,MKT
06079824429070000,2019,122927,413873,536800,MKT
06079824429090000,2021,174794,579506,754300,MKT
06079824429090000,2020,122927,638290,761217,COST
06079824429090000,2019,122927,613250,736177,COST
06079824429110000,2021,174794,357306,532100,MKT
06079824429110000,2020,122927,361473,484400,MKT
06079824429110000,2019,122927,361473,484400,MKT
06079824429130000,2021,174794,307706,482500,MKT
06079824429130000,2020,122927,313673,436600,MKT
06079824429130000,2019,122927,313673,436600,MKT
06079824429150000,2021,182931,361369,544300,MKT
06079824429150000,2020,128566,335134,463700,MKT
06079824429150000,2019,128566,335134,463700,MKT
06079824429170000,2021,181960,471540,653500,MKT
06079824429170000,2020,127894,418706,546600,MKT
06079824429170000,2019,127894,418706,546600,MKT
06079824429190000,2021,174794,448206,623000,MKT
06079824429190000,2020,122927,401773,524700,MKT
06079824429190000,2019,122927,401773,524700,MKT
06079824429210000,2021,174794,550506,725300,MKT
06079824429210000,2020,122927,500873,623800,MKT
06079824429210000,2019,122927,500873,623800,MKT
06079824429230000,2021,174794,495806,670600,MKT
06079824429230000,2020,122927,454073,577000,MKT
06079824429230000,2019,122927,454073,577000,MKT
06079824429250000,2021,174794,503806,678600,MKT
06079824429250000,2020,122927,459073,582000,OVR
06079824429250000,2019,122927,459073,582000,MKT
06079824429270000,2021,174794,448906,623700,MKT
06079824429270000,2020,122927,420273,543200,MKT
06079824429270000,2019,122927,420273,543200,MKT
06079824429290000,2021,174794,314206,489000,MKT
06079824429290000,2020,122927,319573,442500,MKT
06079824429290000,2019,122927,319573,442500,MKT
06079824429310000,2021,180778,464522,645300,MKT
06079824429310000,2020,127075,362225,489300,MKT
06079824429310000,2019,127075,362225,489300,MKT
06079824430016500,2021,84809,0,84809,COST
06079824430016500,2020,59239,0,59239,COST
06079824430016500,2019,59239,0,59239,COST
06079824430030000,2021,167529,313171,480700,MKT
06079824430030000,2020,117888,318212,436100,MKT
06079824430030000,2019,117888,318212,436100,MKT
06079824430050000,2021,167529,461771,629300,MKT
06079824430050000,2020,117888,424612,542500,MKT
06079824430050000,2019,117888,460012,577900,MKT
06079824430070000,2021,167529,384871,552400,MKT
06079824430070000,2020,117888,389912,507800,MKT
06079824430070000,2019,117888,389912,507800,MKT
06079824430090000,2021,167529,520771,688300,MKT
06079824430090000,2020,117888,468912,586800,MKT
06079824430090000,2019,117888,468912,586800,MKT
06079824430110000,2021,167529,393871,561400,MKT
06079824430110000,2020,117888,358712,476600,MKT
06079824430110000,2019,117888,358712,476600,MKT
06079824430130000,2021,167529,370671,538200,MKT
06079824430130000,2020,117888,367012,484900,MKT
06079824430130000,2019,117888,367012,484900,MKT
06079824430150000,2021,173694,372006,545700,MKT
06079824430150000,2020,122164,370236,492400,MKT
06079824430150000,2019,122164,370236,492400,MKT
06079824431010000,2021,174072,408028,582100,MKT
06079824431010000,2020,122426,404074,526500,MKT
06079824431010000,2019,122426,404074,526500,MKT
06079824431036500,2021,88807,0,88807,COST
06079824431036500,2020,61991,0,61991,COST
06079824431036500,2019,61991,0,61991,COST
06079824432010000,2021,213006,656394,869400,MKT
06079824432010000,2020,174705,0,174705,COST
06079824432010000,2019,174705,0,174705,COST
06079824432030000,2021,206257,568043,774300,MKT
06079824432030000,2020,169247,461053,630300,MKT
06079824432030000,2019,169247,461053,630300,MKT
06079824432050000,2021,206257,562443,768700,MKT
06079824432050000,2020,169247,469853,639100,MKT
06079824432050000,2019,169247,469853,639100,MKT
06079824432070000,2021,206257,592943,799200,MKT
06079824432070000,2020,169247,583953,753200,MKT
06079824432070000,2019,169247,477240,646487,COST
06079824432090000,2021,206257,644343,850600,MKT
06079824432090000,2020,169247,608853,778100,MKT
06079824432090000,2019,169247,608853,778100,MKT
06079824432110000,2021,206257,674243,880500,MKT
06079824432110000,2020,169247,630553,799800,MKT
06079824432110000,2019,169247,630553,799800,MKT
06079824432130000,2021,206257,555443,761700,MKT
06079824432130000,2020,169247,452653,621900,MKT
06079824432130000,2019,169247,452653,621900,MKT
06079824432150000,2021,215687,465013,680700,MKT
06079824432150000,2020,176873,435027,611900,MKT
06079824432150000,2019,176873,435027,611900,MKT
06079824432176500,2021,152981,0,152981,COST
06079824432176500,2020,105970,0,105970,COST
06079824432176500,2019,105970,0,105970,COST
06079824432196500,2021,295105,0,295105,COST
06079824432196500,2020,202528,0,202528,COST
06079824432196500,2019,202528,0,202528,COST
06079824432230000,2021,210524,600376,810900,MKT
06079824432230000,2020,172698,593802,766500,MKT
06079824432230000,2019,172698,593802,766500,MKT
06079824432250000,2021,206257,412043,618300,MKT
06079824432250000,2020,169247,431153,600400,MKT
06079824432250000,2019,169247,431153,600400,MKT
06079824432270000,2021,206257,661643,867900,MKT
06079824432270000,2020,169247,660153,829400,MKT
06079824432270000,2019,169247,660153,829400,MKT
06079824432290000,2021,206748,583852,790600,MKT
06079824432290000,2020,169644,464756,634400,MKT
06079824432290000,2019,169644,464756,634400,MKT
06079824432310000,2021,210301,701099,911400,MKT
06079824432310000,2020,172518,676182,848700,MKT
06079824432310000,2019,172518,676182,848700,MKT
06079824433010000,2021,178500,471000,649500,MKT
06079824433010000,2020,125495,426405,551900,MKT
06079824433010000,2019,125495,426405,551900,MKT
06079824433030000,2021,174794,486606,661400,MKT
06079824433030000,2020,122927,457573,580500,MKT
06079824433030000,2019,122927,457573,580500,MKT
06079824433050000,2021,174794,585906,760700,MKT
06079824433050000,2020,122927,564573,687500,MKT
06079824433050000,2019,122927,564573,687500,MKT
06079824433070000,2021,174794,534106,708900,MKT
06079824433070000,2020,122927,477873,600800,MKT
06079824433070000,2019,122927,477873,600800,MKT
06079824433090000,2021,174794,475606,650400,MKT
06079824433090000,2020,122927,443273,566200,MKT
06079824433090000,2019,122927,443273,566200,MKT
06079824433110000,2021,174794,491106,665900,MKT
06079824433110000,2020,122927,436473,559400,MKT
06079824433110000,2019,122927,436473,559400,MKT
06079824433130000,2021,174794,601806,776600,MKT
06079824433130000,2020,122927,529973,652900,MKT
06079824433130000,2019,122927,529973,652900,MKT
06079824433150000,2021,186751,341049,527800,MKT
06079824433150000,2020,131213,340087,471300,MKT
06079824433150000,2019,131213,340087,471300,MKT
06079824433170000,2021,187696,430004,617700,MKT
06079824433170000,2020,131867,381733,513600,MKT
06079824433170000,2019,131867,381733,513600,MKT
06079824433190000,2021,180543,332657,513200,MKT
06079824433190000,2020,126912,335688,462600,MKT
06079824433190000,2019,126912,335688,462600,MKT
06079824433210000,2021,180543,270857,451400,MKT
06079824433210000,2020,126912,278988,405900,MKT
06079824433210000,2019,126912,278988,405900,MKT
06079824433230000,2021,180543,500057,680600,MKT
06079824433230000,2020,126912,485188,612100,MKT
06079824433230000,2019,126912,485188,612100,MKT
06079824433250000,2021,180543,356357,536900,MKT
06079824433250000,2020,126912,363088,490000,MKT
06079824433250000,2019,126912,363088,490000,MKT
06079824433270000,2021,180543,278457,459000,MKT
06079824433270000,2020,126912,290488,417400,MKT
06079824433270000,2019,126912,290488,417400,MKT
06079824433290000,2021,209173,481527,690700,MKT
06079824433290000,2020,143894,413106,557000,MKT
06079824433290000,2019,143894,413106,557000,MKT
06079824434010000,2021,209426,521774,731200,MKT
06079824434010000,2020,144066,481534,625600,MKT
06079824434010000,2019,144066,481534,625600,MKT
06079824434030000,2021,167529,382671,550200,MKT
06079824434030000,2020,117888,380412,498300,MKT
06079824434030000,2019,117888,380412,498300,MKT
06079824434050000,2021,167529,350271,517800,MKT
06079824434050000,2020,117888,349512,467400,MKT
06079824434050000,2019,117888,349512,467400,MKT
06079824434070000,2021,167529,487371,654900,MKT
06079824434070000,2020,117888,441612,559500,MKT
06079824434070000,2019,117888,441612,559500,MKT
06079824434090000,2021,167529,375071,542600,MKT
06079824434090000,2020,117888,373312,491200,MKT
06079824434090000,2019,117888,373312,491200,MKT
06079824434110000,2021,250419,368181,618600,MKT
06079824434110000,2020,175218,346382,521600,MKT
06079824434110000,2019,175218,346382,521600,MKT
06079824434150000,2021,187702,457898,645600,MKT
06079824434150000,2020,129322,431178,560500,MKT
06079824434150000,2019,129322,431178,560500,MKT
06079824435030000,2021,174601,479299,653900,MKT
06079824435030000,2020,122793,449807,572600,MKT
06079824435030000,2019,122793,449807,572600,MKT
06079824435050000,2021,182427,524173,706600,MKT
06079824435050000,2020,128217,489583,617800,MKT
06079824435050000,2019,128217,489583,617800,MKT
06079824435070000,2021,185687,577913,763600,MKT
06079824435070000,2020,130476,499824,630300,MKT
06079824435070000,2019,130476,499824,630300,MKT
06079824435090000,2021,186087,343913,530000,MKT
06079824435090000,2020,130753,341747,472500,MKT
06079824435090000,2019,130753,341747,472500,MKT
06079824435110000,2021,250419,473981,724400,MKT
06079824435110000,2020,175218,360982,536200,MKT
06079824435110000,2019,175218,360982,536200,MKT
06079824435130000,2021,184396,643904,828300,MKT
06079824435130000,2020,129581,555819,685400,MKT
06079824435130000,2019,129581,555819,685400,MKT
06079825101100000,2021,146,0,146,COST
06079825101100000,2020,136,0,136,COST
06079825101100000,2019,136,0,136,COST
06079825101120000,2021,216586,532214,748800,MKT
06079825101120000,2020,157494,489306,646800,MKT
06079825101120000,2019,157494,489306,646800,MKT
06079825101140000,2021,209539,367761,577300,MKT
06079825101140000,2020,152441,372659,525100,MKT
06079825101140000,2019,152441,372659,525100,MKT
06079825101160000,2021,209529,496371,705900,MKT
06079825101160000,2020,152434,480666,633100,MKT
06079825101160000,2019,152434,480666,633100,MKT
06079825101180000,2021,209520,377580,587100,MKT
06079825101180000,2020,152427,375773,528200,MKT
06079825101180000,2019,152427,375773,528200,MKT
06079825101190000,2021,205338,538162,743500,MKT
06079825101190000,2020,149428,480872,630300,MKT
06079825101190000,2019,149428,480872,630300,MKT
06079825101200000,2021,4016,23000,27016,COST
06079825101200000,2020,3737,19340,23077,COST
06079825101200000,2019,3737,19340,23077,COST
06079825101220000,2021,208403,461497,669900,MKT
06079825101220000,2020,151627,434273,585900,MKT
06079825101220000,2019,151627,434273,585900,MKT
06079825101240000,2021,207886,325914,533800,MKT
06079825101240000,2020,151256,344444,495700,MKT
06079825101240000,2019,151256,344444,495700,MKT
06079825101260000,2021,203080,350920,554000,MKT
06079825101260000,2020,147808,348292,496100,MKT
06079825101260000,2019,147808,348292,496100,MKT
06079825101280000,2021,216816,390284,607100,MKT
06079825101280000,2020,157659,361241,518900,MKT
06079825101280000,2019,157659,361241,518900,MKT
06079825101300000,2021,215924,416576,632500,MKT
06079825101300000,2020,157019,381081,538100,MKT
06079825101300000,2019,157019,381081,538100,MKT
06079825101320000,2021,212775,368725,581500,MKT
06079825101320000,2020,154762,365738,520500,MKT
06079825101320000,2019,154762,385738,540500,MKT
06079825101340000,2021,210781,431419,642200,MKT
06079825101340000,2020,153332,399268,552600,MKT
06079825101340000,2019,153332,399268,552600,MKT
06079825101360000,2021,208116,523884,732000,MKT
06079825101360000,2020,151421,525679,677100,MKT
06079825101360000,2019,151421,525679,677100,MKT
06079825101380000,2021,213177,565323,778500,MKT
06079825101380000,2020,155050,502750,657800,MKT
06079825101380000,2019,155050,502750,657800,MKT
06079825101400000,2021,209577,374323,583900,MKT
06079825101400000,2020,152468,358932,511400,MKT
06079825101400000,2019,152468,358932,511400,MKT
06079825101420000,2021,211865,404635,616500,MKT
06079825101420000,2020,154109,380491,534600,MKT
06079825101420000,2019,154109,380491,534600,MKT
06079825101440000,2021,205503,379197,584700,MKT
06079825101440000,2020,149546,352254,501800,MKT
06079825101440000,2019,149546,352254,501800,MKT
06079825101460000,2021,203395,428905,632300,MKT
06079825101460000,2020,148033,403467,551500,MKT
06079825101460000,2019,148033,403467,551500,MKT
06079825102016500,2021,200215,0,200215,COST
06079825102016500,2020,143291,0,143291,COST
06079825102016500,2019,143291,0,143291,COST
06079825102030000,2021,235119,534081,769200,MKT
06079825102030000,2020,170773,485227,656000,MKT
06079825102030000,2019,170773,485227,656000,MKT
06079825102050000,2021,224474,482726,707200,MKT
06079825102050000,2020,163148,446552,609700,MKT
06079825102050000,2019,163148,446552,609700,MKT
06079825102070000,2021,221731,592469,814200,MKT
06079825102070000,2020,161182,521118,682300,MKT
06079825102070000,2019,161182,521118,682300,MKT
06079825102090000,2021,220454,556946,777400,MKT
06079825102090000,2020,160267,522233,682500,MKT
06079825102090000,2019,160267,522233,682500,MKT
06079825102110000,2021,226684,453816,680500,MKT
06079825102110000,2020,164731,391469,556200,MKT
06079825102110000,2019,164731,391469,556200,MKT
06079825102130000,2021,218534,477166,695700,MKT
06079825102130000,2020,158890,437610,596500,MKT
06079825102130000,2019,158890,437610,596500,MKT
06079825102150000,2021,215102,447098,662200,MKT
06079825102150000,2020,156430,429270,585700,MKT
06079825102150000,2019,156430,429270,585700,MKT
06079825102170000,2021,217667,586633,804300,MKT
06079825102170000,2020,158269,549431,707700,MKT
06079825102170000,2019,158269,549431,707700,MKT
06079825102190000,2021,218943,536057,755000,MKT
06079825102190000,2020,159184,477616,636800,MKT
06079825102190000,2019,159184,477616,636800,MKT
06079825102210000,2021,230090,720610,950700,MKT
06079825102210000,2020,167171,777110,944281,COST
06079825102210000,2019,167171,777110,944281,COST
06079825102230000,2021,245523,388077,633600,MKT
06079825102230000,2020,178220,354280,532500,MKT
06079825102230000,2019,178220,354280,532500,MKT
06079825102250000,2021,245531,524069,769600,MKT
06079825102250000,2020,178226,468174,646400,MKT
06079825102250000,2019,178226,468174,646400,MKT
06079825102270000,2021,243728,378472,622200,MKT
06079825102270000,2020,176936,332764,509700,MKT
06079825102270000,2019,176936,332764,509700,MKT
06079825104010000,2021,270345,328355,598700,MKT
06079825104010000,2020,202232,306468,508700,MKT
06079825104010000,2019,202232,306468,508700,MKT
06079825104030000,2021,321138,312662,633800,MKT
06079825104030000,2020,246635,252265,498900,MKT
06079825104030000,2019,246635,252265,498900,MKT
06079825104050000,2021,239631,370160,609791,COST
06079825104050000,2020,179237,399163,578400,MKT
06079825104050000,2019,179237,399163,578400,MKT
06079825104070000,2021,236391,276509,512900,MKT
06079825104070000,2020,176446,276254,452700,MKT
06079825104070000,2019,176446,276254,452700,MKT
06079825104090000,2021,248901,595460,844361,COST
06079825104090000,2020,187253,327147,514400,MKT
06079825104090000,2019,187253,327147,514400,MKT
06079825105010000,2021,247399,247901,495300,MKT
06079825105010000,2020,185952,225448,411400,MKT
06079825105010000,2019,185952,225448,411400,MKT
06079825105030000,2021,268381,240819,509200,MKT
06079825105030000,2020,204248,195552,399800,MKT
06079825105030000,2019,204248,195552,399800,MKT
06079825105050000,2021,273496,296930,570426,COST
06079825105050000,2020,208742,268758,477500,MKT
06079825105050000,2019,208742,268758,477500,MKT
06079825105070000,2021,251854,209846,461700,MKT
06079825105070000,2020,189818,208982,398800,MKT
06079825105070000,2019,189818,208982,398800,MKT
06079825105090000,2021,234740,257260,492000,MKT
06079825105090000,2020,175026,247174,422200,MKT
06079825105090000,2019,175026,242674,417700,MKT
06079825105110000,2021,234740,269860,504600,MKT
06079825105110000,2020,175026,240674,415700,MKT
06079825105110000,2019,175026,240674,415700,MKT
06079825105130000,2021,248901,335599,584500,MKT
06079825105130000,2020,187253,340447,527700,MKT
06079825105130000,2019,187253,340447,527700,MKT
06079825106010000,2021,293133,285467,578600,MKT
06079825106010000,2020,222009,256391,478400,MKT
06079825106010000,2019,222009,256391,478400,MKT
06079825106030000,2021,293133,0,293133,COST
06079825106030000,2020,222009,0,222009,COST
06079825106030000,2019,222009,0,222009,COST
06079825106050000,2021,317220,461980,779200,MKT
06079825106050000,2020,243169,444850,688019,COST
06079825106050000,2019,243169,444850,688019,COST
06079825106070000,2021,248901,592299,841200,MKT
06079825106070000,2020,187253,608770,796023,COST
06079825106070000,2019,187253,608770,796023,COST
06079825106090000,2021,242793,290007,532800,MKT
06079825106090000,2020,181966,265034,447000,MKT
06079825106090000,2019,181966,261134,443100,MKT
06079825106110000,2021,354120,432080,786200,MKT
06079825106110000,2020,276061,359639,635700,MKT
06079825106110000,2019,276061,359639,635700,MKT
06079825106130000,2021,332398,302502,634900,MKT
06079825106130000,2020,256631,228369,485000,MKT
06079825106130000,2019,256631,228369,485000,MKT
06079825106150000,2021,365658,368950,734608,COST
06079825106150000,2020,286456,367690,654146,COST
06079825106150000,2019,286456,367690,654146,COST
06079825106170000,2021,320936,398850,719786,COST
06079825106170000,2020,251014,381420,632434,COST
06079825106170000,2019,251014,381420,632434,COST
06079825106190000,2021,389667,351660,741327,COST
06079825106190000,2020,308247,351380,659627,COST
06079825106190000,2019,308247,351380,659627,COST
06079825107016500,2021,127803,0,127803,COST
06079825107016500,2020,96606,0,96606,COST
06079825107016500,2019,96606,0,96606,COST
06079825107020000,2021,222556,636244,858800,MKT
06079825107020000,2020,169781,564219,734000,MKT
06079825107020000,2019,169781,564219,734000,MKT
06079825107040000,2021,226215,646285,872500,MKT
06079825107040000,2020,172532,574568,747100,MKT
06079825107040000,2019,172532,574568,747100,MKT
06079825107060000,2021,258134,651966,910100,MKT
06079825107060000,2020,196510,644390,840900,MKT
06079825107060000,2019,196510,644390,840900,MKT
06079825107080000,2021,333509,695650,1029159,COST
06079825107080000,2020,261815,665340,927155,COST
06079825107080000,2019,261815,665340,927155,COST
06079825107100000,2021,300661,0,300661,COST
06079825107100000,2020,236374,0,236374,COST
06079825107100000,2019,236374,0,236374,COST
06079825107126500,2021,88729,0,88729,COST
06079825107126500,2020,67417,0,67417,COST
06079825107126500,2019,67417,0,67417,COST
06079825108010000,2021,300000,891200,1191200,MKT
06079825108010000,2020,162400,711100,873500,MKT
06079825108010000,2019,162400,711100,873500,MKT
06079825108030000,2021,303155,482345,785500,MKT
06079825108030000,2020,164370,482500,646870,COST
06079825108030000,2019,164370,482500,646870,COST
06079825108050000,2021,300000,496300,796300,MKT
06079825108050000,2020,162400,434800,597200,MKT
06079825108050000,2019,162400,434800,597200,MKT
06079825108060000,2021,250575,561125,811700,MKT
06079825108060000,2020,190836,594364,785200,MKT
06079825108060000,2019,190836,594364,785200,MKT
06079825108080000,2021,219156,633844,853000,MKT
06079825108080000,2020,156979,561721,718700,MKT
06079825108080000,2019,156979,0,156979,COST
06079825108100000,2021,285244,563656,848900,MKT
06079825108100000,2020,216841,463159,680000,MKT
06079825108100000,2019,216841,463159,680000,MKT
06079825108120000,2021,260657,0,260657,COST
06079825108120000,2020,198403,0,198403,COST
06079825108120000,2019,198403,0,198403,COST
06079825108140000,2021,458533,0,458533,COST
06079825108140000,2020,326556,0,326556,COST
06079825108140000,2019,326556,0,326556,COST
06079825108260000,2021,349606,1055750,1405356,COST
06079825108260000,2020,287055,1015380,1302435,COST
06079825108260000,2019,287055,1015380,1302435,COST
06079825108280000,2021,323440,407960,731400,MKT
06079825108280000,2020,312985,326815,639800,MKT
06079825108280000,2019,312985,326815,639800,MKT
06079825108300000,2021,356169,558640,914809,COST
06079825108300000,2020,292367,448133,740500,MKT
06079825108300000,2019,292367,448133,740500,MKT
06079825108320000,2021,338957,389590,728547,COST
06079825108320000,2020,278433,330767,609200,MKT
06079825108320000,2019,278433,330767,609200,MKT
06079825108340000,2021,338957,527643,866600,MKT
06079825108340000,2020,278433,442467,720900,MKT
06079825108340000,2019,278433,442467,720900,MKT
06079825108360000,2021,338957,599243,938200,MKT
06079825108360000,2020,278433,450667,729100,MKT
06079825108360000,2019,278433,450667,729100,MKT
06079825108380000,2021,338957,683043,1022000,MKT
06079825108380000,2020,278433,521367,799800,MKT
06079825108380000,2019,278433,521367,799800,MKT
06079825108400000,2021,354948,510552,865500,MKT
06079825108400000,2020,291379,379521,670900,MKT
06079825108400000,2019,291379,379521,670900,MKT
06079825108420000,2021,362823,343077,705900,MKT
06079825108420000,2020,297751,284349,582100,MKT
06079825108420000,2019,297751,284349,582100,MKT
06079825108440000,2021,362823,611670,974493,COST
06079825108440000,2020,297751,460949,758700,MKT
06079825108440000,2019,297751,460949,758700,MKT
06079825108460000,2021,355169,382500,737669,COST
06079825108460000,2020,291557,303343,594900,MKT
06079825108460000,2019,291557,303343,594900,MKT
06079825118016500,2021,1655,0,1655,COST
06079825118016500,2020,1540,0,1540,COST
06079825118016500,2019,1540,0,1540,COST
06079825118070000,2021,296106,565494,861600,MKT
06079825118070000,2020,234730,502970,737700,MKT
06079825118070000,2019,234730,502970,737700,MKT
06079825118090000,2021,311483,551340,862823,COST
06079825118090000,2020,246743,467057,713800,MKT
06079825118090000,2019,246743,467057,713800,MKT
06079825118110000,2021,292773,499827,792600,MKT
06079825118110000,2020,232125,459975,692100,MKT
06079825118110000,2019,232125,459975,692100,MKT
06079825118130000,2021,287252,352248,639500,MKT
06079825118130000,2020,227809,310191,538000,MKT
06079825118130000,2019,227809,310191,538000,MKT
06079825118150000,2021,287252,492048,779300,MKT
06079825118150000,2020,227809,473291,701100,MKT
06079825118150000,2019,227809,473291,701100,MKT
06079825118170000,2021,287252,581448,868700,MKT
06079825118170000,2020,227809,504191,732000,MKT
06079825118170000,2019,227809,504191,732000,MKT
06079825118190000,2021,287252,599748,887000,MKT
06079825118190000,2020,227809,525891,753700,MKT
06079825118190000,2019,227809,525891,753700,MKT
06079825118210000,2021,299493,489507,789000,MKT
06079825118210000,2020,237377,409023,646400,MKT
06079825118210000,2019,237377,409023,646400,MKT
06079825118230000,2021,303758,369942,673700,MKT
06079825118230000,2020,240709,316391,557100,MKT
06079825118230000,2019,240709,316391,557100,MKT
06079825118250000,2021,301680,442310,743990,COST
06079825118250000,2020,239086,379331,618417,MRA
06079825118250000,2019,239086,379331,618417,MRA
06079825118270000,2021,287839,425261,713100,MKT
06079825118270000,2020,228268,435632,663900,MKT
06079825118270000,2019,228268,435632,663900,MKT
06079825118310000,2021,290390,312010,602400,MKT
06079825118310000,2020,230262,254738,485000,MKT
06079825118310000,2019,230262,254738,485000,MKT
06079825118330000,2021,274200,428200,702400,MKT
06079825118330000,2020,217601,385999,603600,MKT
06079825118330000,2019,217601,383999,601600,MKT
06079825118350000,2021,270730,687670,958400,MKT
06079825118350000,2020,214886,556514,771400,MKT
06079825118350000,2019,214886,556514,771400,MKT
06079825118370000,2021,283064,0,283064,COST
06079825118370000,2020,224535,0,224535,COST
06079825118370000,2019,224535,0,224535,COST
06079825118390000,2021,273984,443216,717200,MKT
06079825118390000,2020,217432,373168,590600,MKT
06079825118390000,2019,217432,373168,590600,MKT
06079825118410000,2021,300906,550794,851700,MKT
06079825118410000,2020,238481,519519,758000,MKT
06079825118410000,2019,238481,519519,758000,MKT
06079825118430000,2021,320833,466167,787000,MKT
06079825118430000,2020,254044,374256,628300,MKT
06079825118430000,2019,254044,374256,628300,MKT
06079825118450000,2021,277300,383600,660900,MKT
06079825118450000,2020,220026,353874,573900,MKT
06079825118450000,2019,220026,395274,615300,MKT
06079825118470000,2021,282885,379915,662800,MKT
06079825118470000,2020,224395,338405,562800,MKT
06079825118470000,2019,224395,339105,563500,MKT
06079825118490000,2021,282955,457445,740400,MKT
06079825118490000,2020,224449,384851,609300,MKT
06079825118490000,2019,224449,384851,609300,MKT
06079825118510000,2021,311600,280000,591600,MKT
06079825118510000,2020,246835,269865,516700,MKT
06079825118510000,2019,246835,269865,516700,MKT
06079825120010000,2021,1010723,0,1010723,COST
06079825120010000,2020,748319,0,748319,COST
06079825120010000,2019,748319,0,748319,COST
06079825201030000,2021,55637,249080,304717,COST
06079825201030000,2020,52065,237800,289865,COST
06079825201030000,2019,52065,237800,289865,COST
06079825201200000,2021,622974,2561100,3184074,COST
06079825201200000,2020,540600,2244470,2785070,COST
06079825201200000,2019,540600,2244470,2785070,COST
06079825301010000,2021,591783,221470,813253,COST
06079825301010000,2020,509517,217510,727027,COST
06079825301010000,2019,509517,217510,727027,COST
06079825301060000,2021,10763,167780,178543,COST
06079825301060000,2020,10403,162170,172573,COST
06079825301060000,2019,10403,162170,172573,COST
06079825301260000,2021,220552,294500,515052,COST
06079825301260000,2020,163379,291570,454949,COST
06079825301260000,2019,163379,291570,454949,COST
06079825301460000,2021,7889,0,7889,COST
06079825301460000,2020,7319,0,7319,COST
06079825301460000,2019,7319,0,7319,COST
06079825302010000,2021,590165,316360,906525,COST
06079825302010000,2020,507911,306040,813951,COST
06079825302010000,2019,507911,306040,813951,COST
06079825302030000,2021,495850,271470,767320,COST
06079825302030000,2020,415531,264440,679971,COST
06079825302030000,2019,415531,264440,679971,COST
06079825302050000,2021,495850,315330,811180,COST
06079825302050000,2020,415531,307660,723191,COST
06079825302050000,2019,415531,307660,723191,COST
06079825318010000,2021,1663,0,1663,COST
06079825318010000,2020,1548,0,1548,COST
06079825318010000,2019,1548,0,1548,COST
06079825320010000,2021,333003,244960,577963,COST
06079825320010000,2020,262586,243150,505736,COST
06079825320010000,2019,262586,243150,505736,COST
06079825320060000,2021,319712,189088,508800,INCOME
06079825320060000,2020,250540,224460,475000,INCOME
06079825320060000,2019,250540,224460,475000,INCOME
06079825415010000,2021,180460,223550,404010,COST
06079825415010000,2020,203578,212750,416328,OVR
06079825415010000,2019,203578,212750,416328,COST
06079825415020000,2021,231690,0,231690,COST
06079825415040000,2021,193470,0,193470,COST
06079825415040000,2020,140406,0,140406,COST
06079825415040000,2019,140406,0,140406,COST
06079825415060000,2021,205493,0,205493,COST
06079825415060000,2020,150512,0,150512,COST
06079825415060000,2019,150512,0,150512,COST
06079825415080000,2021,215551,0,215551,COST
06079825415080000,2020,159037,0,159037,COST
06079825415080000,2019,159037,0,159037,COST
06079825415100000,2021,183199,271701,454900,MKT
06079825415100000,2020,131847,228670,360517,COST
06079825415100000,2019,131847,228670,360517,COST
06079825415120000,2021,183199,216501,399700,MKT
06079825415120000,2020,131847,181953,313800,MKT
06079825415120000,2019,131847,181953,313800,MKT
06079825415140000,2021,183199,207301,390500,MKT
06079825415140000,2020,131847,173470,305317,COST
06079825415140000,2019,131847,173470,305317,COST
06079825415160000,2021,219500,424950,644450,COST
06079825415160000,2020,162400,424640,587040,COST
06079825415160000,2019,162400,424640,587040,COST
06079825415180000,2021,253965,165535,419500,MKT
06079825415180000,2020,192136,175664,367800,MKT
06079825415180000,2019,192136,175664,367800,MKT
06079825415200000,2021,330922,433150,764072,COST
06079825415200000,2020,260695,421200,681895,COST
06079825415200000,2019,260695,421200,681895,COST
06079825415250000,2021,202833,321067,523900,MKT
06079825415250000,2020,148268,303032,451300,MKT
06079825415250000,2019,148268,303032,451300,MKT
06079825416030000,2021,335275,327640,662915,COST
06079825416030000,2020,264652,325950,590602,COST
06079825416030000,2019,264652,325950,590602,COST
06079825420010000,2021,447286,184030,631316,COST
06079825420010000,2020,13862,175890,189752,COST
06079825420010000,2019,13862,175890,189752,COST
06079825420200000,2021,77714,8310,86024,COST
06079825420200000,2020,87859,8060,95919,COST
06079825420200000,2019,87859,8060,95919,COST
06079826101010000,2021,220552,159450,380002,COST
06079826101010000,2020,163379,155250,318629,COST
06079826101010000,2019,163379,155250,318629,COST
06079826101030000,2021,26988,182620,209608,COST
06079826101030000,2020,25503,181010,206513,COST
06079826101030000,2019,25503,181010,206513,COST
06079826101040000,2021,13067,528920,541987,COST
06079826101040000,2020,17519,504160,521679,COST
06079826101040000,2019,17519,301600,319119,COST
06079826101050000,2021,41770,0,41770,COST
06079826101050000,2020,43529,0,43529,COST
06079826101050000,2019,43529,0,43529,COST
06079826301010000,2021,88133,0,88133,COST
06079826301010000,2020,117017,0,117017,COST
06079826301010000,2019,117017,0,117017,COST
06079826401010000,2021,41600,6100,47700,COST
06079826401010000,2020,55931,6340,62271,COST
06079826401010000,2019,55931,6340,62271,COST
06079826401150000,2021,39939,0,39939,COST
06079826401150000,2020,49017,0,49017,COST
06079826401150000,2019,49017,0,49017,COST
06079827101030000,2021,72473,0,72473,COST
06079827101030000,2020,68574,0,68574,COST
06079827101030000,2019,68574,0,68574,COST
06079827101250000,2021,5116,271720,276836,COST
06079827101250000,2020,5168,266730,271898,COST
06079827101250000,2019,5168,266730,271898,COST
06079827101300000,2021,1134,0,1134,COST
06079827101300000,2020,1056,0,1056,COST
06079827101300000,2019,1056,0,1056,COST
06079827101400000,2021,32275,229560,261835,COST
06079827101400000,2020,30386,222210,252596,COST
06079827101400000,2019,30386,222210,252596,COST
06079827101670000,2021,11817,243580,255397,COST
06079827101670000,2020,12183,235540,247723,COST
06079827101670000,2019,12183,235540,247723,COST
06079827201020000,2021,10906,2968970,2979876,COST
06079827201020000,2020,10535,2894280,2904815,COST
06079827201020000,2019,10535,2894280,2904815,COST
06079827201100000,2021,220577,476140,696717,COST
06079827201100000,2020,163402,466490,629892,COST
06079827201100000,2019,163402,466490,629892,COST
06079827201200000,2021,220576,465410,685986,COST
06079827201200000,2020,163401,453310,616711,COST
06079827201200000,2019,163401,453310,616711,COST
06079827201300000,2021,440019,1858230,2298249,COST
06079827201300000,2020,325748,1784520,2110268,COST
06079827201300000,2019,325748,1784520,2110268,COST
06079827201500000,2021,220574,1543600,1764174,COST
06079827201500000,2020,163400,1511450,1674850,COST
06079827201500000,2019,163400,1511450,1674850,COST
06079827201550000,2021,1129,1950,3079,COST
06079827201550000,2020,1051,1810,2861,COST
06079827201550000,2019,1051,1810,2861,COST
06079827201600000,2021,2265,0,2265,COST
06079827201600000,2020,2107,0,2107,COST
06079827201600000,2019,2107,0,2107,COST
06079827301010000,2021,220552,276500,497052,COST
06079827301010000,2020,163379,272230,435609,COST
06079827301010000,2019,163379,272230,435609,COST
06079827301100000,2021,1207,2310,3517,COST
06079827301100000,2020,1124,2510,3634,COST
06079827301100000,2019,1124,2510,3634,COST
06079827301200000,2021,10741,688690,699431,COST
06079827301200000,2020,10381,671220,681601,COST
06079827301200000,2019,10381,671220,681601,COST
06079827301300000,2021,13652,572320,585972,COST
06079827301300000,2020,13085,558920,572005,COST
06079827301300000,2019,13085,522590,535675,COST
06079827301400000,2021,220552,411510,632062,COST
06079827301400000,2020,163379,399820,563199,COST
06079827301400000,2019,163379,399820,563199,COST
06079827301500000,2021,222467,2903800,3126267,COST
06079827301500000,2020,165161,2828300,2993461,COST
06079827301500000,2019,165161,2828300,2993461,COST
06079827401010000,2021,7482,404490,411972,COST
06079827401010000,2020,7358,403560,410918,COST
06079827401010000,2019,7358,403560,410918,COST
06079827401100000,2021,12880,604250,617130,COST
06079827401100000,2020,12369,576550,588919,COST
06079827401100000,2019,11283,0,11283,COST
06079828101020000,2021,406546,199250,605796,COST
06079828101020000,2020,347012,170670,517682,COST
06079828101020000,2019,347012,170670,517682,COST
06079828101050000,2021,1866,184820,186686,COST
06079828101050000,2020,2144,161550,163694,COST
06079828101050000,2019,2144,161550,163694,COST
06079828101080000,2021,359828,153772,513600,MKT
06079828101080000,2020,312832,110990,423822,COST
06079828101080000,2019,312832,110990,423822,COST
06079828101080900,2021,35071,857150,892221,COST
06079828101080900,2020,47274,718820,766094,COST
06079828101080900,2019,47274,718820,766094,COST
06079828101200000,2021,11412,0,11412,COST
06079828101200000,2020,10594,0,10594,COST
06079828101200000,2019,10594,0,10594,COST
06079828101250000,2021,26623,1146730,1173353,COST
06079828101250000,2020,25538,984350,1009888,COST
06079828101250000,2019,25538,984350,1009888,COST
06079828101350000,2021,16219,0,16219,COST
06079828101350000,2020,15053,0,15053,COST
06079828101350000,2019,15053,0,15053,COST
06079828101400000,2021,17263,0,17263,COST
06079828101400000,2020,21006,0,21006,COST
06079828101400000,2019,21006,0,21006,COST
06079828101450000,2021,13357,0,13357,COST
06079828101450000,2020,19714,0,19714,COST
06079828101450000,2019,19714,0,19714,COST
06079828101500000,2021,13352,0,13352,COST
06079828101500000,2020,20133,0,20133,COST
06079828101500000,2019,20133,0,20133,COST
06079828201010000,2021,3304,0,3304,COST
06079828201010000,2020,3067,0,3067,COST
06079828201010000,2019,3067,0,3067,COST
06079828201100000,2021,4378,0,4378,COST
06079828201100000,2020,4065,0,4065,COST
06079828201100000,2019,4065,0,4065,COST
06079828201200000,2021,7809,0,7809,COST
06079828201200000,2020,7242,0,7242,COST
06079828201200000,2019,7242,0,7242,COST
06079828201300000,2021,4032,243540,247572,COST
06079828201300000,2020,4154,211060,215214,COST
06079828201300000,2019,4154,211060,215214,COST
06079828202010000,2021,2424,278340,280764,COST
06079828202010000,2020,2663,240850,243513,COST
06079828202010000,2019,2663,240850,243513,COST
06079828202100000,2021,620,0,620,COST
06079828202100000,2020,577,0,577,COST
06079828202100000,2019,577,0,577,COST
06079828202200000,2021,883,0,883,COST
06079828202200000,2020,822,0,822,COST
06079828202200000,2019,822,0,822,COST
06079828202300000,2021,2193,0,2193,COST
06079828202300000,2020,2037,0,2037,COST
06079828202300000,2019,2037,0,2037,COST
06079828203010000,2021,3670,0,3670,COST
06079828203010000,2020,3409,0,3409,COST
06079828203010000,2019,3409,0,3409,COST
06079828203100000,2021,3363,0,3363,COST
06079828203100000,2020,3124,0,3124,COST
06079828203100000,2019,3124,0,3124,COST
06079828203200000,2021,4600,0,4600,COST
06079828203200000,2020,4684,0,4684,COST
06079828203200000,2019,4684,0,4684,COST
06079828203300000,2021,1531,0,1531,COST
06079828203300000,2020,1425,0,1425,COST
06079828203300000,2019,1425,0,1425,COST
06079828204010000,2021,7111,0,7111,COST
06079828204010000,2020,6600,0,6600,COST
06079828204010000,2019,6600,0,6600,COST
06079828204100000,2021,8996,0,8996,COST
06079828204100000,2020,8762,0,8762,COST
06079828204100000,2019,8762,0,8762,COST
06079828204200000,2021,7336,0,7336,COST
06079828204200000,2020,6810,0,6810,COST
06079828204200000,2019,6810,0,6810,COST
06079828204300000,2021,6266,0,6266,COST
06079828204300000,2020,5817,0,5817,COST
06079828204300000,2019,5817,0,5817,COST
06079828301050000,2021,192635,206065,398700,MKT
06079828301050000,2020,183994,161906,345900,MKT
06079828301050000,2019,183994,170106,354100,MKT
06079828301060000,2021,210475,472930,683405,COST
06079828301060000,2020,212617,237520,450137,COST
06079828301060000,2019,212617,237520,450137,COST
06079828301100000,2021,14572,469250,483822,COST
06079828301100000,2020,17977,394210,412187,COST
06079828301100000,2019,17977,394210,412187,COST
06079828301250000,2021,11929,367640,379569,COST
06079828301250000,2020,14835,309130,323965,COST
06079828301250000,2019,14835,309130,323965,COST
06079828301300000,2021,545580,160490,706070,COST
06079828301300000,2020,606388,113690,720078,COST
06079828301300000,2019,606388,113690,720078,COST
06079828301400000,2021,145914,1351980,1497894,COST
06079828301400000,2020,145481,1138170,1283651,COST
06079828301400000,2019,145481,1138170,1283651,COST
06079828302050000,2021,16491,0,16491,COST
06079828302050000,2020,15304,0,15304,COST
06079828302050000,2019,15304,0,15304,COST
06079828302150000,2021,11668,0,11668,COST
06079828302150000,2020,10828,0,10828,COST
06079828302150000,2019,10828,0,10828,COST
06079828303010000,2021,13,0,13,COST
06079828303010000,2020,12,0,12,COST
06079828303010000,2019,12,0,12,COST
06079828303050000,2021,76,0,76,COST
06079828303050000,2020,84,0,84,COST
06079828303050000,2019,84,0,84,COST
06079828401010000,2021,145111,508620,653731,COST
06079828401010000,2020,144734,424600,569334,COST
06079828401010000,2019,144734,413920,558654,COST
06079828401020000,2021,149993,405930,555923,COST
06079828401020000,2020,148764,350570,499334,COST
06079828401020000,2019,148764,293060,441824,COST
06079828401150000,2021,7524,0,7524,COST
06079828401150000,2020,6998,0,6998,COST
06079828401150000,2019,6998,0,6998,COST
06079828404060100,2021,40,0,40,COST
06079828404060100,2020,37,0,37,COST
06079828404060100,2019,37,0,37,COST
06079829101010000,2021,287236,340270,627506,COST
06079829101010000,2020,258337,288280,546617,COST
06079829101010000,2019,258337,288280,546617,COST
06079829101020000,2021,422665,0,422665,COST
06079829101020000,2020,358665,0,358665,COST
06079829101020000,2019,358665,0,358665,COST
06079829101030000,2021,378584,331516,710100,MKT
06079829101030000,2020,326631,282600,609231,COST
06079829101030000,2019,326631,282600,609231,COST
06079829101040000,2021,257696,387160,644856,COST
06079829101040000,2020,235587,375240,610827,COST
06079829101040000,2019,235587,375240,610827,COST
06079829101050000,2021,221,0,221,COST
06079829101050000,2020,206,0,206,COST
06079829101050000,2019,206,0,206,COST
06079829101060000,2021,144055,587820,731875,COST
06079829101060000,2020,143752,490570,634322,COST
06079829101060000,2019,143752,490570,634322,COST
06079829101070000,2021,611,0,611,COST
06079829101070000,2020,569,0,569,COST
06079829101070000,2019,569,0,569,COST
06079829101080000,2021,701,0,701,COST
06079829101080000,2020,653,0,653,COST
06079829101080000,2019,653,0,653,COST
06079829101090000,2021,228380,444320,672700,MKT
06079829101090000,2020,212617,369583,582200,MKT
06079829101090000,2019,212617,469520,682137,COST
06079829101100000,2021,8840,369740,378580,COST
06079829101100000,2020,408159,310110,718269,COST
06079829101100000,2019,408159,310110,718269,COST
06079829101110000,2021,3401,0,3401,COST
06079829101110000,2020,1354,0,1354,COST
06079829101110000,2019,1354,0,1354,COST
06079829101120000,2021,291685,474070,765755,COST
06079829101120000,2020,356243,328070,684313,COST
06079829101120000,2019,356243,328070,684313,COST
06079829101130000,2021,331139,0,331139,COST
06079829101130000,2020,396779,0,396779,COST
06079829101130000,2019,396779,0,396779,COST
06079829101140000,2021,303112,198088,501200,MKT
06079829101140000,2020,368065,147820,515885,COST
06079829101140000,2019,368065,147820,515885,COST
06079829101150000,2021,325938,991560,1317498,COST
06079829101150000,2020,287620,830650,1118270,COST
06079829101150000,2019,287620,830650,1118270,COST
06079829101190000,2021,258069,411830,669899,COST
06079829101190000,2020,321052,343930,664982,COST
06079829101190000,2019,321052,343930,664982,COST
06079829102010000,2021,427800,227500,655300,MKT
06079829102010000,2020,493212,178880,672092,COST
06079829102010000,2019,493212,178880,672092,COST
06079829102180000,2021,145612,72050,217662,COST
06079829102180000,2020,145200,74940,220140,COST
06079829102180000,2019,145200,74940,220140,COST
06079829201010000,2021,10294,29330,39624,COST
06079829201010000,2020,9578,28450,38028,COST
06079829201010000,2019,9578,28450,38028,COST
06079829201100000,2021,283002,909500,1192502,COST
06079829201100000,2020,255099,748850,1003949,COST
06079829201100000,2019,255099,748850,1003949,COST
06079829201200000,2021,18132,0,18132,COST
06079829201200000,2020,18712,0,18712,COST
06079829201200000,2019,18712,0,18712,COST
06079829202010000,2021,188656,218944,407600,MKT
06079829202010000,2020,180761,169039,349800,MKT
06079829202010000,2019,180761,169039,349800,MKT
06079829301010000,2021,347608,531290,878898,COST
06079829301010000,2020,303784,443580,747364,COST
06079829301010000,2019,303784,443580,747364,COST
06079829301030000,2021,145052,175220,320272,COST
06079829301030000,2020,144679,151270,295949,COST
06079829301030000,2019,144679,151270,295949,COST
06079829301040000,2021,150449,358651,509100,MKT
06079829301040000,2020,149149,308651,457800,MKT
06079829301040000,2019,149149,308651,457800,MKT
06079829301060000,2021,145160,279350,424510,COST
06079829301060000,2020,144779,234950,379729,OVR
06079829301060000,2019,144779,234950,379729,COST
06079829301070000,2021,30340,148610,178950,COST
06079829301070000,2020,39787,128320,168107,COST
06079829301070000,2019,39787,128320,168107,COST
06079829301080000,2021,1910,204820,206730,COST
06079829301080000,2020,2185,175060,177245,COST
06079829301080000,2019,2185,175060,177245,COST
06079829301090000,2021,288,0,288,COST
06079829301090000,2020,339,0,339,COST
06079829301090000,2019,339,0,339,COST
06079829301100000,2021,232639,344061,576700,MKT
06079829301100000,2020,215981,260619,476600,MKT
06079829301100000,2019,215981,260619,476600,MKT
06079829301150000,2021,52408,448660,501068,COST
06079829301150000,2020,65962,388180,454142,COST
06079829301150000,2019,65962,388180,454142,COST
06079829301160000,2021,162723,545377,708100,MKT
06079829301160000,2020,159423,506390,665813,COST
06079829301160000,2019,159423,506390,665813,COST
06079829303010000,2021,223548,309752,533300,MKT
06079829303010000,2020,208790,235010,443800,MKT
06079829303010000,2019,208790,228910,437700,MKT
06079829305010000,2021,2091,0,2091,COST
06079829305010000,2020,1946,0,1946,COST
06079829305010000,2019,1946,0,1946,COST
06079829401010000,2021,2325,0,2325,COST
06079829401010000,2020,2163,0,2163,COST
06079829401010000,2019,2163,0,2163,COST
06079829401050000,2021,242739,301561,544300,MKT
06079829401050000,2020,223920,234080,458000,MKT
06079829401050000,2019,223920,234080,458000,MKT
06079829401100000,2021,410053,4530,414583,COST
06079829401100000,2020,475777,4980,480757,COST
06079829401100000,2019,475777,4980,480757,COST
06079829401400000,2021,291196,114560,405756,COST
06079829401400000,2020,355736,97510,453246,COST
06079829401400000,2019,355736,97510,453246,COST
06079829401420000,2021,5548,536210,541758,COST
06079829401420000,2020,6202,454460,460662,COST
06079829401420000,2019,6202,454460,460662,COST
06079829402010000,2021,325938,331062,657000,MKT
06079829402010000,2020,287620,299210,586830,COST
06079829402010000,2019,287620,299210,586830,COST
06079830101050000,2021,122219,0,122219,COST
06079830101050000,2020,106149,0,106149,COST
06079830101050000,2019,106149,0,106149,COST
06079830101150000,2021,181937,0,181937,COST
06079830101150000,2020,245268,0,245268,COST
06079830101150000,2019,241219,0,241219,COST
06079830102010000,2021,290263,205737,496000,MKT
06079830102010000,2020,260648,180852,441500,MKT
06079830102010000,2019,260648,180852,441500,MKT
06079830102060000,2021,2589,323290,325879,COST
06079830102060000,2020,2816,273670,276486,COST
06079830102060000,2019,2816,273670,276486,COST
06079830401010000,2021,146311,0,146311,COST
06079830401010000,2020,187976,0,187976,COST
06079830401010000,2019,187976,0,187976,COST
06079831101010000,2021,415888,308960,724848,COST
06079831101010000,2020,353774,263100,616874,COST
06079831101010000,2019,353774,263100,616874,COST
06079831101020000,2021,305312,14290,319602,COST
06079831101020000,2020,405916,14740,420656,COST
06079831101020000,2019,405916,14740,420656,COST
06079831401010000,2021,152265,0,152265,COST
06079831401010000,2020,196794,0,196794,COST
06079831401010000,2019,196794,0,196794,COST
06079831403010000,2021,5535,0,5535,COST
06079831403010000,2020,5151,0,5151,COST
06079831403010000,2019,5151,0,5151,COST
06079832101010000,2021,40149,392080,432229,COST
06079832101010000,2020,51060,340800,391860,COST
06079832101010000,2019,51060,340800,391860,COST
06079832101030000,2021,192635,198665,391300,MKT
06079832101030000,2020,183994,159406,343400,MKT
06079832101030000,2019,183994,159406,343400,MKT
06079832101040000,2021,4633,175530,180163,COST
06079832101040000,2020,4719,150530,155249,COST
06079832101040000,2019,4719,150530,155249,COST
06079832101100000,2021,10664,604900,615564,COST
06079832101100000,2020,12836,504410,517246,COST
06079832101100000,2019,12836,504410,517246,COST
06079832101200000,2021,18674,0,18674,COST
06079832101200000,2020,21057,0,21057,COST
06079832101200000,2019,21057,0,21057,COST
06079832101300000,2021,11219,224950,236169,COST
06079832101300000,2020,11812,0,11812,COST
06079832101300000,2019,11812,0,11812,COST
06079832201010000,2021,93198,0,93198,COST
06079832201010000,2020,81965,0,81965,COST
06079832201010000,2019,81965,0,81965,COST
06079832202010000,2021,6778,0,6778,COST
06079832202010000,2020,6450,0,6450,COST
06079832202010000,2019,6450,0,6450,COST
06079832301031001,2021,311607,2347620,2659227,COST
06079832301031001,2020,276841,2133040,2409881,COST
06079832301031001,2019,276841,2133040,2409881,COST
06079832301031002,2021,92975,0,92975,COST
06079832301031002,2020,275565,0,275565,COST
06079832301031002,2019,275565,0,275565,COST
06079832301100000,2021,149670,897610,1047280,COST
06079832301100000,2020,148976,754660,903636,COST
06079832301100000,2019,148976,754660,903636,COST
06079832304010000,2021,3340,0,3340,COST
06079832304010000,2020,4223,0,4223,COST
06079832304010000,2019,4223,0,4223,COST
06079832401010000,2021,37544,0,37544,COST
06079832401010000,2020,53697,0,53697,COST
06079832401010000,2019,53697,0,53697,COST
06079832401100000,2021,1977,0,1977,COST
06079832401100000,2020,1839,0,1839,COST
06079832401100000,2019,1839,0,1839,COST
06079833101080000,2021,499548,105460,605008,COST
06079833101080000,2020,413374,92430,505804,COST
06079833101080000,2019,413374,92430,505804,COST
06079833101090000,2021,145052,376090,521142,COST
06079833101090000,2020,144679,330170,474849,COST
06079833101090000,2019,144679,330170,474849,COST
06079833101100000,2021,145069,305890,450959,COST
06079833101100000,2020,144695,256930,401625,COST
06079833101100000,2019,144695,256930,401625,COST
06079833101120000,2021,145081,221860,366941,COST
06079833101120000,2020,144706,189170,333876,COST
06079833101120000,2019,144706,189170,333876,COST
06079833101120100,2021,21,0,21,COST
06079833101120100,2020,20,0,20,COST
06079833101120100,2019,20,0,20,COST
06079833101160000,2021,145078,801080,946158,COST
06079833101160000,2020,144703,670980,815683,COST
06079833101160000,2019,144703,670980,815683,COST
06079833101250000,2021,378632,0,378632,COST
06079833101250000,2020,326665,0,326665,COST
06079833101250000,2019,326665,0,326665,COST
06079833101270000,2021,378584,10630,389214,COST
06079833101270000,2020,326631,10780,337411,COST
06079833101270000,2019,326631,10780,337411,COST
06079833101300000,2021,145054,768640,913694,COST
06079833101300000,2020,144680,655070,799750,COST
06079833101300000,2019,144680,655070,799750,COST
06079833101350000,2021,145052,381890,526942,COST
06079833101350000,2020,144679,331510,476189,COST
06079833101350000,2019,144679,331510,476189,COST
06079833201010000,2021,4967,227400,232367,COST
06079833201010000,2020,5032,16020,21052,COST
06079833201010000,2019,5032,16020,21052,COST
06079833201030000,2021,4196,0,4196,COST
06079833201030000,2020,3903,0,3903,COST
06079833201030000,2019,3903,0,3903,COST
06079833201050000,2021,8672,0,8672,COST
06079833201050000,2020,9577,0,9577,COST
06079833201050000,2019,9577,0,9577,COST
06079833202010000,2021,2065,0,2065,COST
06079833202010000,2020,1920,0,1920,COST
06079833202010000,2019,1920,0,1920,COST
06079833202030000,2021,2040,0,2040,COST
06079833202030000,2020,1897,0,1897,COST
06079833202030000,2019,1897,0,1897,COST
06079833202050000,2021,1987,0,1987,COST
06079833202050000,2020,1847,0,1847,COST
06079833202050000,2019,1847,0,1847,COST
06079833301060000,2021,145069,469120,614189,COST
06079833301060000,2020,144695,285590,430285,OVR
06079833301060000,2019,144695,285590,430285,COST
06079833301080000,2021,145072,370550,515622,COST
06079833301080000,2020,144697,316470,461167,COST
06079833301080000,2019,144697,316470,461167,COST
06079833301100000,2021,381980,345020,727000,COST
06079833301100000,2020,329118,243282,572400,INCOME
06079833301100000,2019,329118,243282,572400,INCOME
06079833301120000,2021,379219,352181,731400,MKT
06079833301120000,2020,327096,307504,634600,MKT
06079833301120000,2019,327096,307504,634600,MKT
06079833301140000,2021,385335,289965,675300,MKT
06079833301140000,2020,331571,263420,594991,OVR
06079833301140000,2019,331571,263420,594991,COST
06079833301200000,2021,381037,382663,763700,MKT
06079833301200000,2020,328427,354525,682952,MRA
06079833301200000,2019,328427,354525,682952,MRA
06079833301250000,2021,1108,0,1108,COST
06079833301250000,2020,1031,0,1031,COST
06079833301250000,2019,1031,0,1031,COST
06079833301300000,2021,1224,66960,68184,COST
06079833301300000,2020,1139,67080,68219,COST
06079833301300000,2019,1050,64780,65830,COST
06079833302010000,2021,9359,759470,768829,COST
06079833302010000,2020,6133,416910,423043,COST
06079833302010000,2019,6133,416910,423043,COST
06079833302100000,2021,163778,536820,700598,COST
06079833302100000,2020,217971,457670,675641,COST
06079833302100000,2019,217971,457670,675641,COST
06079833401060000,2021,382059,468764,850823,OVR
06079833401060000,2020,329175,399200,728375,COST
06079833401060000,2019,329175,399200,728375,COST
06079833401120000,2021,165258,1024100,1189358,COST
06079833401120000,2020,219349,949600,1168949,COST
06079833401120000,2019,219349,949600,1168949,COST
06079833401200000,2021,14220,311800,326020,COST
06079833401200000,2020,17118,262390,279508,COST
06079833401200000,2019,17118,262390,279508,COST
06079833401300000,2021,163868,898140,1062008,COST
06079833401300000,2020,218055,775580,993635,COST
06079833401300000,2019,218145,331700,549845,COST
06079833401350000,2021,163997,849170,1013167,COST
06079833401350000,2020,218176,710380,928556,COST
06079833401350000,2019,218176,647590,865766,COST
06079833401400000,2021,145360,379960,525320,COST
06079833401400000,2020,144965,318580,463545,COST
06079833401400000,2019,144965,318580,463545,COST
06079834101010000,2021,22436,0,22436,COST
06079834101010000,2020,28293,0,28293,COST
06079834101010000,2019,28293,0,28293,COST
06079834101080000,2021,439996,2184810,2624806,COST
06079834101080000,2020,325727,2149720,2475447,COST
06079834101080000,2019,325727,2149720,2475447,COST
06079834101120000,2021,1107,137950,139057,COST
06079834101120000,2020,1031,114630,115661,COST
06079834101120000,2019,1024,114630,115654,COST
06079834101160000,2021,221739,460340,682079,COST
06079834101160000,2020,164484,450740,615224,COST
06079834101160000,2019,164484,450740,615224,COST
06079834101400000,2021,220592,499430,720022,COST
06079834101400000,2020,163416,488200,651616,COST
06079834101400000,2019,163416,488200,651616,COST
06079834101450000,2021,582294,215830,798124,COST
06079834101450000,2020,500110,208320,708430,COST
06079834101450000,2019,500110,208320,708430,COST
06079834102010000,2021,24561,659710,684271,COST
06079834102010000,2020,29797,571660,601457,COST
06079834102010000,2019,29797,571660,601457,COST
06079834103010000,2021,441135,2377480,2818615,COST
06079834103010000,2020,326787,2305320,2632107,COST
06079834103010000,2019,326787,2305320,2632107,COST
06079834104010000,2021,12214,689860,702074,COST
06079834104010000,2020,12165,676260,688425,COST
06079834104010000,2019,534710,676260,1210970,COST
06079834104050000,2021,75088,0,75088,COST
06079834104050000,2020,56608,0,56608,COST
06079834104050000,2019,56608,0,56608,COST
06079834201060000,2021,16297,0,16297,COST
06079834201060000,2020,19697,0,19697,COST
06079834201060000,2019,19697,0,19697,COST
06079834201080000,2021,221649,1471890,1693539,COST
06079834201080000,2020,164400,1447120,1611520,COST
06079834201080000,2019,164400,1447120,1611520,COST
06079834201100000,2021,23795,0,23795,COST
06079834201100000,2020,30083,0,30083,COST
06079834201100000,2019,30083,0,30083,COST
06079834301010000,2021,10587,969660,980247,COST
06079834301010000,2020,13239,934460,947699,COST
06079834301010000,2019,13239,934460,947699,COST
06079834301050000,2021,617705,0,617705,COST
06079834301050000,2020,535332,0,535332,COST
06079834301050000,2019,535332,0,535332,COST
06079834301100000,2021,221097,266480,487577,COST
06079834301100000,2020,163886,259720,423606,COST
06079834301100000,2019,163893,259720,423613,COST
06079834301200000,2021,24669,0,24669,COST
06079834301200000,2020,30264,0,30264,COST
06079834301200000,2019,30264,0,30264,COST
06079834301300000,2021,10629,110690,121319,COST
06079834301300000,2020,10280,108260,118540,COST
06079834301300000,2019,10280,108260,118540,COST
06079834401010000,2021,220591,175620,396211,COST
06079834401010000,2020,163415,171790,335205,COST
06079834401010000,2019,163415,171790,335205,COST
06079834401100000,2021,440103,551470,991573,COST
06079834401100000,2020,325826,532190,858016,COST
06079834401100000,2019,325826,532190,858016,COST
06079834401200000,2021,220651,264150,484801,COST
06079834401200000,2020,163471,142190,305661,COST
06079834401200000,2019,163471,142190,305661,COST
06079834410010000,2021,703203,139590,842793,COST
06079834410010000,2020,621626,130520,752146,COST
06079834410010000,2019,621626,130520,752146,COST
06079834410200000,2021,221002,6890,227892,COST
06079834410200000,2020,163797,7370,171167,COST
06079834410200000,2019,163797,7370,171167,COST
06079834410250000,2021,220582,368340,588922,COST
06079834410250000,2020,163407,355020,518427,COST
06079834410250000,2019,163407,355020,518427,COST
06079835101010000,2021,275426,124440,399866,COST
06079835101010000,2020,210972,120360,331332,COST
06079835101010000,2019,210972,120360,331332,COST
06079835101020000,2021,194444,182056,376500,MKT
06079835101020000,2020,141221,44070,185291,COST
06079835101020000,2019,141221,44070,185291,COST
06079835101030000,2021,103532,96710,200242,COST
06079835101030000,2020,147801,94710,242511,COST
06079835101030000,2019,147801,94710,242511,COST
06079835101040000,2021,495832,2520,498352,COST
06079835101040000,2020,415514,2320,417834,COST
06079835101040000,2019,415514,2320,417834,COST
06079835101100000,2021,220967,653810,874777,COST
06079835101100000,2020,163765,650340,814105,COST
06079835101100000,2019,163765,635540,799305,COST
06079835101100100,2021,65,0,65,COST
06079835101100100,2020,61,0,61,COST
06079835101100100,2019,61,0,61,COST
06079835101200000,2021,439996,523060,963056,COST
06079835101200000,2020,325727,509090,834817,COST
06079835101200000,2019,325727,509090,834817,COST
06079835101350000,2021,372297,0,372297,COST
06079835101350000,2020,298619,0,298619,COST
06079835101350000,2019,298619,0,298619,COST
06079835102010000,2021,221732,355268,577000,MKT
06079835102010000,2020,164305,337695,502000,MKT
06079835102010000,2019,164305,337695,502000,MKT
06079835102040000,2021,230061,442550,672611,COST
06079835102040000,2020,171441,435550,606991,COST
06079835102040000,2019,171441,435550,606991,COST
06079835102070000,2021,254559,465341,719900,MKT
06079835102070000,2020,192654,515246,707900,MKT
06079835102070000,2019,192654,515246,707900,MKT
06079835102100000,2021,247632,456068,703700,MKT
06079835102100000,2020,186623,472977,659600,MKT
06079835102100000,2019,186623,472977,659600,MKT
06079835102130000,2021,219888,327312,547200,MKT
06079835102130000,2020,162731,329969,492700,MKT
06079835102130000,2019,162731,329969,492700,MKT
06079835102160000,2021,219888,483512,703400,MKT
06079835102160000,2020,162731,436869,599600,MKT
06079835102160000,2019,162731,436869,599600,MKT
06079835102190000,2021,219888,250012,469900,MKT
06079835102190000,2020,162731,266469,429200,MKT
06079835102190000,2019,162731,254769,417500,MKT
06079835102220000,2021,268922,321178,590100,MKT
06079835102220000,2020,205239,321761,527000,MKT
06079835102220000,2019,205239,321761,527000,MKT
06079835105010000,2021,240331,618969,859300,MKT
06079835105010000,2020,180294,639810,820104,COST
06079835105010000,2019,180294,639810,820104,COST
06079835105040000,2021,231126,357474,588600,MKT
06079835105040000,2020,172356,326590,498946,COST
06079835105040000,2019,172356,326590,498946,COST
06079835105070000,2021,264513,624387,888900,MKT
06079835105070000,2020,201364,615436,816800,MKT
06079835105070000,2019,201364,615436,816800,MKT
06079835105100000,2021,247570,692430,940000,MKT
06079835105100000,2020,186568,679432,866000,MKT
06079835105100000,2019,186568,679432,866000,MKT
06079835105130000,2021,226518,632182,858700,MKT
06079835105130000,2020,168400,621900,790300,MKT
06079835105130000,2019,168400,621900,790300,MKT
06079835105160000,2021,226664,339136,565800,MKT
06079835105160000,2020,168526,318574,487100,OVR
06079835105160000,2019,168526,318574,487100,MKT
06079835105190000,2021,235093,380407,615500,MKT
06079835105190000,2020,175771,345929,521700,MKT
06079835105190000,2019,175771,345929,521700,MKT
06079835105220000,2021,245812,519288,765100,MKT
06079835105220000,2020,185042,513358,698400,MKT
06079835105220000,2019,185042,513358,698400,MKT
06079835105250000,2021,245812,572488,818300,MKT
06079835105250000,2020,185042,565958,751000,MKT
06079835105250000,2019,185042,565958,751000,MKT
06079835105280000,2021,269990,431010,701000,MKT
06079835105280000,2020,206179,413740,619919,COST
06079835105280000,2019,206179,413740,619919,COST
06079835105310000,2021,308445,481455,789900,MKT
06079835105310000,2020,240389,477911,718300,MKT
06079835105310000,2019,240389,477911,718300,MKT
06079835105340000,2021,271842,486258,758100,MKT
06079835105340000,2020,207810,429090,636900,MKT
06079835105340000,2019,207810,429090,636900,MKT
06079835105370000,2021,243967,437433,681400,MKT
06079835105370000,2020,183442,410658,594100,MKT
06079835105370000,2019,183442,410658,594100,MKT
06079835105400000,2021,262510,527290,789800,MKT
06079835105400000,2020,199607,541993,741600,MKT
06079835105400000,2019,199607,541993,741600,MKT
06079835105430000,2021,263404,944140,1207544,COST
06079835105430000,2020,200391,911230,1111621,OVR
06079835105430000,2019,200391,911230,1111621,COST
06079835105460000,2021,285889,1200950,1486839,COST
06079835105460000,2020,220239,1190200,1410439,COST
06079835105460000,2019,220239,1190200,1410439,COST
06079835105490000,2021,248378,374822,623200,MKT
06079835105490000,2020,187271,362229,549500,MKT
06079835105490000,2019,187271,362229,549500,MKT
06079835108010000,2021,307314,376520,683834,COST
06079835108010000,2020,239373,369830,609203,COST
06079835108010000,2019,239373,398560,637933,COST
06079835108040000,2021,222189,377111,599300,MKT
06079835108040000,2020,164695,342520,507215,COST
06079835108040000,2019,164695,342520,507215,COST
06079835108070000,2021,222189,320711,542900,MKT
06079835108070000,2020,164695,327305,492000,MKT
06079835108070000,2019,164695,327305,492000,MKT
06079835108100000,2021,222189,523911,746100,MKT
06079835108100000,2020,164695,521705,686400,MKT
06079835108100000,2019,164695,521705,686400,MKT
06079835108130000,2021,222189,511811,734000,MKT
06079835108130000,2020,164695,497300,661995,COST
06079835108130000,2019,164695,497300,661995,COST
06079835108160000,2021,222189,287211,509400,MKT
06079835108160000,2020,164695,293105,457800,MKT
06079835108160000,2019,164695,293105,457800,MKT
06079835108190000,2021,222189,477011,699200,MKT
06079835108190000,2020,164695,469305,634000,MKT
06079835108190000,2019,164695,469305,634000,MKT
06079835108220000,2021,222189,452911,675100,MKT
06079835108220000,2020,164695,395990,560685,COST
06079835108220000,2019,164695,395990,560685,COST
06079835108250000,2021,222189,497211,719400,MKT
06079835108250000,2020,164695,420805,585500,MKT
06079835108250000,2019,164695,420805,585500,MKT
06079835108280000,2021,316237,544763,861000,MKT
06079835108280000,2020,247403,531497,778900,MKT
06079835108280000,2019,247403,499800,747203,COST
06079835111010000,2021,264146,645360,909506,COST
06079835111010000,2020,197589,616400,813989,COST
06079835111010000,2019,197589,616400,813989,COST
06079835111040000,2021,234956,422044,657000,MKT
06079835111040000,2020,175653,391047,566700,MKT
06079835111040000,2019,175653,391047,566700,MKT
06079835111070000,2021,267467,285733,553200,MKT
06079835111070000,2020,203959,271841,475800,MKT
06079835111070000,2019,203959,271841,475800,MKT
06079835111100000,2021,222189,357811,580000,MKT
06079835111100000,2020,164695,352305,517000,MKT
06079835111100000,2019,164695,352305,517000,MKT
06079835111130000,2021,222189,358511,580700,MKT
06079835111130000,2020,164695,368605,533300,MKT
06079835111130000,2019,164695,368605,533300,MKT
06079835111160000,2021,223473,268927,492400,MKT
06079835111160000,2020,165794,303906,469700,MKT
06079835111160000,2019,165794,303906,469700,MKT
06079835111190000,2021,224372,457828,682200,MKT
06079835111190000,2020,166563,455837,622400,MKT
06079835111190000,2019,166563,455837,622400,MKT
06079835111220000,2021,262689,474611,737300,MKT
06079835111220000,2020,196333,474267,670600,MKT
06079835111220000,2019,175298,419802,595100,MKT
06079835111250000,2021,220737,405363,626100,MKT
06079835111250000,2020,163455,390380,553835,COST
06079835111250000,2019,163455,390380,553835,COST
06079835111280000,2021,220583,503817,724400,MKT
06079835111280000,2020,163324,501476,664800,MKT
06079835111280000,2019,163324,501476,664800,MKT
06079835111310000,2021,264236,430664,694900,MKT
06079835111310000,2020,201122,406578,607700,MKT
06079835111310000,2019,201122,406578,607700,MKT
06079835111340000,2021,268007,390393,658400,MKT
06079835111340000,2020,204434,414366,618800,MKT
06079835111340000,2019,204434,377666,582100,MKT
06079835111370000,2021,299684,508516,808200,MKT
06079835111370000,2020,228541,500459,729000,MKT
06079835111370000,2019,228541,500459,729000,MKT
06079835111400000,2021,292941,434959,727900,MKT
06079835111400000,2020,222622,418578,641200,MKT
06079835111400000,2019,222622,418578,641200,MKT
06079835111430000,2021,295012,524988,820000,MKT
06079835111430000,2020,224438,499662,724100,MKT
06079835111430000,2019,224438,481462,705900,MKT
06079835111496500,2021,149779,0,149779,COST
06079835111496500,2020,125488,0,125488,COST
06079835111496500,2019,125488,0,125488,COST
06079835130010000,2021,220274,314626,534900,MKT
06079835130010000,2020,163061,313939,477000,MKT
06079835130010000,2019,163061,313939,477000,MKT
06079835130030000,2021,221044,374856,595900,MKT
06079835130030000,2020,163717,352983,516700,MKT
06079835130030000,2019,163717,353683,517400,MKT
06079835130050000,2021,221044,307656,528700,MKT
06079835130050000,2020,163717,294583,458300,MKT
06079835130050000,2019,163717,294583,458300,MKT
06079835130070000,2021,219500,561500,781000,MKT
06079835130070000,2020,162400,579900,742300,MKT
06079835130070000,2019,162400,579900,742300,MKT
06079835130090000,2021,219500,464900,684400,MKT
06079835130090000,2020,162400,458000,620400,MKT
06079835130090000,2019,162400,454300,616700,MKT
06079835132016500,2021,71113,0,71113,COST
06079835132016500,2020,53167,0,53167,COST
06079835132016500,2019,53167,0,53167,COST
06079835132050000,2021,222568,615132,837700,MKT
06079835132050000,2020,165020,574340,739360,COST
06079835132050000,2019,165020,569950,734970,COST
06079835132070000,2021,219500,0,219500,COST
06079835132070000,2020,162400,0,162400,COST
06079835132070000,2019,162400,0,162400,COST
06079835132090000,2021,233437,521390,754827,COST
06079835132090000,2020,174345,505070,679415,COST
06079835132090000,2019,174345,505070,679415,COST
06079835132190000,2021,220274,300926,521200,MKT
06079835132190000,2020,163061,314939,478000,MKT
06079835132190000,2019,163061,314939,478000,MKT
06079835132210000,2021,220274,451326,671600,MKT
06079835132210000,2020,163061,462339,625400,MKT
06079835132210000,2019,163061,462339,625400,MKT
06079835132230000,2021,220274,258526,478800,MKT
06079835132230000,2020,163061,261339,424400,MKT
06079835132230000,2019,163061,261339,424400,MKT
06079835132250000,2021,221044,280956,502000,MKT
06079835132250000,2020,163717,252883,416600,OVR
06079835132250000,2019,163717,252883,416600,MKT
06079835201050000,2021,220553,306830,527383,COST
06079835201050000,2020,163380,297230,460610,COST
06079835201050000,2019,163380,297230,460610,COST
06079835201070000,2021,220553,414390,634943,COST
06079835201070000,2020,163380,406690,570070,COST
06079835201070000,2019,163380,406690,570070,COST
06079835201090000,2021,220620,813170,1033790,COST
06079835201090000,2020,163442,799300,962742,COST
06079835201090000,2019,163442,799300,962742,COST
06079835201100000,2021,220921,939540,1160461,COST
06079835201100000,2020,163722,918110,1081832,COST
06079835201100000,2019,163722,918110,1081832,COST
06079835201400000,2021,1384,0,1384,COST
06079835201400000,2020,1288,0,1288,COST
06079835201400000,2019,1288,0,1288,COST
06079835222010000,2021,275239,0,275239,COST
06079835222010000,2020,207186,0,207186,COST
06079835222010000,2019,207186,0,207186,COST
06079835222040000,2021,220197,469403,689600,MKT
06079835222040000,2020,162995,496305,659300,MKT
06079835222040000,2019,162995,496305,659300,MKT
06079835222070000,2021,227758,432042,659800,MKT
06079835222070000,2020,169464,456936,626400,MKT
06079835222070000,2019,169464,456936,626400,MKT
06079835222100000,2021,240857,506943,747800,MKT
06079835222100000,2020,180749,480051,660800,MKT
06079835222100000,2019,180749,480051,660800,MKT
06079835222130000,2021,339377,483870,823247,COST
06079835222130000,2020,263779,301021,564800,MKT
06079835222130000,2019,263779,306721,570500,MKT
06079835222160000,2021,415809,797670,1213479,COST
06079835222160000,2020,333377,758280,1091657,COST
06079835222160000,2019,333377,758280,1091657,COST
06079835222190000,2021,325557,1141330,1466887,COST
06079835222190000,2020,255828,1120910,1376738,COST
06079835222190000,2019,255828,1120910,1376738,COST
06079835222220000,2021,256443,480457,736900,MKT
06079835222220000,2020,194299,470401,664700,MKT
06079835222220000,2019,194299,470401,664700,MKT
06079835222250000,2021,241641,286759,528400,MKT
06079835222250000,2020,181427,327273,508700,MKT
06079835222250000,2019,181427,327273,508700,MKT
06079835222280000,2021,276449,543251,819700,MKT
06079835222280000,2020,211875,524425,736300,MKT
06079835222280000,2019,211875,524425,736300,MKT
06079835222310000,2021,251866,521534,773400,MKT
06079835222310000,2020,190306,503294,693600,MKT
06079835222310000,2019,190306,503294,693600,MKT
06079835222340000,2021,238742,422558,661300,MKT
06079835222340000,2020,178920,420280,599200,MKT
06079835222340000,2019,178920,420280,599200,MKT
06079835222370000,2021,230772,346528,577300,MKT
06079835222370000,2020,172052,347348,519400,MKT
06079835222370000,2019,172052,347348,519400,MKT
06079835222400000,2021,222113,0,222113,COST
06079835222400000,2020,164631,0,164631,COST
06079835222400000,2019,164631,0,164631,COST
06079835222430000,2021,222189,364811,587000,MKT
06079835222430000,2020,164695,359005,523700,MKT
06079835222430000,2019,164695,359005,523700,MKT
06079835222460000,2021,222189,355211,577400,MKT
06079835222460000,2020,164695,348405,513100,MKT
06079835222460000,2019,164695,302905,467600,MKT
06079835222490000,2021,222189,285111,507300,MKT
06079835222490000,2020,164695,291905,456600,MKT
06079835222490000,2019,164695,291905,456600,MKT
06079835222520000,2021,222189,647711,869900,MKT
06079835222520000,2020,164695,677305,842000,MKT
06079835222520000,2019,164695,677305,842000,MKT
06079835222556500,2021,119476,0,119476,COST
06079835222556500,2020,96700,0,96700,COST
06079835222556500,2019,96700,0,96700,COST
06079835401010000,2021,279827,423573,703400,MKT
06079835401010000,2020,154701,375230,529931,COST
06079835401010000,2019,154701,385699,540400,MKT
06079835401020000,2021,388356,255420,643776,COST
06079835401020000,2020,313517,242250,555767,COST
06079835401020000,2019,313517,242250,555767,COST
06079835401030000,2021,263013,302187,565200,MKT
06079835401030000,2020,144035,262365,406400,MKT
06079835401030000,2019,144035,262365,406400,MKT
06079835401040000,2021,263125,373375,636500,MKT
06079835401040000,2020,144106,376994,521100,MKT
06079835401040000,2019,144106,376994,521100,MKT
06079835401050000,2021,268492,413608,682100,MKT
06079835401050000,2020,147500,423700,571200,MKT
06079835401050000,2019,147500,423700,571200,MKT
06079835401060000,2021,255033,382667,637700,MKT
06079835401060000,2020,139008,364892,503900,MKT
06079835401060000,2019,139008,364892,503900,MKT
06079835401150000,2021,367503,349197,716700,MKT
06079835401150000,2020,211817,250883,462700,MKT
06079835401150000,2019,211817,250883,462700,MKT
06079835401160000,2021,237537,299263,536800,MKT
06079835401160000,2020,128073,307527,435600,MKT
06079835401160000,2019,128073,307527,435600,MKT
06079835401170000,2021,301847,475653,777500,MKT
06079835401170000,2020,168819,505881,674700,MKT
06079835401170000,2019,168819,505881,674700,MKT
06079835401180000,2021,224073,350327,574400,MKT
06079835401180000,2020,119741,326559,446300,MKT
06079835401180000,2019,119741,326559,446300,MKT
06079835401200000,2021,218015,367485,585500,MKT
06079835401200000,2020,116016,380084,496100,MKT
06079835401200000,2019,116016,263684,379700,MKT
06079835401220000,2021,218015,11070,229085,COST
06079835401220000,2020,116016,11560,127576,COST
06079835401220000,2019,116016,11560,127576,COST
06079835402010000,2021,9479,336220,345699,COST
06079835402010000,2020,9246,163030,172276,COST
06079835402010000,2019,9246,163030,172276,COST
06079835405030000,2021,242356,368144,610500,MKT
06079835405030000,2020,131074,328526,459600,MKT
06079835405030000,2019,131074,328526,459600,MKT
06079835405050000,2021,254500,299200,553700,MKT
06079835405050000,2020,138674,288726,427400,MKT
06079835405050000,2019,138674,288726,427400,MKT
06079835405070000,2021,247257,320043,567300,MKT
06079835405070000,2020,134134,316366,450500,MKT
06079835405070000,2019,134134,316366,450500,MKT
06079835405090000,2021,254678,368922,623600,MKT
06079835405090000,2020,138785,325715,464500,MKT
06079835405090000,2019,138785,325715,464500,MKT
06079835406010000,2021,254914,355686,610600,MKT
06079835406010000,2020,138934,342966,481900,MKT
06079835406010000,2019,138934,342966,481900,MKT
06079835406030000,2021,224148,238752,462900,MKT
06079835406030000,2020,119787,271213,391000,MKT
06079835406030000,2019,119787,271213,391000,MKT
06079835406050000,2021,179679,14480,194159,COST
06079835406050000,2020,92831,14560,107391,COST
06079835406050000,2019,92831,14560,107391,COST
06079835406070000,2021,177643,540357,718000,MKT
06079835406070000,2020,91619,509781,601400,MKT
06079835406070000,2019,91619,509781,601400,MKT
06079835406090000,2021,216272,319128,535400,MKT
06079835406090000,2020,114948,312252,427200,MKT
06079835406090000,2019,114948,312252,427200,MKT
06079835406110000,2021,218015,242085,460100,MKT
06079835406110000,2020,116016,277184,393200,MKT
06079835406110000,2019,116016,277184,393200,MKT
06079835406130000,2021,168158,344542,512700,MKT
06079835406130000,2020,86002,250498,336500,MKT
06079835406130000,2019,86002,250498,336500,MKT
06079835406150000,2021,170528,299472,470000,MKT
06079835406150000,2020,87401,314199,401600,MKT
06079835406150000,2019,87401,314199,401600,MKT
06079835407010000,2021,502933,747400,1250333,COST
06079835407010000,2020,304115,731430,1035545,COST
06079835407010000,2019,304115,731430,1035545,COST
06079835415010000,2021,359871,79150,439021,COST
06079835415010000,2020,206754,80150,286904,COST
06079835415010000,2019,206754,80150,286904,COST
06079835415050000,2021,172959,7990,180949,COST
06079835415050000,2020,88840,7840,96680,COST
06079835415050000,2019,88840,7840,96680,COST
06079835415070000,2021,173796,279904,453700,MKT
06079835415070000,2020,89335,266065,355400,MKT
06079835415070000,2019,89335,266065,355400,MKT
06079835415110000,2021,243967,447370,691337,COST
06079835415110000,2020,132078,439410,571488,COST
06079835415110000,2019,132078,439410,571488,COST
06079835415150000,2021,243967,424433,668400,MKT
06079835415150000,2020,132078,395922,528000,MKT
06079835415150000,2019,132078,395922,528000,MKT
06079835415200000,2021,243967,543280,787247,COST
06079835415200000,2020,132078,513760,645838,COST
06079835415200000,2019,132078,513760,645838,COST
06079835418090000,2021,219500,186900,406400,MKT
06079835418090000,2020,116928,151630,268558,COST
06079835418090000,2019,116928,151630,268558,COST
06079835418120000,2021,219500,182900,402400,COST
06079835418120000,2020,116928,162809,279737,OVR
06079835418120000,2019,116928,162809,279737,OVR
06079835424010000,2021,264126,415474,679600,MKT
06079835424010000,2020,144738,400362,545100,MKT
06079835424010000,2019,144738,401762,546500,MKT
06079835424030000,2021,263904,429096,693000,MKT
06079835424030000,2020,144598,483102,627700,MKT
06079835424030000,2019,144598,483102,627700,MKT
06079835424050000,2021,264679,910730,1175409,COST
06079835424050000,2020,145087,881650,1026737,COST
06079835424050000,2019,145087,881650,1026737,COST
06079835424070000,2021,264458,656542,921000,MKT
06079835424070000,2020,144947,610153,755100,MKT
06079835424070000,2019,144947,606153,751100,MKT
06079835424090000,2021,264402,588498,852900,MKT
06079835424090000,2020,144913,564087,709000,MKT
06079835424090000,2019,144913,564087,709000,MKT
06079835433010000,2021,263348,437658,701006,OVR
06079835433010000,2020,299170,495430,794600,COST
06079835433010000,2019,299170,503800,802970,COST
06079835433040000,2021,251927,0,251927,COST
06079835433070000,2021,245179,0,245179,COST
06079835433100000,2021,234475,0,234475,COST
06079835433130000,2021,224447,0,224447,COST
06079835433160000,2021,224447,21010,245457,COST
06079835433190000,2021,244031,0,244031,COST
06079835433226500,2021,60896,0,60896,COST
06079835435010000,2021,315878,442822,758700,MKT
06079835435010000,2020,247079,450921,698000,MKT
06079835435010000,2019,247079,450921,698000,MKT
06079835435040000,2021,322158,0,322158,COST
06079835435040000,2020,252751,0,252751,COST
06079835435040000,2019,252751,0,252751,COST
06079835435070000,2021,291448,469552,761000,MKT
06079835435070000,2020,225183,508917,734100,MKT
06079835435070000,2019,225183,508917,734100,MKT
06079835435100000,2021,285841,373500,659341,COST
06079835435100000,2020,220196,415204,635400,MKT
06079835435100000,2019,220196,415204,635400,MKT
06079835435200000,2021,3841,285070,288911,COST
06079835435200000,2020,3978,279600,283578,COST
06079835435200000,2019,3978,279600,283578,COST
06079835435220000,2021,268814,287886,556700,MKT
06079835435220000,2020,205144,290456,495600,MKT
06079835435220000,2019,205144,277256,482400,MKT
06079835437010000,2021,294020,226780,520800,MKT
06079835437010000,2020,227475,168880,396355,COST
06079835437010000,2019,227475,168880,396355,COST
06079835437050000,2021,312732,239668,552400,MKT
06079835437050000,2020,244245,222355,466600,MKT
06079835437050000,2019,244245,222355,466600,MKT
06079835437090000,2021,388054,0,388054,COST
06079835437090000,2020,313236,0,313236,COST
06079835437090000,2019,313236,0,313236,COST
06079836101010000,2021,235707,415420,651127,COST
06079836101010000,2020,301351,407480,708831,COST
06079836101010000,2019,301351,407480,708831,COST
06079836201010000,2021,389967,171640,561607,COST
06079836201010000,2020,315017,167620,482637,COST
06079836201010000,2019,315017,167620,482637,COST
06079836201030000,2021,497058,236150,733208,COST
06079836201030000,2020,416699,229280,645979,COST
06079836201030000,2019,416699,229280,645979,COST
06079836201040000,2021,476856,181350,658206,COST
06079836201040000,2020,397236,175050,572286,COST
06079836201040000,2019,397236,175050,572286,COST
06079836201050000,2021,387972,961520,1349492,COST
06079836201050000,2020,313160,938120,1251280,COST
06079836201050000,2019,313160,938120,1251280,COST
06079836201060000,2021,497058,505440,1002498,COST
06079836201060000,2020,416699,481100,897799,COST
06079836201060000,2019,416699,481100,897799,COST
06079836201070000,2021,3990,453570,457560,COST
06079836201070000,2020,4116,442050,446166,COST
06079836201070000,2019,4116,442050,446166,COST
06079836201070100,2021,199184,0,199184,COST
06079836201070100,2020,145197,0,145197,COST
06079836201070100,2019,145197,0,145197,COST
06079836201100000,2021,496883,0,496883,COST
06079836201100000,2020,416530,0,416530,COST
06079836201100000,2019,416530,0,416530,COST
06079836201110000,2021,471238,424080,895318,COST
06079836201110000,2020,391845,422130,813975,COST
06079836201110000,2019,391845,361900,753745,COST
06079836201200000,2021,497058,862142,1359200,MKT
06079836201200000,2020,416699,866600,1283299,COST
06079836201200000,2019,416699,866600,1283299,COST
06079836201250000,2021,3488,0,3488,COST
06079836201250000,2020,3238,0,3238,COST
06079836201250000,2019,3238,0,3238,COST
06079836201300000,2021,2895,0,2895,COST
06079836201300000,2020,2687,0,2687,COST
06079836201300000,2019,2687,0,2687,COST
06079836201350000,2021,2366,0,2366,COST
06079836201350000,2020,2196,0,2196,COST
06079836201350000,2019,2196,0,2196,COST
06079836201400000,2021,2495,0,2495,COST
06079836201400000,2020,2316,0,2316,COST
06079836201400000,2019,2316,0,2316,COST
06079836201450000,2021,2363,0,2363,COST
06079836201450000,2020,2194,0,2194,COST
06079836201450000,2019,2194,0,2194,COST
06079836201500000,2021,3257,0,3257,COST
06079836201500000,2020,3023,0,3023,COST
06079836201500000,2019,3023,0,3023,COST
06079836201550000,2021,4158,0,4158,COST
06079836201550000,2020,3860,0,3860,COST
06079836201550000,2019,3860,0,3860,COST
06079836201800000,2021,2763,0,2763,COST
06079836201800000,2020,2564,0,2564,COST
06079836201800000,2019,2564,0,2564,COST
06079836230120000,2021,228121,281679,509800,MKT
06079836230120000,2020,169775,236790,406565,COST
06079836230120000,2019,169775,236790,406565,COST
06079836301020000,2021,217384,198630,416014,COST
06079836301020000,2020,160596,192540,353136,COST
06079836301020000,2019,160596,192540,353136,COST
06079836301040000,2021,215712,227600,443312,COST
06079836301040000,2020,159173,220870,380043,COST
06079836301040000,2019,159173,220870,380043,COST
06079836301060000,2021,215551,206149,421700,MKT
06079836301060000,2020,159037,164400,323437,COST
06079836301060000,2019,159037,164400,323437,COST
06079836301080000,2021,215471,268629,484100,MKT
06079836301080000,2020,158968,260132,419100,MKT
06079836301080000,2019,158968,260132,419100,MKT
06079836301100000,2021,215391,203009,418400,MKT
06079836301100000,2020,158900,179660,338560,COST
06079836301100000,2019,158900,179660,338560,COST
06079836301120000,2021,215310,221090,436400,MKT
06079836301120000,2020,158832,206168,365000,MKT
06079836301120000,2019,158832,206168,365000,MKT
06079836302020000,2021,215149,227851,443000,MKT
06079836302020000,2020,158695,210905,369600,MKT
06079836302020000,2019,158695,210905,369600,MKT
06079836302040000,2021,215069,272131,487200,MKT
06079836302040000,2020,158626,256174,414800,MKT
06079836302040000,2019,158626,256174,414800,MKT
06079836302060000,2021,214988,283212,498200,MKT
06079836302060000,2020,158558,277842,436400,MKT
06079836302060000,2019,158558,277842,436400,MKT
06079836302080000,2021,214907,241193,456100,MKT
06079836302080000,2020,158489,236611,395100,MKT
06079836302080000,2019,158489,236611,395100,MKT
06079836302100000,2021,214827,249673,464500,MKT
06079836302100000,2020,158420,224880,383300,MKT
06079836302100000,2019,158420,224980,383400,MKT
06079836302120000,2021,214665,304335,519000,MKT
06079836302120000,2020,158283,299617,457900,MKT
06079836302120000,2019,158283,299617,457900,MKT
06079836303020000,2021,214584,256860,471444,COST
06079836303020000,2020,158214,251040,409254,COST
06079836303020000,2019,158214,251040,409254,COST
06079836303040000,2021,214503,195197,409700,MKT
06079836303040000,2020,158145,154200,312345,COST
06079836303040000,2019,158145,154200,312345,COST
06079836303060000,2021,214341,179859,394200,MKT
06079836303060000,2020,158007,150740,308747,COST
06079836303060000,2019,158007,150740,308747,COST
06079836303080000,2021,214260,187540,401800,MKT
06079836303080000,2020,157938,198062,356000,MKT
06079836303080000,2019,157938,198062,356000,MKT
06079836303100000,2021,214178,226122,440300,MKT
06079836303100000,2020,157869,232531,390400,MKT
06079836303100000,2019,157869,232531,390400,MKT
06079836303120000,2021,214422,0,214422,COST
06079836303120000,2020,158076,0,158076,COST
06079836303120000,2019,158076,0,158076,COST
06079836304020000,2021,219033,342167,561200,MKT
06079836304020000,2020,162002,296198,458200,MKT
06079836304020000,2019,162002,295898,457900,MKT
06079836304040000,2021,214016,224884,438900,MKT
06079836304040000,2020,157731,205869,363600,MKT
06079836304040000,2019,157731,205869,363600,MKT
06079836304060000,2021,214016,203484,417500,MKT
06079836304060000,2020,157731,181369,339100,MKT
06079836304060000,2019,157731,181369,339100,MKT
06079836304080000,2021,214016,216084,430100,MKT
06079836304080000,2020,157731,177450,335181,COST
06079836304080000,2019,157731,177450,335181,COST
06079836304100000,2021,214016,163984,378000,MKT
06079836304100000,2020,157731,147130,304861,COST
06079836304100000,2019,157731,147130,304861,COST
06079836304120000,2021,214016,194584,408600,MKT
06079836304120000,2020,157731,200030,357761,COST
06079836304120000,2019,157731,200030,357761,COST
06079836304140000,2021,214016,230784,444800,MKT
06079836304140000,2020,157731,226569,384300,MKT
06079836304140000,2019,157731,226569,384300,MKT
06079836304160000,2021,214016,323084,537100,MKT
06079836304160000,2020,157731,251160,408891,COST
06079836304160000,2019,157731,251160,408891,COST
06079836304180000,2021,214016,187984,402000,MKT
06079836304180000,2020,157731,204969,362700,MKT
06079836304180000,2019,157731,204969,362700,MKT
06079836304200000,2021,214016,208184,422200,MKT
06079836304200000,2020,157731,132370,290101,OVR
06079836304200000,2019,157731,132370,290101,OVR
06079836304220000,2021,214016,183384,397400,MKT
06079836304220000,2020,157731,200569,358300,MKT
06079836304220000,2019,157731,200569,358300,MKT
06079836304240000,2021,214665,244135,458800,MKT
06079836304240000,2020,158283,248817,407100,MKT
06079836304240000,2019,158283,245317,403600,MKT
06079836305020000,2021,214016,307584,521600,MKT
06079836305020000,2020,157731,297969,455700,MKT
06079836305020000,2019,157731,297969,455700,MKT
06079836305040000,2021,214016,240584,454600,MKT
06079836305040000,2020,157731,233569,391300,MKT
06079836305040000,2019,157731,233569,391300,MKT
06079836305060000,2021,214016,260484,474500,MKT
06079836305060000,2020,157731,270169,427900,MKT
06079836305060000,2019,157731,270169,427900,MKT
06079836305080000,2021,214016,214984,429000,MKT
06079836305080000,2020,157731,195869,353600,MKT
06079836305080000,2019,157731,195869,353600,MKT
06079836305100000,2021,214016,170384,384400,MKT
06079836305100000,2020,157731,201569,359300,MKT
06079836305100000,2019,157731,201569,359300,MKT
06079836305120000,2021,214016,331484,545500,MKT
06079836305120000,2020,157731,290369,448100,OVR
06079836305120000,2019,157731,290369,448100,MKT
06079836305140000,2021,256819,241681,498500,MKT
06079836305140000,2020,157731,236769,394500,MKT
06079836305140000,2019,157731,236769,394500,MKT
06079836305160000,2021,256819,198781,455600,MKT
06079836305160000,2020,157731,199769,357500,MKT
06079836305160000,2019,157731,199769,357500,MKT
06079836305180000,2021,256819,253381,510200,MKT
06079836305180000,2020,157731,222669,380400,MKT
06079836305180000,2019,157731,222669,380400,MKT
06079836305200000,2021,256819,235581,492400,MKT
06079836305200000,2020,157731,194869,352600,MKT
06079836305200000,2019,157731,194869,352600,MKT
06079836305220000,2021,256819,232581,489400,MKT
06079836305220000,2020,157731,208769,366500,MKT
06079836305220000,2019,157731,208769,366500,MKT
06079836305240000,2021,256819,332481,589300,MKT
06079836305240000,2020,157731,305369,463100,MKT
06079836305240000,2019,157731,305369,463100,MKT
06079836306020000,2021,214016,184684,398700,MKT
06079836306020000,2020,157731,202669,360400,MKT
06079836306020000,2019,157731,202669,360400,MKT
