id,year,land,building,total,method
06033802163150000,2021,192674,221226,413900,MKT
06033802163150000,2020,118514,230186,348700,MKT
06033802163150000,2019,118514,230186,348700,MKT
06033802164026500,2021,234556,0,234556,COST
06033802164026500,2020,66319,0,66319,COST
06033802164026500,2019,66319,0,66319,COST
06033802164037000,2021,435892,0,435892,COST
06033802164037000,2020,409518,0,409518,COST
06033802164037000,2019,409518,0,409518,COST
06033802164057000,2021,584088,0,584088,COST
06033802164057000,2020,504354,0,504354,COST
06033802164057000,2019,504354,0,504354,COST
06033802164127000,2021,556732,0,556732,COST
06033802164127000,2020,487425,0,487425,COST
06033802164127000,2019,487425,0,487425,COST
06033802165017000,2021,571544,0,571544,COST
06033802165017000,2020,496621,0,496621,COST
06033802165017000,2019,496621,0,496621,COST
06033802165027000,2021,322783,6950,329733,COST
06033802165027000,2020,322629,7470,330099,COST
06033802165027000,2019,322629,7470,330099,COST
06033802165037000,2021,322783,11220,334003,COST
06033802165037000,2020,413627,10860,424487,COST
06033802165037000,2019,413627,10860,424487,COST
06033802165057000,2021,368250,21820,390070,COST
06033802165057000,2020,519026,21150,540176,COST
06033802165057000,2019,519026,21150,540176,COST
06033802166010000,2021,305160,1930910,2236070,COST
06033802166010000,2020,369111,2053089,2422200,INCOME
06033802166010000,2019,369111,2053089,2422200,INCOME
06033802166020000,2021,344559,3995741,4340300,INCOME
06033802166020000,2020,462856,3698444,4161300,INCOME
06033802166020000,2019,462856,1660244,2123100,INCOME
06033802166030000,2021,412617,0,412617,COST
06033802166030000,2020,393832,0,393832,COST
06033802166030000,2019,393832,0,393832,COST
06033802201010000,2021,1157,0,1157,COST
06033802201010000,2020,1077,0,1077,COST
06033802201010000,2019,1077,0,1077,COST
06033802201120000,2021,1300,18860,20160,COST
06033802201120000,2020,1210,18830,20040,COST
06033802201120000,2019,1210,18830,20040,COST
06033802201230000,2021,1116,0,1116,COST
06033802201230000,2020,1038,0,1038,COST
06033802201230000,2019,1038,0,1038,COST
06033802201340000,2021,246852,1094230,1341082,COST
06033802201340000,2020,204879,889470,1094349,COST
06033802201340000,2019,204879,889470,1094349,COST
06033802201450000,2021,246873,1384450,1631323,COST
06033802201450000,2020,204898,1179960,1384858,COST
06033802201450000,2019,204898,1180570,1385468,COST
06033802201560000,2021,492667,2203950,2696617,COST
06033802201560000,2020,408793,1648060,2056853,COST
06033802201560000,2019,408793,1648060,2056853,COST
06033802201670000,2021,246911,1782930,2029841,COST
06033802201670000,2020,204934,1468500,1673434,OVR
06033802201670000,2019,204934,1468500,1673434,COST
06033802201780000,2021,247057,1411830,1658887,COST
06033802201780000,2020,205070,888430,1093500,COST
06033802201780000,2019,205070,888430,1093500,COST
06033802303030000,2021,329810,1305810,1635620,COST
06033802303030000,2020,254777,1112960,1367737,COST
06033802303030000,2019,254777,1112960,1367737,COST
06033802303036500,2021,116251,0,116251,COST
06033802303036500,2020,112305,0,112305,COST
06033802303036500,2019,112305,0,112305,COST
06033802303050000,2021,355959,0,355959,COST
06033802303050000,2020,278122,0,278122,COST
06033802303050000,2019,278122,0,278122,COST
06033802303090000,2021,406733,1238190,1644923,COST
06033802303090000,2020,324174,880826,1205000,OVR
06033802303090000,2019,324174,880826,1205000,OVR
06033802303130000,2021,345413,0,345413,COST
06033802303130000,2020,268675,0,268675,COST
06033802303130000,2019,268675,0,268675,COST
06033802303170000,2021,357001,0,357001,COST
06033802303170000,2020,279058,0,279058,COST
06033802303170000,2019,279058,0,279058,COST
06033802304010000,2021,349281,0,349281,COST
06033802304010000,2020,272135,0,272135,COST
06033802304010000,2019,272135,0,272135,COST
06033802304030000,2021,337666,728820,1066486,COST
06033802304030000,2020,261763,606630,868393,COST
06033802304030000,2019,261763,606630,868393,COST
06033802304050000,2021,337371,0,337371,COST
06033802304050000,2020,261500,0,261500,COST
06033802304050000,2019,261500,0,261500,COST
06033802304070000,2021,329188,1097770,1426958,COST
06033802304070000,2020,254225,918980,1173205,COST
06033802304070000,2019,254225,0,254225,COST
06033802304090000,2021,306991,1014750,1321741,COST
06033802304090000,2020,234628,857260,1091888,COST
06033802304090000,2019,234628,383410,618038,COST
06033802304110000,2021,306991,1925960,2232951,COST
06033802304110000,2020,234628,1634310,1868938,COST
06033802304110000,2019,234628,1634310,1868938,COST
06033802304130000,2021,310232,1076180,1386412,COST
06033802304130000,2020,237477,320580,558057,COST
06033802304130000,2019,237477,0,237477,COST
06033802304150000,2021,306991,1726060,2033051,COST
06033802304150000,2020,234628,1579740,1814368,COST
06033802304150000,2019,234628,1579740,1814368,COST
06033802304170000,2021,306991,1524360,1831351,COST
06033802304170000,2020,234628,1256100,1490728,COST
06033802304170000,2019,234628,1256100,1490728,COST
06033802304190000,2021,308801,0,308801,COST
06033802304190000,2020,236219,0,236219,COST
06033802304190000,2019,236219,0,236219,COST
06033802304210000,2021,331966,1108980,1440946,COST
06033802304210000,2020,256692,1093308,1350000,OVR
06033802304210000,2019,256692,1093308,1350000,OVR
06033802304230000,2021,306991,701470,1008461,COST
06033802304230000,2020,234628,600460,835088,OVR
06033802304230000,2019,234628,600460,835088,COST
06033802304250000,2021,375636,0,375636,COST
06033802304250000,2020,295860,0,295860,COST
06033802304250000,2019,295860,0,295860,COST
06033802305010000,2021,312000,936000,1248000,COST
06033802305010000,2020,239033,918167,1157200,MKT
06033802305010000,2019,239033,918167,1157200,MKT
06033802305030000,2021,374892,1256200,1631092,COST
06033802305030000,2020,295187,1323600,1618787,COST
06033802305030000,2019,295187,1323600,1618787,COST
06033802305050000,2021,338926,0,338926,COST
06033802305050000,2020,262886,0,262886,COST
06033802305050000,2019,262886,0,262886,COST
06033802305070000,2021,364613,1982800,2347413,COST
06033802305070000,2020,285906,1648190,1934096,COST
06033802305070000,2019,285906,1461530,1747436,COST
06033802305090000,2021,371885,0,371885,COST
06033802305090000,2020,292467,0,292467,COST
06033802305090000,2019,292467,0,292467,COST
06033802305110000,2021,406927,2112900,2519827,COST
06033802305110000,2020,324351,1782540,2106891,COST
06033802305110000,2019,324351,1782540,2106891,COST
06033802305130000,2021,322166,762260,1084426,COST
06033802305130000,2020,248004,630530,878534,COST
06033802305130000,2019,248004,759610,1007614,COST
06033802305150000,2021,307718,993550,1301268,COST
06033802305150000,2020,235267,832380,1067647,COST
06033802305150000,2019,235267,1042170,1277437,COST
06033802305170000,2021,307718,1027830,1335548,COST
06033802305170000,2020,235267,1014733,1250000,MKT
06033802305170000,2019,235267,1014733,1250000,MKT
06033802305190000,2021,367317,0,367317,COST
06033802305190000,2020,288343,0,288343,COST
06033802305190000,2019,288343,0,288343,COST
06033802305210000,2021,382674,0,382674,COST
06033802305210000,2020,302238,0,302238,COST
06033802305210000,2019,302238,0,302238,COST
06033802305230000,2021,319858,1393960,1713818,COST
06033802305230000,2020,245963,1169720,1415683,COST
06033802305230000,2019,245963,1169720,1415683,COST
06033802305250000,2021,376330,1553970,1930300,COST
06033802305250000,2020,296488,1311650,1608138,COST
06033802305250000,2019,296488,704950,1001438,COST
06033802305290000,2021,314783,0,314783,COST
06033802305290000,2020,241485,0,241485,COST
06033802305290000,2019,241485,0,241485,COST
06033802417016500,2021,164207,0,164207,COST
06033802417016500,2020,153652,0,153652,COST
06033802417016500,2019,153652,0,153652,COST
06033802417050000,2021,323389,2099311,2422700,MKT
06033802417050000,2020,249247,1612880,1862127,OVR
06033802417050000,2019,249247,1612880,1862127,COST
06033802417090000,2021,284080,0,284080,COST
06033802417090000,2020,214761,0,214761,COST
06033802417090000,2019,214761,0,214761,COST
06033802417130000,2021,283730,760150,1043880,COST
06033802417130000,2020,214457,631230,845687,COST
06033802417130000,2019,214457,631230,845687,COST
06033802417170000,2021,283730,905770,1189500,MKT
06033802417170000,2020,214457,815210,1029667,COST
06033802417170000,2019,214457,815210,1029667,COST
06033802417210000,2021,283730,0,283730,COST
06033802417210000,2020,214457,0,214457,COST
06033802417210000,2019,214457,0,214457,COST
06033802417250000,2021,283730,0,283730,COST
06033802417250000,2020,214457,0,214457,COST
06033802417250000,2019,214457,0,214457,COST
06033802417290000,2021,284080,785290,1069370,COST
06033802417290000,2020,214761,676190,890951,COST
06033802417290000,2019,214761,676190,890951,COST
06033802417330000,2021,284080,1168030,1452110,COST
06033802417330000,2020,214761,994320,1209081,COST
06033802417330000,2019,214761,994320,1209081,COST
06033802417416500,2021,143,0,143,COST
06033802417416500,2020,133,0,133,COST
06033802417416500,2019,133,0,133,COST
06033802417530000,2021,351602,0,351602,COST
06033802417530000,2020,307653,0,307653,COST
06033802417530000,2019,307653,0,307653,COST
06033802425010000,2021,336238,1465060,1801298,COST
06033802425010000,2020,292256,1224220,1516476,COST
06033802425010000,2019,292256,1293570,1585826,COST
06033802425050000,2021,345356,990180,1335536,COST
06033802425050000,2020,301382,790470,1091852,COST
06033802425050000,2019,301382,790470,1091852,COST
06033802425100000,2021,319958,869430,1189388,COST
06033802425100000,2020,276056,737270,1013326,COST
06033802425100000,2019,276056,737270,1013326,COST
06033802425126500,2021,172292,0,172292,COST
06033802425126500,2020,162376,0,162376,COST
06033802425126500,2019,162376,0,162376,COST
06033802425150000,2021,347815,1574530,1922345,COST
06033802425150000,2020,303849,1325980,1629829,COST
06033802425150000,2019,303849,916640,1220489,COST
06033802425200000,2021,471990,0,471990,COST
06033802425200000,2020,279353,0,279353,COST
06033802425200000,2019,279353,0,279353,COST
06033802425250000,2021,483084,1036420,1519504,COST
06033802425250000,2020,286911,870360,1157271,COST
06033802425250000,2019,286911,870360,1157271,COST
06033802425300000,2021,505766,0,505766,COST
06033802425300000,2020,302443,0,302443,COST
06033802425300000,2019,302443,0,302443,COST
06033802425350000,2021,512842,1519820,2032662,COST
06033802425350000,2020,307311,1265020,1572331,COST
06033802425350000,2019,307311,1265020,1572331,COST
06033802425400000,2021,316126,1862010,2178136,COST
06033802425400000,2020,272260,761310,1033570,COST
06033802425400000,2019,272260,0,272260,COST
06033802425450000,2021,306753,1578160,1884913,COST
06033802425450000,2020,263006,1347770,1610776,COST
06033802425450000,2019,263006,1347770,1610776,COST
06033802425500000,2021,345710,0,345710,COST
06033802425500000,2020,301736,0,301736,COST
06033802425500000,2019,301736,0,301736,COST
06033802425550000,2021,339216,0,339216,COST
06033802425550000,2020,295232,0,295232,COST
06033802425550000,2019,295232,0,295232,COST
06033802425600000,2021,332430,909740,1242170,COST
06033802425600000,2020,288456,766460,1054916,COST
06033802425600000,2019,288456,766460,1054916,COST
06033802425650000,2021,326529,0,326529,COST
06033802425650000,2020,282580,0,282580,COST
06033802425650000,2019,282580,0,282580,COST
06033802425700000,2021,384986,754730,1139716,COST
06033802425700000,2020,341450,272920,614370,COST
06033802425700000,2019,341450,0,341450,COST
06033802425750000,2021,342497,0,342497,COST
06033802425750000,2020,298517,0,298517,COST
06033802425750000,2019,298517,0,298517,COST
06033802450017000,2021,2433659,0,2433659,COST
06033802450017000,2020,635941,0,635941,COST
06033802450017000,2019,635941,0,635941,COST
06033803110010000,2021,10587,0,10587,COST
06033803110010000,2020,5830,0,5830,COST
06033803110010000,2019,5830,0,5830,COST
06033803120010000,2021,11804,0,11804,COST
06033803120010000,2020,6416,0,6416,COST
06033803120010000,2019,6416,0,6416,COST
06033803130010000,2021,11671,0,11671,COST
06033803130010000,2020,6285,0,6285,COST
06033803130010000,2019,6285,0,6285,COST
06033803140010000,2021,11641,0,11641,COST
06033803140010000,2020,6268,0,6268,COST
06033803140010000,2019,6268,0,6268,COST
06033803160016500,2021,1217,0,1217,COST
06033803160016500,2020,1132,0,1132,COST
06033803160016500,2019,1132,0,1132,COST
06033803160030000,2021,466808,0,466808,COST
06033803160030000,2020,371264,0,371264,COST
06033803160030000,2019,371264,0,371264,COST
06033803160050000,2021,448490,0,448490,COST
06033803160050000,2020,357617,0,357617,COST
06033803160050000,2019,357617,0,357617,COST
06033803160070000,2021,374215,0,374215,COST
06033803160070000,2020,301892,0,301892,COST
06033803160070000,2019,301892,0,301892,COST
06033803160090000,2021,362976,1295540,1658516,COST
06033803160090000,2020,293401,1164240,1457641,COST
06033803160090000,2019,293401,1164240,1457641,COST
06033803160110000,2021,404919,0,404919,COST
06033803160110000,2020,325006,0,325006,COST
06033803160110000,2019,325006,0,325006,COST
06033803160130000,2021,461912,0,461912,COST
06033803160130000,2020,367620,0,367620,COST
06033803160130000,2019,367620,0,367620,COST
06033803160150000,2021,396409,0,396409,COST
06033803160150000,2020,318612,0,318612,COST
06033803160150000,2019,318612,0,318612,COST
06033803160170000,2021,415100,0,415100,COST
06033803160170000,2020,332646,0,332646,COST
06033803160170000,2019,332646,0,332646,COST
06033803160190000,2021,424485,0,424485,COST
06033803160190000,2020,339677,0,339677,COST
06033803160190000,2019,339677,0,339677,COST
06033803160210000,2021,424023,2196730,2620753,COST
06033803160210000,2020,339331,1949590,2288921,COST
06033803160210000,2019,339331,1949590,2288921,COST
06033803160230000,2021,368093,0,368093,COST
06033803160230000,2020,297269,0,297269,COST
06033803160230000,2019,297269,0,297269,COST
06033803201010000,2021,22789,0,22789,COST
06033803201010000,2020,12313,0,12313,COST
06033803201010000,2019,12313,0,12313,COST
06033803201300000,2021,1744404,0,1744404,COST
06033803201300000,2020,1188623,0,1188623,COST
06033803201300000,2019,1188623,0,1188623,COST
06033803201406500,2021,379919,0,379919,COST
06033803201406500,2020,264298,0,264298,COST
06033803201406500,2019,264298,0,264298,COST
06033803220016500,2021,2102,0,2102,COST
06033803220016500,2020,1956,0,1956,COST
06033803220016500,2019,1956,0,1956,COST
06033803220050000,2021,387113,2189160,2576273,COST
06033803220050000,2020,311616,1911430,2223046,COST
06033803220050000,2019,311616,1911430,2223046,COST
06033803220100000,2021,403435,1555200,1958635,COST
06033803220100000,2020,323892,1310806,1634698,OVR
06033803220100000,2019,323892,1310806,1634698,OVR
06033803220150000,2021,415100,1789880,2204980,COST
06033803220150000,2020,332646,1253867,1586513,MRA
06033803220150000,2019,332646,1253867,1586513,MRA
06033803220200000,2021,439371,0,439371,COST
06033803220200000,2020,350809,0,350809,COST
06033803220200000,2019,350809,0,350809,COST
06033803220250000,2021,385533,0,385533,COST
06033803220250000,2020,310427,0,310427,COST
06033803220250000,2019,310427,0,310427,COST
06033803220300000,2021,417001,2130500,2547501,COST
06033803220300000,2020,334071,1908800,2242871,COST
06033803220300000,2019,334071,1908800,2242871,COST
06033803220350000,2021,440690,0,440690,COST
06033803220350000,2020,351794,0,351794,COST
06033803220350000,2019,351794,0,351794,COST
06033803220400000,2021,429527,0,429527,COST
06033803220400000,2020,343450,0,343450,COST
06033803220400000,2019,343450,0,343450,COST
06033803220450000,2021,379123,3538700,3917823,COST
06033803220450000,2020,305595,2308260,2613855,COST
06033803220450000,2019,305595,2308260,2613855,COST
06033803220500000,2021,397929,2445970,2843899,COST
06033803220500000,2020,319755,2338730,2658485,COST
06033803220500000,2019,319755,2338730,2658485,COST
06033803220550000,2021,392830,2299260,2692090,COST
06033803220550000,2020,315920,2053590,2369510,COST
06033803220550000,2019,315920,2053590,2369510,COST
06033803220650000,2021,474814,0,474814,COST
06033803220650000,2020,377218,0,377218,COST
06033803220650000,2019,377218,0,377218,COST
06033803220700000,2021,460677,2355000,2815677,COST
06033803220700000,2020,366700,2093190,2459890,COST
06033803220700000,2019,366700,2093190,2459890,COST
06033803220750000,2021,471235,0,471235,COST
06033803220750000,2020,374557,0,374557,COST
06033803220750000,2019,374557,0,374557,COST
06033803220800000,2021,441128,0,441128,COST
06033803220800000,2020,352121,0,352121,COST
06033803220800000,2019,352121,0,352121,COST
06033803220850000,2021,498147,1733160,2231307,COST
06033803220850000,2020,394534,1546880,1941414,COST
06033803220850000,2019,394534,1546880,1941414,COST
06033803230050000,2021,408352,1936470,2344822,COST
06033803230050000,2020,327584,1691600,2019184,COST
06033803230050000,2019,327584,1691600,2019184,COST
06033803230100000,2021,386587,1964890,2351477,COST
06033803230100000,2020,311220,1746380,2057600,COST
06033803230100000,2019,311220,1746380,2057600,COST
06033803230150000,2021,413188,1700070,2113258,COST
06033803230150000,2020,331212,1523690,1854902,COST
06033803230150000,2019,331212,1523690,1854902,COST
06033803230200000,2021,448490,1610030,2058520,COST
06033803230200000,2020,357617,1418560,1776177,COST
06033803230200000,2019,357617,1418560,1776177,COST
06033803230250000,2021,486483,3370680,3857163,COST
06033803230250000,2020,385884,2986200,3372084,COST
06033803230250000,2019,385884,2986200,3372084,COST
06033803230300000,2021,500361,1900670,2401031,COST
06033803230300000,2020,396174,1658190,2054364,COST
06033803230300000,2019,396174,1658190,2054364,COST
06033803230350000,2021,463961,3157540,3621501,COST
06033803230350000,2020,369145,2792730,3161875,COST
06033803230350000,2019,369145,2792730,3161875,COST
06033803230400000,2021,453588,0,453588,COST
06033803230400000,2020,361418,0,361418,COST
06033803230400000,2019,361418,0,361418,COST
06033803230450000,2021,383945,2373070,2757015,COST
06033803230450000,2020,309230,2093150,2402380,COST
06033803230450000,2019,309230,2093150,2402380,COST
06033803230500000,2021,409811,0,409811,COST
06033803230500000,2020,328679,0,328679,COST
06033803230500000,2019,328679,0,328679,COST
06033803230550000,2021,447633,1542240,1989873,COST
06033803230550000,2020,356977,1383290,1740267,COST
06033803230550000,2019,356977,1383290,1740267,COST
06033803240010000,2021,418889,0,418889,COST
06033803240010000,2020,335486,0,335486,COST
06033803240010000,2019,335486,0,335486,COST
06033803240030000,2021,427245,0,427245,COST
06033803240030000,2020,341743,0,341743,COST
06033803240030000,2019,341743,0,341743,COST
06033803301010000,2021,521196,1919670,2440866,COST
06033803301010000,2020,441723,1684070,2125793,COST
06033803301010000,2019,441723,1684070,2125793,COST
06033803301030000,2021,400037,2176110,2576147,COST
06033803301030000,2020,468952,0,468952,COST
06033803301030000,2019,468952,0,468952,COST
06033803301050000,2021,607985,2155660,2763645,COST
06033803301050000,2020,510190,1881710,2391900,COST
06033803301050000,2019,510190,1881710,2391900,COST
06033803301090000,2021,500495,0,500495,COST
06033803301090000,2020,425287,0,425287,COST
06033803301090000,2019,425287,0,425287,COST
06033803301110000,2021,492665,0,492665,COST
06033803301110000,2020,419059,0,419059,COST
06033803301110000,2019,419059,0,419059,COST
06033803301130000,2021,447627,0,447627,COST
06033803301130000,2020,383109,0,383109,COST
06033803301130000,2019,383109,0,383109,COST
06033803301150000,2021,408348,1881410,2289758,COST
06033803301150000,2020,351566,1749240,2100806,COST
06033803301150000,2019,351566,1749240,2100806,COST
06033803301170000,2021,414278,0,414278,COST
06033803301170000,2020,356340,0,356340,COST
06033803301170000,2019,356340,0,356340,COST
06033803302010000,2021,327654,0,327654,COST
06033803302010000,2020,389070,0,389070,COST
06033803302010000,2019,389070,0,389070,COST
06033803302030000,2021,514424,0,514424,COST
06033803302030000,2020,436351,0,436351,COST
06033803302030000,2019,436351,0,436351,COST
06033803302050000,2021,431399,0,431399,COST
06033803302050000,2020,370100,0,370100,COST
06033803302050000,2019,370100,0,370100,COST
06033803431016500,2021,2860,0,2860,COST
06033803431016500,2020,2662,0,2662,COST
06033803431016500,2019,2662,0,2662,COST
06033803431030000,2021,427245,0,427245,COST
06033803431030000,2020,341743,0,341743,COST
06033803431030000,2019,341743,0,341743,COST
06033803431050000,2021,434040,0,434040,COST
06033803431050000,2020,346825,0,346825,COST
06033803431050000,2019,346825,0,346825,COST
06033803431070000,2021,407864,0,407864,COST
06033803431070000,2020,327218,0,327218,COST
06033803431070000,2019,327218,0,327218,COST
06033803431090000,2021,470834,0,470834,COST
06033803431090000,2020,374259,0,374259,COST
06033803431090000,2019,374259,0,374259,COST
06033803431110000,2021,440690,1875230,2315920,COST
06033803431110000,2020,351794,1652510,2004304,COST
06033803431110000,2019,351794,1652510,2004304,COST
06033803441016500,2021,1708,0,1708,COST
06033803441016500,2020,1590,0,1590,COST
06033803441016500,2019,1590,0,1590,COST
06033803441030000,2021,433142,0,433142,COST
06033803441030000,2020,346154,0,346154,COST
06033803441030000,2019,346154,0,346154,COST
06033803441050000,2021,510161,0,510161,COST
06033803441050000,2020,403429,0,403429,COST
06033803441050000,2019,403429,0,403429,COST
06033803441070000,2021,292604,0,292604,COST
06033803441070000,2020,326115,0,326115,COST
06033803441070000,2019,326115,0,326115,COST
06033803441090000,2021,500561,0,500561,COST
06033803441090000,2020,329042,0,329042,COST
06033803441090000,2019,329042,0,329042,COST
06033803441110000,2021,463552,2285480,2749032,COST
06033803441110000,2020,368841,2015940,2384781,COST
06033803441110000,2019,368841,2015940,2384781,COST
06033803441130000,2021,371917,0,371917,COST
06033803441130000,2020,408155,0,408155,COST
06033803441130000,2019,408155,0,408155,COST
06033803441150000,2021,415100,0,415100,COST
06033803441150000,2020,332646,0,332646,COST
06033803441150000,2019,332646,0,332646,COST
06033803441170000,2021,324614,0,324614,COST
06033803441170000,2020,264288,0,264288,COST
06033803441170000,2019,264288,0,264288,COST
06033803441190000,2021,391282,0,391282,COST
06033803441190000,2020,314755,0,314755,COST
06033803441190000,2019,314755,0,314755,COST
06033803441210000,2021,418889,0,418889,COST
06033803441210000,2020,335486,0,335486,COST
06033803441210000,2019,335486,0,335486,COST
06033803441230000,2021,312509,0,312509,COST
06033803441230000,2020,346825,0,346825,COST
06033803441230000,2019,346825,0,346825,COST
06033803441250000,2021,652409,1943610,2596019,COST
06033803441250000,2020,421602,1719040,2140642,COST
06033803441250000,2019,421602,1719040,2140642,COST
06033803441270000,2021,570000,2781910,3351910,COST
06033803441270000,2020,371565,2473920,2845485,COST
06033803441270000,2019,371565,2473920,2845485,COST
06033803441290000,2021,565533,0,565533,COST
06033803441290000,2020,368841,0,368841,COST
06033803441290000,2019,368841,0,368841,COST
06033804101010000,2021,12164,0,12164,COST
06033804101010000,2020,6605,0,6605,COST
06033804101010000,2019,6527,0,6527,COST
06033804101200000,2021,1068966,3123110,4192076,COST
06033804101200000,2020,751732,575580,1327312,COST
06033804101200000,2019,751732,0,751732,COST
06033804101250000,2021,831495,0,831495,COST
06033804101250000,2020,654217,0,654217,COST
06033804101250000,2019,654217,0,654217,COST
06033804101300000,2021,697508,0,697508,COST
06033804101300000,2020,555044,0,555044,COST
06033804101300000,2019,555044,0,555044,COST
06033804110010000,2021,2995120,10075170,13070290,COST
06033804110010000,2020,1776467,9817610,11594077,COST
06033804110010000,2019,2210604,9583520,11794124,COST
06033804201017000,2021,801621,0,801621,COST
06033804201017000,2020,1057287,0,1057287,COST
06033804201017000,2019,1057287,0,1057287,COST
06033804201107001,2021,97239,1913471,2010710,OVR
06033804201107001,2020,215698,2254302,2470000,OVR
06033804201107001,2019,215698,2254302,2470000,OVR
06033804201200000,2021,432191,7221920,7654111,COST
06033804201200000,2020,277076,6937460,7214536,COST
06033804201200000,2019,277076,6183480,6460556,COST
06033804201307000,2021,1499126,259025570,260524696,COST
06033804201307000,2020,1031513,59845270,60876783,COST
06033804201307000,2019,1031513,0,1031513,COST
06033804201400000,2021,829853,0,829853,COST
06033804201400000,2020,593177,0,593177,COST
06033804201450000,2021,498883,0,498883,COST
06033804201450000,2020,368485,0,368485,COST
06033804401016500,2021,499758,0,499758,COST
06033804401016500,2020,341580,0,341580,COST
06033804401016500,2019,341580,0,341580,COST
06033804401040000,2021,600896,0,600896,COST
06033804401040000,2020,438546,0,438546,COST
06033804401040000,2019,438546,0,438546,COST
06033804401070000,2021,669104,0,669104,COST
06033804401070000,2020,484954,0,484954,COST
06033804401070000,2019,484954,0,484954,COST
06033804401100000,2021,710315,0,710315,COST
06033804401100000,2020,512845,0,512845,COST
06033804401100000,2019,512845,0,512845,COST
06033804401130000,2021,675206,1512200,2187406,COST
06033804401130000,2020,489091,1345230,1834321,COST
06033804401130000,2019,489091,1278660,1767751,COST
06033804401160000,2021,214775,0,214775,COST
06033804401160000,2020,102493,0,102493,COST
06033804401160000,2019,102493,0,102493,COST
06033804401190000,2021,717797,0,717797,COST
06033804401190000,2020,517897,0,517897,COST
06033804401190000,2019,517897,0,517897,COST
06033804401220000,2021,452535,0,452535,COST
06033804401220000,2020,457380,0,457380,COST
06033804401220000,2019,457380,0,457380,COST
06033804401250000,2021,596119,0,596119,COST
06033804401250000,2020,435283,0,435283,COST
06033804401250000,2019,435283,0,435283,COST
06033804401280000,2021,596119,0,596119,COST
06033804401280000,2020,435283,0,435283,COST
06033804401280000,2019,435283,0,435283,COST
06033804401310000,2021,593710,0,593710,COST
06033804401310000,2020,433637,0,433637,COST
06033804401310000,2019,433637,0,433637,COST
06033804401340000,2021,696953,3529047,4226000,MKT
06033804401340000,2020,503813,3586340,4090153,COST
06033804401340000,2019,503813,3586340,4090153,COST
06033804401370000,2021,439414,2091540,2530954,COST
06033804401370000,2020,444962,1839820,2284782,COST
06033804401370000,2019,444962,660670,1105632,COST
06033804401400000,2021,624034,0,624034,COST
06033804401400000,2020,454325,0,454325,COST
06033804401400000,2019,454325,0,454325,COST
06033804401430000,2021,628521,0,628521,COST
06033804401430000,2020,457380,0,457380,COST
06033804401430000,2019,457380,0,457380,COST
06033804401460000,2021,603266,0,603266,COST
06033804401460000,2020,440164,0,440164,COST
06033804401460000,2019,440164,0,440164,COST
06033804401490000,2021,637364,0,637364,COST
06033804401490000,2020,463398,0,463398,COST
06033804401490000,2019,463398,0,463398,COST
06033804401520000,2021,675206,0,675206,COST
06033804401520000,2020,489091,0,489091,COST
06033804401520000,2019,489091,0,489091,COST
06033804401550000,2021,681232,0,681232,COST
06033804401550000,2020,493174,0,493174,COST
06033804401550000,2019,493174,0,493174,COST
06033804402010000,2021,481755,0,481755,COST
06033804402010000,2020,484954,0,484954,COST
06033804402010000,2019,484954,0,484954,COST
06033804402040000,2021,573929,0,573929,COST
06033804402040000,2020,420105,0,420105,COST
06033804402040000,2019,420105,0,420105,COST
06033804402070000,2021,814548,0,814548,COST
06033804402070000,2020,641734,0,641734,COST
06033804402070000,2019,641734,0,641734,COST
06033804402100000,2021,727085,0,727085,COST
06033804402100000,2020,577034,0,577034,COST
06033804402100000,2019,577034,0,577034,COST
06033804402130000,2021,738460,0,738460,COST
06033804402130000,2020,585476,0,585476,COST
06033804402130000,2019,585476,0,585476,COST
06033804402160000,2021,757802,0,757802,COST
06033804402160000,2020,599811,0,599811,COST
06033804402160000,2019,599811,0,599811,COST
06033804402190000,2021,784302,0,784302,COST
06033804402190000,2020,619413,0,619413,COST
06033804402190000,2019,619413,0,619413,COST
06033804402220000,2021,643886,0,643886,COST
06033804402220000,2020,467833,0,467833,COST
06033804402220000,2019,467833,0,467833,COST
06033804402250000,2021,630748,3036452,3667200,MKT
06033804402250000,2020,458896,2657540,3116436,COST
06033804402250000,2019,458896,2657540,3116436,COST
06033804402280000,2021,658759,3359341,4018100,MKT
06033804402280000,2020,477936,2827460,3305396,COST
06033804402280000,2019,477936,3121570,3599506,COST
06033804402310000,2021,637364,0,637364,COST
06033804402310000,2020,463398,0,463398,COST
06033804402310000,2019,463398,0,463398,COST
06033804402340000,2021,658759,4133010,4791769,COST
06033804402340000,2020,477936,3179620,3657556,OVR
06033804402340000,2019,477936,3179620,3657556,COST
06033804402370000,2021,624034,2772166,3396200,MKT
06033804402370000,2020,454325,2570164,3024489,OVR
06033804402370000,2019,454325,2570164,3024489,OVR
06033804402400000,2021,643886,0,643886,COST
06033804402400000,2020,467833,0,467833,COST
06033804402400000,2019,467833,0,467833,COST
06033804402430000,2021,773853,2388430,3162283,COST
06033804402430000,2020,611689,2130460,2742149,COST
06033804402430000,2019,611689,2130460,2742149,COST
06033804402460000,2021,746835,3199990,3946825,COST
06033804402460000,2020,449681,1094500,1544181,COST
06033804402460000,2019,449681,0,449681,COST
06033804402490000,2021,724202,0,724202,COST
06033804402490000,2020,574894,0,574894,COST
06033804402490000,2019,574894,0,574894,COST
06033804402520000,2021,773853,0,773853,COST
06033804402520000,2020,611689,0,611689,COST
06033804402520000,2019,611689,0,611689,COST
06033804402550000,2021,773853,3717760,4491613,COST
06033804402550000,2020,611689,3375040,3986729,COST
06033804402550000,2019,611689,3375040,3986729,COST
06033804402580000,2021,718389,2535710,3254099,COST
06033804402580000,2020,570575,2224140,2794715,COST
06033804402580000,2019,570575,2224140,2794715,COST
06033804403010000,2021,621774,0,621774,COST
06033804403010000,2020,452785,0,452785,COST
06033804403010000,2019,452785,0,452785,COST
06033804403040000,2021,607966,3361134,3969100,MKT
06033804403040000,2020,443371,3080740,3524111,COST
06033804403040000,2019,443371,3009150,3452521,COST
06033804403070000,2021,614924,1710520,2325444,COST
06033804403070000,2020,448117,1517600,1965717,COST
06033804403070000,2019,448117,1389090,1837207,COST
06033804403100000,2021,593710,0,593710,COST
06033804403100000,2020,433637,0,433637,COST
06033804403100000,2019,433637,0,433637,COST
06033804403130000,2021,610298,3447302,4057600,MKT
06033804403130000,2020,444962,2817160,3262122,COST
06033804403130000,2019,444962,2817160,3262122,COST
06033804403160000,2021,624034,0,624034,COST
06033804403160000,2020,454325,0,454325,COST
06033804403160000,2019,454325,0,454325,COST
06033804403190000,2021,600896,0,600896,COST
06033804403190000,2020,438546,0,438546,COST
06033804403190000,2019,438546,0,438546,COST
06033804403220000,2021,591287,3366213,3957500,MKT
06033804403220000,2020,431981,2961630,3393611,COST
06033804403220000,2019,431981,2961630,3393611,COST
06033804403250000,2021,586400,0,586400,COST
06033804403250000,2020,428640,0,428640,COST
06033804403250000,2019,428640,0,428640,COST
06033804403280000,2021,591287,0,591287,COST
06033804403280000,2020,431981,0,431981,COST
06033804403280000,2019,431981,0,431981,COST
06033804403310000,2021,628521,0,628521,COST
06033804403310000,2020,457380,0,457380,COST
06033804403310000,2019,457380,0,457380,COST
06033804403340000,2021,600896,0,600896,COST
06033804403340000,2020,438546,0,438546,COST
06033804403340000,2019,438546,0,438546,COST
06033804403370000,2021,624034,0,624034,COST
06033804403370000,2020,454325,0,454325,COST
06033804403370000,2019,454325,0,454325,COST
06033804403400000,2021,591287,3145150,3736437,COST
06033804403400000,2020,431981,0,431981,COST
06033804403400000,2019,431981,0,431981,COST
06033804403430000,2021,626283,0,626283,COST
06033804403430000,2020,455857,0,455857,COST
06033804403430000,2019,455857,0,455857,COST
06033804403460000,2021,639548,3075452,3715000,MKT
06033804403460000,2020,464884,1882060,2346944,COST
06033804403460000,2019,464884,1882060,2346944,COST
06033804403490000,2021,598514,596410,1194924,COST
06033804403490000,2020,436919,0,436919,COST
06033804403490000,2019,436919,0,436919,COST
06033804403520000,2021,605622,2784978,3390600,MKT
06033804403520000,2020,441772,2614730,3056502,COST
06033804403520000,2019,441772,2614730,3056502,COST
06033804403550000,2021,591287,0,591287,COST
06033804403550000,2020,431981,0,431981,COST
06033804403550000,2019,431981,0,431981,COST
06033804403580000,2021,600896,2425104,3026000,MKT
06033804403580000,2020,438546,2119190,2557736,OVR
06033804403580000,2019,438546,2119190,2557736,COST
06033804403610000,2021,626283,2917617,3543900,MKT
06033804403610000,2020,455857,2741310,3197167,COST
06033804403610000,2019,455857,2741310,3197167,COST
06033804403640000,2021,624034,1392610,2016644,COST
06033804403640000,2020,454325,1228850,1683175,COST
06033804403640000,2019,454325,1228850,1683175,COST
06033804403670000,2021,586400,0,586400,COST
06033804403670000,2020,428640,0,428640,COST
06033804403670000,2019,428640,0,428640,COST
06033804403700000,2021,588851,0,588851,COST
06033804403700000,2020,430316,0,430316,COST
06033804403700000,2019,430316,0,430316,COST
06033804404017000,2021,1113821,0,1113821,COST
06033804404017000,2020,926239,0,926239,COST
06033804404017000,2019,926239,0,926239,COST
06033804410010000,2021,12110,0,12110,COST
06033804410010000,2020,6594,0,6594,COST
06033804410010000,2019,6594,0,6594,COST
06033804410046500,2021,2029,0,2029,COST
06033804410046500,2020,1888,0,1888,COST
06033804410046500,2019,1888,0,1888,COST
06033804411010000,2021,536152,2719580,3255732,COST
06033804411010000,2020,477443,2374070,2851513,COST
06033804411010000,2019,477443,2374070,2851513,COST
06033804411060000,2021,492665,0,492665,COST
06033804411060000,2020,441115,0,441115,COST
06033804411060000,2019,441115,0,441115,COST
06033804411110000,2021,521806,0,521806,COST
06033804411110000,2020,465481,0,465481,COST
06033804411110000,2019,465481,0,465481,COST
06033804411160000,2021,547023,0,547023,COST
06033804411160000,2020,403907,0,403907,COST
06033804411160000,2019,403907,0,403907,COST
06033804411210000,2021,572772,0,572772,COST
06033804411210000,2020,421668,0,421668,COST
06033804411210000,2019,421668,0,421668,COST
06033804411260000,2021,496091,2134720,2630811,COST
06033804411260000,2020,368614,1888580,2257194,COST
06033804411260000,2019,368614,1888580,2257194,COST
06033804411310000,2021,602658,0,602658,COST
06033804411310000,2020,442218,0,442218,COST
06033804411310000,2019,442218,0,442218,COST
06033804411360000,2021,456544,0,456544,COST
06033804411360000,2020,410784,0,410784,COST
06033804411360000,2019,410784,0,410784,COST
06033804412010000,2021,569316,2463700,3033016,COST
06033804412010000,2020,419287,2297980,2717267,COST
06033804412010000,2019,419287,2297980,2717267,COST
06033804412060000,2021,497139,0,497139,COST
06033804412060000,2020,369343,0,369343,COST
06033804412060000,2019,369343,0,369343,COST
06033804412110000,2021,651233,1952940,2604173,COST
06033804412110000,2020,475481,1727780,2203261,COST
06033804412110000,2019,475481,1727780,2203261,COST
06033804412160000,2021,580444,0,580444,COST
06033804412160000,2020,426950,0,426950,COST
06033804412160000,2019,426950,0,426950,COST
06033804412210000,2021,592106,0,592106,COST
06033804412210000,2020,434971,0,434971,COST
06033804412210000,2019,434971,0,434971,COST
06033804412260000,2021,568447,0,568447,COST
06033804412260000,2020,418689,0,418689,COST
06033804412260000,2019,418689,0,418689,COST
06033804413010000,2021,615303,0,615303,COST
06033804413010000,2020,450893,0,450893,COST
06033804413010000,2019,450893,0,450893,COST
06033804413060000,2021,662617,4508280,5170897,COST
06033804413060000,2020,483253,2581670,3064923,COST
06033804413060000,2019,483253,2581670,3064923,COST
06033804413110000,2021,664722,0,664722,COST
06033804413110000,2020,484689,0,484689,COST
06033804413110000,2019,484689,0,484689,COST
06033804413160000,2021,572772,0,572772,COST
06033804413160000,2020,421668,0,421668,COST
06033804413160000,2019,421668,0,421668,COST
06033804413210000,2021,555191,1523530,2078721,COST
06033804413210000,2020,409547,0,409547,COST
06033804413210000,2019,409547,0,409547,COST
06033804413260000,2021,552487,0,552487,COST
06033804413260000,2020,407681,0,407681,COST
06033804413260000,2019,407681,0,407681,COST
06033804414010000,2021,595993,0,595993,COST
06033804414010000,2020,527126,0,527126,COST
06033804414010000,2019,527126,0,527126,COST
06033804414060000,2021,539656,0,539656,COST
06033804414060000,2020,480362,0,480362,COST
06033804414060000,2019,480362,0,480362,COST
06033804414110000,2021,519974,0,519974,COST
06033804414110000,2020,463952,0,463952,COST
06033804414110000,2019,463952,0,463952,COST
06033804414160000,2021,594564,0,594564,COST
06033804414160000,2020,436660,0,436660,COST
06033804414160000,2019,436660,0,436660,COST
06033804414210000,2021,683261,1733540,2416801,COST
06033804414210000,2020,497325,1191560,1688885,COST
06033804414210000,2019,497325,1191560,1688885,COST
06033804414260000,2021,695243,0,695243,COST
06033804414260000,2020,505480,0,505480,COST
06033804414260000,2019,505480,0,505480,COST
06033804414310000,2021,722767,7567200,8289967,COST
06033804414310000,2020,524178,6636330,7160508,COST
06033804414310000,2019,524178,4046730,4570908,COST
06033804415010000,2021,462358,0,462358,COST
06033804415010000,2020,415676,0,415676,COST
06033804415010000,2019,415676,0,415676,COST
06033804415060000,2021,579598,0,579598,COST
06033804415060000,2020,426368,0,426368,COST
06033804415060000,2019,426368,0,426368,COST
06033804415110000,2021,632872,0,632872,COST
06033804415110000,2020,462928,0,462928,COST
06033804415110000,2019,462928,0,462928,COST
06033804415160000,2021,582970,0,582970,COST
06033804415160000,2020,428688,0,428688,COST
06033804415160000,2019,428688,0,428688,COST
06033804415210000,2021,619181,0,619181,COST
06033804415210000,2020,453552,0,453552,COST
06033804415210000,2019,453552,0,453552,COST
06033804415260000,2021,641217,0,641217,COST
06033804415260000,2020,564459,0,564459,COST
06033804415260000,2019,564459,0,564459,COST
06033809110010000,2021,90562,0,90562,COST
06033809110010000,2020,49283,0,49283,COST
06033809110010000,2019,49283,0,49283,COST
06033809110100000,2021,480586,2317460,2798046,COST
06033809110100000,2020,306002,2499998,2806000,OVR
06033809110100000,2019,306002,2499998,2806000,OVR
06033809110200000,2021,738122,1992030,2730152,COST
06033809110200000,2020,379559,1754820,2134379,COST
06033809110200000,2019,379559,1754820,2134379,COST
06033809310010000,2021,68464,0,68464,COST
06033809310010000,2020,36884,0,36884,COST
06033809310010000,2019,36884,0,36884,COST
06033809401010000,2021,559616,0,559616,COST
06033809401010000,2020,36712,0,36712,COST
06033809401010000,2019,36712,0,36712,COST
06033810105010000,2021,408348,0,408348,COST
06033810105010000,2020,262749,0,262749,COST
06033810105010000,2019,262749,0,262749,COST
06033810105030000,2021,423366,2416010,2839376,COST
06033810105030000,2020,271779,1994690,2266469,OVR
06033810105030000,2019,271779,1994690,2266469,COST
06033810105050000,2021,419269,3041540,3460809,COST
06033810105050000,2020,269318,2647460,2916778,COST
06033810105050000,2019,269318,2647460,2916778,COST
06033810105070000,2021,413438,0,413438,COST
06033810105070000,2020,265812,0,265812,COST
06033810105070000,2019,265812,0,265812,COST
06033810105090000,2021,443838,2105900,2549738,COST
06033810105090000,2020,284055,1872490,2156545,COST
06033810105090000,2019,284055,1872490,2156545,COST
06033810105110000,2021,511304,0,511304,COST
06033810105110000,2020,324264,0,324264,COST
06033810105110000,2019,324264,0,324264,COST
06033810105150000,2021,560050,0,560050,COST
06033810105150000,2020,353101,0,353101,COST
06033810105150000,2019,353101,0,353101,COST
06033810105190000,2021,516283,0,516283,COST
06033810105190000,2020,327218,0,327218,COST
06033810105190000,2019,327218,0,327218,COST
06033810105230000,2021,473690,2323950,2797640,COST
06033810105230000,2020,301892,1972650,2274542,OVR
06033810105230000,2019,301892,1972650,2274542,COST
06033810106010000,2021,678522,1756400,2434922,COST
06033810106010000,2020,350809,1554840,1905649,COST
06033810106010000,2019,350809,1554840,1905649,COST
06033810106050000,2021,670980,0,670980,COST
06033810106050000,2020,347160,0,347160,COST
06033810106050000,2019,347160,0,347160,COST
06033810106090000,2021,677841,2870050,3547891,COST
06033810106090000,2020,350480,0,350480,COST
06033810106090000,2019,350480,0,350480,COST
06033810106130000,2021,736910,0,736910,COST
06033810106130000,2020,378976,0,378976,COST
06033810106130000,2019,378976,0,378976,COST
06033810107016500,2021,456280,134050,590330,COST
06033810107016500,2020,269799,128260,398059,COST
06033810107016500,2019,269799,128260,398059,COST
06033810120010000,2021,11860,0,11860,COST
06033810120010000,2020,6415,0,6415,COST
06033810120010000,2019,6415,0,6415,COST
06033810201010000,2021,558769,2259380,2818149,COST
06033810201010000,2020,292531,1947350,2239881,COST
06033810201010000,2019,292531,1947350,2239881,COST
06033810201050000,2021,411751,0,411751,COST
06033810201050000,2020,264797,0,264797,COST
06033810201050000,2019,264797,0,264797,COST
06033810202010000,2021,443074,0,443074,COST
06033810202010000,2020,283598,0,283598,COST
06033810202010000,2019,283598,0,283598,COST
06033810202030000,2021,480586,1892520,2373106,COST
06033810202030000,2020,306002,1686320,1992322,COST
06033810202030000,2019,306002,1686320,1992322,COST
06033810202050000,2021,479218,0,479218,COST
06033810202050000,2020,305187,0,305187,COST
06033810202050000,2019,305187,0,305187,COST
06033810202070000,2021,463795,2345960,2809755,COST
06033810202070000,2020,295988,1035420,1331408,COST
06033810202070000,2019,295988,0,295988,COST
06033810202090000,2021,423366,2270300,2693666,COST
06033810202090000,2020,271779,1983370,2255149,COST
06033810202090000,2019,271779,1983370,2255149,COST
06033810202110000,2021,442309,0,442309,COST
06033810202110000,2020,283140,0,283140,COST
06033810202110000,2019,283140,0,283140,COST
06033810202130000,2021,468779,0,468779,COST
06033810202130000,2020,298963,0,298963,COST
06033810202130000,2019,298963,0,298963,COST
06033810202150000,2021,479218,0,479218,COST
06033810202150000,2020,305187,0,305187,COST
06033810202150000,2019,305187,0,305187,COST
06033810202170000,2021,425798,0,425798,COST
06033810202170000,2020,273240,0,273240,COST
06033810202170000,2019,273240,0,273240,COST
06033810202190000,2021,444599,4144130,4588729,COST
06033810202190000,2020,284511,2994189,3278700,OVR
06033810202190000,2019,284511,2994189,3278700,OVR
06033810203010000,2021,597820,2738000,3335820,COST
06033810203010000,2020,311616,2262384,2574000,OVR
06033810203010000,2019,311616,2262384,2574000,OVR
06033810203030000,2021,573631,0,573631,COST
06033810203030000,2020,299804,0,299804,COST
06033810203030000,2019,299804,0,299804,COST
06033810203050000,2021,548853,0,548853,COST
06033810203050000,2020,287671,0,287671,COST
06033810203050000,2019,287671,0,287671,COST
06033810203070000,2021,518487,0,518487,COST
06033810203070000,2020,272754,0,272754,COST
06033810203070000,2019,272754,0,272754,COST
06033810203090000,2021,498185,0,498185,COST
06033810203090000,2020,262749,0,262749,COST
06033810203090000,2019,262749,0,262749,COST
06033810204010000,2021,447627,0,447627,COST
06033810204010000,2020,383109,0,383109,COST
06033810204010000,2019,383109,0,383109,COST
06033810204030000,2021,472294,0,472294,COST
06033810204030000,2020,402827,0,402827,COST
06033810204030000,2019,402827,0,402827,COST
06033810204050000,2021,439230,0,439230,COST
06033810204050000,2020,376382,0,376382,COST
06033810204050000,2019,376382,0,376382,COST
06033810204070000,2021,435339,0,435339,COST
06033810204070000,2020,373261,0,373261,COST
06033810204070000,2019,373261,0,373261,COST
06033810204090000,2021,455811,0,455811,COST
06033810204090000,2020,389658,0,389658,COST
06033810204090000,2019,389658,0,389658,COST
06033810205010000,2021,551582,0,551582,COST
06033810205010000,2020,386703,0,386703,COST
06033810205010000,2019,386703,0,386703,COST
06033810205030000,2021,529199,0,529199,COST
06033810205030000,2020,372002,0,372002,COST
06033810205030000,2019,372002,0,372002,COST
06033810205050000,2021,499227,0,499227,COST
06033810205050000,2020,352254,0,352254,COST
06033810205050000,2019,352254,0,352254,COST
06033810205070000,2021,505420,0,505420,COST
06033810205070000,2020,356340,0,356340,COST
06033810205070000,2019,356340,0,356340,COST
06033810205090000,2021,637866,2253100,2890966,COST
06033810205090000,2020,382505,1807170,2189675,COST
06033810205090000,2019,382505,1559300,1941805,COST
06033810210016500,2021,3161,0,3161,COST
06033810210016500,2020,2942,0,2942,COST
06033810210016500,2019,2942,0,2942,COST
06033810301010000,2021,334435,519630,854065,COST
06033810301010000,2020,251686,446820,698506,COST
06033810301010000,2019,251686,446820,698506,COST
06033810302056500,2021,14071,0,14071,COST
06033810302056500,2020,8179,0,8179,COST
06033810302056500,2019,8179,0,8179,COST
06033810401010000,2021,83229,0,83229,COST
06033810401010000,2020,44892,0,44892,COST
06033810401010000,2019,44892,0,44892,COST
06033810410010000,2021,71654,0,71654,COST
06033810410010000,2020,38551,0,38551,COST
06033810410010000,2019,38551,0,38551,COST
06033811101010000,2021,253807,1732950,1986757,COST
06033811101010000,2020,208212,1414250,1622462,OVR
06033811101010000,2019,208212,1414250,1622462,COST
06033811101100000,2021,13709,0,13709,COST
06033811101100000,2020,7372,0,7372,COST
06033811101100000,2019,7372,0,7372,COST
06033811101200000,2021,11594,0,11594,COST
06033811101200000,2020,6227,0,6227,COST
06033811101200000,2019,6227,0,6227,COST
06033811101300000,2021,256330,1939520,2195850,COST
06033811101300000,2020,208373,1646600,1854973,COST
06033811101300000,2019,208373,1379900,1588273,COST
06033811101500000,2021,256637,2701760,2958397,COST
06033811101500000,2020,210039,426920,636959,COST
06033811101500000,2019,6356,0,6356,COST
06033811201010000,2021,6934,0,6934,COST
06033811201010000,2020,3821,0,3821,COST
06033811201010000,2019,3821,0,3821,COST
06033811201020000,2021,288690,542950,831640,COST
06033811201020000,2020,245289,462810,708099,COST
06033811201020000,2019,245289,462810,708099,COST
06033811201200000,2021,264051,2683530,2947581,COST
06033811201200000,2020,214144,2219740,2433884,COST
06033811201200000,2019,10461,0,10461,COST
06033811201400000,2021,9226,0,9226,COST
06033811201400000,2020,4967,0,4967,COST
06033811201400000,2019,4967,0,4967,COST
06033811201600000,2021,266183,3573670,3839853,COST
06033811201600000,2020,215042,2866960,3082002,COST
06033811201600000,2019,215042,2866960,3082002,COST
06033811201800000,2021,9444,0,9444,COST
06033811201800000,2020,5086,0,5086,COST
06033811201800000,2019,5086,0,5086,COST
06033811301010000,2021,70861,899150,970011,COST
06033811301010000,2020,39595,740180,779775,COST
06033811301010000,2019,39595,740180,779775,COST
06033811401010000,2021,314616,12309610,12624226,COST
06033811401010000,2020,241492,6705450,6946942,COST
06033811401010000,2019,241492,6705450,6946942,COST
06033812110010000,2021,431209,0,431209,COST
06033812110010000,2020,348838,0,348838,COST
06033812110010000,2019,348838,0,348838,COST
06033812120010000,2021,431069,0,431069,COST
06033812120010000,2020,348708,0,348708,COST
06033812120010000,2019,348708,0,348708,COST
06033812140010000,2021,2206,0,2206,COST
06033812140010000,2020,2053,0,2053,COST
06033812140010000,2019,2053,0,2053,COST
06033812150010000,2021,172153,2837440,3009593,COST
06033812150010000,2020,121580,2402960,2524540,COST
06033812150010000,2019,121580,2402960,2524540,COST
06033812160010000,2021,1108,0,1108,COST
06033812160010000,2020,1031,0,1031,COST
06033812160010000,2019,1031,0,1031,COST
06033812180010000,2021,173256,2553940,2727196,COST
06033812180010000,2020,122607,1325240,1447847,COST
06033812180010000,2019,122607,1325240,1447847,COST
06033812210010000,2021,431195,0,431195,COST
06033812210010000,2020,348825,0,348825,COST
06033812210010000,2019,348825,0,348825,COST
06033812220010000,2021,1108,0,1108,COST
06033812220010000,2020,1031,0,1031,COST
06033812220010000,2019,1031,0,1031,COST
06033812230010000,2021,431209,1382850,1814059,COST
06033812230010000,2020,348838,1171360,1520198,COST
06033812230010000,2019,348838,1171360,1520198,COST
06033812240010000,2021,1108,0,1108,COST
06033812240010000,2020,1031,0,1031,COST
06033812240010000,2019,1031,0,1031,COST
06033812250010000,2021,431229,3261690,3692919,COST
06033812250010000,2020,348856,2505990,2854846,OVR
06033812250010000,2019,348856,2505990,2854846,COST
06033812260010000,2021,431249,1908130,2339379,COST
06033812260010000,2020,348875,1615390,1964265,COST
06033812260010000,2019,348875,1615390,1964265,COST
06033812270010000,2021,1108,7480,8588,COST
06033812270010000,2020,1031,7220,8251,COST
06033812270010000,2019,1031,7220,8251,COST
06033812280010000,2021,1108,0,1108,COST
06033812280010000,2020,1032,0,1032,COST
06033812280010000,2019,1032,0,1032,COST
06033812310010000,2021,1100,0,1100,COST
06033812310010000,2020,1023,0,1023,COST
06033812310010000,2019,1023,0,1023,COST
06033812320010000,2021,343187,3970400,4313587,COST
06033812320010000,2020,242119,3278400,3520519,COST
06033812320010000,2019,242119,3278400,3520519,COST
06033812330010000,2021,1097,0,1097,COST
06033812330010000,2020,1021,0,1021,COST
06033812330010000,2019,1021,0,1021,COST
06033812340010000,2021,430462,0,430462,COST
06033812340010000,2020,348143,0,348143,COST
06033812340010000,2019,348143,0,348143,COST
06033812350010000,2021,430535,1596290,2026825,COST
06033812350010000,2020,348212,1356770,1704982,COST
06033812350010000,2019,348212,1356770,1704982,COST
06033812360010000,2021,430609,0,430609,COST
06033812360010000,2020,348280,0,348280,COST
06033812360010000,2019,348280,0,348280,COST
06033812370010000,2021,430341,3421490,3851831,COST
06033812370010000,2020,348031,3059550,3407581,COST
06033812370010000,2019,348031,3059550,3407581,COST
06033812380010000,2021,430188,0,430188,COST
06033812380010000,2020,1022,0,1022,COST
06033812380010000,2019,1022,0,1022,COST
06033812410010000,2021,1096,0,1096,COST
06033812410010000,2020,1020,0,1020,COST
06033812410010000,2019,1020,0,1020,COST
06033812420010000,2021,1098,0,1098,COST
06033812420010000,2020,1021,0,1021,COST
06033812420010000,2019,1021,0,1021,COST
06033812440010000,2021,2199,0,2199,COST
06033812440010000,2020,2046,0,2046,COST
06033812440010000,2019,2046,0,2046,COST
06033812450010000,2021,430054,0,430054,COST
06033812450010000,2020,347764,0,347764,COST
06033812450010000,2019,347764,0,347764,COST
06033812460010000,2021,430054,0,430054,COST
06033812460010000,2020,1021,0,1021,COST
06033812460010000,2019,1021,0,1021,COST
06033812480010000,2021,2199,0,2199,COST
06033812480010000,2020,2046,0,2046,COST
06033812480010000,2019,2046,0,2046,COST
06033813101010000,2021,300890,1596620,1897510,COST
06033813101010000,2020,234575,1266930,1501505,COST
06033813101010000,2019,234575,1283460,1518035,COST
06033813201010000,2021,49371,4448010,4497381,COST
06033813201010000,2020,29693,3696120,3725813,COST
06033813201010000,2019,29693,3696120,3725813,COST
06033813301010000,2021,48438,0,48438,COST
06033813301010000,2020,27784,0,27784,COST
06033813301010000,2019,27784,0,27784,COST
06033813401010000,2021,40911,0,40911,COST
06033813401010000,2020,24368,0,24368,COST
06033813401010000,2019,24368,0,24368,COST
06033814101010000,2021,355540,3272640,3628180,COST
06033814101010000,2020,239001,3046080,3285081,COST
06033814101010000,2019,239001,2928500,3167501,COST
06033814101100000,2021,1538,0,1538,COST
06033814102010000,2021,1108,0,1108,COST
06033814102010000,2020,6181,0,6181,COST
06033814102010000,2019,6181,0,6181,COST
06033814103010000,2021,183484,235280,418764,COST
06033814104010000,2021,4463,0,4463,COST
06033814104100000,2021,4307,0,4307,COST
06033814104200000,2021,1110,0,1110,COST
06033814210010000,2021,8085,0,8085,COST
06033814210010000,2020,4343,0,4343,COST
06033814210010000,2019,4343,0,4343,COST
06033814220010000,2021,8085,0,8085,COST
06033814220010000,2020,4343,0,4343,COST
06033814220010000,2019,4343,0,4343,COST
06033814230010000,2021,183381,1181450,1364831,COST
06033814230010000,2020,120225,1046100,1166325,COST
06033814230010000,2019,120225,1046100,1166325,COST
06033814240010000,2021,8085,0,8085,COST
06033814240010000,2020,4343,0,4343,COST
06033814240010000,2019,4343,0,4343,COST
06033814250010000,2021,8252,0,8252,COST
06033814250010000,2020,4434,0,4434,COST
06033814250010000,2019,4434,0,4434,COST
06033814260010000,2021,8085,0,8085,COST
06033814260010000,2020,4343,0,4343,COST
06033814260010000,2019,4343,0,4343,COST
06033814270010000,2021,8085,0,8085,COST
06033814270010000,2020,4343,0,4343,COST
06033814270010000,2019,4343,0,4343,COST
06033814280010000,2021,8085,0,8085,COST
06033814280010000,2020,4343,0,4343,COST
06033814280010000,2019,4343,0,4343,COST
06033814310010000,2021,8085,0,8085,COST
06033814310010000,2020,4343,0,4343,COST
06033814310010000,2019,4343,0,4343,COST
06033814320010000,2021,183381,2115820,2299201,COST
06033814320010000,2020,120225,1789820,1910045,COST
06033814320010000,2019,120225,1789820,1910045,COST
06033814330010000,2021,8085,0,8085,COST
06033814330010000,2020,4343,0,4343,COST
06033814330010000,2019,4343,0,4343,COST
06033814340010000,2021,8085,0,8085,COST
06033814340010000,2020,4343,0,4343,COST
06033814340010000,2019,4343,0,4343,COST
06033814350010000,2021,8085,0,8085,COST
06033814350010000,2020,4343,0,4343,COST
06033814350010000,2019,4343,0,4343,COST
06033814360010000,2021,8085,0,8085,COST
06033814360010000,2020,4343,0,4343,COST
06033814360010000,2019,4343,0,4343,COST
06033814370010000,2021,8085,0,8085,COST
06033814370010000,2020,4343,0,4343,COST
06033814370010000,2019,4343,0,4343,COST
06033814380010000,2021,8085,0,8085,COST
06033814380010000,2020,4343,0,4343,COST
06033814380010000,2019,4343,0,4343,COST
06033814401010000,2021,200129,1441020,1641149,COST
06033814401010000,2020,130220,1213220,1343440,COST
06033814401010000,2019,130220,1213220,1343440,COST
06033814410010000,2021,8085,0,8085,COST
06033814410010000,2020,4343,0,4343,COST
06033814410010000,2019,4343,0,4343,COST
06033814440010000,2021,1107,0,1107,COST
06033814440010000,2020,1030,0,1030,COST
06033814440010000,2019,1030,0,1030,COST
06033814460010000,2021,1107,0,1107,COST
06033814460010000,2020,1030,0,1030,COST
06033814460010000,2019,1030,0,1030,COST
06033815280010000,2021,66765,0,66765,COST
06033815280010000,2020,35880,0,35880,COST
06033815280010000,2019,35880,0,35880,COST
06033815330010000,2021,66975,0,66975,COST
06033815330010000,2020,35995,0,35995,COST
06033815330010000,2019,35995,0,35995,COST
06033815410010000,2021,73869,0,73869,COST
06033815410010000,2020,39770,0,39770,COST
06033815410010000,2019,39770,0,39770,COST
06033816101010000,2021,64585,0,64585,COST
06033816101010000,2020,34858,0,34858,COST
06033816101010000,2019,34858,0,34858,COST
06033816201010000,2021,64708,0,64708,COST
06033816201010000,2020,34755,0,34755,COST
06033816201010000,2019,34755,0,34755,COST
06033816301010000,2021,64688,0,64688,COST
06033816301010000,2020,34744,0,34744,COST
06033816301010000,2019,34744,0,34744,COST
06033816401010000,2021,555589,6937560,7493149,COST
06033816401010000,2020,442169,1688780,2130949,COST
06033816401010000,2019,34803,0,34803,COST
06033821101010000,2021,346451,3329010,3675461,COST
06033821101010000,2020,54943,0,54943,COST
06033821101010000,2019,54943,0,54943,COST
06033821201010000,2021,125148,0,125148,COST
06033821201010000,2020,67218,0,67218,COST
06033821201010000,2019,67218,0,67218,COST
06033822101010000,2021,68854,0,68854,COST
06033822101010000,2020,37021,0,37021,COST
06033822101010000,2019,37021,0,37021,COST
06033822201010000,2021,62860,0,62860,COST
06033822201010000,2020,33852,0,33852,COST
06033822201010000,2019,33852,0,33852,COST
06033822301010000,2021,58792,0,58792,COST
06033822301010000,2020,31672,0,31672,COST
06033822301010000,2019,31672,0,31672,COST
06033822401010000,2021,59729,0,59729,COST
06033822401010000,2020,32825,0,32825,COST
06033822401010000,2019,32825,0,32825,COST
06033823110010000,2021,4891,0,4891,COST
06033823110010000,2020,2826,0,2826,COST
06033823110010000,2019,2826,0,2826,COST
06033823120010000,2021,4926,0,4926,COST
06033823120010000,2020,2842,0,2842,COST
06033823120010000,2019,2842,0,2842,COST
06033823130010000,2021,8085,0,8085,COST
06033823130010000,2020,4343,0,4343,COST
06033823130010000,2019,4343,0,4343,COST
06033823140010000,2021,182856,3921510,4104366,COST
06033823140010000,2020,119976,3261360,3381336,COST
06033823140010000,2019,119976,3261360,3381336,COST
06033823150010000,2021,8085,0,8085,COST
06033823150010000,2020,4343,0,4343,COST
06033823150010000,2019,4343,0,4343,COST
06033823160010000,2021,8085,0,8085,COST
06033823160010000,2020,4343,0,4343,COST
06033823160010000,2019,4343,0,4343,COST
06033823170010000,2021,8085,0,8085,COST
06033823170010000,2020,4343,0,4343,COST
06033823170010000,2019,4343,0,4343,COST
06033823180010000,2021,1107,0,1107,COST
06033823180010000,2020,1030,0,1030,COST
06033823180010000,2019,1030,0,1030,COST
06033823210010000,2021,8085,0,8085,COST
06033823210010000,2020,4343,0,4343,COST
06033823210010000,2019,4343,0,4343,COST
06033823220010000,2021,8085,0,8085,COST
06033823220010000,2020,4343,0,4343,COST
06033823220010000,2019,4343,0,4343,COST
06033823230010000,2021,8085,0,8085,COST
06033823230010000,2020,4343,0,4343,COST
06033823230010000,2019,4343,0,4343,COST
06033823240010000,2021,5854,0,5854,COST
06033823240010000,2020,3283,0,3283,COST
06033823240010000,2019,3283,0,3283,COST
06033823250010000,2021,8085,0,8085,COST
06033823250010000,2020,4343,0,4343,COST
06033823250010000,2019,4343,0,4343,COST
06033823260010000,2021,8085,0,8085,COST
06033823260010000,2020,4343,0,4343,COST
06033823260010000,2019,4343,0,4343,COST
06033823270010000,2021,8085,0,8085,COST
06033823270010000,2020,4343,0,4343,COST
06033823270010000,2019,4343,0,4343,COST
06033823280010000,2021,8085,0,8085,COST
06033823280010000,2020,4343,0,4343,COST
06033823280010000,2019,4343,0,4343,COST
06033823310010000,2021,1107,0,1107,COST
06033823310010000,2020,1030,0,1030,COST
06033823310010000,2019,1030,0,1030,COST
06033823320010000,2021,7699,0,7699,COST
06033823320010000,2020,4160,0,4160,COST
06033823320010000,2019,4160,0,4160,COST
06033823330010000,2021,1107,0,1107,COST
06033823330010000,2020,1030,0,1030,COST
06033823330010000,2019,1030,0,1030,COST
06033823340010000,2021,1107,0,1107,COST
06033823340010000,2020,1030,0,1030,COST
06033823340010000,2019,1030,0,1030,COST
06033823350010000,2021,8085,0,8085,COST
06033823350010000,2020,4343,0,4343,COST
06033823350010000,2019,4343,0,4343,COST
06033823360010000,2021,6777,0,6777,COST
06033823360010000,2020,3724,0,3724,COST
06033823360010000,2019,3724,0,3724,COST
06033823370010000,2021,2483,0,2483,COST
06033823370010000,2020,1684,0,1684,COST
06033823370010000,2019,1684,0,1684,COST
06033823380010000,2021,7509,0,7509,COST
06033823380010000,2020,4069,0,4069,COST
06033823380010000,2019,4069,0,4069,COST
06033823410010000,2021,1107,0,1107,COST
06033823410010000,2020,1030,0,1030,COST
06033823410010000,2019,1030,0,1030,COST
06033823420010000,2021,1107,0,1107,COST
06033823420010000,2020,1030,0,1030,COST
06033823420010000,2019,1030,0,1030,COST
06033823430010000,2021,6858,0,6858,COST
06033823430010000,2020,3759,0,3759,COST
06033823430010000,2019,3759,0,3759,COST
06033823440010000,2021,7415,0,7415,COST
06033823440010000,2020,4024,0,4024,COST
06033823440010000,2019,4024,0,4024,COST
06033823450010000,2021,176752,2556960,2733712,COST
06033823450010000,2020,117079,2123070,2240149,COST
06033823450010000,2019,117079,2123070,2240149,COST
06033823460010000,2021,176752,2734730,2911482,COST
06033823460010000,2020,117079,2266360,2383439,COST
06033823460010000,2019,117079,2266360,2383439,COST
06033823470010000,2021,1107,0,1107,COST
06033823470010000,2020,1030,0,1030,COST
06033823470010000,2019,1030,0,1030,COST
06033823480010000,2021,176752,1661200,1837952,COST
06033823480010000,2020,117079,1406200,1523279,COST
06033823480010000,2019,117079,1406200,1523279,COST
06033824110010000,2021,3101,0,3101,COST
06033824110010000,2020,1977,0,1977,COST
06033824110010000,2019,1977,0,1977,COST
06033824120010000,2021,1107,0,1107,COST
06033824120010000,2020,1030,0,1030,COST
06033824120010000,2019,1030,0,1030,COST
06033824140010000,2021,13330,0,13330,COST
06033824140010000,2020,7369,0,7369,COST
06033824140010000,2019,7369,0,7369,COST
06033824150010000,2021,1107,0,1107,COST
06033824150010000,2020,2563,0,2563,COST
06033824150010000,2019,2563,0,2563,COST
06033824160010000,2021,1107,0,1107,COST
06033824160010000,2020,2351,0,2351,COST
06033824160010000,2019,2351,0,2351,COST
06033824180010000,2021,11429,0,11429,COST
06033824180010000,2020,6491,0,6491,COST
06033824180010000,2019,6491,0,6491,COST
06033824230010000,2021,2053,0,2053,COST
06033824230010000,2020,1911,0,1911,COST
06033824230010000,2019,1911,0,1911,COST
06033824240010000,2021,181914,1166260,1348174,COST
06033824240010000,2020,119529,974380,1093909,COST
06033824240010000,2019,119529,974380,1093909,COST
06033824250010000,2021,354610,7108600,7463210,COST
06033824250010000,2020,235188,5773370,6008558,COST
06033824250010000,2019,235188,5773370,6008558,COST
06033824270010000,2021,2319,0,2319,COST
06033824270010000,2020,2158,0,2158,COST
06033824270010000,2019,2158,0,2158,COST
06033824310010000,2021,5324,0,5324,COST
06033824310010000,2020,3032,0,3032,COST
06033824310010000,2019,3032,0,3032,COST
06033824320010000,2021,4276,0,4276,COST
06033824320010000,2020,2572,0,2572,COST
06033824320010000,2019,2572,0,2572,COST
06033824330010000,2021,10339,0,10339,COST
06033824330010000,2020,5605,0,5605,COST
06033824330010000,2019,5605,0,5605,COST
06033824340010000,2021,185256,874870,1060126,COST
06033824340010000,2020,121252,749710,870962,COST
06033824340010000,2019,121252,749710,870962,COST
06033824350010000,2021,176752,3366800,3543552,COST
06033824350010000,2020,117079,2841320,2958399,COST
06033824350010000,2019,117079,2841320,2958399,COST
06033824360010000,2021,176752,3701110,3877862,COST
06033824360010000,2020,117079,4182921,4300000,OVR
06033824360010000,2019,117079,4182921,4300000,OVR
06033824370010000,2021,176757,1276290,1453047,COST
06033824370010000,2020,117083,1172600,1289683,COST
06033824370010000,2019,117083,1172600,1289683,COST
06033824380010000,2021,1114,0,1114,COST
06033824380010000,2020,1036,0,1036,COST
06033824380010000,2019,1036,0,1036,COST
06033824410010000,2021,8425,0,8425,COST
06033824410010000,2020,4528,0,4528,COST
06033824410010000,2019,4528,0,4528,COST
06033824420010000,2021,1638,0,1638,COST
06033824420010000,2020,1524,0,1524,COST
06033824420010000,2019,1524,0,1524,COST
06033824440010000,2021,188973,1150950,1339923,COST
06033824440010000,2020,123339,978620,1101959,COST
06033824440010000,2019,123339,978620,1101959,COST
06033824450010000,2021,8085,0,8085,COST
06033824450010000,2020,4343,0,4343,COST
06033824450010000,2019,4343,0,4343,COST
06033824460010000,2021,8514,0,8514,COST
06033824460010000,2020,4626,0,4626,COST
06033824460010000,2019,4626,0,4626,COST
06033824480010000,2021,191986,416970,608956,COST
06033824480010000,2020,125089,349540,474629,COST
06033824480010000,2019,125089,353590,478679,COST
06033825110010000,2021,183245,780700,963945,COST
06033825110010000,2020,120153,677720,797873,OVR
06033825110010000,2019,120153,677720,797873,COST
06033825120010000,2021,8312,0,8312,COST
06033825120010000,2020,4941,0,4941,COST
06033825120010000,2019,4941,0,4941,COST
06033825140010000,2021,7991,0,7991,COST
06033825140010000,2020,4292,0,4292,COST
06033825140010000,2019,4292,0,4292,COST
06033825150010000,2021,7931,0,7931,COST
06033825150010000,2020,4260,0,4260,COST
06033825150010000,2019,4260,0,4260,COST
06033825160010000,2021,440505,0,440505,COST
06033825160010000,2020,333821,0,333821,COST
06033825160010000,2019,333821,0,333821,COST
06033825170010000,2021,183304,1201580,1384884,COST
06033825170010000,2020,120188,1002980,1123168,COST
06033825170010000,2019,120188,1002980,1123168,COST
06033825180010000,2021,183272,1141650,1324922,COST
06033825180010000,2020,120167,956040,1076207,COST
06033825180010000,2019,120167,956040,1076207,COST
06033825210010000,2021,183287,852790,1036077,COST
06033825210010000,2020,119994,716830,836824,COST
06033825210010000,2019,119994,716830,836824,COST
06033825220010000,2021,7995,0,7995,COST
06033825220010000,2020,4294,0,4294,COST
06033825220010000,2019,334548,0,334548,COST
06033825230010000,2021,7999,0,7999,COST
06033825230010000,2020,4296,0,4296,COST
06033825230010000,2019,4296,0,4296,COST
06033825240010000,2021,183299,2126340,2309639,COST
06033825240010000,2020,120182,1472550,1592732,COST
06033825240010000,2019,120182,690260,810442,COST
06033825250010000,2021,183302,681740,865042,COST
06033825250010000,2020,119606,569490,689096,COST
06033825250010000,2019,119606,569490,689096,COST
06033825260010000,2021,8010,0,8010,COST
06033825260010000,2020,4302,0,4302,COST
06033825260010000,2019,4302,0,4302,COST
06033825270010000,2021,183310,614070,797380,COST
06033825270010000,2020,120187,519580,639767,COST
06033825270010000,2019,120187,519580,639767,COST
06033825280010000,2021,183314,1930210,2113524,COST
06033825280010000,2020,120190,1632810,1753000,COST
06033825280010000,2019,120190,1755170,1875360,COST
06033825310010000,2021,16127,0,16127,COST
06033825310010000,2020,8662,0,8662,COST
06033825310010000,2019,8662,0,8662,COST
06033825320010000,2021,16119,0,16119,COST
06033825320010000,2020,8658,0,8658,COST
06033825320010000,2019,8658,0,8658,COST
06033825330010000,2021,191408,2191430,2382838,COST
06033825330010000,2020,124537,1802710,1927247,COST
06033825330010000,2019,124537,1352040,1476577,COST
06033825340010000,2021,191440,2495640,2687080,COST
06033825340010000,2020,124554,2116760,2241314,COST
06033825340010000,2019,124554,2116760,2241314,COST
06033825350010000,2021,8072,0,8072,COST
06033825350010000,2020,4336,0,4336,COST
06033825350010000,2019,4336,0,4336,COST
06033825360010000,2021,8072,0,8072,COST
06033825360010000,2020,4336,0,4336,COST
06033825360010000,2019,4336,0,4336,COST
06033825370010000,2021,183368,1027710,1211078,COST
06033825370010000,2020,120219,841200,961419,COST
06033825370010000,2019,120219,833290,953509,COST
06033825380010000,2021,16104,0,16104,COST
06033825380010000,2020,8649,0,8649,COST
06033825380010000,2019,8649,0,8649,COST
06033825410010000,2021,16056,0,16056,COST
06033825410010000,2020,8624,0,8624,COST
06033825410010000,2019,8624,0,8624,COST
06033825420010000,2021,16049,0,16049,COST
06033825420010000,2020,8620,0,8620,COST
06033825420010000,2019,8620,0,8620,COST
06033825430010000,2021,16042,0,16042,COST
06033825430010000,2020,8616,0,8616,COST
06033825430010000,2019,8616,0,8616,COST
06033825440010000,2021,16033,0,16033,COST
06033825440010000,2020,8611,0,8611,COST
06033825440010000,2019,8611,0,8611,COST
06033825460010000,2021,16060,0,16060,COST
06033825460010000,2020,8626,0,8626,COST
06033825460010000,2019,8626,0,8626,COST
06033825480010000,2021,183324,1372220,1555544,COST
06033825480010000,2020,120195,1211810,1332005,COST
06033825480010000,2019,120195,1211810,1332005,COST
06033826110010000,2021,8085,0,8085,COST
06033826110010000,2020,4343,0,4343,COST
06033826110010000,2019,4343,0,4343,COST
06033826120010000,2021,8085,0,8085,COST
06033826120010000,2020,4343,0,4343,COST
06033826120010000,2019,4343,0,4343,COST
06033826130010000,2021,183381,1486680,1670061,COST
06033826130010000,2020,120225,1237080,1357305,COST
06033826130010000,2019,120225,1237080,1357305,COST
06033826140010000,2021,8085,0,8085,COST
06033826140010000,2020,4036,0,4036,COST
06033826140010000,2019,4036,0,4036,COST
06033826150010000,2021,183381,2953260,3136641,COST
06033826150010000,2020,120225,2429510,2549735,COST
06033826150010000,2019,120225,2429510,2549735,COST
06033826160010000,2021,5642,0,5642,COST
06033826160010000,2020,3073,0,3073,COST
06033826160010000,2019,3073,0,3073,COST
06033826170010000,2021,5618,0,5618,COST
06033826170010000,2020,3060,0,3060,COST
06033826170010000,2019,3060,0,3060,COST
06033826180010000,2021,6871,0,6871,COST
06033826180010000,2020,3706,0,3706,COST
06033826180010000,2019,3706,0,3706,COST
06033826210010000,2021,6680,0,6680,COST
06033826210010000,2020,3605,0,3605,COST
06033826210010000,2019,3605,0,3605,COST
06033826220010000,2021,7037,0,7037,COST
06033826220010000,2020,3798,0,3798,COST
06033826220010000,2019,3798,0,3798,COST
06033826230010000,2021,6809,0,6809,COST
06033826230010000,2020,3680,0,3680,COST
06033826230010000,2019,3680,0,3680,COST
06033826240010000,2021,8085,0,8085,COST
06033826240010000,2020,4343,0,4343,COST
06033826240010000,2019,4343,0,4343,COST
06033826250010000,2021,176752,1239740,1416492,COST
06033826250010000,2020,117079,1060390,1177469,COST
06033826250010000,2019,117079,1060390,1177469,COST
06033826260010000,2021,176752,3112930,3289682,COST
06033826260010000,2020,117079,2624520,2741599,COST
06033826260010000,2019,117079,2624520,2741599,COST
06033826270010000,2021,176752,3005430,3182182,COST
06033826270010000,2020,117079,1999200,2116279,COST
06033826270010000,2019,117079,1999200,2116279,COST
06033826280010000,2021,8085,0,8085,COST
06033826280010000,2020,4343,0,4343,COST
06033826280010000,2019,4343,0,4343,COST
06033826310010000,2021,22344,0,22344,COST
06033826310010000,2020,12626,0,12626,COST
06033826310010000,2019,12626,0,12626,COST
06033826330010000,2021,12096,0,12096,COST
06033826330010000,2020,6751,0,6751,COST
06033826330010000,2019,6751,0,6751,COST
06033826340010000,2021,365535,2188500,2554035,COST
06033826340010000,2020,239874,1867650,2107524,COST
06033826340010000,2019,239874,1867650,2107524,COST
06033826350010000,2021,6794,0,6794,COST
06033826350010000,2020,3664,0,3664,COST
06033826350010000,2019,3664,0,3664,COST
06033826360010000,2021,4207,0,4207,COST
06033826360010000,2020,2304,0,2304,COST
06033826360010000,2019,2304,0,2304,COST
06033826370010000,2021,5966,0,5966,COST
06033826370010000,2020,3228,0,3228,COST
06033826370010000,2019,3228,0,3228,COST
06033826380010000,2021,6826,0,6826,COST
06033826380010000,2020,3687,0,3687,COST
06033826380010000,2019,3687,0,3687,COST
06033826410010000,2021,16174,0,16174,COST
06033826410010000,2020,8687,0,8687,COST
06033826410010000,2019,8687,0,8687,COST
06033826420010000,2021,16158,0,16158,COST
06033826420010000,2020,8678,0,8678,COST
06033826420010000,2019,8678,0,8678,COST
06033826430010000,2021,16186,0,16186,COST
06033826430010000,2020,8694,0,8694,COST
06033826430010000,2019,8694,0,8694,COST
06033826440010000,2021,16158,0,16158,COST
06033826440010000,2020,8678,0,8678,COST
06033826440010000,2019,8678,0,8678,COST
06033826450010000,2021,8101,0,8101,COST
06033826450010000,2020,4351,0,4351,COST
06033826450010000,2019,4351,0,4351,COST
06033826460010000,2021,183393,1778850,1962243,COST
06033826460010000,2020,120232,1520040,1640272,COST
06033826460010000,2019,120232,1520040,1640272,COST
06033826470010000,2021,8085,0,8085,COST
06033826470010000,2020,4343,0,4343,COST
06033826470010000,2019,4343,0,4343,COST
06033826480010000,2021,183381,1014100,1197481,COST
06033826480010000,2020,4343,0,4343,COST
06033826480010000,2019,4343,0,4343,COST
06033827101010000,2021,54123,0,54123,COST
06033827101010000,2020,29812,0,29812,COST
06033827101010000,2019,29812,0,29812,COST
06033827201010000,2021,117919,0,117919,COST
06033827201010000,2020,63455,0,63455,COST
06033827201010000,2019,63455,0,63455,COST
06033827401010000,2021,56891,0,56891,COST
06033827401010000,2020,30687,0,30687,COST
06033827401010000,2019,30687,0,30687,COST
06033828101010000,2021,168644,0,168644,COST
06033828101010000,2020,91595,0,91595,COST
06033828101010000,2019,91595,0,91595,COST
06033833101010000,2021,176584,0,176584,COST
06033833101010000,2020,95780,0,95780,COST
06033833101010000,2019,95780,0,95780,COST
06033834101010000,2021,164641,0,164641,COST
06033834101010000,2020,90006,0,90006,COST
06033834101010000,2019,90006,0,90006,COST
06033835301010000,2021,146959,0,146959,COST
06033835301010000,2020,79791,0,79791,COST
06033835301010000,2019,79791,0,79791,COST
06033836101010000,2021,93519,0,93519,COST
06033836101010000,2020,54870,0,54870,COST
06033836101010000,2019,54870,0,54870,COST
06033901101010000,2021,187915,0,187915,COST
06033901101010000,2020,101558,0,101558,COST
06033901101010000,2019,101558,0,101558,COST
06033902101010000,2021,249411,0,249411,COST
06033902101010000,2020,134038,0,134038,COST
06033902101010000,2019,134038,0,134038,COST
06033903101010000,2021,195000,0,195000,COST
06033903101010000,2020,104760,0,104760,COST
06033903101010000,2019,104760,0,104760,COST
06033903301010000,2021,65000,0,65000,COST
06033903301010000,2020,34920,0,34920,COST
06033903301010000,2019,34920,0,34920,COST
06033904101010000,2021,193392,0,193392,COST
06033904101010000,2020,104009,0,104009,COST
06033904101010000,2019,104009,0,104009,COST
06033904101060000,2021,1498,0,1498,COST
06033904101060000,2020,1394,0,1394,COST
06033904101060000,2019,1394,0,1394,COST
06033904301010000,2021,520509,0,520509,COST
06033904301010000,2020,772434,0,772434,COST
06033904301010000,2019,772434,0,772434,COST
06033904301020000,2021,416677,241920,658597,COST
06033904301020000,2020,598177,180700,778877,COST
06033904301020000,2019,598177,180700,778877,COST
06033904301040000,2021,395184,1485520,1880704,COST
06033904301040000,2020,562860,1184850,1747710,COST
06033904301040000,2019,562860,1184850,1747710,COST
06033904301200000,2021,1789,0,1789,COST
06033904301200000,2020,1667,0,1667,COST
06033904301200000,2019,1667,0,1667,COST
06033904301300000,2021,11,0,11,COST
06033904301300000,2020,10,0,10,COST
06033904301300000,2019,10,0,10,COST
06033905101020000,2021,855645,409190,1264835,COST
06033905101020000,2020,538987,359760,898747,COST
06033905101020000,2019,619124,391530,1010654,COST
06033905101040000,2021,374979,524900,899879,COST
06033905101040000,2020,529920,551910,1081830,COST
06033905101040000,2019,529920,551910,1081830,COST
06033905101060000,2021,487569,228831,716400,INCOME
06033905101060000,2020,404386,245914,650300,INCOME
06033905101060000,2019,404386,245914,650300,INCOME
06033905101100000,2021,512919,559400,1072319,COST
06033905101100000,2020,759506,391820,1151326,COST
06033905101100000,2019,759506,391820,1151326,COST
06033905101110000,2021,465720,0,465720,COST
06033905101110000,2020,373864,0,373864,COST
06033905101110000,2019,373864,0,373864,COST
06033905101120000,2021,438943,446430,885373,COST
06033905101120000,2020,358399,615301,973700,INCOME
06033905101120000,2019,358399,615301,973700,INCOME
06033905101130000,2021,587539,654300,1241839,COST
06033905101130000,2020,260713,555160,815873,COST
06033905101130000,2019,260713,555160,815873,COST
06033905101147000,2021,347619,11130,358749,COST
06033905101147000,2020,274133,10780,284913,COST
06033905101147000,2019,274133,10780,284913,COST
06033905101150000,2021,281116,502090,783206,COST
06033905101150000,2020,237909,432230,670139,COST
06033905101150000,2019,237909,432230,670139,COST
06033905101160000,2021,629155,1113590,1742745,COST
06033905101160000,2020,542029,1009770,1551799,COST
06033905101160000,2019,542029,1009770,1551799,COST
06033905101260000,2021,314581,126800,441381,COST
06033905101260000,2020,244414,85686,330100,INCOME
06033905101260000,2019,244414,85686,330100,INCOME
06033905101300000,2021,310672,75428,386100,INCOME
06033905101300000,2020,249076,39424,288500,INCOME
06033905101300000,2019,249076,39424,288500,INCOME
06033905101310000,2021,304425,675920,980345,COST
06033905101310000,2020,260713,528530,789243,COST
06033905101310000,2019,260713,528530,789243,COST
06033905101320000,2021,323396,295004,618400,INCOME
06033905101320000,2020,252300,305200,557500,INCOME
06033905101320000,2019,252300,305200,557500,INCOME
06033905102010000,2021,1017658,542460,1560118,COST
06033905102010000,2020,490103,460170,950273,COST
06033905102010000,2019,490103,460170,950273,COST
06033905102030000,2021,26645,0,26645,COST
06033905102030000,2020,19012,0,19012,COST
06033905102030000,2019,19012,0,19012,COST
06033905105017000,2021,321559,169340,490899,COST
06033905105017000,2020,250654,171520,422174,COST
06033905105017000,2019,250654,171520,422174,COST
06033905105020000,2021,402421,936180,1338601,COST
06033905105020000,2020,324351,1027540,1351891,COST
06033905105020000,2019,324351,1027540,1351891,COST
06033905105040000,2021,322529,1150,323679,COST
06033905105040000,2020,251523,1290,252813,COST
06033905105040000,2019,251523,1290,252813,COST
06033905105050000,2021,325399,0,325399,COST
06033905105050000,2020,254096,0,254096,COST
06033905105050000,2019,254096,0,254096,COST
06033905105060000,2021,330060,1790,331850,COST
06033905105060000,2020,258283,2030,260313,COST
06033905105060000,2019,258283,2030,260313,COST
06033905105070000,2021,251498,0,251498,COST
06033905105070000,2020,188990,0,188990,COST
06033905105070000,2019,188990,0,188990,COST
06033905105080000,2021,298677,0,298677,COST
06033905105080000,2020,230270,0,230270,COST
06033905105080000,2019,230270,0,230270,COST
06033905105100000,2021,210188,0,210188,COST
06033905105100000,2020,158980,0,158980,COST
06033905105100000,2019,158980,0,158980,COST
06033905105110000,2021,65726,0,65726,COST
06033905105110000,2020,53655,0,53655,COST
06033905105110000,2019,53655,0,53655,COST
06033905105120000,2021,69839,0,69839,COST
06033905105120000,2020,57531,0,57531,COST
06033905105120000,2019,57531,0,57531,COST
06033905105130000,2021,208866,0,208866,COST
06033905105130000,2020,169107,0,169107,COST
06033905105130000,2019,169107,0,169107,COST
06033905105140000,2021,198465,0,198465,COST
06033905105140000,2020,159467,0,159467,COST
06033905105140000,2019,159467,0,159467,COST
06033905201010000,2021,882088,0,882088,COST
06033905201010000,2020,704973,0,704973,COST
06033905201010000,2019,704973,0,704973,COST
06033905201200000,2021,69744,0,69744,COST
06033905201200000,2020,37836,0,37836,COST
06033905201200000,2019,37836,0,37836,COST
06033905301010000,2021,41140,0,41140,COST
06033905301010000,2020,37993,0,37993,COST
06033905301010000,2019,37993,0,37993,COST
06033905302010000,2021,488485,722530,1211015,COST
06033905302010000,2020,262350,720950,983300,INCOME
06033905302010000,2019,262350,720950,983300,INCOME
06033905302030000,2021,468051,955200,1423251,COST
06033905302030000,2020,249780,1005320,1255100,INCOME
06033905302030000,2019,249780,1005320,1255100,INCOME
06033905302050000,2021,464154,965760,1429914,COST
06033905302050000,2020,247391,905509,1152900,INCOME
06033905302050000,2019,247391,0,247391,COST
06033905302070000,2021,456736,0,456736,COST
06033905302070000,2020,242854,0,242854,COST
06033905302070000,2019,242854,0,242854,COST
06033905302096500,2021,97469,0,97469,COST
06033905302096500,2020,62352,0,62352,COST
06033905302096500,2019,62352,0,62352,COST
06033905303010000,2021,327841,0,327841,COST
06033905303010000,2020,256289,0,256289,COST
06033905303010000,2019,256289,0,256289,COST
06033905303030000,2021,314479,750820,1065299,COST
06033905303030000,2020,244323,611677,856000,INCOME
06033905303030000,2019,244323,611677,856000,INCOME
06033905303050000,2021,314479,745960,1060439,COST
06033905303050000,2020,244323,611677,856000,INCOME
06033905303050000,2019,244323,611677,856000,INCOME
06033905303070000,2021,314989,1111090,1426079,COST
06033905303070000,2020,244778,636680,881458,COST
06033905303070000,2019,244778,0,244778,COST
06033905303090000,2021,341706,89540,431246,COST
06033905303090000,2020,268782,93760,362542,COST
06033905303090000,2019,268782,93760,362542,COST
06033905303110000,2021,347619,96181,443800,INCOME
06033905303110000,2020,274133,117067,391200,INCOME
06033905303110000,2019,274133,0,274133,COST
06033905303137000,2021,347619,106480,454099,COST
06033905303137000,2020,274133,109920,384053,COST
06033905303137000,2019,274133,109920,384053,COST
06033905304010000,2021,366465,0,366465,COST
06033905304010000,2020,291279,0,291279,COST
06033905304010000,2019,291279,0,291279,COST
06033905304030000,2021,355816,0,355816,COST
06033905304030000,2020,281574,0,281574,COST
06033905304030000,2019,281574,0,281574,COST
06033905304057000,2021,338098,64760,402858,COST
06033905304057000,2020,265523,62040,327563,COST
06033905304057000,2019,265523,0,265523,COST
06033905304070000,2021,373916,1305384,1679300,INCOME
06033905304070000,2020,298094,136980,435074,COST
06033905304070000,2019,298094,0,298094,COST
06033905304097000,2021,371610,0,371610,COST
06033905304097000,2020,295983,0,295983,COST
06033905304097000,2019,295983,0,295983,COST
06033905304150000,2021,2250,0,2250,COST
06033905305010000,2021,188938,0,188938,COST
06033905305040000,2021,193386,234980,428366,COST
06033905305070000,2021,189863,0,189863,COST
06033905305100000,2021,194661,0,194661,COST
06033905305130000,2021,199357,426080,625437,COST
06033905305160000,2021,200771,926170,1126941,COST
06033905305190000,2021,196616,0,196616,COST
06033905305220000,2021,204175,0,204175,COST
06033905305250000,2021,209188,0,209188,COST
06033905305280000,2021,198756,926890,1125646,COST
06033905305310000,2021,186187,0,186187,COST
06033905305340000,2021,207730,0,207730,COST
06033905305370000,2021,206525,0,206525,COST
06033905305400000,2021,207695,0,207695,COST
06033905305430000,2021,202344,0,202344,COST
06033905305466500,2021,1931,0,1931,COST
06033905305490000,2021,113172,0,113172,COST
06033905305520000,2021,33,0,33,COST
06033905440320000,2021,498400,10300,508700,INCOME
06033905440320000,2020,414725,80840,495565,COST
06033905440320000,2019,414725,80840,495565,COST
06033905440400000,2021,463269,308430,771699,COST
06033905440400000,2020,381315,159985,541300,INCOME
06033905440400000,2019,381315,159985,541300,INCOME
06033905440450000,2021,449048,3741352,4190400,INCOME
06033905440450000,2020,367896,3760304,4128200,INCOME
06033905440450000,2019,367896,3760304,4128200,INCOME
06033906101200000,2021,256430,1014670,1271100,COST
06033906101200000,2020,209633,849870,1059503,COST
06033906101200000,2019,209633,1188710,1398343,COST
06033906101300000,2021,10098,0,10098,COST
06033906101300000,2020,5429,0,5429,COST
06033906101300000,2019,5429,0,5429,COST
06033906101400000,2021,8307,0,8307,COST
06033906101400000,2020,4452,0,4452,COST
06033906101400000,2019,4452,0,4452,COST
06033906101500000,2021,11113,0,11113,COST
06033906101500000,2020,5999,0,5999,COST
06033906101500000,2019,5999,0,5999,COST
06033906101600000,2021,10984,0,10984,COST
06033906101600000,2020,5929,0,5929,COST
06033906101600000,2019,5929,0,5929,COST
06033906101700000,2021,9207,0,9207,COST
06033906101700000,2020,5092,0,5092,COST
06033906101700000,2019,5092,0,5092,COST
06033906101800000,2021,501354,2567210,3068564,COST
06033906101800000,2020,209283,2111820,2321103,COST
06033906101800000,2019,209283,1836020,2045303,COST
06033906101900000,2021,1118,0,1118,COST
06033906101900000,2020,1041,0,1041,COST
06033906101900000,2019,1041,0,1041,COST
06033906201010000,2021,255903,2267220,2523123,COST
06033906201010000,2020,204939,1922980,2127919,COST
06033906201010000,2019,204939,1922980,2127919,COST
06033906201090000,2021,11230,0,11230,COST
06033906201090000,2020,5899,0,5899,COST
06033906201090000,2019,5899,0,5899,COST
06033906201170000,2021,246907,1990340,2237247,COST
06033906201170000,2020,204930,1682110,1887040,COST
06033906201170000,2019,204930,1682110,1887040,COST
06033906201260000,2021,255393,2222230,2477623,COST
06033906201260000,2020,209074,1888060,2097134,COST
06033906201260000,2019,209074,1888060,2097134,COST
06033906201350000,2021,255683,2129410,2385093,COST
06033906201350000,2020,209255,1806840,2016095,COST
06033906201350000,2019,209255,1806840,2016095,COST
06033906201440000,2021,256005,1767660,2023665,COST
06033906201440000,2020,209393,1483820,1693213,COST
06033906201440000,2019,209393,1483820,1693213,COST
06033906201530000,2021,256164,5284860,5541024,COST
06033906201530000,2020,209512,4829110,5038622,COST
06033906201530000,2019,209512,4829110,5038622,COST
06033906201620000,2021,246907,1784660,2031567,COST
06033906201620000,2020,204930,1810040,2014970,COST
06033906201620000,2019,204930,1810040,2014970,COST
06033906201710000,2021,1162,0,1162,COST
06033906201710000,2020,1082,0,1082,COST
06033906201710000,2019,1082,0,1082,COST
06033906201800000,2021,256687,1881650,2138337,COST
06033906201800000,2020,209836,1590810,1800646,COST
06033906201800000,2019,209836,1258930,1468766,COST
06033906301010000,2021,1118,0,1118,COST
06033906301010000,2020,1041,0,1041,COST
06033906301010000,2019,1041,0,1041,COST
06033906301100000,2021,1118,0,1118,COST
06033906301100000,2020,1041,0,1041,COST
06033906301100000,2019,1041,0,1041,COST
06033906301200000,2021,350702,1198160,1548862,COST
06033906301200000,2020,245781,1000450,1246231,COST
06033906301200000,2019,245781,915580,1161361,COST
06033906301500000,2021,172163,1404500,1576663,COST
06033906301500000,2020,121589,634260,755849,COST
06033906301500000,2019,121589,752770,874359,COST
06033906301600000,2021,1118,0,1118,COST
06033906301600000,2020,1041,0,1041,COST
06033906301600000,2019,1041,0,1041,COST
06033906301700000,2021,10963,0,10963,COST
06033906301700000,2020,5931,0,5931,COST
06033906301700000,2019,5931,0,5931,COST
06033906401010000,2021,8069,0,8069,COST
06033906401010000,2020,4481,0,4481,COST
06033906401010000,2019,4481,0,4481,COST
06033906401120000,2021,181123,640510,821633,COST
06033906401120000,2020,126050,624770,750820,COST
06033906401120000,2019,126050,624770,750820,COST
06033906401240000,2021,1118,0,1118,COST
06033906401240000,2020,1041,0,1041,COST
06033906401240000,2019,1041,0,1041,COST
06033906401360000,2021,181583,1250690,1432273,COST
06033906401360000,2020,126259,1055050,1181309,COST
06033906401360000,2019,126259,1055050,1181309,COST
06033906430300000,2021,3014,0,3014,COST
06033906430300000,2020,2063,0,2063,COST
06033906430300000,2019,2063,0,2063,COST
06033906430400000,2021,1118,0,1118,COST
06033906430400000,2020,1041,0,1041,COST
06033906430400000,2019,1041,0,1041,COST
06033907101010000,2021,61061,0,61061,COST
06033907101010000,2020,41494,0,41494,COST
06033907101010000,2019,41494,0,41494,COST
06033907201010000,2021,88264,0,88264,COST
06033907201010000,2020,40593,0,40593,COST
06033907201010000,2019,40593,0,40593,COST
06033907301010000,2021,73075,0,73075,COST
06033907301010000,2020,43839,0,43839,COST
06033907301010000,2019,43839,0,43839,COST
06033907401010000,2021,79360,0,79360,COST
06033907401010000,2020,37878,0,37878,COST
06033907401010000,2019,37878,0,37878,COST
06033908101350000,2021,940457,6293743,7234200,INCOME
06033908101350000,2020,556898,4739602,5296500,INCOME
06033908101350000,2019,556898,4739602,5296500,INCOME
06033908101370000,2021,398563,587137,985700,INCOME
06033908101370000,2020,207662,648638,856300,INCOME
06033908101370000,2019,207662,648638,856300,INCOME
06033908101400000,2021,138811,1050,139861,COST
06033908101400000,2020,126676,1080,127756,COST
06033908101400000,2019,126676,1080,127756,COST
06033908101450000,2021,159577,1072770,1232347,COST
06033908101450000,2020,128526,936200,1064726,COST
06033908101450000,2019,128526,936200,1064726,COST
06033908102010000,2021,152199,393201,545400,MKT
06033908102010000,2020,114792,356108,470900,MKT
06033908102010000,2019,114792,356108,470900,MKT
06033908102030000,2021,141563,409137,550700,MKT
06033908102030000,2020,105623,389477,495100,MKT
06033908102030000,2019,105623,389477,495100,MKT
06033908102050000,2021,141563,377937,519500,MKT
06033908102050000,2020,105623,349377,455000,MKT
06033908102050000,2019,105623,349377,455000,MKT
06033908102070000,2021,141563,384637,526200,MKT
06033908102070000,2020,105623,337977,443600,MKT
06033908102070000,2019,105623,337977,443600,MKT
06033908102090000,2021,424515,269010,693525,COST
06033908102090000,2020,536877,258840,795717,COST
06033908102090000,2019,536877,258840,795717,COST
06033908102110000,2021,140707,373693,514400,MKT
06033908102110000,2020,104890,356010,460900,MKT
06033908102110000,2019,104890,356010,460900,MKT
06033908102130000,2021,140707,444693,585400,MKT
06033908102130000,2020,104890,372610,477500,MKT
06033908102130000,2019,104890,372610,477500,MKT
06033908102150000,2021,141733,431367,573100,MKT
06033908102150000,2020,105769,366931,472700,MKT
06033908102150000,2019,105769,366931,472700,MKT
06033908102170000,2021,141733,448567,590300,MKT
06033908102170000,2020,105769,375131,480900,MKT
06033908102170000,2019,105769,375131,480900,MKT
06033908102190000,2021,150590,460210,610800,MKT
06033908102190000,2020,113399,392401,505800,MKT
06033908102190000,2019,113399,392401,505800,MKT
06033908102210000,2021,145036,433664,578700,MKT
06033908102210000,2020,108606,425494,534100,MKT
06033908102210000,2019,108606,425494,534100,MKT
06033908102230000,2021,145036,416964,562000,MKT
06033908102230000,2020,108606,375894,484500,MKT
06033908102230000,2019,108606,375894,484500,MKT
06033908102250000,2021,145036,408064,553100,MKT
06033908102250000,2020,108606,393594,502200,MKT
06033908102250000,2019,108606,393594,502200,MKT
06033908102270000,2021,145036,427064,572100,MKT
06033908102270000,2020,108606,392994,501600,MKT
06033908102270000,2019,108606,392994,501600,MKT
06033908102290000,2021,138247,549653,687900,MKT
06033908102290000,2020,102785,455115,557900,MKT
06033908102290000,2019,102785,455115,557900,MKT
06033908102310000,2021,154193,481807,636000,MKT
06033908102310000,2020,116521,438779,555300,MKT
06033908102310000,2019,116521,438779,555300,MKT
06033908102330000,2021,142071,0,142071,COST
06033908102330000,2020,106059,0,106059,COST
06033908102330000,2019,106059,0,106059,COST
06033908102350000,2021,148485,703215,851700,MKT
06033908102350000,2020,111579,566321,677900,MKT
06033908102350000,2019,111579,566321,677900,MKT
06033908102370000,2021,162521,0,162521,COST
06033908102370000,2020,123781,0,123781,COST
06033908102370000,2019,123781,0,123781,COST
06033908102390000,2021,151618,375982,527600,MKT
06033908102390000,2020,114289,336311,450600,MKT
06033908102390000,2019,114289,336311,450600,MKT
06033908102410000,2021,152487,418313,570800,MKT
06033908102410000,2020,115042,406958,522000,MKT
06033908102410000,2019,115042,406958,522000,MKT
06033908102430000,2021,149396,427604,577000,MKT
06033908102430000,2020,112365,373335,485700,MKT
06033908102430000,2019,112365,373335,485700,MKT
06033908102450000,2021,152054,449046,601100,MKT
06033908102450000,2020,114666,399334,514000,MKT
06033908102450000,2019,114666,399334,514000,MKT
06033908103016500,2021,115106,0,115106,COST
06033908103016500,2020,99627,0,99627,COST
06033908103016500,2019,99627,0,99627,COST
06033908104010000,2021,181305,616195,797500,MKT
06033908104010000,2020,140358,385530,525888,COST
06033908104010000,2019,140358,385530,525888,COST
06033908104030000,2021,179927,712540,892467,COST
06033908104030000,2020,139132,586320,725452,COST
06033908104030000,2019,139132,586320,725452,COST
06033908104050000,2021,179927,545473,725400,MKT
06033908104050000,2020,139132,471768,610900,MKT
06033908104050000,2019,139132,471768,610900,MKT
06033908104070000,2021,168852,485048,653900,MKT
06033908104070000,2020,129338,447762,577100,MKT
06033908104070000,2019,129338,447762,577100,MKT
06033908104090000,2021,180422,726678,907100,MKT
06033908104090000,2020,139572,582928,722500,MKT
06033908104090000,2019,139572,582928,722500,MKT
06033908104110000,2021,170997,401503,572500,MKT
06033908104110000,2020,131228,383872,515100,MKT
06033908104110000,2019,131228,383872,515100,MKT
06033908104130000,2021,168966,427034,596000,MKT
06033908104130000,2020,129439,353361,482800,MKT
06033908104130000,2019,129439,353361,482800,MKT
06033908104150000,2021,162521,671079,833600,MKT
06033908104150000,2020,123781,619819,743600,MKT
06033908104150000,2019,123781,619819,743600,MKT
06033908104170000,2021,162521,0,162521,COST
06033908104170000,2020,123781,0,123781,COST
06033908104170000,2019,123781,0,123781,COST
06033908104190000,2021,157749,633751,791500,MKT
06033908104190000,2020,119615,529685,649300,MKT
06033908104190000,2019,119615,529685,649300,MKT
06033908105100000,2021,286673,3365800,3652473,COST
06033908105100000,2020,251932,2828790,3080722,COST
06033908105100000,2019,251932,2828790,3080722,COST
06033908105200000,2021,274862,0,274862,COST
06033908105200000,2020,240042,0,240042,COST
06033908105200000,2019,240042,0,240042,COST
06033908105300000,2021,268277,520430,788707,COST
06033908105300000,2020,233445,451440,684885,COST
06033908105300000,2019,233445,451440,684885,COST
06033908105400000,2021,267230,765700,1032930,COST
06033908105400000,2020,232399,575730,808129,OVR
06033908105400000,2019,232399,575730,808129,COST
06033908105496500,2021,77020,36590,113610,COST
06033908105496500,2020,62788,35610,98398,COST
06033908105496500,2019,62788,35610,98398,COST
06033908105500000,2021,312112,1250600,1562712,COST
06033908105500000,2020,262000,1052200,1314200,COST
06033908105500000,2019,262000,1052200,1314200,COST
06033908105560000,2021,194042,708658,902700,MKT
06033908105560000,2020,151746,803880,955626,COST
06033908105560000,2019,151746,803880,955626,COST
06033908105576500,2021,50560,0,50560,COST
06033908105576500,2020,38711,0,38711,COST
06033908105576500,2019,38711,0,38711,COST
06033908105580000,2021,187055,897870,1084925,COST
06033908105580000,2020,145485,812986,958471,MRA
06033908105580000,2019,145485,812986,958471,MRA
06033908105600000,2021,195538,637062,832600,MKT
06033908105600000,2020,153092,570608,723700,MKT
06033908105600000,2019,153092,570608,723700,MKT
06033908105620000,2021,198934,926266,1125200,MKT
06033908105620000,2020,156151,819710,975861,COST
06033908105620000,2019,156151,819710,975861,COST
06033908105640000,2021,198537,408963,607500,MKT
06033908105640000,2020,155792,390008,545800,MKT
06033908105640000,2019,155792,390008,545800,MKT
06033908105660000,2021,200740,569460,770200,MKT
06033908105660000,2020,157780,500220,658000,MKT
06033908105660000,2019,157780,500220,658000,MKT
06033908105680000,2021,188499,597401,785900,MKT
06033908105680000,2020,146776,551224,698000,MKT
06033908105680000,2019,146776,551224,698000,MKT
06033908105706500,2021,116096,0,116096,COST
06033908105706500,2020,100613,0,100613,COST
06033908105706500,2019,100613,0,100613,COST
06033908105760000,2021,163880,493420,657300,MKT
06033908105760000,2020,124972,488628,613600,MKT
06033908105760000,2019,124972,488628,613600,MKT
06033908106010000,2021,148179,1018760,1166939,COST
06033908106010000,2020,111315,841240,952555,COST
06033908106010000,2019,111315,836380,947695,COST
06033908106030000,2021,151618,761982,913600,MKT
06033908106030000,2020,114289,209420,323709,COST
06033908106030000,2019,114289,0,114289,COST
06033908109010000,2021,164002,394998,559000,MKT
06033908109010000,2020,125079,359921,485000,OVR
06033908109010000,2019,125079,359921,485000,MKT
06033908109030000,2021,158281,461380,619661,COST
06033908109030000,2020,120078,448680,568758,COST
06033908109030000,2019,120078,342430,462508,COST
06033908109050000,2021,158677,530923,689600,MKT
06033908109050000,2020,120423,473910,594333,OVR
06033908109050000,2019,120423,473910,594333,COST
06033908109070000,2021,157348,586370,743718,COST
06033908109070000,2020,119265,194910,314175,COST
06033908109070000,2019,119265,0,119265,COST
06033908109090000,2021,158148,400752,558900,MKT
06033908109090000,2020,119963,388137,508100,MKT
06033908109090000,2019,119963,388137,508100,MKT
06033908109110000,2021,152631,503069,655700,MKT
06033908109110000,2020,115166,419134,534300,MKT
06033908109110000,2019,115166,419134,534300,MKT
06033908109130000,2021,152631,1004520,1157151,COST
06033908109130000,2020,115166,726369,841535,MRA
06033908109130000,2019,115166,726369,841535,MRA
06033908109150000,2021,152343,0,152343,COST
06033908109150000,2020,114917,0,114917,COST
06033908109150000,2019,114917,0,114917,COST
06033908109170000,2021,159071,1017329,1176400,MKT
06033908109170000,2020,120767,674501,795268,OVR
06033908109170000,2019,120767,674501,795268,OVR
06033908109190000,2021,160880,0,160880,COST
06033908109190000,2020,122347,0,122347,COST
06033908109190000,2019,122347,0,122347,COST
06033908109210000,2021,164247,846953,1011200,MKT
06033908109210000,2020,125293,683610,808903,COST
06033908109210000,2019,125293,683610,808903,COST
06033908109230000,2021,164611,966889,1131500,MKT
06033908109230000,2020,125613,802187,927800,MKT
06033908109230000,2019,125613,404550,530163,COST
06033908109250000,2021,156809,622991,779800,MKT
06033908109250000,2020,118796,542904,661700,MKT
06033908109250000,2019,118796,542904,661700,MKT
06033908109270000,2021,156809,564791,721600,MKT
06033908109270000,2020,118796,483504,602300,MKT
06033908109270000,2019,118796,483504,602300,MKT
06033908109290000,2021,162645,665155,827800,MKT
06033908109290000,2020,123890,523910,647800,MKT
06033908109290000,2019,123890,523910,647800,MKT
06033908109310000,2021,159201,860570,1019771,COST
06033908109310000,2020,120881,659219,780100,MKT
06033908109310000,2019,120881,659219,780100,MKT
06033908109330000,2021,149396,676704,826100,MKT
06033908109330000,2020,112365,521935,634300,MKT
06033908109330000,2019,112365,509235,621600,MKT
06033908109350000,2021,159462,0,159462,COST
06033908109350000,2020,121109,0,121109,COST
06033908109350000,2019,121109,0,121109,COST
06033908109370000,2021,160880,704220,865100,MKT
06033908109370000,2020,122347,565853,688200,MKT
06033908109370000,2019,122347,565853,688200,MKT
06033908109390000,2021,168162,634538,802700,MKT
06033908109390000,2020,128731,489569,618300,MKT
06033908109390000,2019,128731,489569,618300,MKT
06033908109410000,2021,156674,375520,532194,COST
06033908109410000,2020,118679,399121,517800,MKT
06033908109410000,2019,118679,399121,517800,MKT
06033908109430000,2021,154891,730209,885100,MKT
06033908109430000,2020,117128,592372,709500,MKT
06033908109430000,2019,117128,592372,709500,MKT
06033908109450000,2021,154891,530509,685400,MKT
06033908109450000,2020,117128,447072,564200,MKT
06033908109450000,2019,117128,447072,564200,MKT
06033908109470000,2021,154891,725809,880700,MKT
06033908109470000,2020,117128,613172,730300,MKT
06033908109470000,2019,117128,613172,730300,MKT
06033908109490000,2021,160368,0,160368,COST
06033908109490000,2020,124541,0,124541,COST
06033908109490000,2019,124541,0,124541,COST
06033908109510000,2021,157348,677952,835300,MKT
06033908109510000,2020,119265,432935,552200,MKT
06033908109510000,2019,119265,432935,552200,MKT
06033908109530000,2021,156403,658997,815400,MKT
06033908109530000,2020,118442,521058,639500,MKT
06033908109530000,2019,118442,521058,639500,MKT
06033908109550000,2021,155582,488618,644200,MKT
06033908109550000,2020,117729,443371,561100,MKT
06033908109550000,2019,117729,443371,561100,MKT
06033908109570000,2021,161262,637838,799100,MKT
06033908109570000,2020,122680,584420,707100,MKT
06033908109570000,2019,122680,584420,707100,MKT
06033908210010000,2021,1107,0,1107,COST
06033908210010000,2020,1030,0,1030,COST
06033908210010000,2019,1030,0,1030,COST
06033908210200000,2021,1107,0,1107,COST
06033908210200000,2020,1030,0,1030,COST
06033908210200000,2019,1030,0,1030,COST
06033908210300000,2021,158364,1214830,1373194,COST
06033908210300000,2020,127397,1028540,1155937,COST
06033908210300000,2019,127397,1028540,1155937,COST
06033908210400000,2021,158364,2825940,2984304,COST
06033908210400000,2020,127397,2605220,2732617,COST
06033908210400000,2019,127397,2605220,2732617,COST
06033908210500000,2021,7905,0,7905,COST
06033908210500000,2020,4330,0,4330,COST
06033908210500000,2019,4330,0,4330,COST
06033908210600000,2021,158364,909840,1068204,COST
06033908210600000,2020,127397,775800,903197,COST
06033908210600000,2019,127397,775800,903197,COST
06033908210700000,2021,10801,0,10801,COST
06033908210700000,2020,5831,0,5831,COST
06033908210700000,2019,5831,0,5831,COST
06033908280010000,2021,1107,0,1107,COST
06033908280010000,2020,1030,0,1030,COST
06033908280010000,2019,1030,0,1030,COST
06033908310100000,2021,164179,623850,788029,COST
06033908310100000,2020,130203,494170,624373,OVR
06033908310100000,2019,130203,494170,624373,COST
06033908310200000,2021,158364,1136900,1295264,COST
06033908310200000,2020,127397,967810,1095207,COST
06033908310200000,2019,127397,967810,1095207,COST
06033908310300000,2021,315620,2342310,2657930,COST
06033908310300000,2020,253763,2006690,2260453,COST
06033908310300000,2019,253763,2006690,2260453,COST
06033908310400000,2021,158364,1652970,1811334,COST
06033908310400000,2020,127397,1378170,1505567,COST
06033908310400000,2019,127397,1378170,1505567,COST
06033908310500000,2021,158364,3232900,3391264,COST
06033908310500000,2020,127397,2703110,2830507,COST
06033908310500000,2019,127397,2703110,2830507,COST
06033908310600000,2021,246852,898720,1145572,COST
06033908310600000,2020,1030,0,1030,COST
06033908310600000,2019,1030,0,1030,COST
06033908310700000,2021,158364,1381050,1539414,COST
06033908310700000,2020,127397,973470,1100867,COST
06033908310700000,2019,127397,973470,1100867,COST
06033908310800000,2021,1107,0,1107,COST
06033908310800000,2020,1030,0,1030,COST
06033908310800000,2019,1030,0,1030,COST
06033908401050000,2021,326174,0,326174,COST
06033908401050000,2020,292214,0,292214,COST
06033908401050000,2019,292214,0,292214,COST
06033908401070000,2021,267111,2342139,2609250,MRA
06033908401070000,2020,232280,1746555,1978835,MRA
06033908401070000,2019,232280,1746555,1978835,MRA
06033908401150000,2021,260244,12360,272604,COST
06033908401150000,2020,225432,12370,237802,COST
06033908401150000,2019,225432,12370,237802,COST
06033908401200000,2021,258518,0,258518,COST
06033908401200000,2020,223715,0,223715,COST
06033908401200000,2019,223715,0,223715,COST
06033908401260000,2021,263361,990720,1254081,COST
06033908401260000,2020,228537,838460,1066997,COST
06033908401260000,2019,228537,838460,1066997,COST
06033908401280000,2021,263361,1001960,1265321,COST
06033908401280000,2020,228537,867180,1095717,OVR
06033908401280000,2019,228537,867180,1095717,COST
06033908401320000,2021,258550,427720,686270,COST
06033908401320000,2020,223746,364720,588466,COST
06033908401320000,2019,223746,364720,588466,COST
06033908402170000,2021,258518,284390,542908,COST
06033908402170000,2020,223715,241620,465335,COST
06033908402170000,2019,223715,241620,465335,COST
06033908402250000,2021,254294,0,254294,COST
06033908402250000,2020,219519,0,219519,COST
06033908402250000,2019,219519,0,219519,COST
06033908402300000,2021,258199,1960,260159,COST
06033908402300000,2020,223397,1870,225267,COST
06033908402300000,2019,223397,1870,225267,COST
06033908402350000,2021,258310,985110,1243420,COST
06033908402350000,2020,223508,844070,1067578,COST
06033908402350000,2019,223508,844070,1067578,COST
06033908402400000,2021,254294,2010,256304,COST
06033908402400000,2020,219519,2060,221579,COST
06033908402400000,2019,219519,2060,221579,COST
06033908402500000,2021,161894,629506,791400,MKT
06033908402500000,2020,123233,373860,497093,COST
06033908402500000,2019,123233,373860,497093,COST
06033908402520000,2021,160110,489290,649400,COST
06033908402520000,2020,121674,405140,526814,COST
06033908402520000,2019,121674,405140,526814,COST
06033908402540000,2021,163265,0,163265,COST
06033908402540000,2020,124433,0,124433,COST
06033908402540000,2019,124433,0,124433,COST
06033908402560000,2021,170439,381761,552200,MKT
06033908402560000,2020,130736,370164,500900,MKT
06033908402560000,2019,130736,368964,499700,MKT
06033908402580000,2021,189743,0,189743,COST
06033908402580000,2020,147889,0,147889,COST
06033908402580000,2019,147889,0,147889,COST
06033908402600000,2021,172975,401425,574400,MKT
06033908402600000,2020,132974,344626,477600,MKT
06033908402600000,2019,132974,344626,477600,MKT
06033908402620000,2021,184747,335653,520400,MKT
06033908402620000,2020,143424,340276,483700,MKT
06033908402620000,2019,143424,340276,483700,MKT
06033908402640000,2021,171220,582880,754100,MKT
06033908402640000,2020,131424,352170,483594,COST
06033908402640000,2019,131424,352170,483594,COST
06033908402660000,2021,173516,453384,626900,MKT
06033908402660000,2020,133452,372248,505700,MKT
06033908402660000,2019,133452,372248,505700,MKT
06033908402680000,2021,173516,560584,734100,MKT
06033908402680000,2020,133452,468148,601600,MKT
06033908402680000,2019,133452,468148,601600,MKT
06033908402700000,2021,164853,591647,756500,MKT
06033908402700000,2020,125825,542775,668600,MKT
06033908402700000,2019,125825,542775,668600,MKT
06033908402726500,2021,63043,0,63043,COST
06033908402726500,2020,49882,0,49882,COST
06033908402726500,2019,49882,0,49882,COST
06033908402740000,2021,174692,566008,740700,MKT
06033908402740000,2020,134492,438250,572742,COST
06033908402740000,2019,134492,438250,572742,COST
06033908402760000,2021,201514,614486,816000,MKT
06033908402760000,2020,158480,521520,680000,OVR
06033908402760000,2019,158480,521520,680000,MKT
06033908402766500,2021,34005,30300,64305,COST
06033908402766500,2020,24540,30710,55250,COST
06033908402766500,2019,24540,30710,55250,COST
06033908402776500,2021,29282,0,29282,COST
06033908402776500,2020,20667,0,20667,COST
06033908402776500,2019,20667,0,20667,COST
06033908402780000,2021,211089,743211,954300,MKT
06033908402780000,2020,167163,631237,798400,MKT
06033908402780000,2019,167163,631237,798400,MKT
06033908402820000,2021,217273,725427,942700,MKT
06033908402820000,2020,172802,615298,788100,OVR
06033908402820000,2019,172802,615298,788100,MKT
06033908402840000,2021,215499,743301,958800,MKT
06033908402840000,2020,171182,578018,749200,MKT
06033908402840000,2019,171182,578018,749200,MKT
06033908402860000,2021,215499,581601,797100,MKT
06033908402860000,2020,171182,488818,660000,MKT
06033908402860000,2019,171182,488818,660000,MKT
06033908402900000,2021,215499,581701,797200,MKT
06033908402900000,2020,171182,468218,639400,MKT
06033908402900000,2019,171182,468218,639400,MKT
06033908402920000,2021,231216,732130,963346,COST
06033908402920000,2020,185604,605260,790864,COST
06033908402920000,2019,185604,605260,790864,COST
06033908403010000,2021,179734,468920,648654,COST
06033908403010000,2020,147334,390840,538174,COST
06033908403010000,2019,147334,390840,538174,COST
06033908403150000,2021,212260,514810,727070,COST
06033908403150000,2020,178365,353350,531715,COST
06033908403150000,2019,178365,353350,531715,COST
06033908403200000,2021,157312,0,157312,COST
06033908403200000,2020,126418,0,126418,COST
06033908403200000,2019,126418,0,126418,COST
06033908403300000,2021,158364,227740,386104,COST
06033908403300000,2020,127397,190770,318167,COST
06033908403300000,2019,127397,190770,318167,COST
06033908403330000,2021,348395,479010,827405,COST
06033908403330000,2020,315204,410680,725884,COST
06033908403330000,2019,315204,410680,725884,COST
06033908403350000,2021,371047,809810,1180857,COST
06033908403350000,2020,338865,623940,962805,COST
06033908403350000,2019,338865,623940,962805,COST
06033908403400000,2021,297099,1220,298319,COST
06033908403400000,2020,262488,1350,263838,COST
06033908403400000,2019,262488,1350,263838,COST
06033908403500000,2021,265934,1564940,1830874,COST
06033908403500000,2020,231105,1310180,1541285,COST
06033908403500000,2019,231105,890620,1121725,COST
06033908404050000,2021,268144,0,268144,COST
06033908404050000,2020,233313,0,233313,COST
06033908404050000,2019,233313,0,233313,COST
06033908404090000,2021,267407,0,267407,COST
06033908404090000,2020,232576,0,232576,COST
06033908404090000,2019,232576,0,232576,COST
06033909101010000,2021,54034,0,54034,COST
06033909101010000,2020,29894,0,29894,COST
06033909101010000,2019,29894,0,29894,COST
06033909201010000,2021,3650,0,3650,COST
06033909201010000,2020,3400,0,3400,COST
06033909201010000,2019,3400,0,3400,COST
06033910101010000,2021,235641,0,235641,COST
06033910101010000,2020,126870,0,126870,COST
06033910101010000,2019,126870,0,126870,COST
06033911101010000,2021,260000,0,260000,COST
06033911101010000,2020,139680,0,139680,COST
06033911101010000,2019,139680,0,139680,COST
06033912101010000,2021,249768,0,249768,COST
06033912101010000,2020,134207,0,134207,COST
06033912101010000,2019,134207,0,134207,COST
06033913101010000,2021,190938,0,190938,COST
06033913101010000,2020,102578,0,102578,COST
06033913101010000,2019,102578,0,102578,COST
06033913301010000,2021,65000,0,65000,COST
06033913301010000,2020,34920,0,34920,COST
06033913301010000,2019,34920,0,34920,COST
06033914101010000,2021,176940,0,176940,COST
06033914101010000,2020,96023,0,96023,COST
06033914101010000,2019,96023,0,96023,COST
06033915101010000,2021,49852,0,49852,COST
06033915101010000,2020,29259,0,29259,COST
06033915101010000,2019,29259,0,29259,COST
06033916101010000,2021,70766,0,70766,COST
06033916101010000,2020,39140,0,39140,COST
06033916101010000,2019,39140,0,39140,COST
06033916101160000,2021,702997,531670,1234667,COST
06033916101160000,2020,1091045,556130,1647175,COST
06033916101160000,2019,1091045,556130,1647175,COST
06033916102010000,2021,273120,608880,882000,MKT
06033916102010000,2020,368162,568680,936842,OVR
06033916102010000,2019,368162,568680,936842,COST
06033916102030000,2021,272621,646479,919100,MKT
06033916102030000,2020,367388,609300,976688,OVR
06033916102030000,2019,367388,609300,976688,COST
06033916102050000,2021,271362,608938,880300,MKT
06033916102050000,2020,365440,568680,934120,OVR
06033916102050000,2019,365440,568680,934120,COST
06033916102070000,2021,269192,609008,878200,MKT
06033916102070000,2020,362085,568680,930765,OVR
06033916102070000,2019,362085,568680,930765,COST
06033916102090000,2021,269192,609008,878200,MKT
06033916102090000,2020,362085,580370,942455,OVR
06033916102090000,2019,362085,580370,942455,COST
06033916102110000,2021,269192,616708,885900,MKT
06033916102110000,2020,362085,577350,939435,COST
06033916102110000,2019,362085,568680,930765,COST
06033916102130000,2021,269192,616508,885700,MKT
06033916102130000,2020,362085,597710,959795,COST
06033916102130000,2019,362085,597710,959795,COST
06033916102150000,2021,279793,616207,896000,MKT
06033916102150000,2020,378517,575690,954207,COST
06033916102150000,2019,378517,575690,954207,COST
06033916102176500,2021,134192,0,134192,COST
06033916102176500,2020,121845,0,121845,COST
06033916102176500,2019,121845,0,121845,COST
06033916201010000,2021,3223,268960,272183,COST
06033916201010000,2020,3408,321090,324498,COST
06033916201010000,2019,3408,321090,324498,COST
06033916203010000,2021,456,0,456,COST
06033916203010000,2020,425,0,425,COST
06033916203010000,2019,425,0,425,COST
06033916301300000,2021,309665,0,309665,COST
06033916301300000,2020,424363,0,424363,COST
06033916301300000,2019,424363,0,424363,COST
06033916301650000,2021,459963,370310,830273,COST
06033916301650000,2020,670117,393690,1063807,COST
06033916301650000,2019,670117,393690,1063807,COST
06033916301700000,2021,408969,0,408969,COST
06033916301700000,2020,585479,0,585479,COST
06033916301700000,2019,585479,0,585479,COST
06033916301740000,2021,408969,0,408969,COST
06033916301740000,2020,585479,0,585479,COST
06033916301740000,2019,585479,0,585479,COST
06033916302010000,2021,266634,1820,268454,COST
06033916302010000,2020,215520,0,215520,COST
06033916302010000,2019,215520,0,215520,COST
06033916491010000,2021,865772,559428,1425200,INCOME
06033916491010000,2020,532819,728081,1260900,INCOME
06033916491010000,2019,532819,728081,1260900,INCOME
06033917101060000,2021,211919,494330,706249,COST
06033917101060000,2020,167918,404420,572338,COST
06033917101060000,2019,167918,404420,572338,COST
06033917101080000,2021,238858,0,238858,COST
06033917101080000,2020,192670,0,192670,COST
06033917101080000,2019,192670,0,192670,COST
06033917101090000,2021,507669,865060,1372729,COST
06033917101090000,2020,469212,730670,1199882,COST
06033917101090000,2019,469212,730670,1199882,COST
06033917101100000,2021,518134,553000,1071134,COST
06033917101100000,2020,480344,4580,484924,OVR
06033917101100000,2019,480344,4580,484924,COST
06033917101140000,2021,246712,610920,857632,COST
06033917101140000,2020,562370,490240,1052610,COST
06033917101140000,2019,562370,490240,1052610,COST
06033917101150000,2021,389190,1467280,1856470,COST
06033917101150000,2020,329495,1254470,1583965,COST
06033917101150000,2019,329495,1254470,1583965,COST
06033917101200000,2021,509157,0,509157,COST
06033917101200000,2020,470794,0,470794,COST
06033917101200000,2019,470794,0,470794,COST
06033917101220000,2021,284009,618650,902659,COST
06033917101220000,2020,229416,507030,736446,COST
06033917101220000,2019,229416,507030,736446,COST
06033917101230000,2021,515248,518770,1034018,COST
06033917101230000,2020,477271,431010,908281,COST
06033917101230000,2019,477271,431010,908281,COST
06033917101240000,2021,428451,644990,1073441,COST
06033917101240000,2020,367968,537450,905418,COST
06033917101240000,2019,367968,537450,905418,COST
06033917101400000,2021,427183,0,427183,COST
06033917101400000,2020,395107,0,395107,COST
06033917101400000,2019,395107,0,395107,COST
06033917101450000,2021,347406,1108060,1455466,COST
06033917101450000,2020,289782,937220,1227002,COST
06033917101450000,2019,289782,937220,1227002,COST
06033917101500000,2021,409886,0,409886,COST
06033917101500000,2020,376781,0,376781,COST
06033917101500000,2019,376781,0,376781,COST
06033917140010000,2021,1535,0,1535,COST
06033917140010000,2020,1429,0,1429,COST
06033917140010000,2019,1429,0,1429,COST
06033917140200000,2021,292512,637370,929882,COST
06033917140200000,2020,237818,549682,787500,MKT
06033917140200000,2019,237818,549682,787500,MKT
06033917140250000,2021,289279,2078710,2367989,COST
06033917140250000,2020,234801,1734660,1969461,COST
06033917140250000,2019,234801,1076034,1310835,MRA
06033917140300000,2021,289279,1139860,1429139,COST
06033917140300000,2020,234801,990870,1225671,COST
06033917140300000,2019,234801,990870,1225671,COST
06033917140350000,2021,287482,0,287482,COST
06033917140350000,2020,233124,0,233124,COST
06033917140350000,2019,233124,0,233124,COST
06033917140500000,2021,505220,8310200,8815420,COST
06033917140500000,2020,421253,7837870,8259123,COST
06033917140500000,2019,421253,7837870,8259123,COST
06033917201030000,2021,306022,1230450,1536472,COST
06033917201030000,2020,250482,1045750,1296232,COST
06033917201030000,2019,250482,1045750,1296232,COST
06033917201050000,2021,431276,1441480,1872756,COST
06033917201050000,2020,371526,1255500,1627026,COST
06033917201050000,2019,287111,1255500,1542611,COST
06033917201250000,2021,453130,1445350,1898480,COST
06033917201250000,2020,393239,1213040,1606279,COST
06033917201250000,2019,320274,1202570,1522844,COST
06033917201300000,2021,305233,1687967,1993200,MKT
06033917201300000,2020,249740,1694080,1943820,COST
06033917201300000,2019,249740,1461900,1711640,COST
06033917201350000,2021,335930,0,335930,COST
06033917201350000,2020,278811,0,278811,COST
06033917201350000,2019,278811,0,278811,COST
06033917201400000,2021,355298,590880,946178,COST
06033917201400000,2020,297360,488330,785690,COST
06033917201400000,2019,297360,0,297360,COST
06033917201450000,2021,316136,961730,1277866,COST
06033917201450000,2020,260017,813750,1073767,COST
06033917201450000,2019,260017,633420,893437,COST
06033917201500000,2021,303373,0,303373,COST
06033917201500000,2020,247992,0,247992,COST
06033917201500000,2019,247992,0,247992,COST
06033917201550000,2021,342593,1555030,1897623,COST
06033917201550000,2020,285174,1312420,1597594,COST
06033917201550000,2019,285174,1312420,1597594,COST
06033917201600000,2021,314665,836730,1151395,COST
06033917201600000,2020,258628,591372,850000,OVR
06033917201600000,2019,258628,591372,850000,OVR
06033917201656500,2021,1483,0,1483,COST
06033917201656500,2020,1380,0,1380,COST
06033917201656500,2019,1380,0,1380,COST
06033917220150000,2021,1600,0,1600,COST
06033917220150000,2020,1489,0,1489,COST
06033917220150000,2019,1489,0,1489,COST
06033917220250000,2021,1208,0,1208,COST
06033917220250000,2020,1124,0,1124,COST
06033917220250000,2019,1124,0,1124,COST
06033917220350000,2021,1517,0,1517,COST
06033917220350000,2020,1411,0,1411,COST
06033917220350000,2019,1411,0,1411,COST
06033917220400000,2021,409613,0,409613,COST
06033917220400000,2020,350164,0,350164,COST
06033917220400000,2019,350164,0,350164,COST
06033917220450000,2021,371536,0,371536,COST
06033917220450000,2020,313028,0,313028,COST
06033917220450000,2019,313028,0,313028,COST
06033917220500000,2021,331392,0,331392,COST
06033917220500000,2020,274487,0,274487,COST
06033917220500000,2019,274487,0,274487,COST
06033917220550000,2021,391536,763660,1155196,COST
06033917220550000,2020,332466,638860,971326,COST
06033917220550000,2019,332466,638860,971326,COST
06033917220650000,2021,419189,2887140,3306329,COST
06033917220650000,2020,359587,2333040,2692627,COST
06033917220650000,2019,359587,2333040,2692627,COST
06033917220700000,2021,359924,1097800,1457724,COST
06033917220700000,2020,301812,913260,1215072,COST
06033917220700000,2019,301812,913260,1215072,COST
06033917220750000,2021,297635,0,297635,COST
06033917220750000,2020,242610,0,242610,COST
06033917220750000,2019,242610,0,242610,COST
06033917220800000,2021,298748,1477590,1776338,COST
06033917220800000,2020,243652,1016540,1260192,COST
06033917220800000,2019,243652,1016540,1260192,COST
06033917220850000,2021,315402,561540,876942,COST
06033917220850000,2020,259324,464390,723714,COST
06033917220850000,2019,259324,464390,723714,COST
06033917301016500,2021,547,0,547,COST
06033917301016500,2020,509,0,509,COST
06033917301016500,2019,509,0,509,COST
06033917301100000,2021,377049,1929010,2306059,COST
06033917301100000,2020,318371,1620460,1938831,COST
06033917301100000,2019,318371,1620460,1938831,COST
06033917301200000,2021,372552,0,372552,COST
06033917301200000,2020,314012,0,314012,COST
06033917301200000,2019,314012,0,314012,COST
06033917301306500,2021,2201,0,2201,COST
06033917301306500,2020,2048,0,2048,COST
06033917301306500,2019,2048,0,2048,COST
06033917301400000,2021,409340,938240,1347580,COST
06033917301400000,2020,349896,718410,1068306,COST
06033917301400000,2019,349896,718410,1068306,COST
06033917301500000,2021,381429,0,381429,COST
06033917301500000,2020,322624,0,322624,COST
06033917301500000,2019,322624,0,322624,COST
06033917301600000,2021,332485,1580470,1912955,COST
06033917301600000,2020,275528,1309580,1585108,COST
06033917301600000,2019,275528,445260,720788,COST
06033917320016500,2021,2355,0,2355,COST
06033917320016500,2020,2192,0,2192,COST
06033917320016500,2019,2192,0,2192,COST
06033917320100000,2021,303,0,303,COST
06033917320100000,2020,290726,0,290726,COST
06033917320100000,2019,290726,0,290726,COST
06033917320300000,2021,316380,814250,1130630,COST
06033917320300000,2020,260248,664570,924818,OVR
06033917320300000,2019,260248,664570,924818,COST
06033917320400000,2021,323734,898630,1222364,COST
06033917320400000,2020,267211,753330,1020541,COST
06033917320400000,2019,267211,753330,1020541,COST
06033917320500000,2021,327162,1002480,1329642,COST
06033917320500000,2020,270465,835830,1106295,COST
06033917320500000,2019,270465,835830,1106295,COST
06033917320600000,2021,323039,0,323039,COST
06033917320600000,2020,266552,0,266552,COST
06033917320600000,2019,266552,0,266552,COST
06033917401200000,2021,297683,1107120,1404803,COST
06033917401200000,2020,254089,932020,1186109,COST
06033917401200000,2019,254089,932020,1186109,COST
06033917410016500,2021,143555,0,143555,COST
06033917410016500,2020,110364,0,110364,COST
06033917410016500,2019,110364,0,110364,COST
06033917410020000,2021,432917,0,432917,COST
06033917410020000,2020,327689,0,327689,COST
06033917410020000,2019,327689,0,327689,COST
06033917410030000,2021,427901,892690,1320591,COST
06033917410030000,2020,385538,752700,1138238,COST
06033917410030000,2019,385538,567080,952618,COST
06033917410040000,2021,418055,736240,1154295,COST
06033917410040000,2020,375361,581639,957000,MKT
06033917410040000,2019,375361,581639,957000,MKT
06033917410050000,2021,363556,469910,833466,COST
06033917410050000,2020,319702,444940,764642,COST
06033917410050000,2019,319702,444940,764642,COST
06033917410060000,2021,343109,554880,897989,COST
06033917410060000,2020,299130,445330,744460,COST
06033917410060000,2019,299130,455870,755000,OVR
06033917410070000,2021,363965,978920,1342885,COST
06033917410070000,2020,268464,815130,1083594,COST
06033917410070000,2019,320116,767190,1087306,COST
06033917410080000,2021,320000,0,320000,COST
06033917410080000,2020,231549,0,231549,COST
06033917410080000,2019,231549,0,231549,COST
06033917410090000,2021,336388,463800,800188,COST
06033917410090000,2020,245225,348070,593295,COST
06033917410090000,2019,245225,348070,593295,COST
06033917410100000,2021,314563,0,314563,COST
06033917410100000,2020,227034,0,227034,COST
06033917410100000,2019,227034,0,227034,COST
06033917410110000,2021,312275,0,312275,COST
06033917410110000,2020,225137,0,225137,COST
06033917410110000,2019,225137,0,225137,COST
06033917410120000,2021,333084,0,333084,COST
06033917410120000,2020,242460,0,242460,COST
06033917410120000,2019,242460,0,242460,COST
06033917410130000,2021,328284,695820,1024104,COST
06033917410130000,2020,238450,586110,824560,COST
06033917410130000,2019,238450,576560,815010,COST
06033917410140000,2021,321712,888460,1210172,COST
06033917410140000,2020,232973,763120,996093,COST
06033917410140000,2019,232973,763120,996093,COST
06033917410150000,2021,327010,0,327010,COST
06033917410150000,2020,237386,0,237386,COST
06033917410150000,2019,237386,0,237386,COST
06033917410170000,2021,314912,37860,352772,COST
06033917410170000,2020,227323,38180,265503,COST
06033917410170000,2019,227323,38180,265503,COST
06033917410180000,2021,286071,457640,743711,COST
06033917410180000,2020,203568,348870,552438,COST
06033917410180000,2019,203568,348870,552438,COST
06033917415010000,2021,404159,922150,1326309,COST
06033917415010000,2020,361060,786850,1147910,COST
06033917415010000,2019,361060,786850,1147910,COST
06033917415020000,2021,403934,488450,892384,COST
06033917415020000,2020,360830,412330,773160,COST
06033917415020000,2019,360830,412330,773160,COST
06033917415030000,2021,337191,472690,809881,COST
06033917415030000,2020,341422,379710,721132,COST
06033917415030000,2019,341422,379710,721132,COST
06033917415040000,2021,346239,0,346239,COST
06033917415040000,2020,253495,0,253495,COST
06033917415040000,2019,253495,0,253495,COST
06033917415050000,2021,361235,536550,897785,COST
06033917415050000,2020,266151,454510,720661,COST
06033917415050000,2019,266151,454510,720661,COST
06033918101010000,2021,4266,778570,782836,COST
06033918101010000,2020,3970,642450,646420,COST
06033918101010000,2019,3970,642450,646420,COST
06033918101060000,2021,44329,474500,518829,COST
06033918101060000,2020,28724,403750,432474,COST
06033918101060000,2019,28724,403750,432474,COST
06033918101100000,2021,8577,0,8577,COST
06033918101100000,2020,4612,0,4612,COST
06033918101100000,2019,4612,0,4612,COST
06033918101200000,2021,6754,0,6754,COST
06033918101200000,2020,3755,0,3755,COST
06033918101200000,2019,3755,0,3755,COST
06033918101300000,2021,6700,0,6700,COST
06033918101300000,2020,3641,0,3641,COST
06033918101300000,2019,3641,0,3641,COST
06033918101400000,2021,8059,0,8059,COST
06033918101400000,2020,4341,0,4341,COST
06033918101400000,2019,4341,0,4341,COST
06033918101500000,2021,2723,0,2723,COST
06033918101500000,2020,2197,0,2197,COST
06033918101500000,2019,2197,0,2197,COST
06033918101600000,2021,2079,0,2079,COST
06033918101600000,2020,1935,0,1935,COST
06033918101600000,2019,1935,0,1935,COST
06033918101700000,2021,2084,0,2084,COST
06033918101700000,2020,1940,0,1940,COST
06033918101700000,2019,1940,0,1940,COST
06033918220010000,2021,9873,0,9873,COST
06033918220010000,2020,5568,0,5568,COST
06033918220010000,2019,5568,0,5568,COST
06033918230010000,2021,4974,0,4974,COST
06033918230010000,2020,2884,0,2884,COST
06033918230010000,2019,2884,0,2884,COST
06033918240010000,2021,176773,2007800,2184573,COST
06033918240010000,2020,117099,1693260,1810359,COST
06033918240010000,2019,117099,1693260,1810359,COST
06033918260010000,2021,13742,0,13742,COST
06033918260010000,2020,7386,0,7386,COST
06033918260010000,2019,7386,0,7386,COST
06033918270010000,2021,9221,0,9221,COST
06033918270010000,2020,4983,0,4983,COST
06033918270010000,2019,4983,0,4983,COST
06033918280010000,2021,7195,0,7195,COST
06033918280010000,2020,3947,0,3947,COST
06033918280010000,2019,3947,0,3947,COST
06033918320010000,2021,11580,0,11580,COST
06033918320010000,2020,6507,0,6507,COST
06033918320010000,2019,6507,0,6507,COST
06033918360010000,2021,12048,0,12048,COST
06033918360010000,2020,6614,0,6614,COST
06033918360010000,2019,6614,0,6614,COST
06033918370010000,2021,970,0,970,COST
06033918370010000,2020,904,0,904,COST
06033918370010000,2019,904,0,904,COST
06033918401010000,2021,644,0,644,COST
06033918401010000,2020,667,0,667,COST
06033918401010000,2019,667,0,667,COST
06033918402010000,2021,1127,0,1127,COST
06033918402010000,2020,1049,0,1049,COST
06033918402010000,2019,1049,0,1049,COST
06033919110010000,2021,176752,1705660,1882412,COST
06033919110010000,2020,117079,1411810,1528889,COST
06033919110010000,2019,117079,1411810,1528889,COST
06033919120010000,2021,181706,2103750,2285456,COST
06033919120010000,2020,119430,1744860,1864290,COST
06033919120010000,2019,119430,1744860,1864290,COST
06033919130010000,2021,4061,0,4061,COST
06033919130010000,2020,2433,0,2433,COST
06033919130010000,2019,2433,0,2433,COST
06033919140010000,2021,176752,2065630,2242382,COST
06033919140010000,2020,117079,1460020,1577099,COST
06033919140010000,2019,117079,1460020,1577099,COST
06033919150010000,2021,257582,689670,947252,COST
06033919150010000,2020,117086,559440,676526,COST
06033919150010000,2019,117086,559440,676526,COST
06033919160010000,2021,1116,0,1116,COST
06033919160010000,2020,1039,0,1039,COST
06033919160010000,2019,1039,0,1039,COST
06033919170010000,2021,1107,0,1107,COST
06033919170010000,2020,1030,0,1030,COST
06033919170010000,2019,1030,0,1030,COST
06033919180010000,2021,176752,1591770,1768522,COST
06033919180010000,2020,117079,1308880,1425959,COST
06033919180010000,2019,117079,1308880,1425959,COST
06033919220010000,2021,258341,431720,690061,COST
06033919220010000,2020,117793,358620,476413,COST
06033919220010000,2019,117793,358620,476413,COST
06033919230010000,2021,7073,0,7073,COST
06033919230010000,2020,3861,0,3861,COST
06033919230010000,2019,3861,0,3861,COST
06033919240010000,2021,257574,1072310,1329884,COST
06033919240010000,2020,117079,770220,887299,OVR
06033919240010000,2019,117079,770220,887299,COST
06033919260010000,2021,8607,0,8607,COST
06033919260010000,2020,4956,0,4956,COST
06033919260010000,2019,4956,0,4956,COST
06033919270010000,2021,359662,530200,889862,COST
06033919270010000,2020,264442,443040,707482,COST
06033919270010000,2019,264442,443040,707482,COST
06033919270050000,2021,1096,0,1096,COST
06033919270050000,2020,1020,0,1020,COST
06033919270050000,2019,1020,0,1020,COST
06033919280010000,2021,176773,1224920,1401693,COST
06033919280010000,2020,117098,1047320,1164418,COST
06033919280010000,2019,117098,1071380,1188478,COST
06033919320010000,2021,190924,2929680,3120604,COST
06033919320010000,2020,124350,2414390,2538740,COST
06033919320010000,2019,124350,2394550,2518900,COST
06033919330010000,2021,187307,2208680,2395987,COST
06033919330010000,2020,122364,1717850,1840214,COST
06033919330010000,2019,122364,1717850,1840214,COST
06033919340010000,2021,184828,572310,757138,COST
06033919340010000,2020,121017,522840,643857,COST
06033919340010000,2019,121017,522840,643857,COST
06033919360010000,2021,190024,2358690,2548714,COST
06033919360010000,2020,123855,2003710,2127565,COST
06033919360010000,2019,123855,1926410,2050265,COST
06033919370010000,2021,188577,1963840,2152417,COST
06033919370010000,2020,123034,1627400,1750434,COST
06033919370010000,2019,123034,1627400,1750434,COST
06033919380010000,2021,6364,0,6364,COST
06033919380010000,2020,3536,0,3536,COST
06033919380010000,2019,3536,0,3536,COST
06033919410010000,2021,183958,720090,904048,COST
06033919410010000,2020,120541,619000,739541,COST
06033919410010000,2019,120541,619000,739541,COST
06033919420010000,2021,184277,1689220,1873497,COST
06033919420010000,2020,120716,1424850,1545566,COST
06033919420010000,2019,120716,1424850,1545566,COST
06033919430010000,2021,9384,0,9384,COST
06033919430010000,2020,5053,0,5053,COST
06033919430010000,2019,5053,0,5053,COST
06033919440010000,2021,176752,6264380,6441132,COST
06033919440010000,2020,117079,5245460,5362539,COST
06033919440010000,2019,117079,3780090,3897169,COST
06033919450010000,2021,8169,0,8169,COST
06033919450010000,2020,4387,0,4387,COST
06033919450010000,2019,4387,0,4387,COST
06033919460010000,2021,8160,0,8160,COST
06033919460010000,2020,4383,0,4383,COST
06033919460010000,2019,4383,0,4383,COST
06033919470010000,2021,1116,0,1116,COST
06033919470010000,2020,3699,0,3699,COST
06033919470010000,2019,3699,0,3699,COST
06033919480010000,2021,1115,0,1115,COST
06033919480010000,2020,3582,0,3582,COST
06033919480010000,2019,3582,0,3582,COST
06033920101016500,2021,180559,0,180559,COST
06033920101016500,2020,171361,0,171361,COST
06033920101016500,2019,171361,0,171361,COST
06033920101030000,2021,73,0,73,COST
06033920101030000,2020,67,0,67,COST
06033920101030000,2019,67,0,67,COST
06033920101060000,2021,68,0,68,COST
06033920101060000,2020,63,0,63,COST
06033920101060000,2019,63,0,63,COST
06033920101090000,2021,68,0,68,COST
06033920101090000,2020,63,0,63,COST
06033920101090000,2019,63,0,63,COST
06033920101120000,2021,80,0,80,COST
06033920101120000,2020,75,0,75,COST
06033920101120000,2019,75,0,75,COST
06033920101150000,2021,88,0,88,COST
06033920101150000,2020,82,0,82,COST
06033920101150000,2019,82,0,82,COST
06033920101180000,2021,70,0,70,COST
06033920101180000,2020,65,0,65,COST
06033920101180000,2019,65,0,65,COST
06033920101200000,2021,8249,0,8249,COST
06033920101200000,2020,4925,0,4925,COST
06033920101200000,2019,4925,0,4925,COST
06033920101210000,2021,66,0,66,COST
06033920101210000,2020,62,0,62,COST
06033920101210000,2019,62,0,62,COST
06033920101240000,2021,62,0,62,COST
06033920101240000,2020,58,0,58,COST
06033920101240000,2019,58,0,58,COST
06033920101270000,2021,74,0,74,COST
06033920101270000,2020,69,0,69,COST
06033920101270000,2019,69,0,69,COST
06033920101300000,2021,92,0,92,COST
06033920101300000,2020,86,0,86,COST
06033920101300000,2019,86,0,86,COST
06033920101330000,2021,83,0,83,COST
06033920101330000,2020,77,0,77,COST
06033920101330000,2019,77,0,77,COST
06033920101360000,2021,72,0,72,COST
06033920101360000,2020,67,0,67,COST
06033920101360000,2019,67,0,67,COST
06033920101390000,2021,86,0,86,COST
06033920101390000,2020,80,0,80,COST
06033920101390000,2019,80,0,80,COST
06033920101420000,2021,82,0,82,COST
06033920101420000,2020,77,0,77,COST
06033920101420000,2019,77,0,77,COST
06033920101450000,2021,81,0,81,COST
06033920101450000,2020,76,0,76,COST
06033920101450000,2019,76,0,76,COST
06033920101480000,2021,80,0,80,COST
06033920101480000,2020,75,0,75,COST
06033920101480000,2019,75,0,75,COST
06033920101516500,2021,67628,0,67628,COST
06033920101516500,2020,54072,0,54072,COST
06033920101516500,2019,54072,0,54072,COST
06033920201010000,2021,16519,2141030,2157549,COST
06033920201010000,2020,11947,1895240,1907187,COST
06033920201010000,2019,11947,1895240,1907187,COST
06033920301010000,2021,2214,0,2214,COST
06033920301010000,2020,425,0,425,COST
06033920301010000,2019,425,0,425,COST
06033920301050000,2021,2214,0,2214,COST
06033920301050000,2020,425,0,425,COST
06033920301050000,2019,425,0,425,COST
06033920301150000,2021,2214,0,2214,COST
06033920301150000,2020,425,0,425,COST
06033920301150000,2019,425,0,425,COST
06033920401010000,2021,59377,0,59377,COST
06033920401010000,2020,32398,0,32398,COST
06033920401010000,2019,32398,0,32398,COST
06033921101010000,2021,169440,0,169440,COST
06033921101010000,2020,91382,0,91382,COST
06033921101010000,2019,91382,0,91382,COST
06033921201150000,2021,1077,0,1077,COST
06033921201150000,2020,1002,0,1002,COST
06033921201150000,2019,1002,0,1002,COST
06033921240010000,2021,285659,363670,649329,COST
06033921240010000,2020,236650,193720,430370,COST
06033921240010000,2019,236650,193720,430370,COST
06033921240050000,2021,285659,0,285659,COST
06033921240050000,2020,236650,0,236650,COST
06033921240050000,2019,236650,0,236650,COST
06033921301010000,2021,17873,0,17873,COST
06033921301010000,2020,10072,0,10072,COST
06033921301010000,2019,10072,0,10072,COST
06033922101010000,2021,152095,0,152095,COST
06033922101010000,2020,82990,0,82990,COST
06033922101010000,2019,82990,0,82990,COST
06033923101010000,2021,123157,0,123157,COST
06033923101010000,2020,68202,0,68202,COST
06033923101010000,2019,68202,0,68202,COST
06033924101010000,2021,204423,0,204423,COST
06033924101010000,2020,110555,0,110555,COST
06033924101010000,2019,110555,0,110555,COST
06033925101010000,2021,265824,0,265824,COST
06033925101010000,2020,142880,0,142880,COST
06033925101010000,2019,142880,0,142880,COST
06033926101010000,2021,259175,0,259175,COST
06033926101010000,2020,139734,0,139734,COST
06033926101010000,2019,139734,0,139734,COST
06033927101010000,2021,182825,0,182825,COST
06033927101010000,2020,99388,0,99388,COST
06033927101010000,2019,99388,0,99388,COST
06033928101010000,2021,19062,0,19062,COST
06033928101010000,2020,10266,0,10266,COST
06033928101010000,2019,10266,0,10266,COST
06033928101150000,2021,29544,0,29544,COST
06033928101150000,2020,16078,0,16078,COST
06033928101150000,2019,16078,0,16078,COST
06033928102030000,2021,488152,1109980,1598132,COST
06033928102030000,2020,717518,1150860,1868378,OVR
06033928102030000,2019,717518,1150860,1868378,COST
06033928102040000,2021,432586,512700,945286,COST
06033928102040000,2020,624493,531470,1155963,COST
06033928102040000,2019,624493,531470,1155963,COST
06033928102060000,2021,405158,0,405158,COST
06033928102060000,2020,598805,0,598805,COST
06033928102060000,2019,598805,0,598805,COST
06033928105010000,2021,324,0,324,COST
06033928105010000,2020,175,0,175,COST
06033928105010000,2019,175,0,175,COST
06033928105020000,2021,243,63720,63963,COST
06033928105020000,2020,279,53990,54269,COST
06033928105020000,2019,279,53990,54269,COST
06033928105030000,2021,283618,410,284028,COST
06033928105030000,2020,240344,7700,248044,COST
06033928105030000,2019,240344,7700,248044,COST
06033928105040000,2021,188069,339840,527909,COST
06033928105040000,2020,149907,169450,319357,OVR
06033928105040000,2019,149907,169450,319357,COST
06033928105060000,2021,1866,181180,183046,COST
06033928105060000,2020,2144,151880,154024,COST
06033928105060000,2019,2144,151880,154024,COST
06033928105070000,2021,443918,446282,890200,INCOME
06033928105070000,2020,363071,428829,791900,INCOME
06033928105070000,2019,363071,428829,791900,INCOME
06033928201010000,2021,115875,0,115875,COST
06033928201010000,2020,63043,0,63043,COST
06033928201010000,2019,63043,0,63043,COST
06033928401010000,2021,18196,0,18196,COST
06033928401010000,2020,9804,0,9804,COST
06033928401010000,2019,9804,0,9804,COST
06033928402030000,2021,1043855,2257445,3301300,INCOME
06033928402030000,2020,660580,2412020,3072600,INCOME
06033928402030000,2019,660580,2412020,3072600,INCOME
