id,year,land,building,total,method
06006234213280000,2021,313065,198350,511415,COST
06006234213280000,2020,258292,196990,455282,COST
06006234213280000,2019,258292,196990,455282,COST
06006234213300000,2021,362294,361406,723700,INCOME
06006234213300000,2020,412131,280740,692871,COST
06006234213300000,2019,412131,280740,692871,COST
06006234214010000,2021,313065,153820,466885,COST
06006234214010000,2020,257926,181480,439406,COST
06006234214010000,2019,257926,181480,439406,COST
06006234214030000,2021,313065,137490,450555,COST
06006234214030000,2020,258292,25208,283500,INCOME
06006234214030000,2019,258292,25208,283500,INCOME
06006234214050000,2021,313065,861590,1174655,COST
06006234214050000,2020,258292,842670,1100962,COST
06006234214050000,2019,258292,842670,1100962,COST
06006234214070000,2021,313065,144335,457400,INCOME
06006234214070000,2020,258292,126950,385242,COST
06006234214070000,2019,258292,126950,385242,COST
06006234214090000,2021,270525,299710,570235,COST
06006234214090000,2020,161648,291700,453348,COST
06006234214090000,2019,161648,291700,453348,COST
06006234214120000,2021,313065,343990,657055,COST
06006234214120000,2020,257926,334740,592666,COST
06006234214120000,2019,257926,334740,592666,COST
06006234214140000,2021,270525,182140,452665,COST
06006234214140000,2020,161877,179680,341557,COST
06006234214140000,2019,161877,179680,341557,COST
06006234214160000,2021,313065,233435,546500,INCOME
06006234214160000,2020,258292,186908,445200,INCOME
06006234214160000,2019,258292,186908,445200,INCOME
06006234214180000,2021,313065,69335,382400,INCOME
06006234214180000,2020,258292,92008,350300,INCOME
06006234214180000,2019,258292,92008,350300,INCOME
06006234214200000,2021,313065,6735,319800,MKT
06006234214200000,2020,257926,24374,282300,MKT
06006234214200000,2019,257926,24374,282300,MKT
06006234214220000,2021,313065,186420,499485,COST
06006234214220000,2020,258292,204110,462402,COST
06006234214220000,2019,258292,204110,462402,COST
06006234214240000,2021,313065,306430,619495,COST
06006234214240000,2020,258292,287300,545592,COST
06006234214240000,2019,258292,287300,545592,COST
06006234214260000,2021,313065,338735,651800,INCOME
06006234214260000,2020,258292,227408,485700,INCOME
06006234214260000,2019,258292,227408,485700,INCOME
06006234214280000,2021,313065,208220,521285,COST
06006234214280000,2020,257926,267180,525106,COST
06006234214280000,2019,257926,267180,525106,COST
06006234214300000,2021,313065,0,313065,COST
06006234214300000,2020,257926,0,257926,COST
06006234214300000,2019,257926,0,257926,COST
06006234215050000,2021,313065,488035,801100,INCOME
06006234215050000,2020,258292,373108,631400,INCOME
06006234215050000,2019,258292,373108,631400,INCOME
06006234215070000,2021,743139,161620,904759,COST
06006234215070000,2020,393479,102060,495539,COST
06006234215070000,2019,393479,102060,495539,COST
06006234215080000,2021,743139,560560,1303699,COST
06006234215080000,2020,393479,735021,1128500,INCOME
06006234215080000,2019,393479,735021,1128500,INCOME
06006234215090000,2021,743139,295060,1038199,COST
06006234215090000,2020,393479,310660,704139,COST
06006234215090000,2019,393479,310660,704139,COST
06006234215150000,2021,362294,101670,463964,COST
06006234215150000,2020,411547,98980,510527,COST
06006234215150000,2019,411547,98980,510527,COST
06006234215180000,2021,270525,182150,452675,COST
06006234215180000,2020,161648,193152,354800,MKT
06006234215180000,2019,161648,193152,354800,MKT
06006234215200000,2021,198846,0,198846,COST
06006234215200000,2020,60373,0,60373,COST
06006234215200000,2019,60373,0,60373,COST
06006234215220000,2021,258100,112880,370980,COST
06006234215220000,2020,139073,110840,249913,COST
06006234215220000,2019,139073,126927,266000,MKT
06006234215240000,2021,313065,131980,445045,COST
06006234215240000,2020,258292,130370,388662,COST
06006234215240000,2019,258292,130370,388662,COST
06006234215260000,2021,674458,9340,683798,COST
06006234215260000,2020,606100,8470,614570,COST
06006234215260000,2019,606100,8470,614570,COST
06006234215280000,2021,313065,186380,499445,COST
06006234215280000,2020,257926,158674,416600,MKT
06006234215280000,2019,257926,158674,416600,MKT
06006234215340000,2021,903252,7476648,8379900,INCOME
06006234215340000,2020,1543096,6730004,8273100,INCOME
06006234215340000,2019,1543096,6730004,8273100,INCOME
06006234216010000,2021,903252,5234448,6137700,INCOME
06006234216010000,2020,1543096,4167504,5710600,INCOME
06006234216010000,2019,1543096,4167504,5710600,INCOME
06006234216040000,2021,313065,349735,662800,INCOME
06006234216040000,2020,258292,197308,455600,INCOME
06006234216040000,2019,258292,197308,455600,INCOME
06006234216050000,2021,936698,2010,938708,COST
06006234216050000,2020,825181,0,825181,COST
06006234216050000,2019,825181,0,825181,COST
06006234216100000,2021,743139,837760,1580899,COST
06006234216100000,2020,393479,407521,801000,INCOME
06006234216100000,2019,393479,407521,801000,INCOME
06006234216127000,2021,313065,0,313065,COST
06006234216127000,2020,258292,0,258292,COST
06006234216127000,2019,258292,0,258292,COST
06006234216150000,2021,936698,2076002,3012700,INCOME
06006234216150000,2020,825181,1115319,1940500,INCOME
06006234216150000,2019,825181,1148419,1973600,INCOME
06006234216180000,2021,313065,743570,1056635,COST
06006234216180000,2020,258292,721200,979492,COST
06006234216180000,2019,258292,721200,979492,COST
06006234218010000,2021,313065,12450,325515,COST
06006234218010000,2020,258292,11290,269582,COST
06006234218010000,2019,258292,11290,269582,COST
06006234218020000,2021,313065,2160,315225,COST
06006234218020000,2020,257926,0,257926,COST
06006234218020000,2019,257926,0,257926,COST
06006234218030000,2021,250900,56120,307020,COST
06006234218030000,2020,127217,52940,180157,COST
06006234218030000,2019,127217,52940,180157,COST
06006234218050000,2021,317050,255650,572700,INCOME
06006234218050000,2020,268958,265442,534400,INCOME
06006234218050000,2019,268958,265442,534400,INCOME
06006234218060000,2021,291923,115890,407813,COST
06006234218060000,2020,206520,136290,342810,COST
06006234218060000,2019,206520,136290,342810,COST
06006234218100000,2021,66091,0,66091,COST
06006234218100000,2020,9089,0,9089,COST
06006234218100000,2019,9089,0,9089,COST
06006234218130000,2021,264172,302840,567012,COST
06006234218130000,2020,150025,293260,443285,COST
06006234218130000,2019,150025,278040,428065,COST
06006234218150000,2021,104915,0,104915,COST
06006234218150000,2020,69228,0,69228,COST
06006234218150000,2019,69228,0,69228,COST
06006234218160000,2021,76789,0,76789,COST
06006234218160000,2020,40686,0,40686,COST
06006234218160000,2019,40686,0,40686,COST
06006234218177000,2021,313065,0,313065,COST
06006234218177000,2020,258292,0,258292,COST
06006234218177000,2019,258292,0,258292,COST
06006234218180000,2021,322896,91204,414100,INCOME
06006234218180000,2020,285150,48050,333200,INCOME
06006234218180000,2019,285150,48050,333200,INCOME
06006234218200000,2021,313065,340020,653085,COST
06006234218200000,2020,257926,328980,586906,COST
06006234218200000,2019,257926,328980,586906,COST
06006234218220000,2021,313065,0,313065,COST
06006234218220000,2020,257926,0,257926,COST
06006234218220000,2019,257926,0,257926,COST
06006234218240000,2021,313065,87490,400555,COST
06006234218240000,2020,257926,85550,343476,COST
06006234218240000,2019,257926,85550,343476,COST
06006234218260000,2021,313065,47135,360200,MKT
06006234218260000,2020,257926,23516,281442,OVR
06006234218260000,2019,257926,23516,281442,OVR
06006234218280000,2021,278098,269050,547148,COST
06006234218280000,2020,176575,266150,442725,COST
06006234218280000,2019,176575,266150,442725,COST
06006234218300000,2021,268208,220210,488418,COST
06006234218300000,2020,157261,216600,373861,COST
06006234218300000,2019,157261,216600,373861,COST
06006234218320000,2021,313065,120450,433515,COST
06006234218320000,2020,257926,35374,293300,MKT
06006234218320000,2019,257926,35374,293300,MKT
06006234218990000,2021,257087,12630,269717,COST
06006234218990000,2020,137528,12480,150008,COST
06006234218990000,2019,137528,12480,150008,COST
06006234219010000,2021,382322,742840,1125162,COST
06006234219010000,2020,489548,724960,1214508,COST
06006234219010000,2019,489548,724960,1214508,COST
06006234219020000,2021,313065,166835,479900,INCOME
06006234219020000,2020,258292,72208,330500,INCOME
06006234219020000,2019,258292,72208,330500,INCOME
06006234219040000,2021,313065,218970,532035,COST
06006234219040000,2020,258292,229660,487952,COST
06006234219040000,2019,258292,229660,487952,COST
06006234219050000,2021,313056,579820,892876,COST
06006234219050000,2020,257903,569100,827003,COST
06006234219050000,2019,257903,569100,827003,COST
06006234219060000,2021,313065,122230,435295,COST
06006234219060000,2020,257926,96374,354300,MKT
06006234219060000,2019,257926,96374,354300,MKT
06006234219070000,2021,313065,355270,668335,COST
06006234219070000,2020,257926,242174,500100,MKT
06006234219070000,2019,257926,242174,500100,MKT
06006234219120000,2021,382886,1271410,1654296,COST
06006234219120000,2020,491863,1054537,1546400,INCOME
06006234219120000,2019,491863,1054537,1546400,INCOME
06006234219140000,2021,340986,87420,428406,COST
06006234219140000,2020,338999,85610,424609,COST
06006234219140000,2019,338999,85610,424609,COST
06006234219150000,2021,270153,18470,288623,COST
06006234219150000,2020,193035,17880,210915,COST
06006234219150000,2019,193035,17880,210915,COST
06006234219160000,2021,266380,139690,406070,COST
06006234219160000,2020,153856,171344,325200,MKT
06006234219160000,2019,153856,171344,325200,MKT
06006234219170000,2021,273071,101050,374121,COST
06006234219170000,2020,166567,117633,284200,MKT
06006234219170000,2019,166567,117633,284200,MKT
06006234220010000,2021,279610,191790,471400,INCOME
06006234220010000,2020,179922,218378,398300,INCOME
06006234220010000,2019,179922,218378,398300,INCOME
06006234220030000,2021,312225,146060,458285,COST
06006234220030000,2020,256082,136310,392392,OVR
06006234220030000,2019,258292,134100,392392,COST
06006234220060000,2021,419263,690340,1109603,COST
06006234220060000,2020,657589,1147911,1805500,INCOME
06006234220060000,2019,657589,1147911,1805500,INCOME
06006234220110000,2021,313065,180130,493195,COST
06006234220110000,2020,257926,176620,434546,COST
06006234220110000,2019,257926,206790,464716,COST
06006234220120000,2021,313065,144750,457815,COST
06006234220120000,2020,258292,144540,402832,COST
06006234220120000,2019,258292,144540,402832,COST
06006234220140000,2021,313065,200540,513605,COST
06006234220140000,2020,258292,237030,495322,COST
06006234220140000,2019,258292,237030,495322,COST
06006234220150000,2021,236653,80447,317100,INCOME
06006234220150000,2020,105517,237960,343477,COST
06006234220150000,2019,105517,237960,343477,COST
06006234220160000,2021,282586,0,282586,COST
06006234220160000,2020,186119,0,186119,COST
06006234220160000,2019,186119,0,186119,COST
06006234220170000,2021,60081,0,60081,COST
06006234220170000,2020,6699,0,6699,COST
06006234220170000,2019,6699,0,6699,COST
06006234220180000,2021,313065,485235,798300,INCOME
06006234220180000,2020,258292,310908,569200,INCOME
06006234220180000,2019,258292,310908,569200,INCOME
06006234220200000,2021,308848,104010,412858,COST
06006234220200000,2020,246975,101830,348805,COST
06006234220200000,2019,246975,101830,348805,COST
06006234220220000,2021,220468,74860,295328,COST
06006234220220000,2020,83999,117701,201700,MKT
06006234220220000,2019,83999,117701,201700,MKT
06006234220240000,2021,277885,72715,350600,INCOME
06006234220240000,2020,176394,95360,271754,COST
06006234220240000,2019,176394,95360,271754,COST
06006234220260000,2021,281323,266100,547423,COST
06006234220260000,2020,183472,260240,443712,COST
06006234220260000,2019,183472,260240,443712,COST
06006234221010000,2021,313065,403135,716200,INCOME
06006234221010000,2020,258292,333908,592200,INCOME
06006234221010000,2019,258292,333908,592200,INCOME
06006234221030000,2021,313065,128300,441365,COST
06006234221030000,2020,258292,100830,359122,COST
06006234221030000,2019,258292,100830,359122,COST
06006234221040000,2021,313065,0,313065,COST
06006234221040000,2020,257926,0,257926,COST
06006234221040000,2019,257926,0,257926,COST
06006234221050000,2021,313065,0,313065,COST
06006234221050000,2020,257926,0,257926,COST
06006234221050000,2019,257926,0,257926,COST
06006234221080000,2021,394606,1281600,1676206,COST
06006234221080000,2020,541674,1246550,1788224,COST
06006234221080000,2019,541674,1246550,1788224,COST
06006234221090000,2021,313065,19550,332615,COST
06006234221090000,2020,258292,18920,277212,COST
06006234221090000,2019,258292,18920,277212,COST
06006234221100000,2021,287430,16580,304010,COST
06006234221100000,2020,196242,0,196242,COST
06006234221100000,2019,196242,0,196242,COST
06006234221110000,2021,214624,25620,240244,COST
06006234221110000,2020,77080,24830,101910,COST
06006234221110000,2019,77080,24830,101910,COST
06006234221150000,2021,723090,245910,969000,INCOME
06006234221150000,2020,360512,343550,704062,COST
06006234221150000,2019,360512,343550,704062,COST
06006234221160000,2021,178771,0,178771,COST
06006234221160000,2020,43012,0,43012,COST
06006234221160000,2019,43012,0,43012,COST
06006234221180000,2021,323595,33640,357235,COST
06006234221180000,2020,286721,32640,319361,COST
06006234221180000,2019,286721,32640,319361,COST
06006234221190000,2021,789094,213290,1002384,COST
06006234221190000,2020,476752,199880,676632,COST
06006234221190000,2019,476752,199880,676632,COST
06006234221200000,2021,214624,65710,280334,COST
06006234221200000,2020,77080,64210,141290,COST
06006234221200000,2019,77080,64210,141290,COST
06006234222010000,2021,917559,1985141,2902700,INCOME
06006234222010000,2020,772439,2089761,2862200,INCOME
06006234222010000,2019,772439,2089761,2862200,INCOME
06006234222020000,2021,313065,857835,1170900,INCOME
06006234222020000,2020,258292,664508,922800,INCOME
06006234222020000,2019,258292,664508,922800,INCOME
06006234222040000,2021,394606,3133930,3528536,COST
06006234222040000,2020,541674,2737140,3278814,COST
06006234222040000,2019,541674,2737140,3278814,COST
06006234222060000,2021,340986,430660,771646,COST
06006234222060000,2020,339480,420080,759560,COST
06006234222060000,2019,339480,420080,759560,COST
06006234222080000,2021,340986,405114,746100,INCOME
06006234222080000,2020,339480,204220,543700,INCOME
06006234222080000,2019,339480,204220,543700,INCOME
06006234222100000,2021,313065,533340,846405,COST
06006234222100000,2020,258292,550120,808412,COST
06006234222100000,2019,258292,550120,808412,COST
06006234222110000,2021,313065,423635,736700,INCOME
06006234222110000,2020,258292,214508,472800,INCOME
06006234222110000,2019,258292,214508,472800,INCOME
06006234222120000,2021,743139,603310,1346449,COST
06006234222120000,2020,393479,487221,880700,INCOME
06006234222120000,2019,393479,487221,880700,INCOME
06006234222160000,2021,743139,420861,1164000,INCOME
06006234222160000,2020,393479,124621,518100,INCOME
06006234222160000,2019,393479,124621,518100,INCOME
06006234222180000,2021,239415,14860,254275,COST
06006234222180000,2020,109351,1080,110431,COST
06006234222180000,2019,109351,1080,110431,COST
06006234223010000,2021,357297,804300,1161597,COST
06006234223010000,2020,394216,633200,1027416,COST
06006234223010000,2019,393402,633200,1026602,COST
06006234223040000,2021,419265,78780,498045,COST
06006234223040000,2020,657596,169220,826816,COST
06006234223040000,2019,657596,169220,826816,COST
06006234223060000,2021,313065,138930,451995,COST
06006234223060000,2020,258292,127340,385632,COST
06006234223060000,2019,258292,127340,385632,COST
06006234223080000,2021,313065,56550,369615,COST
06006234223080000,2020,257926,55220,313146,COST
06006234223080000,2019,257926,55220,313146,COST
06006234223110000,2021,234419,22090,256509,COST
06006234223110000,2020,102217,20710,122927,COST
06006234223110000,2019,102217,20710,122927,COST
06006234224010000,2021,270525,291375,561900,INCOME
06006234224010000,2020,161648,254952,416600,INCOME
06006234224010000,2019,161648,254952,416600,INCOME
06006234224020000,2021,270525,381675,652200,INCOME
06006234224020000,2020,161877,12823,174700,INCOME
06006234224020000,2019,161877,12823,174700,INCOME
06006234224040000,2021,313065,228010,541075,COST
06006234224040000,2020,257926,147774,405700,MKT
06006234224040000,2019,257926,147774,405700,MKT
06006234224070000,2021,313065,2180,315245,COST
06006234224070000,2020,257926,2130,260056,COST
06006234224070000,2019,257926,2130,260056,COST
06006234224090000,2021,313065,0,313065,COST
06006234224090000,2020,257926,0,257926,COST
06006234224090000,2019,257926,0,257926,COST
06006234224130000,2021,362294,1051906,1414200,INCOME
06006234224130000,2020,412131,720469,1132600,INCOME
06006234224130000,2019,412131,720469,1132600,INCOME
06006234224180000,2021,270525,2620,273145,COST
06006234224180000,2020,161648,2660,164308,COST
06006234224180000,2019,161648,2660,164308,COST
06006234224190000,2021,270525,4850,275375,COST
06006234224190000,2020,161648,4920,166568,COST
06006234224190000,2019,161648,4920,166568,COST
06006234225010000,2021,270525,152900,423425,COST
06006234225010000,2020,161648,173352,335000,MKT
06006234225010000,2019,161648,173352,335000,MKT
06006234225020000,2021,313065,54540,367605,COST
06006234225020000,2020,257926,53530,311456,COST
06006234225020000,2019,257926,53530,311456,COST
06006234225050000,2021,270525,113075,383600,MKT
06006234225050000,2020,161648,175652,337300,MKT
06006234225050000,2019,161648,175652,337300,MKT
06006234225060000,2021,248373,53970,302343,COST
06006234225060000,2020,122989,54190,177179,COST
06006234225060000,2019,122989,54190,177179,COST
06006234225090000,2021,313065,180470,493535,COST
06006234225090000,2020,257926,151474,409400,MKT
06006234225090000,2019,257926,151474,409400,MKT
06006234225100000,2021,313065,1083835,1396900,INCOME
06006234225100000,2020,258292,632508,890800,INCOME
06006234225100000,2019,258292,632508,890800,INCOME
06006234225120000,2021,362294,0,362294,COST
06006234225120000,2020,411547,0,411547,COST
06006234225120000,2019,411547,118030,529577,COST
06006234225150000,2021,287430,36110,323540,COST
06006234225150000,2020,196242,36800,233042,COST
06006234225150000,2019,196242,36800,233042,COST
06006234226010000,2021,313065,647180,960245,COST
06006234226010000,2020,258292,665380,923672,COST
06006234226010000,2019,258292,665380,923672,COST
06006234226020000,2021,313065,535235,848300,INCOME
06006234226020000,2020,258292,413708,672000,INCOME
06006234226020000,2019,258292,413708,672000,INCOME
06006234226030000,2021,313065,79610,392675,COST
06006234226030000,2020,257926,78190,336116,COST
06006234226030000,2019,257926,78190,336116,COST
06006234226040000,2021,313065,196200,509265,COST
06006234226040000,2020,257926,123274,381200,MKT
06006234226040000,2019,257926,123274,381200,MKT
06006234226050000,2021,270525,63575,334100,INCOME
06006234226050000,2020,161877,176450,338327,COST
06006234226050000,2019,161877,176450,338327,COST
06006234226070000,2021,352243,101710,453953,COST
06006234226070000,2020,376654,230210,606864,COST
06006234226070000,2019,376654,230210,606864,COST
06006234226080000,2021,313065,429690,742755,COST
06006234226080000,2020,257926,511150,769076,COST
06006234226080000,2019,257926,511150,769076,COST
06006234227017000,2021,362294,0,362294,COST
06006234227017000,2020,412131,0,412131,COST
06006234227017000,2019,412131,0,412131,COST
06006234227020000,2021,270525,0,270525,COST
06006234227020000,2020,161648,0,161648,COST
06006234227020000,2019,161648,0,161648,COST
06006234227030000,2021,270525,46700,317225,COST
06006234227030000,2020,161648,45650,207298,COST
06006234227030000,2019,161648,45650,207298,COST
06006234227040000,2021,233766,0,233766,COST
06006234227040000,2020,101309,0,101309,COST
06006234227040000,2019,101309,0,101309,COST
06006234227060000,2021,294652,260450,555102,COST
06006234227060000,2020,212458,252450,464908,COST
06006234227060000,2019,212458,252450,464908,COST
06006234227070000,2021,313065,161240,474305,COST
06006234227070000,2020,257926,109974,367900,MKT
06006234227070000,2019,257926,109974,367900,MKT
06006234227080000,2021,270525,60475,331000,MKT
06006234227080000,2020,161648,138300,299948,COST
06006234227080000,2019,161648,138300,299948,COST
06006234227090000,2021,270525,63550,334075,COST
06006234227090000,2020,161648,39352,201000,MKT
06006234227090000,2019,161648,39352,201000,MKT
06006234227150000,2021,313065,361040,674105,COST
06006234227150000,2020,257926,346450,604376,COST
06006234227150000,2019,257926,107574,365500,MKT
06006234228010000,2021,328066,0,328066,COST
06006234228010000,2020,299589,0,299589,COST
06006234228010000,2019,299589,0,299589,COST
06006234228020000,2021,282087,257100,539187,COST
06006234228020000,2020,184808,256680,441488,COST
06006234228020000,2019,184808,256680,441488,COST
06006234228030000,2021,279200,0,279200,COST
06006234228030000,2020,178824,0,178824,COST
06006234228030000,2019,178824,0,178824,COST
06006234228040000,2021,276196,301240,577436,COST
06006234228040000,2020,172741,287259,460000,MKT
06006234228040000,2019,172741,287259,460000,MKT
06006234228050000,2021,295071,0,295071,COST
06006234228050000,2020,213425,0,213425,COST
06006234228050000,2019,213425,0,213425,COST
06006234229010000,2021,297423,308800,606223,COST
06006234229010000,2020,218916,280284,499200,MKT
06006234229010000,2019,218916,280284,499200,MKT
06006234229030000,2021,295071,215690,510761,COST
06006234229030000,2020,213425,271275,484700,MKT
06006234229030000,2019,213425,271275,484700,MKT
06006234229040000,2021,308268,735730,1043998,COST
06006234229040000,2020,245493,634540,880033,COST
06006234229040000,2019,245493,634540,880033,COST
06006234232010000,2021,1786023,0,1786023,COST
06006234232010000,2020,6505526,0,6505526,COST
06006234232010000,2019,6505526,0,6505526,COST
06006234301010000,2021,50537,0,50537,COST
06006234301010000,2020,27484,0,27484,COST
06006234301010000,2019,27484,0,27484,COST
06006234368010000,2021,962109,1949190,2911299,COST
06006234368010000,2020,1285498,1425702,2711200,INCOME
06006234368010000,2019,1285498,1425702,2711200,INCOME
06006234368400000,2021,506749,0,506749,COST
06006234368400000,2020,1102827,0,1102827,COST
06006234368400000,2019,1102827,0,1102827,COST
06006234370090000,2021,1609440,11902060,13511500,INCOME
06006234370090000,2020,6667531,3881569,10549100,INCOME
06006234370090000,2019,6667531,3881569,10549100,INCOME
06006234370500000,2021,1116003,2631597,3747600,INCOME
06006234370500000,2020,2066527,1443973,3510500,INCOME
06006234370500000,2019,2066527,1443973,3510500,INCOME
06006234370660000,2021,1285717,19166783,20452500,INCOME
06006234370660000,2020,1797278,17063119,18860397,OVR
06006234370660000,2019,1797278,17063119,18860397,OVR
06006234371010000,2021,892168,3852832,4745000,INCOME
06006234371010000,2020,1009730,3664770,4674500,INCOME
06006234371010000,2019,1009730,3664770,4674500,INCOME
06006234371090000,2021,885394,9171506,10056900,INCOME
06006234371090000,2020,985406,8096594,9082000,INCOME
06006234371090000,2019,985406,8096594,9082000,INCOME
06006234371110000,2021,150937,289320,440257,COST
06006234371110000,2020,182277,285610,467887,COST
06006234371110000,2019,182277,285610,467887,COST
06006234371130000,2021,134075,284870,418945,COST
06006234371130000,2020,124778,281040,405818,COST
06006234371130000,2019,124778,281040,405818,COST
06006234371150000,2021,134075,308300,442375,COST
06006234371150000,2020,124778,304160,428938,COST
06006234371150000,2019,124778,304160,428938,COST
06006234371170000,2021,134075,176140,310215,COST
06006234371170000,2020,124778,173780,298558,COST
06006234371170000,2019,124778,173780,298558,COST
06006234371190000,2021,134075,276180,410255,COST
06006234371190000,2020,124778,272210,396988,COST
06006234371190000,2019,124778,272210,396988,COST
06006234371210000,2021,134075,213340,347415,COST
06006234371210000,2020,124778,210480,335258,COST
06006234371210000,2019,124778,210480,335258,COST
06006234371230000,2021,134075,189910,323985,COST
06006234371230000,2020,124778,187360,312138,COST
06006234371230000,2019,124778,187360,312138,COST
06006234371250000,2021,134075,176140,310215,COST
06006234371250000,2020,124778,173780,298558,COST
06006234371250000,2019,124778,173780,298558,COST
06006234371270000,2021,134075,213340,347415,COST
06006234371270000,2020,124778,210480,335258,COST
06006234371270000,2019,124778,210480,335258,COST
06006234371290000,2021,134075,284870,418945,COST
06006234371290000,2020,124778,281040,405818,COST
06006234371290000,2019,124778,281040,405818,COST
06006234371310000,2021,134075,0,134075,COST
06006234371310000,2020,124778,0,124778,COST
06006234371310000,2019,124778,0,124778,COST
06006234371330000,2021,146126,478274,624400,INCOME
06006234371330000,2020,164333,428430,592763,COST
06006234371330000,2019,164333,428430,592763,COST
06006234373300000,2021,1235282,0,1235282,COST
06006234373300000,2020,1999869,0,1999869,COST
06006234373300000,2019,1999869,0,1999869,COST
06006234376010000,2021,965883,0,965883,COST
06006234376010000,2020,1301703,0,1301703,COST
06006234376010000,2019,1301703,0,1301703,COST
06006234376070000,2021,807086,1204360,2011446,COST
06006234376070000,2020,732738,1163190,1895928,COST
06006234376070000,2019,732738,465030,1197768,COST
06006234376110000,2021,850997,914750,1765747,COST
06006234376110000,2020,868080,888340,1756420,COST
06006234376110000,2019,868080,888340,1756420,COST
06006234376150000,2021,192559,1187841,1380400,INCOME
06006234376150000,2020,397300,833100,1230400,INCOME
06006234376150000,2019,397300,833100,1230400,INCOME
06006234378010000,2021,148033,1133767,1281800,INCOME
06006234378010000,2020,171292,1091408,1262700,INCOME
06006234378010000,2019,171292,1091408,1262700,INCOME
06006234378030000,2021,147587,679813,827400,INCOME
06006234378030000,2020,169647,436653,606300,INCOME
06006234378030000,2019,169647,175260,344907,COST
06006234378070000,2021,813924,696070,1509994,COST
06006234378070000,2020,752784,675500,1428284,COST
06006234378070000,2019,752784,675500,1428284,COST
06006234378100000,2021,859149,4987051,5846200,INCOME
06006234378100000,2020,894967,4387533,5282500,INCOME
06006234378100000,2019,894967,4387533,5282500,INCOME
06006234378140000,2021,832351,969200,1801551,COST
06006234378140000,2020,808682,956990,1765672,COST
06006234378140000,2019,808682,956990,1765672,COST
06006234378180000,2021,832351,2926649,3759000,INCOME
06006234378180000,2020,808682,2894518,3703200,INCOME
06006234378180000,2019,808682,2894518,3703200,INCOME
06006234378220000,2021,832351,969200,1801551,COST
06006234378220000,2020,808682,956990,1765672,COST
06006234378220000,2019,808682,956990,1765672,COST
06006234378250000,2021,931670,430780,1362450,COST
06006234378250000,2020,816900,391200,1208100,COST
06006234378250000,2019,816900,391200,1208100,COST
06006234378360000,2021,1104257,10357643,11461900,INCOME
06006234378360000,2020,1997738,9921262,11919000,INCOME
06006234378360000,2019,1997738,9921262,11919000,INCOME
06006234381010000,2021,1245884,248516,1494400,INCOME
06006234381010000,2020,2070020,125400,2195420,COST
06006234381010000,2019,2070020,125400,2195420,COST
06006234381220000,2021,1626845,4115400,5742245,COST
06006234381220000,2020,4860457,3964470,8824927,COST
06006234381220000,2019,4860457,3964470,8824927,COST
06006234401010000,2021,2163,0,2163,COST
06006234401010000,2020,2017,0,2017,COST
06006234401010000,2019,2017,0,2017,COST
06006235101010000,2021,11797,0,11797,COST
06006235101010000,2020,10997,0,10997,COST
06006235101010000,2019,10997,0,10997,COST
06006236101010000,2021,11552,0,11552,COST
06006236101010000,2020,10185,0,10185,COST
06006236101010000,2019,10185,0,10185,COST
06008401101010000,2021,185164,0,185164,COST
06008401101010000,2020,55864,0,55864,COST
06008401101010000,2019,55864,0,55864,COST
06008401101030000,2021,272227,150220,422447,COST
06008401101030000,2020,88211,153180,241391,COST
06008401101030000,2019,88211,153180,241391,COST
06008401101040000,2021,213296,126070,339366,COST
06008401101040000,2020,66000,79620,145620,COST
06008401101040000,2019,66000,79620,145620,COST
06008401101050000,2021,226386,471520,697906,COST
06008401101050000,2020,70893,399307,470200,MKT
06008401101050000,2019,70893,399307,470200,MKT
06008401101060000,2021,276725,139750,416475,COST
06008401101060000,2020,89941,150059,240000,MKT
06008401101060000,2019,89941,150059,240000,MKT
06008401101070000,2021,188802,0,188802,COST
06008401101070000,2020,57167,0,57167,COST
06008401101070000,2019,57167,0,57167,COST
06008401101080000,2021,188802,291098,479900,MKT
06008401101080000,2020,57167,263933,321100,MKT
06008401101080000,2019,57167,263933,321100,MKT
06008401101090000,2021,188802,0,188802,COST
06008401101090000,2020,57167,0,57167,COST
06008401101090000,2019,57167,0,57167,COST
06008401101100000,2021,188802,0,188802,COST
06008401101100000,2020,57167,0,57167,COST
06008401101100000,2019,57167,0,57167,COST
06008401101110000,2021,221407,0,221407,COST
06008401101110000,2020,69048,0,69048,COST
06008401101110000,2019,69048,0,69048,COST
06008401101120000,2021,269241,0,269241,COST
06008401101120000,2020,87065,0,87065,COST
06008401101120000,2019,87065,0,87065,COST
06008401102010000,2021,240319,0,240319,COST
06008401102010000,2020,129158,0,129158,COST
06008401102010000,2019,129158,0,129158,COST
06008402101010000,2021,244891,0,244891,COST
06008402101010000,2020,131514,0,131514,COST
06008402101010000,2019,131514,0,131514,COST
06008403101010000,2021,242024,0,242024,COST
06008403101010000,2020,130009,0,130009,COST
06008403101010000,2019,130009,0,130009,COST
06008404101010000,2021,188495,0,188495,COST
06008404101010000,2020,101913,0,101913,COST
06008404101010000,2019,101913,0,101913,COST
06008409101010000,2021,146193,0,146193,COST
06008409101010000,2020,79644,0,79644,COST
06008409101010000,2019,79644,0,79644,COST
06008410101010000,2021,241030,0,241030,COST
06008410101010000,2020,129487,0,129487,COST
06008410101010000,2019,129487,0,129487,COST
06008411101010000,2021,245661,0,245661,COST
06008411101010000,2020,131919,0,131919,COST
06008411101010000,2019,131919,0,131919,COST
06008412101010000,2021,222848,0,222848,COST
06008412101010000,2020,119943,0,119943,COST
06008412101010000,2019,119943,0,119943,COST
06008413101010000,2021,235440,0,235440,COST
06008413101010000,2020,126553,0,126553,COST
06008413101010000,2019,126553,0,126553,COST
06008414101010000,2021,244789,0,244789,COST
06008414101010000,2020,131461,0,131461,COST
06008414101010000,2019,131461,0,131461,COST
06008415101010000,2021,216671,0,216671,COST
06008415101010000,2020,116703,0,116703,COST
06008415101010000,2019,116703,0,116703,COST
06008416101010000,2021,155526,0,155526,COST
06008416101010000,2020,84590,0,84590,COST
06008416101010000,2019,84590,0,84590,COST
06008421101010000,2021,72142,0,72142,COST
06008421101010000,2020,40815,0,40815,COST
06008421101010000,2019,40815,0,40815,COST
06008422101010000,2021,193445,0,193445,COST
06008422101010000,2020,104484,0,104484,COST
06008422101010000,2019,104484,0,104484,COST
06008423101010000,2021,240740,0,240740,COST
06008423101010000,2020,129336,0,129336,COST
06008423101010000,2019,129336,0,129336,COST
06008424101010000,2021,242239,0,242239,COST
06008424101010000,2020,130145,0,130145,COST
06008424101010000,2019,130145,0,130145,COST
06008425101010000,2021,241300,0,241300,COST
06008425101010000,2020,129767,0,129767,COST
06008425101010000,2019,129767,0,129767,COST
06008426101010000,2021,221580,0,221580,COST
06008426101010000,2020,119278,0,119278,COST
06008426101010000,2019,119278,0,119278,COST
06008427101010000,2021,142833,0,142833,COST
06008427101010000,2020,77919,0,77919,COST
06008427101010000,2019,77919,0,77919,COST
06008428101010000,2021,176357,0,176357,COST
06008428101010000,2020,95539,0,95539,COST
06008428101010000,2019,95539,0,95539,COST
06008433101010000,2021,100419,0,100419,COST
06008433101010000,2020,54614,0,54614,COST
06008433101010000,2019,54614,0,54614,COST
06008434101010000,2021,159443,0,159443,COST
06008434101010000,2020,86662,0,86662,COST
06008434101010000,2019,86662,0,86662,COST
06008435101010000,2021,170480,0,170480,COST
06008435101010000,2020,92455,0,92455,COST
06008435101010000,2019,92455,0,92455,COST
06008436101010000,2021,170812,0,170812,COST
06008436101010000,2020,92609,0,92609,COST
06008436101010000,2019,92609,0,92609,COST
06008501101010000,2021,217845,0,217845,COST
06008501101010000,2020,117423,0,117423,COST
06008501101010000,2019,117423,0,117423,COST
06008502201010000,2021,173987,0,173987,COST
06008502201010000,2020,93620,0,93620,COST
06008502201010000,2019,93620,0,93620,COST
06008503101010000,2021,220419,0,220419,COST
06008503101010000,2020,118635,0,118635,COST
06008503101010000,2019,118635,0,118635,COST
06008504101010000,2021,185354,0,185354,COST
06008504101010000,2020,99826,0,99826,COST
06008504101010000,2019,99826,0,99826,COST
06008504315020000,2021,140688,0,140688,COST
06008504315020000,2020,95127,0,95127,COST
06008504315020000,2019,95127,0,95127,COST
06008504315040000,2021,140331,0,140331,COST
06008504315040000,2020,94842,0,94842,COST
06008504315040000,2019,94842,0,94842,COST
06008504316020000,2021,176282,0,176282,COST
06008504316020000,2020,124282,0,124282,COST
06008504316020000,2019,124282,0,124282,COST
06008504316040000,2021,269102,0,269102,COST
06008504316040000,2020,150748,0,150748,COST
06008504316040000,2019,150748,0,150748,COST
06008504316060000,2021,306868,0,306868,COST
06008504316060000,2020,130549,0,130549,COST
06008504316060000,2019,130549,0,130549,COST
06008504316080000,2021,302058,344240,646298,COST
06008504316080000,2020,128128,370472,498600,MKT
06008504316080000,2019,128128,370472,498600,MKT
06008504316100000,2021,333225,471120,804345,COST
06008504316100000,2020,143944,469570,613514,COST
06008504316100000,2019,143944,469570,613514,COST
06008504316120000,2021,314492,338490,652982,COST
06008504316120000,2020,134403,276697,411100,MKT
06008504316120000,2019,134403,276697,411100,MKT
06008504316140000,2021,195865,301720,497585,COST
06008504316140000,2020,140810,285690,426500,MKT
06008504316140000,2019,140810,285690,426500,MKT
06008504316150000,2021,216828,0,216828,COST
06008504316150000,2020,158845,0,158845,COST
06008504316150000,2019,158845,0,158845,COST
06008504316160000,2021,194993,180107,375100,MKT
06008504316160000,2020,140068,201932,342000,OVR
06008504316160000,2019,140068,201932,342000,MKT
06008504316180000,2021,185165,0,185165,COST
06008504316180000,2020,131739,0,131739,COST
06008504316180000,2019,131739,0,131739,COST
06008504316200000,2021,169027,268773,437800,MKT
06008504316200000,2020,118243,244957,363200,OVR
06008504316200000,2019,118243,244957,363200,MKT
06008504316220000,2021,163033,0,163033,COST
06008504316220000,2020,113289,0,113289,COST
06008504316220000,2019,113289,0,113289,COST
06008504316240000,2021,163793,304260,468053,COST
06008504316240000,2020,113916,288484,402400,MKT
06008504316240000,2019,113916,288484,402400,MKT
06008504316260000,2021,166646,259954,426600,MKT
06008504316260000,2020,116271,234629,350900,MKT
06008504316260000,2019,116271,234629,350900,MKT
06008504316280000,2021,176160,0,176160,COST
06008504316280000,2020,124180,0,124180,COST
06008504316280000,2019,124180,0,124180,COST
06008504316300000,2021,167113,190987,358100,MKT
06008504316300000,2020,116658,188342,305000,MKT
06008504316300000,2019,116658,188342,305000,MKT
06008504316320000,2021,165026,332174,497200,MKT
06008504316320000,2020,114932,336668,451600,MKT
06008504316320000,2019,114932,336668,451600,MKT
06008504316340000,2021,151531,270569,422100,MKT
06008504316340000,2020,103878,260122,364000,MKT
06008504316340000,2019,103878,260122,364000,MKT
06008504316360000,2021,183126,208974,392100,MKT
06008504316360000,2020,130022,217078,347100,MKT
06008504316360000,2019,130022,196078,326100,MKT
06008504316380000,2021,157971,235729,393700,MKT
06008504316380000,2020,109132,232968,342100,MKT
06008504316380000,2019,109132,232968,342100,MKT
06008504316400000,2021,190266,202150,392416,COST
06008504316400000,2020,136052,250848,386900,OVR
06008504316400000,2019,136052,250848,386900,MKT
06008504326020000,2021,167512,0,167512,COST
06008504326020000,2020,116988,0,116988,COST
06008504326020000,2019,116988,0,116988,COST
06008504326040000,2021,170197,464120,634317,COST
06008504326040000,2020,119214,473600,592814,OVR
06008504326040000,2019,119214,473600,592814,COST
06008504326060000,2021,167380,362420,529800,MKT
06008504326060000,2020,116878,202822,319700,MKT
06008504326060000,2019,116878,202822,319700,MKT
06008504326080000,2021,171800,317730,489530,COST
06008504326080000,2020,120546,313010,433556,OVR
06008504326080000,2019,120546,313010,433556,COST
06008504326090000,2021,166109,629410,795519,COST
06008504326090000,2020,115827,634660,750487,COST
06008504326090000,2019,115827,601560,717387,COST
06008504326100000,2021,167180,1247850,1415030,COST
06008504326100000,2020,116713,1028440,1145153,COST
06008504326100000,2019,116713,1028440,1145153,COST
06008504326140000,2021,440380,376490,816870,COST
06008504326140000,2020,200318,375880,576198,COST
06008504326140000,2019,200318,375880,576198,COST
06008504326180000,2021,258591,140590,399181,COST
06008504326180000,2020,106577,189823,296400,MKT
06008504326180000,2019,106577,189823,296400,MKT
06008504326200000,2021,233156,470790,703946,COST
06008504326200000,2020,94268,359400,453668,COST
06008504326200000,2019,94268,304350,398618,COST
06008504326220000,2021,336669,705890,1042559,COST
06008504326220000,2020,145709,690810,836519,COST
06008504326220000,2019,145709,690810,836519,COST
06008504326240000,2021,163102,0,163102,COST
06008504326240000,2020,113346,0,113346,COST
06008504326240000,2019,113346,0,113346,COST
06008504326260000,2021,177614,215586,393200,MKT
06008504326260000,2020,125396,211804,337200,MKT
06008504326260000,2019,125396,211804,337200,MKT
06008504334020000,2021,171737,0,171737,COST
06008504334020000,2020,120493,0,120493,COST
06008504334020000,2019,120493,0,120493,COST
06008504334040000,2021,162963,0,162963,COST
06008504334040000,2020,113231,0,113231,COST
06008504334040000,2019,113231,0,113231,COST
06008504334060000,2021,157162,0,157162,COST
06008504334060000,2020,108470,0,108470,COST
06008504334060000,2019,108470,0,108470,COST
06008504334080000,2021,182783,0,182783,COST
06008504334080000,2020,129733,0,129733,COST
06008504334080000,2019,129733,0,129733,COST
06008504334120000,2021,207396,0,207396,COST
06008504334120000,2020,150689,0,150689,COST
06008504334120000,2019,150689,0,150689,COST
06008504334140000,2021,172181,555594,727775,MRA
06008504334140000,2020,120862,436430,557292,OVR
06008504334140000,2019,120862,436430,557292,COST
06008504334160000,2021,203578,581090,784668,COST
06008504334160000,2020,147406,586610,734016,COST
06008504334160000,2019,147406,586610,734016,COST
06008504334180000,2021,180815,0,180815,COST
06008504334180000,2020,128079,0,128079,COST
06008504334180000,2019,128079,0,128079,COST
06008505101010000,2021,2788,0,2788,COST
06008505101010000,2020,1510,0,1510,COST
06008505101010000,2019,1510,0,1510,COST
06008505102050000,2021,153597,253010,406607,COST
06008505102050000,2020,170973,251670,422643,COST
06008505102050000,2019,170973,251670,422643,COST
06008505102060000,2021,66675,302525,369200,MKT
06008505102060000,2020,63584,271416,335000,MKT
06008505102060000,2019,63584,271416,335000,MKT
06008505103010000,2021,935,0,935,COST
06008505103010000,2020,871,0,871,COST
06008505103010000,2019,871,0,871,COST
06008505129020000,2021,163725,0,163725,COST
06008505129020000,2020,113859,0,113859,COST
06008505129020000,2019,113859,0,113859,COST
06008505129040000,2021,143399,0,143399,COST
06008505129040000,2020,97304,0,97304,COST
06008505129040000,2019,97304,0,97304,COST
06008505129060000,2021,156570,780190,936760,COST
06008505129060000,2020,107986,709290,817276,COST
06008505129060000,2019,107986,709290,817276,COST
06008505129080000,2021,174376,0,174376,COST
06008505129080000,2020,122691,0,122691,COST
06008505129080000,2019,122691,0,122691,COST
06008505129100000,2021,178214,0,178214,COST
06008505129100000,2020,125898,0,125898,COST
06008505129100000,2019,125898,0,125898,COST
06008505129120000,2021,171418,0,171418,COST
06008505129120000,2020,120228,0,120228,COST
06008505129120000,2019,120228,0,120228,COST
06008505129140000,2021,178334,0,178334,COST
06008505129140000,2020,125998,0,125998,COST
06008505129140000,2019,125998,0,125998,COST
06008505129160000,2021,185948,296480,482428,COST
06008505129160000,2020,132400,265900,398300,MKT
06008505129160000,2019,132400,265900,398300,MKT
06008505129180000,2021,160997,209103,370100,MKT
06008505129180000,2020,111614,218286,329900,MKT
06008505129180000,2019,111614,218286,329900,MKT
06008505129200000,2021,291183,0,291183,COST
06008505129200000,2020,225295,0,225295,COST
06008505129200000,2019,225295,0,225295,COST
06008505129220000,2021,172624,269976,442600,MKT
06008505129220000,2020,121231,238469,359700,OVR
06008505129220000,2019,121231,238469,359700,MKT
06008505129300000,2021,168174,285626,453800,MKT
06008505129300000,2020,117536,245564,363100,MKT
06008505129300000,2019,117536,245564,363100,MKT
06008505129320000,2021,164206,0,164206,COST
06008505129320000,2020,114256,0,114256,COST
06008505129320000,2019,114256,0,114256,COST
06008505134020000,2021,146941,0,146941,COST
06008505134020000,2020,100160,0,100160,COST
06008505134020000,2019,100160,0,100160,COST
06008505134040000,2021,167047,0,167047,COST
06008505134040000,2020,116602,0,116602,COST
06008505134040000,2019,116602,0,116602,COST
06008505134060000,2021,164617,0,164617,COST
06008505134060000,2020,114595,0,114595,COST
06008505134060000,2019,114595,0,114595,COST
06008505136020000,2021,158409,570400,728809,COST
06008505136020000,2020,109491,573390,682881,COST
06008505136020000,2019,109491,573390,682881,COST
06008505136040000,2021,158918,432620,591538,COST
06008505136040000,2020,109908,421000,530908,OVR
06008505136040000,2019,109908,421000,530908,COST
06008505136060000,2021,163033,0,163033,COST
06008505136060000,2020,113289,0,113289,COST
06008505136060000,2019,113289,0,113289,COST
06008505136080000,2021,156496,0,156496,COST
06008505136080000,2020,107925,0,107925,COST
06008505136080000,2019,107925,0,107925,COST
06008505136100000,2021,165907,0,165907,COST
06008505136100000,2020,115660,0,115660,COST
06008505136100000,2019,115660,0,115660,COST
06008505136120000,2021,156867,0,156867,COST
06008505136120000,2020,108228,0,108228,COST
06008505136120000,2019,108228,0,108228,COST
06008505138020000,2021,173128,271572,444700,MKT
06008505138020000,2020,121650,235150,356800,OVR
06008505138020000,2019,121650,235150,356800,MKT
06008505138040000,2021,158846,321640,480486,COST
06008505138040000,2020,109849,349151,459000,OVR
06008505138040000,2019,109849,349151,459000,MKT
06008505138060000,2021,159568,410590,570158,COST
06008505138060000,2020,110441,379859,490300,OVR
06008505138060000,2019,110441,379859,490300,MKT
06008505138080000,2021,159135,0,159135,COST
06008505138080000,2020,110086,0,110086,COST
06008505138080000,2019,110086,0,110086,COST
06008505138100000,2021,161493,0,161493,COST
06008505138100000,2020,112021,0,112021,COST
06008505138100000,2019,112021,0,112021,COST
06008505141020000,2021,150504,0,150504,COST
06008505141020000,2020,103045,0,103045,COST
06008505141020000,2019,103045,0,103045,COST
06008505141040000,2021,305332,0,305332,COST
06008505141040000,2020,238329,0,238329,COST
06008505141040000,2019,238329,0,238329,COST
06008505141400000,2021,136840,0,136840,COST
06008505141400000,2020,149094,0,149094,COST
06008505141400000,2019,149094,0,149094,COST
06008505141500000,2021,208695,194705,403400,INCOME
06008505141500000,2020,168740,222860,391600,INCOME
06008505141500000,2019,168740,222860,391600,INCOME
06008505141550000,2021,613059,832770,1445829,COST
06008505141550000,2020,445847,884680,1330527,OVR
06008505141550000,2019,445847,884680,1330527,COST
06008505141560000,2021,121588,668150,789738,COST
06008505141560000,2020,129607,679550,809157,COST
06008505141560000,2019,129607,679550,809157,COST
06008505141600000,2021,123561,114139,237700,MKT
06008505141600000,2020,132104,118960,251064,COST
06008505141600000,2019,132104,118960,251064,COST
06008505143010000,2021,398527,577061,975588,OVR
06008505143010000,2020,266264,518860,785124,COST
06008505143010000,2019,266264,463130,729394,COST
06008505143030000,2021,397754,288546,686300,MKT
06008505143030000,2020,265651,335580,601231,COST
06008505143030000,2019,265651,321750,587401,COST
06008505143060000,2021,333564,0,333564,COST
06008505143060000,2020,215633,0,215633,COST
06008505143060000,2019,215633,0,215633,COST
06008505143080000,2021,339258,418747,758005,OVR
06008505143080000,2020,220002,434600,654602,COST
06008505143080000,2019,220002,434600,654602,COST
06008505143100000,2021,359562,595838,955400,MKT
06008505143100000,2020,235694,534710,770404,COST
06008505143100000,2019,235694,534710,770404,COST
06008505143120000,2021,342599,0,342599,COST
06008505143120000,2020,222573,0,222573,COST
06008505143120000,2019,222573,0,222573,COST
06008505143140000,2021,424683,0,424683,COST
06008505143140000,2020,287101,0,287101,COST
06008505143140000,2019,287101,0,287101,COST
06008505143160000,2021,328889,356811,685700,MKT
06008505143160000,2020,212055,325800,537855,COST
06008505143160000,2019,212055,299830,511885,COST
06008505143180000,2021,344797,617803,962600,MKT
06008505143180000,2020,224266,647340,871606,COST
06008505143180000,2019,224266,647340,871606,COST
06008505334100000,2021,207396,402030,609426,COST
06008505334100000,2020,150689,334011,484700,MKT
06008505334100000,2019,150689,334011,484700,MKT
06008505450020000,2021,175487,0,175487,COST
06008505450020000,2020,123618,0,123618,COST
06008505450020000,2019,123618,0,123618,COST
06008505450040000,2021,167113,237487,404600,MKT
06008505450040000,2020,116658,235442,352100,MKT
06008505450040000,2019,116658,235442,352100,MKT
06008505450060000,2021,148172,183228,331400,MKT
06008505450060000,2020,101155,179845,281000,MKT
06008505450060000,2019,101155,82870,184025,COST
06008505450070000,2021,133737,0,133737,COST
06008505450070000,2020,89583,0,89583,COST
06008505450070000,2019,89583,0,89583,COST
06008505491010000,2021,328178,720922,1049100,MKT
06008505491010000,2020,211512,693390,904902,COST
06008505491010000,2019,211512,693390,904902,COST
06008506301010000,2021,684,0,684,COST
06008506301010000,2020,638,0,638,COST
06008506301010000,2019,638,0,638,COST
06008506301100000,2021,172526,211974,384500,MKT
06008506301100000,2020,51374,159726,211100,MKT
06008506301100000,2019,51374,159726,211100,MKT
06008506301120000,2021,147802,212720,360522,COST
06008506301120000,2020,42768,212050,254818,COST
06008506301120000,2019,42768,212050,254818,COST
06008506301140000,2021,193277,0,193277,COST
06008506301140000,2020,58777,0,58777,COST
06008506301140000,2019,58777,0,58777,COST
06008506301160000,2021,101475,0,101475,COST
06008506301160000,2020,27386,0,27386,COST
06008506301160000,2019,27386,0,27386,COST
06008506301170000,2021,156777,0,156777,COST
06008506301170000,2020,45864,0,45864,COST
06008506301170000,2019,45864,0,45864,COST
06008506301200000,2021,1203638,1177020,2380658,COST
06008506301200000,2020,601904,1158270,1760174,COST
06008506301200000,2019,601904,1158270,1760174,COST
06008506302010000,2021,315422,0,315422,COST
06008506302010000,2020,201802,0,201802,COST
06008506302010000,2019,201802,0,201802,COST
06008506330010000,2021,9548,0,9548,COST
06008506330010000,2020,5151,0,5151,COST
06008506330010000,2019,5151,0,5151,COST
06008507101140000,2021,456441,113160,569601,COST
06008507101140000,2020,212047,151537,363584,MRA
06008507101140000,2019,212047,151537,363584,MRA
06008507201030000,2021,181555,52290,233845,COST
06008507201030000,2020,177340,124060,301400,MKT
06008507201030000,2019,177340,124060,301400,MKT
06008507201040000,2021,115,0,115,COST
06008507201040000,2020,107,0,107,COST
06008507201040000,2019,107,0,107,COST
06008507202010000,2021,4825,0,4825,COST
06008507202010000,2020,2655,0,2655,COST
06008507202010000,2019,2655,0,2655,COST
06008507301010000,2021,115,0,115,COST
06008507301010000,2020,107,0,107,COST
06008507301010000,2019,107,0,107,COST
06008507301020000,2021,181132,207510,388642,COST
06008507301020000,2020,141481,200690,342171,COST
06008507301020000,2019,141481,200690,342171,COST
06008507301200000,2021,420,0,420,COST
06008507301200000,2020,391,0,391,COST
06008507301200000,2019,391,0,391,COST
06008507401010000,2021,3432,225750,229182,COST
06008507401010000,2020,3603,226200,229803,COST
06008507401010000,2019,3603,226200,229803,COST
06008507404010000,2021,17773,0,17773,COST
06008507404010000,2020,9886,0,9886,COST
06008507404010000,2019,9886,0,9886,COST
06008508201150000,2021,2358,1470790,1473148,COST
06008508201150000,2020,2602,1237120,1239722,COST
06008508201150000,2019,2602,1237120,1239722,COST
06008508201200000,2021,417,0,417,COST
06008508201200000,2020,389,0,389,COST
06008508201200000,2019,389,0,389,COST
06008508201400000,2021,411,0,411,COST
06008508201400000,2020,383,0,383,COST
06008508201400000,2019,383,0,383,COST
06008508301010000,2021,1190,0,1190,COST
06008508301010000,2020,1109,0,1109,COST
06008508301010000,2019,1109,0,1109,COST
06008508320010000,2021,913,0,913,COST
06008508320010000,2020,850,0,850,COST
06008508320010000,2019,850,0,850,COST
06008509101010000,2021,11746,0,11746,COST
06008509101010000,2020,6915,0,6915,COST
06008509101010000,2019,6915,0,6915,COST
06008509102037000,2021,457335,1260,458595,COST
06008509102037000,2020,356714,1250,357964,COST
06008509102037000,2019,356714,1250,357964,COST
06008509102047000,2021,418439,12440,430879,COST
06008509102047000,2020,626601,15170,641771,COST
06008509102047000,2019,626601,15170,641771,COST
06008509102200000,2021,1186785,76950,1263735,COST
06008509102200000,2020,667123,63280,730403,COST
06008509102200000,2019,667123,63280,730403,COST
06008510101100000,2021,1427065,3433735,4860800,INCOME
06008510101100000,2020,830069,1959031,2789100,INCOME
06008510101100000,2019,830069,1959031,2789100,INCOME
06008510114020000,2021,63350,0,63350,COST
06008510114020000,2020,58378,0,58378,COST
06008510114020000,2019,58378,0,58378,COST
06008510114060000,2021,68346,0,68346,COST
06008510114060000,2020,63873,0,63873,COST
06008510114060000,2019,63873,0,63873,COST
06008510114070000,2021,70381,0,70381,COST
06008510114070000,2020,66134,0,66134,COST
06008510114070000,2019,66134,0,66134,COST
06008510114090000,2021,66750,360850,427600,MKT
06008510114090000,2020,62109,260791,322900,MKT
06008510114090000,2019,62109,260791,322900,MKT
06008510114100000,2021,69376,313824,383200,MKT
06008510114100000,2020,65016,324584,389600,MKT
06008510114100000,2019,65016,324584,389600,MKT
06008510114110000,2021,63938,228062,292000,MKT
06008510114110000,2020,59020,197680,256700,MKT
06008510114110000,2019,59020,197680,256700,MKT
06008510114120000,2021,68346,542570,610916,COST
06008510114120000,2020,63873,528490,592363,COST
06008510114120000,2019,63873,528490,592363,COST
06008510114140000,2021,66203,257097,323300,MKT
06008510114140000,2020,61507,239193,300700,MKT
06008510114140000,2019,61507,239193,300700,MKT
06008510114160000,2021,68346,0,68346,COST
06008510114160000,2020,63873,0,63873,COST
06008510114160000,2019,63873,0,63873,COST
06008510114180000,2021,63350,0,63350,COST
06008510114180000,2020,58378,0,58378,COST
06008510114180000,2019,58378,0,58378,COST
06008510114200000,2021,68346,0,68346,COST
06008510114200000,2020,63873,0,63873,COST
06008510114200000,2019,63873,0,63873,COST
06008510114220000,2021,63350,181250,244600,MKT
06008510114220000,2020,58378,203122,261500,MKT
06008510114220000,2019,58378,203122,261500,MKT
06008510114240000,2021,68346,379754,448100,MKT
06008510114240000,2020,63873,355727,419600,MKT
06008510114240000,2019,63873,355727,419600,MKT
06008510114260000,2021,68346,348854,417200,MKT
06008510114260000,2020,63873,326827,390700,MKT
06008510114260000,2019,63873,326827,390700,MKT
06008510114280000,2021,67821,0,67821,COST
06008510114280000,2020,63292,0,63292,COST
06008510114280000,2019,63292,0,63292,COST
06008510114300000,2021,63350,0,63350,COST
06008510114300000,2020,58378,0,58378,COST
06008510114300000,2019,58378,0,58378,COST
06008510114320000,2021,67821,0,67821,COST
06008510114320000,2020,63292,0,63292,COST
06008510114320000,2019,63292,0,63292,COST
06008510114340000,2021,60903,269097,330000,MKT
06008510114340000,2020,55714,228086,283800,MKT
06008510114340000,2019,55714,228086,283800,MKT
06008510114360000,2021,62753,0,62753,COST
06008510114360000,2020,57726,0,57726,COST
06008510114360000,2019,57726,0,57726,COST
06008510114380000,2021,63938,0,63938,COST
06008510114380000,2020,59020,0,59020,COST
06008510114380000,2019,59020,0,59020,COST
06008510114400000,2021,62753,258547,321300,MKT
06008510114400000,2020,57726,220074,277800,MKT
06008510114400000,2019,57726,220074,277800,MKT
06008510114420000,2021,64517,255783,320300,MKT
06008510114420000,2020,59654,306346,366000,MKT
06008510114420000,2019,59654,306346,366000,MKT
06008510114440000,2021,63938,324062,388000,MKT
06008510114440000,2020,59020,314780,373800,MKT
06008510114440000,2019,59020,314780,373800,MKT
06008510114460000,2021,63938,260362,324300,MKT
06008510114460000,2020,59020,218580,277600,OVR
06008510114460000,2019,59020,218580,277600,MKT
06008510114480000,2021,63938,297562,361500,MKT
06008510114480000,2020,59020,271680,330700,MKT
06008510114480000,2019,59020,271680,330700,MKT
06008510114500000,2021,62753,297747,360500,MKT
06008510114500000,2020,57726,259574,317300,MKT
06008510114500000,2019,57726,259574,317300,MKT
06008510114520000,2021,62753,0,62753,COST
06008510114520000,2020,57726,0,57726,COST
06008510114520000,2019,57726,0,57726,COST
06008510114540000,2021,64517,0,64517,COST
06008510114540000,2020,59654,0,59654,COST
06008510114540000,2019,59654,0,59654,COST
06008510114560000,2021,65087,314913,380000,MKT
06008510114560000,2020,60279,299821,360100,MKT
06008510114560000,2019,60279,299821,360100,MKT
06008510114580000,2021,63938,0,63938,COST
06008510114580000,2020,59020,0,59020,COST
06008510114580000,2019,59020,0,59020,COST
06008510114620000,2021,70875,429925,500800,MKT
06008510114620000,2020,66684,328916,395600,MKT
06008510114620000,2019,66684,328916,395600,MKT
06008510114640000,2021,63350,0,63350,COST
06008510114640000,2020,58378,0,58378,COST
06008510114640000,2019,58378,0,58378,COST
06008510114650000,2021,92167,632250,724417,COST
06008510114650000,2020,91042,595219,686261,MRA
06008510114650000,2019,91042,595219,686261,MRA
06008510114660000,2021,68864,0,68864,COST
06008510114660000,2020,64448,0,64448,COST
06008510114660000,2019,64448,0,64448,COST
06008510114670000,2021,68864,186936,255800,MKT
06008510114670000,2020,64448,151952,216400,MKT
06008510114670000,2019,64448,151952,216400,MKT
06008510114680000,2021,68864,0,68864,COST
06008510114680000,2020,64448,0,64448,COST
06008510114680000,2019,64448,0,64448,COST
06008510114700000,2021,67821,0,67821,COST
06008510114700000,2020,63292,0,63292,COST
06008510114700000,2019,63292,0,63292,COST
06008510114720000,2021,63350,628660,692010,COST
06008510114720000,2020,58378,539312,597690,MRA
06008510114720000,2019,58378,539312,597690,MRA
06008510114740000,2021,67821,0,67821,COST
06008510114740000,2020,63292,0,63292,COST
06008510114740000,2019,63292,0,63292,COST
06008510115040000,2021,74181,258319,332500,MKT
06008510115040000,2020,70387,221230,291617,COST
06008510115040000,2019,70387,171580,241967,COST
06008510115080000,2021,67821,415479,483300,MKT
06008510115080000,2020,63292,383908,447200,MKT
06008510115080000,2019,63292,383908,447200,MKT
06008510115120000,2021,67821,301579,369400,MKT
06008510115120000,2020,63292,276008,339300,MKT
06008510115120000,2019,63292,276008,339300,MKT
06008510115160000,2021,66203,0,66203,COST
06008510115160000,2020,61507,0,61507,COST
06008510115160000,2019,61507,0,61507,COST
06008510115200000,2021,66203,270030,336233,COST
06008510115200000,2020,61507,264680,326187,OVR
06008510115200000,2019,61507,264680,326187,COST
06008510115240000,2021,68864,253536,322400,MKT
06008510115240000,2020,64448,219852,284300,MKT
06008510115240000,2019,64448,219852,284300,MKT
06008510115280000,2021,69882,0,69882,COST
06008510115280000,2020,65578,0,65578,COST
06008510115280000,2019,65578,0,65578,COST
06008510115320000,2021,67289,0,67289,COST
06008510115320000,2020,62704,0,62704,COST
06008510115320000,2019,62704,0,62704,COST
06008510115360000,2021,68864,0,68864,COST
06008510115360000,2020,64448,0,64448,COST
06008510115360000,2019,64448,0,64448,COST
06008510115400000,2021,69376,271724,341100,MKT
06008510115400000,2020,65016,229184,294200,MKT
06008510115400000,2019,65016,229184,294200,MKT
06008510115440000,2021,70381,528519,598900,MKT
06008510115440000,2020,66134,418766,484900,MKT
06008510115440000,2019,66134,418766,484900,MKT
06008510115480000,2021,77257,0,77257,COST
06008510115480000,2020,73859,0,73859,COST
06008510115480000,2019,73859,0,73859,COST
06008510116040000,2021,67821,501940,569761,COST
06008510116040000,2020,63292,468908,532200,MKT
06008510116040000,2019,63292,468908,532200,MKT
06008510116080000,2021,67821,0,67821,COST
06008510116080000,2020,63292,0,63292,COST
06008510116080000,2019,63292,0,63292,COST
06008510116100000,2021,67821,0,67821,COST
06008510116100000,2020,63292,0,63292,COST
06008510116100000,2019,63292,0,63292,COST
06008510116120000,2021,44970,0,44970,COST
06008510116120000,2020,38890,0,38890,COST
06008510116120000,2019,38890,0,38890,COST
06008510116160000,2021,71363,0,71363,COST
06008510116160000,2020,67229,0,67229,COST
06008510116160000,2019,67229,0,67229,COST
06008510116200000,2021,74633,284867,359500,MKT
06008510116200000,2020,70896,251704,322600,MKT
06008510116200000,2019,70896,251704,322600,MKT
06008510116230000,2021,60329,0,60329,COST
06008510116230000,2020,55092,0,55092,COST
06008510116230000,2019,55092,0,55092,COST
06008510116240000,2021,46995,197105,244100,MKT
06008510116240000,2020,40975,167825,208800,MKT
06008510116240000,2019,40975,167825,208800,MKT
06008510116280000,2021,71363,0,71363,COST
06008510116280000,2020,67229,0,67229,COST
06008510116280000,2019,67229,0,67229,COST
06008510116320000,2021,71363,298337,369700,MKT
06008510116320000,2020,67229,277671,344900,MKT
06008510116320000,2019,67229,277671,344900,MKT
06008510121020000,2021,71363,0,71363,COST
06008510121020000,2020,67229,0,67229,COST
06008510121020000,2019,67229,0,67229,COST
06008510121120000,2021,65649,0,65649,COST
06008510121120000,2020,60897,0,60897,COST
06008510121120000,2019,60897,0,60897,COST
06008510121140000,2021,71315,242185,313500,MKT
06008510121140000,2020,66684,187140,253824,COST
06008510121140000,2019,66684,187140,253824,COST
06008510121200000,2021,86871,397529,484400,MKT
06008510121200000,2020,87856,346944,434800,MKT
06008510121200000,2019,87856,346944,434800,MKT
06008510121256500,2021,35903,0,35903,COST
06008510121256500,2020,38014,0,38014,COST
06008510121256500,2019,38014,0,38014,COST
06008510201010000,2021,22254,0,22254,COST
06008510201010000,2020,12976,0,12976,COST
06008510201010000,2019,12976,0,12976,COST
06008510401010000,2021,217,0,217,COST
06008510401010000,2020,202,0,202,COST
06008510401010000,2019,202,0,202,COST
06008511101050000,2021,278,0,278,COST
06008511101050000,2020,259,0,259,COST
06008511101050000,2019,259,0,259,COST
06008511101060000,2021,339964,791380,1131344,COST
06008511101060000,2020,262685,779020,1041705,COST
06008511101060000,2019,262685,779020,1041705,COST
06008511201010000,2021,2868,0,2868,COST
06008511201010000,2020,1691,0,1691,COST
06008511201010000,2019,1691,0,1691,COST
06008511205010000,2021,1172,0,1172,COST
06008511205010000,2020,1091,0,1091,COST
06008511205010000,2019,1091,0,1091,COST
06008511205250000,2021,220,0,220,COST
06008511205250000,2020,205,0,205,COST
06008511205250000,2019,205,0,205,COST
06008511205300000,2021,194,0,194,COST
06008511205300000,2020,181,0,181,COST
06008511205300000,2019,181,0,181,COST
06008511205350000,2021,358,0,358,COST
06008511205350000,2020,333,0,333,COST
06008511205350000,2019,333,0,333,COST
06008511205400000,2021,283,0,283,COST
06008511205400000,2020,263,0,263,COST
06008511205400000,2019,263,0,263,COST
06008511205450000,2021,234,0,234,COST
06008511205450000,2020,217,0,217,COST
06008511205450000,2019,217,0,217,COST
06008511205500000,2021,231,0,231,COST
06008511205500000,2020,215,0,215,COST
06008511205500000,2019,215,0,215,COST
06008511205550000,2021,208,0,208,COST
06008511205550000,2020,193,0,193,COST
06008511205550000,2019,193,0,193,COST
06008511205600000,2021,202,0,202,COST
06008511205600000,2020,188,0,188,COST
06008511205600000,2019,188,0,188,COST
06008511205650000,2021,351,0,351,COST
06008511205650000,2020,327,0,327,COST
06008511205650000,2019,327,0,327,COST
06008511205700000,2021,398,0,398,COST
06008511205700000,2020,370,0,370,COST
06008511205700000,2019,370,0,370,COST
06008511301010000,2021,359607,0,359607,COST
06008511301010000,2020,280771,0,280771,COST
06008511301010000,2019,280771,0,280771,COST
06008511301050000,2021,230000,0,230000,COST
06008511301050000,2020,115000,0,115000,COST
06008511301050000,2019,115000,0,115000,COST
06008511301100000,2021,471838,0,471838,COST
06008511301100000,2020,250000,0,250000,COST
06008511301100000,2019,250000,0,250000,COST
06008511301156500,2021,200805,0,200805,COST
06008511301156500,2020,47556,0,47556,COST
06008511301156500,2019,47556,0,47556,COST
06008511302016500,2021,234802,0,234802,COST
06008511302016500,2020,177782,0,177782,COST
06008511302016500,2019,177782,0,177782,COST
06008511302030000,2021,267903,0,267903,COST
06008511302030000,2020,166293,0,166293,COST
06008511302030000,2019,166293,0,166293,COST
06008511303010000,2021,354,0,354,COST
06008511303010000,2020,330,0,330,COST
06008511303010000,2019,330,0,330,COST
06008511304010000,2021,305255,0,305255,COST
06008511304010000,2020,194116,0,194116,COST
06008511304010000,2019,194116,0,194116,COST
06008511304040000,2021,308575,0,308575,COST
06008511304040000,2020,196621,0,196621,COST
06008511304040000,2019,196621,0,196621,COST
06008511304070000,2021,277610,0,277610,COST
06008511304070000,2020,173457,0,173457,COST
06008511304070000,2019,173457,0,173457,COST
06008511304100000,2021,268900,0,268900,COST
06008511304100000,2020,167026,0,167026,COST
06008511304100000,2019,167026,0,167026,COST
06008511304130000,2021,288996,0,288996,COST
06008511304130000,2020,181922,0,181922,COST
06008511304130000,2019,181922,0,181922,COST
06008511304160000,2021,284080,0,284080,COST
06008511304160000,2020,178260,0,178260,COST
06008511304160000,2019,178260,0,178260,COST
06008512101010000,2021,6085,0,6085,COST
06008512101010000,2020,5668,0,5668,COST
06008512101010000,2019,5668,0,5668,COST
06008512101030000,2021,121588,252612,374200,MKT
06008512101030000,2020,129607,155190,284797,COST
06008512101030000,2019,129607,155190,284797,COST
06008512101660000,2021,95,0,95,COST
06008512101660000,2020,88,0,88,COST
06008512101660000,2019,88,0,88,COST
06008512110010000,2021,1426,0,1426,COST
06008512110010000,2020,1328,0,1328,COST
06008512110010000,2019,1328,0,1328,COST
06008512110260000,2021,1264,0,1264,COST
06008512110260000,2020,1177,0,1177,COST
06008512110260000,2019,1177,0,1177,COST
06008512201150000,2021,24192,242100,266292,COST
06008512201150000,2020,17013,240480,257493,COST
06008512201150000,2019,17013,316150,333163,COST
06008512201450000,2021,141,0,141,COST
06008512201450000,2020,132,0,132,COST
06008512201450000,2019,132,0,132,COST
06008512401010000,2021,1072,0,1072,COST
06008512401010000,2020,999,0,999,COST
06008512401010000,2019,999,0,999,COST
06008513101100000,2021,346208,0,346208,COST
06008513101100000,2020,568738,0,568738,COST
06008513101100000,2019,568738,0,568738,COST
06008513101120000,2021,359562,706790,1066352,COST
06008513101120000,2020,235694,560130,795824,OVR
06008513101120000,2019,235694,560130,795824,COST
06008513101130000,2021,292197,597750,889947,COST
06008513101130000,2020,184313,561880,746193,COST
06008513101130000,2019,184313,561880,746193,COST
06008513101140000,2021,619773,0,619773,COST
06008513101140000,2020,449388,0,449388,COST
06008513101140000,2019,449388,0,449388,COST
06008513101150000,2021,256139,75140,331279,COST
06008513101150000,2020,157672,71110,228782,COST
06008513101150000,2019,157672,71110,228782,COST
06008513101180000,2021,394374,402170,796544,COST
06008513101180000,2020,262978,340070,603048,COST
06008513101180000,2019,262978,340070,603048,COST
06008513101200000,2021,346208,360492,706700,MKT
06008513101200000,2020,208400,330140,538540,COST
06008513101200000,2019,208400,278920,487320,COST
06008514201010000,2021,445,0,445,COST
06008514201010000,2020,414,0,414,COST
06008514201010000,2019,414,0,414,COST
06008514301010000,2021,60,0,60,COST
06008514301010000,2020,56,0,56,COST
06008514301010000,2019,56,0,56,COST
06008515101010000,2021,7499,0,7499,COST
06008515101010000,2020,5167,0,5167,COST
06008515101010000,2019,5167,0,5167,COST
06008517201010000,2021,635,0,635,COST
06008517201010000,2020,592,0,592,COST
06008517201010000,2019,592,0,592,COST
06008517301010000,2021,5414,0,5414,COST
06008517301010000,2020,2915,0,2915,COST
06008517301010000,2019,2915,0,2915,COST
06008518101010000,2021,231533,0,231533,COST
06008518101010000,2020,124467,0,124467,COST
06008518101010000,2019,124467,0,124467,COST
06008519101010000,2021,237491,0,237491,COST
06008519101010000,2020,127630,0,127630,COST
06008519101010000,2019,127630,0,127630,COST
06008520301010000,2021,69525,0,69525,COST
06008520301010000,2020,37347,0,37347,COST
06008520301010000,2019,37347,0,37347,COST
06008522101010000,2021,118287,0,118287,COST
06008522101010000,2020,64811,0,64811,COST
06008522101010000,2019,64811,0,64811,COST
06008523101010000,2021,456,0,456,COST
06008523101010000,2020,425,0,425,COST
06008523101010000,2019,425,0,425,COST
06008523101150000,2021,2477,75700,78177,COST
06008523101150000,2020,2307,77800,80107,COST
06008523101150000,2019,2307,77800,80107,COST
06008523201010000,2021,228,0,228,COST
06008523201010000,2020,213,0,213,COST
06008523201010000,2019,213,0,213,COST
06008523301010000,2021,24948,0,24948,COST
06008523301010000,2020,14272,0,14272,COST
06008523301010000,2019,14272,0,14272,COST
06008523401010000,2021,228,0,228,COST
06008523401010000,2020,213,0,213,COST
06008523401010000,2019,213,0,213,COST
06008523401100000,2021,2083,2047230,2049313,COST
06008523401100000,2020,213,0,213,COST
06008523401100000,2019,213,0,213,COST
06008523401200000,2021,277,0,277,COST
06008523401200000,2020,258,0,258,COST
06008523401200000,2019,258,0,258,COST
06008523401300000,2021,1970,0,1970,COST
06008523401300000,2020,1835,0,1835,COST
06008523401300000,2019,1835,0,1835,COST
06008524101010000,2021,182190,0,182190,COST
06008524101010000,2020,98464,0,98464,COST
06008524101010000,2019,98464,0,98464,COST
06008524101030000,2021,56329,0,56329,COST
06008524101030000,2020,52066,0,52066,COST
06008524101030000,2019,52066,0,52066,COST
06008524101050000,2021,97227,21940,119167,COST
06008524101050000,2020,99433,21960,121393,COST
06008524101050000,2019,99433,21960,121393,COST
06008524101060000,2021,766795,854030,1620825,COST
06008524101060000,2020,578359,721750,1300109,COST
06008524101060000,2019,578359,721750,1300109,COST
06008524101070000,2021,38438,178062,216500,MKT
06008524101070000,2020,33100,215500,248600,MKT
06008524101070000,2019,33100,215500,248600,MKT
06008524201300000,2021,2296,0,2296,COST
06008524201300000,2020,2137,0,2137,COST
06008524201300000,2019,2137,0,2137,COST
06008524204010000,2021,67340,184760,252100,MKT
06008524204010000,2020,64338,157062,221400,MKT
06008524204010000,2019,64338,157062,221400,MKT
06008524204100000,2021,67340,0,67340,COST
06008524204100000,2020,64338,0,64338,COST
06008524204100000,2019,64338,0,64338,COST
06008524204140000,2021,67340,0,67340,COST
06008524204140000,2020,64338,0,64338,COST
06008524204140000,2019,64338,0,64338,COST
06008524204150000,2021,67340,0,67340,COST
06008524204150000,2020,64338,0,64338,COST
06008524204150000,2019,64338,0,64338,COST
06008524204170000,2021,67340,22720,90060,COST
06008524204170000,2020,64338,22690,87028,COST
06008524204170000,2019,64338,22690,87028,COST
06008524204180000,2021,67340,281860,349200,MKT
06008524204180000,2020,64338,209662,274000,MKT
06008524204180000,2019,64338,209662,274000,MKT
06008524208010000,2021,67340,1910,69250,COST
06008524208010000,2020,64338,1930,66268,COST
06008524208010000,2019,64338,1930,66268,COST
06008524208100000,2021,67340,0,67340,COST
06008524208100000,2020,64338,0,64338,COST
06008524208100000,2019,64338,0,64338,COST
06008524208120000,2021,67340,133060,200400,MKT
06008524208120000,2020,64338,136262,200600,OVR
06008524208120000,2019,64338,136262,200600,MKT
06008524208140000,2021,67340,0,67340,COST
06008524208140000,2020,64338,0,64338,COST
06008524208140000,2019,64338,0,64338,COST
06008524210010000,2021,67340,660,68000,COST
06008524210010000,2020,64338,680,65018,COST
06008524210010000,2019,64338,680,65018,COST
06008524210060000,2021,67340,0,67340,COST
06008524210060000,2020,64338,0,64338,COST
06008524210060000,2019,64338,0,64338,COST
06008524212010000,2021,65667,0,65667,COST
06008524212010000,2020,62448,0,62448,COST
06008524212010000,2019,62448,0,62448,COST
06008524212060000,2021,73297,103870,177167,MRA
06008524212060000,2020,71137,50970,122107,COST
06008524212060000,2019,71137,50970,122107,COST
06008524212180000,2021,66749,186951,253700,MKT
06008524212180000,2020,63669,178531,242200,MKT
06008524212180000,2019,63669,178531,242200,MKT
06008524302010000,2021,68163,278237,346400,MKT
06008524302010000,2020,65271,227629,292900,MKT
06008524302010000,2019,65271,227629,292900,MKT
06008524302040000,2021,53292,850,54142,COST
06008524302040000,2020,48756,930,49686,COST
06008524302040000,2019,48756,930,49686,COST
06008524304010000,2021,43844,245156,289000,MKT
06008524304010000,2020,38688,224512,263200,MKT
06008524304010000,2019,38688,224512,263200,MKT
06008524304020000,2021,48992,317608,366600,MKT
06008524304020000,2020,44128,272372,316500,MKT
06008524304020000,2019,44128,272372,316500,MKT
06008524304030000,2021,42978,0,42978,COST
06008524304030000,2020,37783,0,37783,COST
06008524304030000,2019,37783,0,37783,COST
06008524304040000,2021,42978,243622,286600,MKT
06008524304040000,2020,37783,201317,239100,MKT
06008524304040000,2019,37783,201317,239100,MKT
06008524304050000,2021,43794,177706,221500,MKT
06008524304050000,2020,38635,153965,192600,MKT
06008524304050000,2019,38635,153965,192600,MKT
06008524304060000,2021,45450,266550,312000,MKT
06008524304060000,2020,40372,239720,280092,COST
06008524304060000,2019,40372,239720,280092,COST
06008524304070000,2021,43895,339270,383165,COST
06008524304070000,2020,38740,349320,388060,COST
06008524304070000,2019,38740,349320,388060,COST
06008524304080000,2021,52782,305818,358600,MKT
06008524304080000,2020,48203,260297,308500,MKT
06008524304080000,2019,48203,260297,308500,MKT
06008524304090000,2021,47365,433735,481100,MKT
06008524304090000,2020,42396,312804,355200,MKT
06008524304090000,2019,42396,312804,355200,MKT
06008524304100000,2021,50809,292491,343300,MKT
06008524304100000,2020,46075,261525,307600,MKT
06008524304100000,2019,46075,261525,307600,MKT
06008524304110000,2021,46965,306835,353800,MKT
06008524304110000,2020,41973,295927,337900,MKT
06008524304110000,2019,41973,295927,337900,MKT
06008524304120000,2021,48061,337139,385200,MKT
06008524304120000,2020,43136,311464,354600,MKT
06008524304120000,2019,43136,332764,375900,MKT
06008524304130000,2021,50216,0,50216,COST
06008524304130000,2020,45438,0,45438,COST
06008524304130000,2019,45438,0,45438,COST
06008524304140000,2021,52965,353235,406200,MKT
06008524304140000,2020,48401,301299,349700,MKT
06008524304140000,2019,48401,295099,343500,MKT
06008524304150000,2021,48061,391939,440000,MKT
06008524304150000,2020,43136,299864,343000,MKT
06008524304150000,2019,43136,299864,343000,MKT
06008524304160000,2021,42874,0,42874,COST
06008524304160000,2020,37675,0,37675,COST
06008524304160000,2019,37675,0,37675,COST
06008524304170000,2021,40586,312914,353500,MKT
06008524304170000,2020,35304,308396,343700,MKT
06008524304170000,2019,35304,328296,363600,MKT
06008524304180000,2021,45021,308879,353900,MKT
06008524304180000,2020,39922,0,39922,COST
06008524304180000,2019,39922,0,39922,COST
06008524304190000,2021,44780,270120,314900,MKT
06008524304190000,2020,39669,259031,298700,MKT
06008524304190000,2019,39669,258431,298100,MKT
06008524304200000,2021,42926,0,42926,COST
06008524304200000,2020,37729,0,37729,COST
06008524304200000,2019,37729,0,37729,COST
06008524304210000,2021,44586,446014,490600,MKT
06008524304210000,2020,39465,399535,439000,MKT
06008524304210000,2019,39465,399535,439000,MKT
06008524304220000,2021,42717,296783,339500,MKT
06008524304220000,2020,37511,271889,309400,MKT
06008524304220000,2019,37511,271889,309400,MKT
06008524304230000,2021,42454,311646,354100,MKT
06008524304230000,2020,37238,247262,284500,MKT
06008524304230000,2019,37238,247262,284500,MKT
06008524304250000,2021,41865,0,41865,COST
06008524304250000,2020,36626,0,36626,COST
06008524304250000,2019,36626,0,36626,COST
06008524304267000,2021,128992,15150,144142,COST
06008524304267000,2020,366708,14880,381588,COST
06008524304267000,2019,366708,14880,381588,COST
06008524304280000,2021,47453,262447,309900,MKT
06008524304280000,2020,42490,218710,261200,MKT
06008524304280000,2019,42490,218710,261200,MKT
06008524304290000,2021,45165,303935,349100,MKT
06008524304290000,2020,40073,281527,321600,MKT
06008524304290000,2019,40073,281527,321600,MKT
06008524304300000,2021,45165,0,45165,COST
06008524304300000,2020,40073,206670,246743,COST
06008524304300000,2019,40073,206670,246743,COST
06008524304310000,2021,43133,234167,277300,MKT
06008524304310000,2020,37944,194456,232400,MKT
06008524304310000,2019,37944,194456,232400,MKT
06008524304320000,2021,50848,239652,290500,MKT
06008524304320000,2020,46117,205383,251500,MKT
06008524304320000,2019,46117,205383,251500,MKT
06008524305010000,2021,76888,215712,292600,INCOME
06008524305010000,2020,51667,207733,259400,INCOME
06008524305010000,2019,51667,207733,259400,INCOME
06008524305020000,2021,44780,0,44780,COST
06008524305020000,2020,39669,0,39669,COST
06008524305020000,2019,39669,0,39669,COST
06008524305030000,2021,45778,239420,285198,COST
06008524305030000,2020,40718,212482,253200,MKT
06008524305030000,2019,40718,212482,253200,MKT
06008524305040000,2021,68437,210163,278600,INCOME
06008524305040000,2020,45006,160594,205600,INCOME
06008524305040000,2019,45006,160594,205600,INCOME
06008524305050000,2021,60427,468973,529400,MKT
06008524305050000,2020,56585,438115,494700,MKT
06008524305050000,2019,56585,438115,494700,MKT
06008524305070000,2021,49282,270618,319900,MKT
06008524305070000,2020,44438,247462,291900,MKT
06008524305070000,2019,44438,247462,291900,MKT
06008524305120000,2021,56064,246336,302400,MKT
06008524305120000,2020,51776,206524,258300,MKT
06008524305120000,2019,39001,207099,246100,MKT
06008524305140000,2021,47188,284312,331500,MKT
06008524305140000,2020,42209,239091,281300,MKT
06008524305140000,2019,42209,239091,281300,MKT
06008524305150000,2021,44586,0,44586,COST
06008524305150000,2020,39465,0,39465,COST
06008524305150000,2019,39465,0,39465,COST
06008524305160000,2021,65194,225806,291000,INCOME
06008524305160000,2020,42490,191410,233900,INCOME
06008524305160000,2019,42490,191410,233900,INCOME
06008524305170000,2021,46241,228759,275000,MKT
06008524305170000,2020,41207,162520,203727,COST
06008524305170000,2019,41207,162520,203727,COST
06008524305180000,2021,44537,264963,309500,MKT
06008524305180000,2020,39413,241187,280600,MKT
06008524305180000,2019,39413,241187,280600,MKT
06008524305190000,2021,51082,236218,287300,MKT
06008524305190000,2020,46368,191332,237700,MKT
06008524305190000,2019,46368,191332,237700,MKT
06008524305200000,2021,51506,347694,399200,MKT
06008524305200000,2020,46825,287975,334800,MKT
06008524305200000,2019,46825,287975,334800,MKT
06008524305210000,2021,59806,0,59806,COST
06008524305210000,2020,55897,0,55897,COST
06008524305210000,2019,55897,0,55897,COST
06008524306010000,2021,66375,0,66375,COST
06008524306010000,2020,63246,0,63246,COST
06008524306010000,2019,63246,0,63246,COST
06008524306020000,2021,42454,278746,321200,MKT
06008524306020000,2020,37238,238762,276000,MKT
06008524306020000,2019,37238,238762,276000,MKT
06008524306030000,2021,43542,248758,292300,MKT
06008524306030000,2020,38371,210129,248500,MKT
06008524306030000,2019,38371,210129,248500,MKT
06008524306040000,2021,43744,252856,296600,MKT
06008524306040000,2020,38583,210217,248800,MKT
06008524306040000,2019,38583,210217,248800,MKT
06008524306050000,2021,46741,299359,346100,MKT
06008524306050000,2020,41735,225765,267500,MKT
06008524306050000,2019,41735,225765,267500,MKT
06008524306060000,2021,42822,0,42822,COST
06008524306060000,2020,37620,0,37620,COST
06008524306060000,2019,37620,0,37620,COST
06008524306070000,2021,47232,282968,330200,MKT
06008524306070000,2020,42256,233544,275800,MKT
06008524306070000,2019,42256,233544,275800,MKT
06008524306080000,2021,44973,0,44973,COST
06008524306080000,2020,39871,0,39871,COST
06008524306080000,2019,39871,0,39871,COST
06008524306090000,2021,45069,0,45069,COST
06008524306090000,2020,39972,0,39972,COST
06008524306090000,2019,39972,0,39972,COST
06008524306100000,2021,47010,0,47010,COST
06008524306100000,2020,42020,0,42020,COST
06008524306100000,2019,42020,0,42020,COST
06008524306110000,2021,44973,312927,357900,MKT
06008524306110000,2020,39871,305829,345700,MKT
06008524306110000,2019,39871,305829,345700,MKT
06008524306120000,2021,45069,0,45069,COST
06008524306120000,2020,39972,0,39972,COST
06008524306120000,2019,39972,0,39972,COST
06008524306130000,2021,47497,339803,387300,MKT
06008524306130000,2020,42536,309964,352500,MKT
06008524306130000,2019,42536,309964,352500,MKT
06008524306140000,2021,45544,0,45544,COST
06008524306140000,2020,40471,0,40471,COST
06008524306140000,2019,40471,0,40471,COST
06008524306150000,2021,46287,0,46287,COST
06008524306150000,2020,41255,0,41255,COST
06008524306150000,2019,41255,0,41255,COST
06008524306160000,2021,46786,0,46786,COST
06008524306160000,2020,41783,0,41783,COST
06008524306160000,2019,41783,0,41783,COST
06008524306170000,2021,47055,0,47055,COST
06008524306170000,2020,42067,0,42067,COST
06008524306170000,2019,42067,0,42067,COST
06008524306180000,2021,45685,0,45685,COST
06008524306180000,2020,40620,0,40620,COST
06008524306180000,2019,40620,0,40620,COST
06008524306190000,2021,45685,0,45685,COST
06008524306190000,2020,40620,0,40620,COST
06008524306190000,2019,40620,0,40620,COST
06008524306200000,2021,94102,0,94102,COST
06008524306200000,2020,95657,0,95657,COST
06008524306200000,2019,95657,0,95657,COST
06008524306210000,2021,44094,269306,313400,MKT
06008524306210000,2020,38949,211451,250400,MKT
06008524306210000,2019,38949,211451,250400,MKT
06008524306220000,2021,42134,0,42134,COST
06008524306220000,2020,36906,0,36906,COST
06008524306220000,2019,36906,0,36906,COST
06008524306230000,2021,42134,206366,248500,MKT
06008524306230000,2020,36906,164860,201766,COST
06008524306230000,2019,36906,164860,201766,COST
06008524306240000,2021,43236,0,43236,COST
06008524306240000,2020,38052,0,38052,COST
06008524306240000,2019,38052,0,38052,COST
06008524306250000,2021,42822,0,42822,COST
06008524306250000,2020,37620,0,37620,COST
06008524306250000,2019,37620,0,37620,COST
06008524306260000,2021,47975,364725,412700,MKT
06008524306260000,2020,43045,319955,363000,MKT
06008524306260000,2019,43045,319955,363000,MKT
06008524306270000,2021,43593,0,43593,COST
06008524306270000,2020,38424,0,38424,COST
06008524306270000,2019,38424,0,38424,COST
06008524306280000,2021,42978,336822,379800,MKT
06008524306280000,2020,37783,320317,358100,MKT
06008524306280000,2019,37783,320317,358100,MKT
06008524306290000,2021,40586,0,40586,COST
06008524306290000,2020,35304,0,35304,COST
06008524306290000,2019,35304,0,35304,COST
06008524306300000,2021,40586,0,40586,COST
06008524306300000,2020,35304,0,35304,COST
06008524306300000,2019,35304,0,35304,COST
06008524306310000,2021,42081,0,42081,COST
06008524306310000,2020,36850,0,36850,COST
06008524306310000,2019,36850,0,36850,COST
06008524306320000,2021,44292,0,44292,COST
06008524306320000,2020,39156,0,39156,COST
06008524306320000,2019,39156,0,39156,COST
06008524306330000,2021,46831,0,46831,COST
06008524306330000,2020,41830,0,41830,COST
06008524306330000,2019,41830,0,41830,COST
06008524306340000,2021,49406,278894,328300,MKT
06008524306340000,2020,44570,232430,277000,MKT
06008524306340000,2019,44570,232430,277000,MKT
06008524306350000,2021,48573,0,48573,COST
06008524306350000,2020,43681,0,43681,COST
06008524306350000,2019,43681,0,43681,COST
06008524306360000,2021,47932,339268,387200,MKT
06008524306360000,2020,42999,315801,358800,MKT
06008524306360000,2019,42999,315801,358800,MKT
06008524306370000,2021,44193,0,44193,COST
06008524306370000,2020,39053,0,39053,COST
06008524306370000,2019,39053,0,39053,COST
06008524306380000,2021,44586,531014,575600,MKT
06008524306380000,2020,39465,469735,509200,MKT
06008524306380000,2019,39465,462835,502300,MKT
06008524306390000,2021,44044,252856,296900,MKT
06008524306390000,2020,38897,251903,290800,MKT
06008524306390000,2019,38897,253203,292100,MKT
06008524306400000,2021,44635,211265,255900,MKT
06008524306400000,2020,39516,178584,218100,MKT
06008524306400000,2019,39516,178584,218100,MKT
06008524306410000,2021,48741,276659,325400,MKT
06008524306410000,2020,43860,242940,286800,MKT
06008524306410000,2019,43860,242940,286800,MKT
06008524306420000,2021,45685,266115,311800,MKT
06008524306420000,2020,40620,226380,267000,MKT
06008524306420000,2019,40620,226380,267000,MKT
06008524306430000,2021,47802,278298,326100,MKT
06008524306430000,2020,42861,219339,262200,MKT
06008524306430000,2019,42861,219339,262200,MKT
06008524306440000,2021,41647,0,41647,COST
06008524306440000,2020,36400,0,36400,COST
06008524306440000,2019,36400,0,36400,COST
06008524306450000,2021,42926,0,42926,COST
06008524306450000,2020,37729,0,37729,COST
06008524306450000,2019,37729,0,37729,COST
06008524306460000,2021,42612,0,42612,COST
06008524306460000,2020,37402,0,37402,COST
06008524306460000,2019,37402,0,37402,COST
06008524306470000,2021,42717,235783,278500,MKT
06008524306470000,2020,37511,195589,233100,MKT
06008524306470000,2019,37511,195589,233100,MKT
06008524306480000,2021,40529,0,40529,COST
06008524306480000,2020,35245,0,35245,COST
06008524306480000,2019,35245,0,35245,COST
06008524306490000,2021,43236,253664,296900,MKT
06008524306490000,2020,38052,212348,250400,MKT
06008524306490000,2019,38052,212348,250400,MKT
06008524306500000,2021,45260,263240,308500,MKT
06008524306500000,2020,40173,283827,324000,MKT
06008524306500000,2019,40173,239827,280000,MKT
06008524306510000,2021,47759,9750,57509,COST
06008524306510000,2020,42814,9330,52144,COST
06008524306510000,2019,42814,9330,52144,COST
06008524307010000,2021,60632,348368,409000,MKT
06008524307010000,2020,56813,329087,385900,MKT
06008524307010000,2019,56813,329087,385900,MKT
06008524307036500,2021,29867,0,29867,COST
06008524307036500,2020,30563,0,30563,COST
06008524307036500,2019,30563,0,30563,COST
06008524307050000,2021,151261,7140,158401,COST
06008524307050000,2020,167896,6880,174776,COST
06008524307050000,2019,167896,6880,174776,COST
06008524308010000,2021,45964,244236,290200,MKT
06008524308010000,2020,40914,203686,244600,MKT
06008524308010000,2019,40914,203686,244600,MKT
06008524308020000,2021,45165,212135,257300,MKT
06008524308020000,2020,40073,181327,221400,MKT
06008524308020000,2019,40073,181327,221400,MKT
06008524308030000,2021,43440,304860,348300,MKT
06008524308030000,2020,38265,258835,297100,MKT
06008524308030000,2019,38265,272135,310400,MKT
06008524308040000,2021,43440,425570,469010,COST
06008524308040000,2020,38265,381263,419528,OVR
06008524308040000,2019,38265,381263,419528,OVR
06008524308050000,2021,43338,0,43338,COST
06008524308050000,2020,38159,0,38159,COST
06008524308050000,2019,38159,0,38159,COST
06008524308060000,2021,40643,0,40643,COST
06008524308060000,2020,35363,0,35363,COST
06008524308060000,2019,35363,0,35363,COST
06008524308070000,2021,42081,361619,403700,MKT
06008524308070000,2020,36850,317250,354100,MKT
06008524308070000,2019,36850,317250,354100,MKT
06008524308080000,2021,44341,0,44341,COST
06008524308080000,2020,39208,0,39208,COST
06008524308080000,2019,39208,0,39208,COST
06008524308090000,2021,46965,0,46965,COST
06008524308090000,2020,41973,0,41973,COST
06008524308090000,2019,41973,0,41973,COST
06008524308100000,2021,53147,0,53147,COST
06008524308100000,2020,48599,0,48599,COST
06008524308100000,2019,48599,0,48599,COST
06008524308116500,2021,32755,0,32755,COST
06008524308116500,2020,34096,0,34096,COST
06008524308116500,2019,34096,0,34096,COST
06008524309010000,2021,52188,0,52188,COST
06008524309010000,2020,47561,0,47561,COST
06008524309010000,2019,47561,0,47561,COST
06008524309020000,2021,39950,229550,269500,MKT
06008524309020000,2020,34649,191451,226100,MKT
06008524309020000,2019,34649,191451,226100,MKT
06008524309030000,2021,51735,334465,386200,MKT
06008524309030000,2020,47072,289428,336500,MKT
06008524309030000,2019,47072,289428,336500,MKT
06008524309050000,2021,39297,349403,388700,MKT
06008524309050000,2020,33978,320022,354000,MKT
06008524309050000,2019,33978,320022,354000,MKT
06008524309060000,2021,42188,0,42188,COST
06008524309060000,2020,36961,0,36961,COST
06008524309060000,2019,36961,0,36961,COST
06008524309070000,2021,38250,318350,356600,MKT
06008524309070000,2020,32908,294592,327500,OVR
06008524309070000,2019,32908,294592,327500,MKT
06008524309080000,2021,39477,0,39477,COST
06008524309080000,2020,34163,0,34163,COST
06008524309080000,2019,34163,0,34163,COST
06008524309090000,2021,38438,0,38438,COST
06008524309090000,2020,33100,0,33100,COST
06008524309090000,2019,33100,0,33100,COST
06008524310010000,2021,38500,0,38500,COST
06008524310010000,2020,33164,0,33164,COST
06008524310010000,2019,33164,0,33164,COST
06008524310020000,2021,52263,232637,284900,MKT
06008524310020000,2020,47642,193258,240900,MKT
06008524310020000,2019,47642,193258,240900,MKT
06008524310040000,2021,43030,202370,245400,MKT
06008524310040000,2020,37837,167663,205500,MKT
06008524310040000,2019,37837,167663,205500,MKT
06008524310050000,2021,43389,265411,308800,MKT
06008524310050000,2020,38212,224288,262500,MKT
06008524310050000,2019,38212,224288,262500,MKT
06008524310060000,2021,39055,0,39055,COST
06008524310060000,2020,33730,0,33730,COST
06008524310060000,2019,33730,0,33730,COST
06008524310070000,2021,38438,1970,40408,COST
06008524310070000,2020,33100,2020,35120,COST
06008524310070000,2019,33100,0,33100,COST
06008524310080000,2021,38375,0,38375,COST
06008524310080000,2020,33036,0,33036,COST
06008524310080000,2019,33036,0,33036,COST
06008524310090000,2021,46332,50650,96982,COST
06008524310090000,2020,41303,51150,92453,COST
06008524310090000,2019,41303,51150,92453,COST
06008524311010000,2021,48488,0,48488,COST
06008524311010000,2020,43591,0,43591,COST
06008524311010000,2019,43591,0,43591,COST
06008524311016500,2021,44801,18510,63311,COST
06008524311016500,2020,49421,18190,67611,COST
06008524311016500,2019,49421,18190,67611,COST
06008524311030000,2021,47010,257890,304900,MKT
06008524311030000,2020,42020,220680,262700,MKT
06008524311030000,2019,42020,220680,262700,MKT
06008524311040000,2021,42717,259683,302400,MKT
06008524311040000,2020,37511,218789,256300,MKT
06008524311040000,2019,37511,189089,226600,MKT
06008524311060000,2021,58655,223045,281700,MKT
06008524311060000,2020,54623,196177,250800,MKT
06008524311060000,2019,54623,196177,250800,MKT
06008525101200000,2021,184005,0,184005,COST
06008525101200000,2020,94869,0,94869,COST
06008525101200000,2019,94869,0,94869,COST
06008525101210000,2021,184835,227665,412500,MKT
06008525101210000,2020,95377,204923,300300,MKT
06008525101210000,2019,95377,204923,300300,MKT
06008525101220000,2021,184629,0,184629,COST
06008525101220000,2020,95250,0,95250,COST
06008525101220000,2019,95250,0,95250,COST
06008525101230000,2021,184629,226890,411519,COST
06008525101230000,2020,95250,228690,323940,COST
06008525101230000,2019,95250,228690,323940,COST
06008525101240000,2021,184629,0,184629,COST
06008525101240000,2020,95250,0,95250,COST
06008525101240000,2019,95250,0,95250,COST
06008525101250000,2021,184629,264580,449209,COST
06008525101250000,2020,95250,261050,356300,MKT
06008525101250000,2019,95250,261050,356300,MKT
06008525101260000,2021,235505,368290,603795,COST
06008525101260000,2020,127102,374320,501422,COST
06008525101260000,2019,127102,374320,501422,COST
06008525101380000,2021,1173,0,1173,COST
06008525101380000,2020,1092,0,1092,COST
06008525101380000,2019,1092,0,1092,COST
06008525101406500,2021,77769,0,77769,COST
06008525101406500,2020,52110,0,52110,COST
06008525101406500,2019,52110,0,52110,COST
06008525101420000,2021,121588,190812,312400,MKT
06008525101420000,2020,129607,190793,320400,MKT
06008525101420000,2019,129607,190793,320400,MKT
06008525102010000,2021,57014,214886,271900,MKT
06008525102010000,2020,52817,187683,240500,MKT
06008525102010000,2019,52817,187683,240500,MKT
06008525102060000,2021,50216,0,50216,COST
06008525102060000,2020,45438,0,45438,COST
06008525102060000,2019,45438,0,45438,COST
06008525102100000,2021,49813,0,49813,COST
06008525102100000,2020,45006,0,45006,COST
06008525102100000,2019,45006,0,45006,COST
06008525104010000,2021,49813,446587,496400,MKT
06008525104010000,2020,45006,432194,477200,MKT
06008525104010000,2019,45006,432194,477200,MKT
06008525104100000,2021,71742,423058,494800,MKT
06008525104100000,2020,69352,387748,457100,MKT
06008525104100000,2019,69352,387748,457100,MKT
06008525104140000,2021,56362,353438,409800,MKT
06008525104140000,2020,52102,301598,353700,MKT
06008525104140000,2019,52102,301598,353700,MKT
06008525104180000,2021,53616,240484,294100,MKT
06008525104180000,2020,49107,200393,249500,MKT
06008525104180000,2019,49107,200393,249500,MKT
06008525104220000,2021,49813,0,49813,COST
06008525104220000,2020,45006,0,45006,COST
06008525104220000,2019,45006,0,45006,COST
06008525104280000,2021,49813,257587,307400,MKT
06008525104280000,2020,45006,272794,317800,MKT
06008525104280000,2019,45006,272794,317800,MKT
06008525104300000,2021,49813,176687,226500,MKT
06008525104300000,2020,45006,124730,169736,COST
06008525104300000,2019,45006,124730,169736,COST
06008525104310000,2021,49813,239587,289400,MKT
06008525104310000,2020,45006,180340,225346,COST
06008525104310000,2019,45006,180340,225346,COST
06008525106010000,2021,51004,221196,272200,MKT
06008525106010000,2020,46285,184215,230500,MKT
06008525106010000,2019,46285,121160,167445,COST
06008525106040000,2021,50613,258987,309600,MKT
06008525106040000,2020,45864,223060,268924,COST
06008525106040000,2019,45864,223060,268924,COST
06008525106080000,2021,52151,325349,377500,MKT
06008525106080000,2020,47520,306380,353900,MKT
06008525106080000,2019,47520,306380,353900,MKT
06008525108010000,2021,66275,295625,361900,MKT
06008525108010000,2020,63133,251067,314200,MKT
06008525108010000,2019,63133,243367,306500,MKT
06008525108020000,2021,66500,573020,639520,COST
06008525108020000,2020,63387,562198,625585,MRA
06008525108020000,2019,63387,562198,625585,MRA
06008525108030000,2021,65180,387120,452300,MKT
06008525108030000,2020,61898,374502,436400,MKT
06008525108030000,2019,61898,374502,436400,MKT
06008525108040000,2021,65257,423843,489100,MKT
06008525108040000,2020,61985,386215,448200,MKT
06008525108040000,2019,61985,386215,448200,MKT
06008525110010000,2021,66073,291427,357500,MKT
06008525110010000,2020,62905,281895,344800,MKT
06008525110010000,2019,62905,281895,344800,MKT
06008525110020000,2021,70583,0,70583,COST
06008525110020000,2020,68025,0,68025,COST
06008525110020000,2019,68025,0,68025,COST
06008525111220000,2021,116598,0,116598,COST
06008525111220000,2020,123326,0,123326,COST
06008525111220000,2019,123326,0,123326,COST
06008525120010000,2021,65734,0,65734,COST
06008525120010000,2020,35655,0,35655,COST
06008525120010000,2019,35655,0,35655,COST
06008525301010000,2021,12261,0,12261,COST
06008525301010000,2020,6617,0,6617,COST
06008525301010000,2019,6617,0,6617,COST
06008525301090000,2021,74257,634890,709147,COST
06008525301090000,2020,67694,481300,548994,COST
06008525301090000,2019,67694,481300,548994,COST
06008525301140000,2021,269791,399410,669201,COST
06008525301140000,2020,274222,372576,646798,MRA
06008525301140000,2019,274222,372576,646798,MRA
06008525301150000,2021,270782,511400,782182,COST
06008525301150000,2020,183610,228930,412540,COST
06008525301150000,2019,183610,0,183610,COST
06008525301450000,2021,266630,685270,951900,COST
06008525301450000,2020,180278,669090,849368,COST
06008525301450000,2019,180278,669090,849368,COST
06008525301470000,2021,269995,0,269995,COST
06008525301470000,2020,182978,0,182978,COST
06008525301470000,2019,182978,0,182978,COST
06008525301480000,2021,35071,0,35071,COST
06008525301480000,2020,29692,0,29692,COST
06008525301480000,2019,29692,0,29692,COST
06008525301490000,2021,119932,193068,313000,MKT
06008525301490000,2020,127517,212383,339900,MKT
06008525301490000,2019,127517,212383,339900,MKT
06008525301500000,2021,266734,0,266734,COST
06008525301500000,2020,180362,0,180362,COST
06008525301500000,2019,180362,0,180362,COST
06008525301520000,2021,121724,221376,343100,MKT
06008525301520000,2020,129779,245621,375400,MKT
06008525301520000,2019,129779,245621,375400,MKT
06008525301540000,2021,120349,227730,348079,COST
06008525301540000,2020,128044,228140,356184,OVR
06008525301540000,2019,128044,228140,356184,COST
06008525301550000,2021,267546,470810,738356,COST
06008525301550000,2020,181013,463540,644553,COST
06008525301550000,2019,181013,463540,644553,COST
06008525301640000,2021,269577,590090,859667,COST
06008525301640000,2020,182643,581350,763993,COST
06008525301640000,2019,182643,581350,763993,COST
06008525301660000,2021,265727,319530,585257,COST
06008525301660000,2020,179555,320070,499625,COST
06008525301660000,2019,179555,320070,499625,COST
06008525301700000,2021,200484,323216,523700,MKT
06008525301700000,2020,128579,321121,449700,MKT
06008525301700000,2019,128579,343821,472400,MKT
06008525402010000,2021,205830,0,205830,COST
06008525402010000,2020,198979,0,198979,COST
06008525402010000,2019,198979,0,198979,COST
06008525402020000,2021,205435,311065,516500,MKT
06008525402020000,2020,198526,344297,542823,MRA
06008525402020000,2019,198526,344297,542823,MRA
06008525402030000,2021,201986,271750,473736,COST
06008525402030000,2020,194582,237318,431900,MKT
06008525402030000,2019,194582,237318,431900,MKT
06008525402040000,2021,201986,317840,519826,COST
06008525402040000,2020,194582,286155,480737,MRA
06008525402040000,2019,194582,286155,480737,MRA
06008525402050000,2021,201986,289414,491400,MKT
06008525402050000,2020,194582,281418,476000,MKT
06008525402050000,2019,194582,281418,476000,MKT
06008525402060000,2021,201986,1690,203676,COST
06008525402060000,2020,194582,1430,196012,COST
06008525402060000,2019,194582,1430,196012,COST
06008525402070000,2021,201986,356514,558500,MKT
06008525402070000,2020,194582,321318,515900,MKT
06008525402070000,2019,194582,321318,515900,MKT
06008525402080000,2021,205845,0,205845,COST
06008525402080000,2020,198996,0,198996,COST
06008525402080000,2019,198996,0,198996,COST
06008525402090000,2021,201971,284720,486691,COST
06008525402090000,2020,194565,240297,434862,MRA
06008525402090000,2019,194565,240297,434862,MRA
06008525402100000,2021,201986,608470,810456,COST
06008525402100000,2020,194582,489387,683969,MRA
06008525402100000,2019,194582,489387,683969,MRA
06008525402110000,2021,201986,239400,441386,COST
06008525402110000,2020,194582,239818,434400,MKT
06008525402110000,2019,194582,239818,434400,MKT
06008525403010000,2021,216870,380600,597470,COST
06008525403010000,2020,211691,379380,591071,COST
06008525403010000,2019,211691,379380,591071,COST
06008525403020000,2021,217124,0,217124,COST
06008525403020000,2020,211985,0,211985,COST
06008525403020000,2019,211985,0,211985,COST
06008525403030000,2021,216870,0,216870,COST
06008525403030000,2020,211691,0,211691,COST
06008525403030000,2019,211691,0,211691,COST
06008525406010000,2021,185523,0,185523,COST
06008525406010000,2020,95797,0,95797,COST
06008525406010000,2019,95797,0,95797,COST
06008525406020000,2021,184835,242565,427400,MKT
06008525406020000,2020,95377,242223,337600,MKT
06008525406020000,2019,95377,242223,337600,MKT
06008525406030000,2021,184835,369065,553900,MKT
06008525406030000,2020,95377,365623,461000,MKT
06008525406030000,2019,95377,365623,461000,MKT
06008525406040000,2021,184835,0,184835,COST
06008525406040000,2020,95377,0,95377,COST
06008525406040000,2019,95377,0,95377,COST
06008525406050000,2021,183936,145964,329900,MKT
06008525406050000,2020,94827,155173,250000,MKT
06008525406050000,2019,94827,155173,250000,MKT
06008525406060000,2021,184835,355480,540315,COST
06008525406060000,2020,95377,363120,458497,COST
06008525406060000,2019,95377,363120,458497,COST
06008525406070000,2021,186205,0,186205,COST
06008525406070000,2020,96215,0,96215,COST
06008525406070000,2019,96215,0,96215,COST
06008525406080000,2021,184835,101180,286015,COST
06008525406080000,2020,95377,102340,197717,COST
06008525406080000,2019,95377,102340,197717,COST
06008525406090000,2021,184835,288665,473500,MKT
06008525406090000,2020,128440,282360,410800,MKT
06008525406090000,2019,128440,282360,410800,MKT
06008525406100000,2021,184835,0,184835,COST
06008525406100000,2020,95377,0,95377,COST
06008525406100000,2019,95377,0,95377,COST
06008525406110000,2021,184835,0,184835,COST
06008525406110000,2020,95377,0,95377,COST
06008525406110000,2019,95377,0,95377,COST
06008525406120000,2021,184835,625420,810255,COST
06008525406120000,2020,95377,618100,713477,COST
06008525406120000,2019,95377,618100,713477,COST
06008525406130000,2021,184767,284180,468947,COST
06008525406130000,2020,95334,273466,368800,MKT
06008525406130000,2019,95334,273466,368800,MKT
06008525406140000,2021,184767,22180,206947,COST
06008525406140000,2020,128384,22010,150394,COST
06008525406140000,2019,128384,22010,150394,COST
06008525406150000,2021,184767,292580,477347,COST
06008525406150000,2020,95334,314666,410000,OVR
06008525406150000,2019,95334,314666,410000,MKT
06008525406160000,2021,184767,209933,394700,MKT
06008525406160000,2020,95334,225366,320700,MKT
06008525406160000,2019,95334,225366,320700,MKT
06008525406170000,2021,184767,202933,387700,MKT
06008525406170000,2020,95334,224266,319600,MKT
06008525406170000,2019,95334,224266,319600,MKT
06008525406180000,2021,184698,0,184698,COST
06008525406180000,2020,95292,0,95292,COST
06008525406180000,2019,95292,0,95292,COST
06008525406190000,2021,184698,0,184698,COST
06008525406190000,2020,95292,0,95292,COST
06008525406190000,2019,95292,0,95292,COST
06008526101010000,2021,2012,1108790,1110802,COST
06008526101010000,2020,1875,275520,277395,COST
06008526101010000,2019,1875,0,1875,COST
06008526101280000,2021,121588,0,121588,COST
06008526101280000,2020,129607,0,129607,COST
06008526101280000,2019,129607,0,129607,COST
06008526101300000,2021,123295,300705,424000,MKT
06008526101300000,2020,131767,270533,402300,MKT
06008526101300000,2019,131767,270533,402300,MKT
06008526201010000,2021,260,0,260,COST
06008526201010000,2020,242,0,242,COST
06008526201010000,2019,242,0,242,COST
06008526201100000,2021,228,0,228,COST
06008526201100000,2020,213,0,213,COST
06008526201100000,2019,213,0,213,COST
06008526201200000,2021,903,0,903,COST
06008526201200000,2020,570,0,570,COST
06008526201200000,2019,570,0,570,COST
06008526301010000,2021,78812,0,78812,COST
06008526301010000,2020,43813,0,43813,COST
06008526301010000,2019,43813,0,43813,COST
06008526401010000,2021,8625,0,8625,COST
06008526401010000,2020,4679,0,4679,COST
06008526401010000,2019,4679,0,4679,COST
06008527101010000,2021,22858,0,22858,COST
06008527101010000,2020,13544,0,13544,COST
06008527101010000,2019,13544,0,13544,COST
06008529301010000,2021,112342,0,112342,COST
06008529301010000,2020,60405,0,60405,COST
06008529301010000,2019,60405,0,60405,COST
06008530101010000,2021,227791,0,227791,COST
06008530101010000,2020,123403,0,123403,COST
06008530101010000,2019,123403,0,123403,COST
06008531101010000,2021,251760,0,251760,COST
06008531101010000,2020,135120,0,135120,COST
06008531101010000,2019,135120,0,135120,COST
06008532201010000,2021,214973,0,214973,COST
06008532201010000,2020,115471,0,115471,COST
06008532201010000,2019,115471,0,115471,COST
06008533301010000,2021,83104,0,83104,COST
06008533301010000,2020,44895,0,44895,COST
06008533301010000,2019,44895,0,44895,COST
06008534301010000,2021,1692,0,1692,COST
06008534301010000,2020,908,0,908,COST
06008534301010000,2019,908,0,908,COST
06008534401010000,2021,41490,0,41490,COST
06008534401010000,2020,22439,0,22439,COST
06008534401010000,2019,22439,0,22439,COST
06008535101010000,2021,2947,0,2947,COST
06008535101010000,2020,2040,0,2040,COST
06008535101010000,2019,2040,0,2040,COST
06008535301010000,2021,11022,0,11022,COST
06008535301010000,2020,5946,0,5946,COST
06008535301010000,2019,5946,0,5946,COST
06008535401010000,2021,80,0,80,COST
06008535401010000,2020,74,0,74,COST
06008535401010000,2019,74,0,74,COST
06008536101010000,2021,46447,0,46447,COST
06008536101010000,2020,25764,0,25764,COST
06008536101010000,2019,25764,0,25764,COST
06008601101010000,2021,10864,0,10864,COST
06008601101010000,2020,9754,0,9754,COST
06008601101010000,2019,9754,0,9754,COST
06008602101010000,2021,11566,0,11566,COST
06008602101010000,2020,10782,0,10782,COST
06008602101010000,2019,10782,0,10782,COST
06008603101010000,2021,182835,0,182835,COST
06008603101010000,2020,98194,0,98194,COST
06008603101010000,2019,98194,0,98194,COST
06008603401010000,2021,3097,0,3097,COST
06008603401010000,2020,2495,0,2495,COST
06008603401010000,2019,2495,0,2495,COST
06008604101010000,2021,242401,0,242401,COST
06008604101010000,2020,130170,0,130170,COST
06008604101010000,2019,130170,0,130170,COST
06008605101010000,2021,240123,0,240123,COST
06008605101010000,2020,128975,0,128975,COST
06008605101010000,2019,128975,0,128975,COST
06008606101010000,2021,191251,0,191251,COST
06008606101010000,2020,103329,0,103329,COST
06008606101010000,2019,103329,0,103329,COST
06008607101010000,2021,60521,0,60521,COST
06008607101010000,2020,33429,0,33429,COST
06008607101010000,2019,33429,0,33429,COST
06008607201300000,2021,659,0,659,COST
06008607201300000,2020,614,0,614,COST
06008607201300000,2019,614,0,614,COST
06008607301010000,2021,3429,394250,397679,COST
06008607301010000,2020,3600,341530,345130,COST
06008607301010000,2019,3600,341530,345130,COST
06008607301040000,2021,62947,0,62947,COST
06008607301040000,2020,59393,0,59393,COST
06008607301040000,2019,59393,0,59393,COST
06008607342130000,2021,2398,3687150,3689548,COST
06008607342130000,2020,2639,3086150,3088789,COST
06008607342130000,2019,2639,3053110,3055749,COST
06008607401010000,2021,228,0,228,COST
06008607401010000,2020,213,0,213,COST
06008607401010000,2019,213,0,213,COST
06008608101010000,2021,133273,0,133273,COST
06008608101010000,2020,72163,0,72163,COST
06008608101010000,2019,72163,0,72163,COST
06008608301300000,2021,72080,577730,649810,COST
06008608301300000,2020,3196,588460,591656,COST
06008608301300000,2019,3196,588460,591656,COST
06008608302010000,2021,146829,698400,845229,COST
06008608302010000,2020,117917,676050,793967,COST
06008608302010000,2019,117917,676050,793967,COST
06008609101010000,2021,147380,0,147380,COST
06008609101010000,2020,79655,0,79655,COST
06008609101010000,2019,79655,0,79655,COST
06008609101020000,2021,169219,898340,1067559,COST
06008609101020000,2020,191773,1041450,1233223,COST
06008609101020000,2019,191773,1041450,1233223,COST
06008609301010000,2021,67653,394950,462603,COST
06008609301010000,2020,64480,393590,458070,COST
06008609301010000,2019,64480,393590,458070,COST
06008609302010000,2021,1448,0,1448,COST
06008609302010000,2020,1347,0,1347,COST
06008609302010000,2019,1347,0,1347,COST
06008609401010000,2021,1108,0,1108,COST
06008609401010000,2020,1031,0,1031,COST
06008609401010000,2019,1031,0,1031,COST
06008609401100000,2021,67653,521120,588773,COST
06008609401100000,2020,64480,522470,586950,COST
06008609401100000,2019,64480,522470,586950,COST
06008609402010000,2021,1117,0,1117,COST
06008609402010000,2020,1040,0,1040,COST
06008609402010000,2019,1040,0,1040,COST
06008609402100000,2021,67653,304910,372563,COST
06008609402100000,2020,64480,303130,367610,COST
06008609402100000,2019,64480,303130,367610,COST
06008610101010000,2021,153553,0,153553,COST
06008610101010000,2020,82793,0,82793,COST
06008610101010000,2019,82793,0,82793,COST
06008610301300000,2021,67680,426090,493770,COST
06008610301300000,2020,64505,433110,497615,COST
06008610301300000,2019,64505,433110,497615,COST
06008610302010000,2021,93850,0,93850,COST
06008610302010000,2020,95353,0,95353,COST
06008610302010000,2019,95353,0,95353,COST
06008610401010000,2021,2201,0,2201,COST
06008610401010000,2020,2051,0,2051,COST
06008610401010000,2019,2051,0,2051,COST
06008611101010000,2021,11795,0,11795,COST
06008611101010000,2020,10996,0,10996,COST
06008611101010000,2019,10996,0,10996,COST
06008612101010000,2021,11055,0,11055,COST
06008612101010000,2020,9943,0,9943,COST
06008612101010000,2019,9943,0,9943,COST
06008613101010000,2021,11077,0,11077,COST
06008613101010000,2020,9955,0,9955,COST
06008613101010000,2019,9955,0,9955,COST
06008614101010000,2021,11794,0,11794,COST
06008614101010000,2020,10994,0,10994,COST
06008614101010000,2019,10994,0,10994,COST
06008615101010000,2021,1107,0,1107,COST
06008615101010000,2020,1030,0,1030,COST
06008615101010000,2019,1030,0,1030,COST
06008615104010000,2021,2530,0,2530,COST
06008615104010000,2020,1731,0,1731,COST
06008615104010000,2019,1731,0,1731,COST
06008615201010000,2021,148446,1390,149836,COST
06008615201010000,2020,104624,1540,106164,COST
06008615201010000,2019,104624,1540,106164,COST
06008615201020000,2021,145458,0,145458,COST
06008615201020000,2020,102132,0,102132,COST
06008615201020000,2019,102132,0,102132,COST
06008615201030000,2021,146940,0,146940,COST
06008615201030000,2020,103366,0,103366,COST
06008615201030000,2019,103366,0,103366,COST
06008615201040000,2021,151433,243267,394700,MKT
06008615201040000,2020,107124,237976,345100,MKT
06008615201040000,2019,107124,237976,345100,MKT
06008615201060000,2021,613059,476460,1089519,COST
06008615201060000,2020,445847,456640,902487,COST
06008615201060000,2019,445847,456640,902487,COST
06008615201080000,2021,396271,0,396271,COST
06008615201080000,2020,387319,0,387319,COST
06008615201080000,2019,387319,0,387319,COST
06008615202010000,2021,153292,0,153292,COST
06008615202010000,2020,108684,0,108684,COST
06008615202010000,2019,108684,0,108684,COST
06008615202020000,2021,146787,292213,439000,MKT
06008615202020000,2020,103240,286260,389500,MKT
06008615202020000,2019,103240,286260,389500,MKT
06008615202030000,2021,146125,0,146125,COST
06008615202030000,2020,102688,0,102688,COST
06008615202030000,2019,102688,0,102688,COST
06008615202040000,2021,139153,441147,580300,MKT
06008615202040000,2020,96906,428994,525900,MKT
06008615202040000,2019,96906,428994,525900,MKT
06008615202050000,2021,151529,0,151529,COST
06008615202050000,2020,107204,0,107204,COST
06008615202050000,2019,107204,0,107204,COST
06008615202060000,2021,145510,307440,452950,COST
06008615202060000,2020,102175,293225,395400,MKT
06008615202060000,2019,102175,293225,395400,MKT
06008615202070000,2021,136846,363354,500200,MKT
06008615202070000,2020,95005,321895,416900,MKT
06008615202070000,2019,95005,321895,416900,MKT
06008615202080000,2021,146279,231321,377600,MKT
06008615202080000,2020,102816,216484,319300,MKT
06008615202080000,2019,102816,216484,319300,MKT
06008615202090000,2021,150853,284847,435700,MKT
06008615202090000,2020,106638,266962,373600,MKT
06008615202090000,2019,106638,266962,373600,MKT
06008615202100000,2021,154883,134017,288900,MKT
06008615202100000,2020,110022,146278,256300,MKT
06008615202100000,2019,110022,146278,256300,MKT
06008615202110000,2021,148346,342540,490886,COST
06008615202110000,2020,104541,294459,399000,MKT
06008615202110000,2019,104541,294459,399000,MKT
06008615202120000,2021,144108,392460,536568,COST
06008615202120000,2020,101010,381473,482483,MRA
06008615202120000,2019,101010,381473,482483,MRA
06008615202130000,2021,146432,258668,405100,MKT
06008615202130000,2020,102943,227957,330900,MKT
06008615202130000,2019,102943,227957,330900,MKT
06008615202140000,2021,166398,197700,364098,COST
06008615202140000,2020,119783,168117,287900,MKT
06008615202140000,2019,119783,168117,287900,MKT
06008615202150000,2021,144474,0,144474,COST
06008615202150000,2020,101314,0,101314,COST
06008615202150000,2019,101314,0,101314,COST
06008615202160000,2021,146381,338619,485000,MKT
06008615202160000,2020,102901,308199,411100,MKT
06008615202160000,2019,102901,308199,411100,MKT
06008615202170000,2021,153716,842720,996436,COST
06008615202170000,2020,109040,852070,961110,COST
06008615202170000,2019,109040,863100,972140,COST
06008615202180000,2021,143161,410970,554131,COST
06008615202180000,2020,100224,400170,500394,COST
06008615202180000,2019,100224,400170,500394,COST
06008615202190000,2021,142150,214950,357100,MKT
06008615202190000,2020,99385,158770,258155,COST
06008615202190000,2019,99385,158770,258155,COST
06008615202200000,2021,142150,333250,475400,MKT
06008615202200000,2020,99385,312015,411400,MKT
06008615202200000,2019,99385,312015,411400,MKT
06008615202210000,2021,142150,331670,473820,COST
06008615202210000,2020,99385,339670,439055,COST
06008615202210000,2019,99385,339670,439055,COST
06008615202220000,2021,142150,0,142150,COST
06008615202220000,2020,99385,0,99385,COST
06008615202220000,2019,99385,0,99385,COST
06008615202230000,2021,142150,0,142150,COST
06008615202230000,2020,99385,0,99385,COST
06008615202230000,2019,99385,0,99385,COST
06008615202240000,2021,142150,226850,369000,MKT
06008615202240000,2020,99385,176830,276215,COST
06008615202240000,2019,99385,176830,276215,COST
06008615202260000,2021,150318,253282,403600,MKT
06008615202260000,2020,106190,223610,329800,MKT
06008615202260000,2019,106190,223610,329800,MKT
06008615202270000,2021,48784,0,48784,COST
06008615202270000,2020,46616,0,46616,COST
06008615202270000,2019,46616,0,46616,COST
06008615203010000,2021,149338,263162,412500,MKT
06008615203010000,2020,105369,227331,332700,MKT
06008615203010000,2019,105369,227331,332700,MKT
06008615203020000,2021,150025,218475,368500,MKT
06008615203020000,2020,105944,214156,320100,MKT
06008615203020000,2019,105944,214156,320100,MKT
06008615203030000,2021,142684,0,142684,COST
06008615203030000,2020,99827,0,99827,COST
06008615203030000,2019,99827,0,99827,COST
06008615203040000,2021,139208,342092,481300,MKT
06008615203040000,2020,96952,306448,403400,MKT
06008615203040000,2019,96952,306448,403400,MKT
06008615203050000,2021,145818,540,146358,COST
06008615203050000,2020,102432,500,102932,COST
06008615203050000,2019,102432,500,102932,COST
06008615203060000,2021,142524,262676,405200,MKT
06008615203060000,2020,99695,242505,342200,MKT
06008615203060000,2019,99695,242505,342200,MKT
06008615203070000,2021,142524,4490,147014,COST
06008615203070000,2020,99695,3840,103535,COST
06008615203070000,2019,99695,3840,103535,COST
06008615203080000,2021,142524,185576,328100,MKT
06008615203080000,2020,99695,180205,279900,MKT
06008615203080000,2019,99695,180205,279900,MKT
06008615203090000,2021,147646,246054,393700,MKT
06008615203090000,2020,103956,218444,322400,MKT
06008615203090000,2019,103956,218444,322400,MKT
06008615203100000,2021,148396,0,148396,COST
06008615203100000,2020,104582,0,104582,COST
06008615203100000,2019,104582,0,104582,COST
06008615204010000,2021,1855,0,1855,COST
06008615204010000,2020,1728,0,1728,COST
06008615204010000,2019,1728,0,1728,COST
06008615301010000,2021,1150,0,1150,COST
06008615301010000,2020,1711,0,1711,COST
06008615301010000,2019,1711,0,1711,COST
06008615401010000,2021,2188,0,2188,COST
06008615401010000,2020,2038,0,2038,COST
06008615401010000,2019,2038,0,2038,COST
06008615401100000,2021,93822,0,93822,COST
06008615401100000,2020,95319,0,95319,COST
06008615401100000,2019,95319,0,95319,COST
06008615401200000,2021,113224,427510,540734,COST
06008615401200000,2020,87588,420140,507728,COST
06008615401200000,2019,87588,420140,507728,COST
06008615401300000,2021,686,0,686,COST
06008616101030000,2021,1279,880,2159,COST
06008616101030000,2020,1191,830,2021,COST
06008616101030000,2019,1191,830,2021,COST
06008616103010000,2021,86471,403229,489700,MKT
06008616103010000,2020,86533,347667,434200,MKT
06008616103010000,2019,86533,347667,434200,MKT
06008616125010000,2021,93620,304170,397790,COST
06008616125010000,2020,128921,301990,430911,COST
06008616125010000,2019,128921,301990,430911,COST
06008616159010000,2021,115516,512790,628306,COST
06008616159010000,2020,121971,513630,635601,COST
06008616159010000,2019,121971,513630,635601,COST
06008616159020000,2021,113709,222591,336300,MKT
06008616159020000,2020,119713,169087,288800,MKT
06008616159020000,2019,119713,169087,288800,MKT
06008616159030000,2021,113912,680,114592,COST
06008616159030000,2020,119967,750,120717,COST
06008616159030000,2019,119967,750,120717,COST
06008616159040000,2021,114518,223682,338200,MKT
06008616159040000,2020,120723,210277,331000,MKT
06008616159040000,2019,120723,212777,333500,MKT
06008616159050000,2021,112787,313013,425800,MKT
06008616159050000,2020,118563,266937,385500,MKT
06008616159050000,2019,118563,266937,385500,MKT
06008616159060000,2021,117662,262538,380200,MKT
06008616159060000,2020,124662,223738,348400,MKT
06008616159060000,2019,124662,223738,348400,MKT
06008616159070000,2021,123827,224573,348400,MKT
06008616159070000,2020,132440,214560,347000,MKT
06008616159070000,2019,132440,214560,347000,MKT
06008616159080000,2021,121040,243360,364400,MKT
06008616159080000,2020,128915,195720,324635,COST
06008616159080000,2019,128915,195720,324635,COST
06008616159090000,2021,117950,0,117950,COST
06008616159090000,2020,125024,0,125024,COST
06008616159090000,2019,125024,0,125024,COST
06008616159100000,2021,116792,0,116792,COST
06008616159100000,2020,123570,0,123570,COST
06008616159100000,2019,123570,0,123570,COST
06008616159110000,2021,120118,259482,379600,MKT
06008616159110000,2020,127751,245649,373400,MKT
06008616159110000,2019,127751,245649,373400,MKT
06008616159120000,2021,115019,279281,394300,MKT
06008616159120000,2020,121349,230251,351600,MKT
06008616159120000,2019,121349,230251,351600,MKT
06008616159130000,2021,111957,601580,713537,COST
06008616159130000,2020,117919,594879,712798,MRA
06008616159130000,2019,117919,594879,712798,MRA
06008616159140000,2021,112580,439620,552200,MKT
06008616159140000,2020,118306,359590,477896,MRA
06008616159140000,2019,118306,359590,477896,MRA
06008616159150000,2021,111852,387848,499700,MKT
06008616159150000,2020,117400,340300,457700,MKT
06008616159150000,2019,117400,340300,457700,MKT
06008616159160000,2021,112890,279110,392000,MKT
06008616159160000,2020,118692,252808,371500,MKT
06008616159160000,2019,118692,252808,371500,MKT
06008616159170000,2021,114417,321500,435917,COST
06008616159170000,2020,120598,299702,420300,OVR
06008616159170000,2019,120598,299702,420300,MKT
06008616160010000,2021,114317,238740,353057,COST
06008616160010000,2020,120472,228000,348472,COST
06008616160010000,2019,120472,228000,348472,COST
06008616160020000,2021,114618,292682,407300,MKT
06008616160020000,2020,120849,233851,354700,MKT
06008616160020000,2019,120849,233851,354700,MKT
06008616160030000,2021,112477,250123,362600,MKT
06008616160030000,2020,118177,213223,331400,MKT
06008616160030000,2019,118177,213223,331400,MKT
06008616160040000,2021,113607,0,113607,COST
06008616160040000,2020,119586,2550,122136,COST
06008616160040000,2019,119586,2550,122136,COST
06008616160050000,2021,113301,262899,376200,MKT
06008616160050000,2020,119204,255396,374600,MKT
06008616160050000,2019,119204,255396,374600,MKT
06008616160060000,2021,113301,184499,297800,MKT
06008616160060000,2020,119204,186096,305300,MKT
06008616160060000,2019,119204,195696,314900,MKT
06008616160070000,2021,115615,652640,768255,COST
06008616160070000,2020,122095,645560,767655,COST
06008616160070000,2019,122095,645560,767655,COST
06008616160080000,2021,111957,201643,313600,MKT
06008616160080000,2020,117530,174270,291800,MKT
06008616160080000,2019,117530,174270,291800,MKT
06008616160090000,2021,117758,243542,361300,MKT
06008616160090000,2020,124783,210617,335400,MKT
06008616160090000,2019,124783,210617,335400,MKT
06008616201010000,2021,2491,0,2491,COST
06008616201010000,2020,2318,0,2318,COST
06008616201010000,2019,2318,0,2318,COST
06008616301010000,2021,68356,584760,653116,COST
06008616301010000,2020,65134,585110,650244,COST
06008616301010000,2019,65134,585110,650244,COST
06008616301100000,2021,1469,0,1469,COST
06008616301100000,2020,1368,0,1368,COST
06008616301100000,2019,1368,0,1368,COST
06008616301120000,2021,125225,263075,388300,MKT
06008616301120000,2020,134215,254585,388800,MKT
06008616301120000,2019,134215,254585,388800,MKT
06008616401010000,2021,4502,0,4502,COST
06008616401010000,2020,4189,0,4189,COST
06008616401010000,2019,4189,0,4189,COST
06008616440010000,2021,2477,0,2477,COST
06008616440010000,2020,2307,0,2307,COST
06008616440010000,2019,2307,0,2307,COST
06008617101010000,2021,70239,117730,187969,COST
06008617101010000,2020,66889,114490,181379,COST
06008617101010000,2019,3400,0,3400,COST
06008617101030000,2021,202703,296297,499000,MKT
06008617101030000,2020,237536,308480,546016,COST
06008617101030000,2019,237536,308480,546016,COST
06008617201120000,2021,87031,350569,437600,MKT
06008617201120000,2020,97771,290729,388500,MKT
06008617201120000,2019,97771,261929,359700,MKT
06008617201130000,2021,87047,120480,207527,COST
06008617201130000,2020,97792,0,97792,COST
06008617201130000,2019,97792,0,97792,COST
06008617201140000,2021,86856,0,86856,COST
06008617201140000,2020,97538,0,97538,COST
06008617201140000,2019,97538,0,97538,COST
06008617201150000,2021,86358,172042,258400,MKT
06008617201150000,2020,96876,194824,291700,MKT
06008617201150000,2019,96876,194824,291700,MKT
06008617201160000,2021,106868,291432,398300,MKT
06008617201160000,2020,124712,288488,413200,MKT
06008617201160000,2019,124712,288488,413200,MKT
06008617203070000,2021,89487,280813,370300,MKT
06008617203070000,2020,101050,231850,332900,COST
06008617203070000,2019,101050,231850,332900,COST
06008617203080000,2021,89487,0,89487,COST
06008617203080000,2020,101050,0,101050,COST
06008617203080000,2019,101050,0,101050,COST
06008617203090000,2021,87364,0,87364,COST
06008617203090000,2020,98215,0,98215,COST
06008617203090000,2019,98215,0,98215,COST
06008617203100000,2021,87364,0,87364,COST
06008617203100000,2020,98215,0,98215,COST
06008617203100000,2019,98215,0,98215,COST
06008617203110000,2021,95194,221006,316200,MKT
06008617203110000,2020,108734,167366,276100,MKT
06008617203110000,2019,108734,167366,276100,MKT
06008617204030000,2021,120043,2780,122823,COST
06008617204030000,2020,143138,3080,146218,COST
06008617204030000,2019,143138,3080,146218,COST
06008617204040000,2021,119932,443110,563042,COST
06008617204040000,2020,142980,444820,587800,COST
06008617204040000,2019,142980,444820,587800,COST
06008617204050000,2021,87206,0,87206,COST
06008617204050000,2020,98004,0,98004,COST
06008617204050000,2019,98004,0,98004,COST
06008617204060000,2021,86792,365108,451900,MKT
06008617204060000,2020,97453,306547,404000,MKT
06008617204060000,2019,97453,306547,404000,MKT
06008617204070000,2021,86760,336640,423400,MKT
06008617204070000,2020,97410,278790,376200,MKT
06008617204070000,2019,97410,278790,376200,MKT
06008617204080000,2021,86696,0,86696,COST
06008617204080000,2020,97325,0,97325,COST
06008617204080000,2019,97325,0,97325,COST
06008617204090000,2021,86887,308613,395500,MKT
06008617204090000,2020,97580,265820,363400,MKT
06008617204090000,2019,97580,265820,363400,MKT
06008617204100000,2021,86824,150776,237600,MKT
06008617204100000,2020,97495,152005,249500,MKT
06008617204100000,2019,97495,152005,249500,MKT
06008617204110000,2021,86310,207790,294100,MKT
06008617204110000,2020,96811,175189,272000,MKT
06008617204110000,2019,96811,175189,272000,MKT
06008617204120000,2021,86423,204677,291100,MKT
06008617204120000,2020,96961,163920,260881,COST
06008617204120000,2019,96961,163920,260881,COST
06008617204130000,2021,86983,379617,466600,MKT
06008617204130000,2020,97707,346993,444700,MKT
06008617204130000,2019,97707,327093,424800,MKT
06008617204140000,2021,86310,0,86310,COST
06008617204140000,2020,96811,0,96811,COST
06008617204140000,2019,96811,0,96811,COST
06008617204150000,2021,126060,342940,469000,MKT
06008617204150000,2020,151680,273320,425000,MKT
06008617204150000,2019,151680,273320,425000,MKT
06008617301010000,2021,86358,0,86358,COST
06008617301010000,2020,96876,0,96876,COST
06008617301010000,2019,96876,0,96876,COST
06008617301020000,2021,86358,0,86358,COST
06008617301020000,2020,96876,0,96876,COST
06008617301020000,2019,96876,0,96876,COST
06008617301030000,2021,86423,0,86423,COST
06008617301030000,2020,96961,0,96961,COST
06008617301030000,2019,96961,0,96961,COST
06008617301040000,2021,86423,1457020,1543443,COST
06008617301040000,2020,96961,1441590,1538551,COST
06008617301040000,2019,96961,1441590,1538551,COST
06008617301050000,2021,86423,0,86423,COST
06008617301050000,2020,96961,0,96961,COST
06008617301050000,2019,96961,0,96961,COST
06008617301060000,2021,86310,0,86310,COST
06008617301060000,2020,96811,0,96811,COST
06008617301060000,2019,96811,0,96811,COST
06008617301070000,2021,89654,394846,484500,MKT
06008617301070000,2020,101274,338526,439800,MKT
06008617301070000,2019,101274,338526,439800,MKT
06008617301080000,2021,97832,351768,449600,MKT
06008617301080000,2020,112313,305787,418100,MKT
06008617301080000,2019,112313,305787,418100,MKT
06008617301090000,2021,86310,184790,271100,MKT
06008617301090000,2020,96811,158789,255600,MKT
06008617301090000,2019,96811,167189,264000,MKT
06008617301100000,2021,86535,196465,283000,MKT
06008617301100000,2020,97111,168789,265900,MKT
06008617301100000,2019,97111,168789,265900,MKT
06008617301110000,2021,86856,188244,275100,MKT
06008617301110000,2020,97538,162262,259800,MKT
06008617301110000,2019,97538,162262,259800,MKT
06008617302010000,2021,86439,0,86439,COST
06008617302010000,2020,96983,0,96983,COST
06008617302010000,2019,96983,0,96983,COST
06008617302020000,2021,86423,302777,389200,MKT
06008617302020000,2020,96961,239739,336700,MKT
06008617302020000,2019,96961,239739,336700,MKT
06008617302030000,2021,86439,0,86439,COST
06008617302030000,2020,96983,0,96983,COST
06008617302030000,2019,96983,0,96983,COST
06008617302040000,2021,86423,270277,356700,MKT
06008617302040000,2020,96961,247639,344600,MKT
06008617302040000,2019,96961,247639,344600,MKT
06008617302050000,2021,86439,248961,335400,MKT
06008617302050000,2020,96983,246717,343700,MKT
06008617302050000,2019,96983,246717,343700,MKT
06008617302060000,2021,104205,0,104205,COST
06008617302060000,2020,121037,0,121037,COST
06008617302060000,2019,121037,0,121037,COST
06008617302070000,2021,104205,195690,299895,COST
06008617302070000,2020,121037,0,121037,COST
06008617302070000,2019,121037,0,121037,COST
06008617302080000,2021,86439,488561,575000,MKT
06008617302080000,2020,96983,385317,482300,MKT
06008617302080000,2019,96983,385317,482300,MKT
06008617302090000,2021,86423,333077,419500,MKT
06008617302090000,2020,96961,280839,377800,MKT
06008617302090000,2019,96961,280839,377800,MKT
06008617302100000,2021,86439,0,86439,COST
06008617302100000,2020,96983,0,96983,COST
06008617302100000,2019,96983,0,96983,COST
06008617302110000,2021,86423,373377,459800,MKT
06008617302110000,2020,96961,301039,398000,OVR
06008617302110000,2019,96961,285539,382500,MKT
06008617302120000,2021,86439,133460,219899,COST
06008617302120000,2020,96983,133700,230683,COST
06008617302120000,2019,96983,133700,230683,COST
06008617303010000,2021,95236,0,95236,COST
06008617303010000,2020,108789,0,108789,COST
06008617303010000,2019,108789,0,108789,COST
06008617303020000,2021,87364,263136,350500,MKT
06008617303020000,2020,98215,266685,364900,MKT
06008617303020000,2019,98215,266685,364900,MKT
06008617303030000,2021,87364,0,87364,COST
06008617303030000,2020,98215,0,98215,COST
06008617303030000,2019,98215,0,98215,COST
06008617303040000,2021,87364,325836,413200,MKT
06008617303040000,2020,98215,268985,367200,MKT
06008617303040000,2019,98215,268985,367200,MKT
06008617303050000,2021,89700,0,89700,COST
06008617303050000,2020,101335,0,101335,COST
06008617303050000,2019,101335,0,101335,COST
06008617303060000,2021,89700,243300,333000,MKT
06008617303060000,2020,101335,183565,284900,MKT
06008617303060000,2019,101335,183565,284900,MKT
06008617304010000,2021,89274,0,89274,COST
06008617304010000,2020,100765,0,100765,COST
06008617304010000,2019,100765,0,100765,COST
06008617304020000,2021,92126,0,92126,COST
06008617304020000,2020,104592,0,104592,COST
06008617304020000,2019,104592,0,104592,COST
06008617305010000,2021,121588,1332790,1454378,COST
06008617305010000,2020,108870,1318780,1427650,COST
06008617305010000,2019,108870,1318780,1427650,COST
06008617305020000,2021,121588,0,121588,COST
06008617305020000,2020,108870,0,108870,COST
06008617305020000,2019,108870,0,108870,COST
06008617305030000,2021,121588,0,121588,COST
06008617305030000,2020,108870,0,108870,COST
06008617305030000,2019,108870,0,108870,COST
06008617305040000,2021,121588,0,121588,COST
06008617305040000,2020,108870,0,108870,COST
06008617305040000,2019,108870,0,108870,COST
06008617305050000,2021,121588,383130,504718,COST
06008617305050000,2020,108870,377230,486100,MKT
06008617305050000,2019,108870,377230,486100,MKT
06008617305060000,2021,121588,0,121588,COST
06008617305060000,2020,108870,0,108870,COST
06008617305060000,2019,108870,0,108870,COST
06008617305070000,2021,121588,574810,696398,COST
06008617305070000,2020,108870,581870,690740,COST
06008617305070000,2019,108870,581870,690740,COST
06008617305080000,2021,121588,0,121588,COST
06008617305080000,2020,108870,0,108870,COST
06008617305080000,2019,108870,0,108870,COST
06008617306010000,2021,121651,469550,591201,COST
06008617306010000,2020,108937,392963,501900,MKT
06008617306010000,2019,108937,372263,481200,MKT
06008617306020000,2021,121651,0,121651,COST
06008617306020000,2020,108937,0,108937,COST
06008617306020000,2019,108937,0,108937,COST
06008617307010000,2021,121796,0,121796,COST
06008617307010000,2020,109091,0,109091,COST
06008617307010000,2019,109091,0,109091,COST
06008617307020000,2021,121597,520603,642200,MKT
06008617307020000,2020,108879,509140,618019,COST
06008617307020000,2019,108879,509140,618019,COST
06008617307030000,2021,121606,0,121606,COST
06008617307030000,2020,108889,0,108889,COST
06008617307030000,2019,108889,0,108889,COST
06008617307040000,2021,121860,0,121860,COST
06008617307040000,2020,109159,0,109159,COST
06008617307040000,2019,109159,0,109159,COST
06008617307050000,2021,121597,0,121597,COST
06008617307050000,2020,108879,0,108879,COST
06008617307050000,2019,108879,0,108879,COST
06008617402030000,2021,86342,297158,383500,MKT
06008617402030000,2020,96854,256646,353500,MKT
06008617402030000,2019,96854,256646,353500,MKT
06008617403030000,2021,86423,204077,290500,MKT
06008617403030000,2020,96961,189939,286900,MKT
06008617403030000,2019,96961,189939,286900,MKT
06008617404010000,2021,121588,450712,572300,MKT
06008617404010000,2020,108870,441930,550800,MKT
06008617404010000,2019,108870,441930,550800,MKT
06008617404020000,2021,121588,0,121588,COST
06008617404020000,2020,108870,0,108870,COST
06008617404020000,2019,108870,0,108870,COST
06008617404030000,2021,121588,0,121588,COST
06008617404030000,2020,108870,0,108870,COST
06008617404030000,2019,108870,0,108870,COST
06008617405010000,2021,121588,438712,560300,MKT
06008617405010000,2020,108870,416130,525000,MKT
06008617405010000,2019,108870,416130,525000,MKT
06008617405020000,2021,121588,0,121588,COST
06008617405020000,2020,108870,0,108870,COST
06008617405020000,2019,108870,0,108870,COST
06008617405030000,2021,121588,0,121588,COST
06008617405030000,2020,108870,0,108870,COST
06008617405030000,2019,108870,0,108870,COST
06008617405040000,2021,121588,574350,695938,COST
06008617405040000,2020,108870,405660,514530,COST
06008617405040000,2019,108870,405660,514530,COST
06008617406010000,2021,121660,370640,492300,MKT
06008617406010000,2020,108947,340853,449800,MKT
06008617406010000,2019,108947,340853,449800,MKT
06008617406020000,2021,121651,378249,499900,MKT
06008617406020000,2020,108937,341563,450500,MKT
06008617406020000,2019,108937,341563,450500,MKT
06008617406030000,2021,121651,0,121651,COST
06008617406030000,2020,108937,0,108937,COST
06008617406030000,2019,108937,0,108937,COST
06008617406040000,2021,121651,433649,555300,MKT
06008617406040000,2020,108937,374463,483400,MKT
06008617406040000,2019,108937,374463,483400,MKT
06008617406050000,2021,121651,366549,488200,MKT
06008617406050000,2020,108937,357863,466800,MKT
06008617406050000,2019,108937,357863,466800,MKT
06008617406060000,2021,121651,0,121651,COST
06008617406060000,2020,108937,0,108937,COST
06008617406060000,2019,108937,0,108937,COST
06008617406070000,2021,121651,39750,161401,COST
06008617406070000,2020,108937,39470,148407,COST
06008617406070000,2019,108937,39470,148407,COST
06008617406080000,2021,121651,469749,591400,MKT
06008617406080000,2020,108937,440563,549500,MKT
06008617406080000,2019,108937,440563,549500,MKT
06008618101010000,2021,1369,0,1369,COST
06008618101010000,2020,1275,0,1275,COST
06008618101010000,2019,1275,0,1275,COST
06008618201010000,2021,334,0,334,COST
06008618201010000,2020,311,0,311,COST
06008618201010000,2019,311,0,311,COST
06008618201150000,2021,117,0,117,COST
06008618201150000,2020,109,0,109,COST
06008618201150000,2019,109,0,109,COST
06008618301200000,2021,72,0,72,COST
06008618301200000,2020,67,0,67,COST
06008618301200000,2019,67,0,67,COST
06008618401010000,2021,340,0,340,COST
06008618401010000,2020,317,0,317,COST
06008618401010000,2019,317,0,317,COST
06008618401200000,2021,4428,0,4428,COST
06008618401200000,2020,4121,0,4121,COST
06008618401200000,2019,4121,0,4121,COST
06008618402010000,2021,86390,0,86390,COST
06008618402010000,2020,96919,0,96919,COST
06008618402010000,2019,96919,0,96919,COST
06008618402020000,2021,86390,379810,466200,MKT
06008618402020000,2020,96919,284381,381300,MKT
06008618402020000,2019,96919,284381,381300,MKT
06008618403010000,2021,86439,0,86439,COST
06008618403010000,2020,96983,0,96983,COST
06008618403010000,2019,96983,0,96983,COST
06008618403020000,2021,86423,438177,524600,MKT
06008618403020000,2020,96961,377739,474700,MKT
06008618403020000,2019,96961,377739,474700,MKT
06008618403040000,2021,86439,0,86439,COST
06008618403040000,2020,96983,0,96983,COST
06008618403040000,2019,96983,0,96983,COST
06008618404010000,2021,169663,911860,1081523,COST
06008618404010000,2020,215696,934330,1150026,COST
06008618404010000,2019,215696,845390,1061086,COST
06008618404020000,2021,112009,392091,504100,MKT
06008618404020000,2020,131854,374346,506200,MKT
06008618404020000,2019,131854,374346,506200,MKT
06008618404030000,2021,117547,458553,576100,MKT
06008618404030000,2020,139616,557380,696996,COST
06008618404030000,2019,139616,557380,696996,COST
06008618404040000,2021,87110,0,87110,COST
06008618404040000,2020,97877,0,97877,COST
06008618404040000,2019,97877,0,97877,COST
06008618404050000,2021,87110,0,87110,COST
06008618404050000,2020,97877,0,97877,COST
06008618404050000,2019,97877,0,97877,COST
06008619301010000,2021,259845,0,259845,COST
06008619301010000,2020,140570,0,140570,COST
06008619301010000,2019,140570,0,140570,COST
06008620101010000,2021,771,0,771,COST
06008620101010000,2020,718,0,718,COST
06008620101010000,2019,718,0,718,COST
06008620101020000,2021,603100,185620,788720,COST
06008620101020000,2020,435095,158570,593665,COST
06008620101020000,2019,435095,158570,593665,COST
06008620101040000,2021,102872,230628,333500,MKT
06008620101040000,2020,106313,176387,282700,MKT
06008620101040000,2019,106313,176387,282700,MKT
06008620104010000,2021,153060,0,153060,COST
06008620104010000,2020,83357,0,83357,COST
06008620104010000,2019,83357,0,83357,COST
06008620201030000,2021,591911,0,591911,COST
06008620201040000,2021,87364,42650,130014,COST
06008620201040000,2020,87593,88107,175700,MKT
06008620201040000,2019,87593,88107,175700,MKT
06008620201050000,2021,704739,0,704739,COST
06008620201060000,2021,623562,169260,792822,COST
06008620201060000,2020,452646,151730,604376,COST
06008620201060000,2019,452646,151730,604376,COST
06008620201070000,2021,122113,0,122113,COST
06008620201070000,2020,130271,0,130271,COST
06008620201070000,2019,130271,0,130271,COST
06008620201080000,2021,815036,0,815036,COST
06008620201080000,2020,1275,0,1275,COST
06008620201080000,2019,1275,0,1275,COST
06008620201090000,2021,121588,0,121588,COST
06008620201090000,2020,129607,0,129607,COST
06008620201090000,2019,129607,0,129607,COST
06008620201100000,2021,449373,155390,604763,COST
06008620201100000,2020,306990,138440,445430,COST
06008620201100000,2019,306990,138440,445430,COST
06008620201110000,2021,121978,0,121978,COST
06008620201110000,2020,130100,0,130100,COST
06008620201110000,2019,130100,0,130100,COST
06008620201120000,2021,449443,0,449443,COST
06008620201120000,2020,307047,0,307047,COST
06008620201120000,2019,307047,0,307047,COST
06008620201130000,2021,121969,163470,285439,COST
06008620201130000,2020,130088,109560,239648,COST
06008620201130000,2019,130088,327330,457418,COST
06008620201140000,2021,121615,171985,293600,MKT
06008620201140000,2020,129641,166859,296500,MKT
06008620201140000,2019,129641,166859,296500,MKT
06008620201150000,2021,121932,0,121932,COST
06008620201150000,2020,130042,0,130042,COST
06008620201150000,2019,130042,0,130042,COST
06008620201170000,2021,121588,654300,775888,COST
06008620201170000,2020,129607,640520,770127,COST
06008620201170000,2019,129607,640520,770127,COST
06008621101010000,2021,333508,52270,385778,COST
06008621101010000,2020,216215,50660,266875,COST
06008621101010000,2019,216215,50660,266875,COST
06008621104010000,2021,156705,0,156705,COST
06008621104010000,2020,85308,0,85308,COST
06008621104010000,2019,85308,0,85308,COST
06008622101010000,2021,162980,0,162980,COST
06008622101010000,2020,88146,0,88146,COST
06008622101010000,2019,88146,0,88146,COST
06008622101100000,2021,441636,721830,1163466,COST
06008622101100000,2020,255393,569607,825000,OVR
06008622101100000,2019,255393,569607,825000,OVR
06008622101140000,2021,344070,245480,589550,COST
06008622101140000,2020,189978,259322,449300,MKT
06008622101140000,2019,189978,259322,449300,MKT
06008622101160000,2021,236727,367880,604607,COST
06008622101160000,2020,121958,365880,487838,COST
06008622101160000,2019,121958,365880,487838,COST
06008622101170000,2021,182204,408796,591000,MKT
06008622101170000,2020,89425,322275,411700,MKT
06008622101170000,2019,89425,322275,411700,MKT
06008622101180000,2021,343707,499170,842877,COST
06008622101180000,2020,189740,493500,683240,COST
06008622101180000,2019,189740,493500,683240,COST
06008622101186700,2021,64555,0,64555,COST
06008622101186700,2020,61196,0,61196,COST
06008622101186700,2019,61196,0,61196,COST
06008622101190000,2021,265168,0,265168,COST
06008622101190000,2020,139513,0,139513,COST
06008622101190000,2019,139513,0,139513,COST
06008622101200000,2021,266124,137230,403354,COST
06008622101200000,2020,140109,172191,312300,MKT
06008622101200000,2019,140109,172191,312300,MKT
06008622101210000,2021,310578,8910,319488,COST
06008622101210000,2020,168262,8860,177122,COST
06008622101210000,2019,168262,8860,177122,COST
06008622101220000,2021,100543,355280,455823,COST
06008622101220000,2020,103465,325035,428500,MKT
06008622101220000,2019,103465,325035,428500,MKT
06008622101230000,2021,292619,516930,809549,COST
06008622101230000,2020,156792,408608,565400,MKT
06008622101230000,2019,156792,408608,565400,MKT
06008622101240000,2021,66600,9970,76570,COST
06008622101240000,2020,63500,9980,73480,COST
06008622101240000,2019,63500,9980,73480,COST
06008622101280000,2021,481823,986990,1468813,COST
06008622101280000,2020,283166,981300,1264466,COST
06008622101280000,2019,283166,981300,1264466,COST
06008622101320000,2021,214420,692770,907190,COST
06008622101320000,2020,108459,706240,814699,COST
06008622101320000,2019,108459,706240,814699,COST
06008622101340000,2021,191299,0,191299,COST
06008622101340000,2020,94739,0,94739,COST
06008622101340000,2019,94739,0,94739,COST
06008622101360000,2021,224798,0,224798,COST
06008622101360000,2020,114708,0,114708,COST
06008622101360000,2019,114708,0,114708,COST
06008622101400000,2021,321207,818010,1139217,COST
06008622101400000,2020,175108,820200,995308,COST
06008622101400000,2019,175108,820200,995308,COST
06008622201010000,2021,175824,0,175824,COST
06008622201010000,2020,85725,0,85725,COST
06008622201010000,2019,85725,0,85725,COST
06008622201100000,2021,66600,234900,301500,MKT
06008622201100000,2020,63500,167410,230910,COST
06008622201100000,2019,63500,167410,230910,COST
06008622260010000,2021,448255,0,448255,COST
06008622260010000,2020,448250,0,448250,COST
06008622260010000,2019,448250,0,448250,COST
06008622281050000,2021,312371,655510,967881,COST
06008622281050000,2020,177658,671890,849548,COST
06008622281050000,2019,177658,671890,849548,COST
06008622401010000,2021,4166,0,4166,COST
06008622401010000,2020,3078,0,3078,COST
06008622401010000,2019,3078,0,3078,COST
06008623101010000,2021,11794,0,11794,COST
06008623101010000,2020,10995,0,10995,COST
06008623101010000,2019,10995,0,10995,COST
06008624101010000,2021,11098,0,11098,COST
06008624101010000,2020,9971,0,9971,COST
06008624101010000,2019,9971,0,9971,COST
