id,year,land,building,total,method
06079907158150100,2021,51201,0,51201,COST
06079907158150100,2020,52415,0,52415,COST
06079907158150100,2019,52415,0,52415,COST
06079907201010000,2021,3913756,2315040,6228796,COST
06079907201010000,2020,2472263,2126930,4599193,COST
06079907201010000,2019,2472263,2126930,4599193,COST
06079907201160000,2021,2493457,3922343,6415800,INCOME
06079907201160000,2020,2038080,3790740,5828820,COST
06079907201160000,2019,2038080,3790740,5828820,COST
06079907202010000,2021,183568,298932,482500,INCOME
06079907202010000,2020,339478,137922,477400,INCOME
06079907202010000,2019,339478,137922,477400,INCOME
06079907202030000,2021,140931,565269,706200,INCOME
06079907202030000,2020,932725,246410,1179135,COST
06079907202030000,2019,932725,246410,1179135,COST
06079907202050000,2021,154240,666160,820400,INCOME
06079907202050000,2020,315083,503717,818800,INCOME
06079907202050000,2019,315083,503717,818800,INCOME
06079907202097000,2021,5461391,100880,5562271,COST
06079907202097000,2020,2294134,97260,2391394,COST
06079907202097000,2019,2294134,97260,2391394,COST
06079907202200000,2021,3313108,1370292,4683400,INCOME
06079907202200000,2020,1851959,2761841,4613800,INCOME
06079907202200000,2019,1851959,2761841,4613800,INCOME
06079907202240000,2021,2828606,622294,3450900,INCOME
06079907202240000,2020,1730682,1668918,3399600,INCOME
06079907202240000,2019,1730682,1668918,3399600,INCOME
06079907203050000,2021,342751,8390,351141,COST
06079907203050000,2020,1196674,8120,1204794,COST
06079907203050000,2019,1196674,8120,1204794,COST
06079907203100000,2021,870378,203222,1073600,INCOME
06079907203100000,2020,918000,357000,1275000,OVR
06079907203100000,2019,918000,357000,1275000,COST
06079907203157000,2021,2226340,0,2226340,COST
06079907203157000,2020,1592549,0,1592549,COST
06079907203157000,2019,1592549,0,1592549,COST
06079907203170000,2021,872138,267662,1139800,INCOME
06079907203170000,2020,1045492,4908,1050400,OVR
06079907203170000,2019,1045492,4908,1050400,INCOME
06079907203190000,2021,1701962,1903338,3605300,INCOME
06079907203190000,2020,1392217,1389383,2781600,INCOME
06079907203190000,2019,1392217,1389383,2781600,INCOME
06079907203210000,2021,1474671,1568829,3043500,INCOME
06079907203210000,2020,1309297,1225403,2534700,INCOME
06079907203210000,2019,1309297,1225403,2534700,INCOME
06079907203240000,2021,2210741,1383670,3594411,COST
06079907203240000,2020,1557277,1779430,3336707,COST
06079907203240000,2019,1557277,1779430,3336707,COST
06079907203277000,2021,2210741,0,2210741,COST
06079907203277000,2020,1557277,0,1557277,COST
06079907203277000,2019,1557277,0,1557277,COST
06079907203290000,2021,1271686,346714,1618400,INCOME
06079907203290000,2020,1228816,246884,1475700,INCOME
06079907203290000,2019,1228816,246884,1475700,INCOME
06079907203317000,2021,1633717,0,1633717,COST
06079907203317000,2020,1368023,0,1368023,COST
06079907203317000,2019,1368023,0,1368023,COST
06079907203330000,2021,1659305,750295,2409600,INCOME
06079907203330000,2020,1377161,689439,2066600,INCOME
06079907203330000,2019,1377161,689439,2066600,INCOME
06079907203370000,2021,578381,485219,1063600,INCOME
06079907203370000,2020,524436,458264,982700,INCOME
06079907203370000,2019,524436,458264,982700,INCOME
06079907204010000,2021,1643623,1210450,2854073,COST
06079907204010000,2020,1639697,1173750,2813447,COST
06079907204010000,2019,1639697,1173750,2813447,COST
06079907204110000,2021,2597077,663800,3260877,COST
06079907204110000,2020,1701173,625090,2326263,COST
06079907204110000,2019,1701173,625090,2326263,COST
06079907204160000,2021,1792354,1516146,3308500,INCOME
06079907204160000,2020,1423424,1558276,2981700,INCOME
06079907204160000,2019,1423424,1558276,2981700,INCOME
06079907204190000,2021,1792354,603846,2396200,INCOME
06079907204190000,2020,1423424,578876,2002300,INCOME
06079907204190000,2019,1423424,578876,2002300,INCOME
06079907204220000,2021,2503108,1822492,4325600,INCOME
06079907204220000,2020,1642379,1673521,3315900,INCOME
06079907204220000,2019,1642379,1590450,3232829,COST
06079907204230000,2021,1488790,651210,2140000,INCOME
06079907204230000,2020,1314653,368847,1683500,INCOME
06079907204230000,2019,1314653,368847,1683500,INCOME
06079907204270000,2021,3127146,3010454,6137600,INCOME
06079907204270000,2020,1806693,3507007,5313700,INCOME
06079907204270000,2019,1806693,3507007,5313700,INCOME
06079907205080000,2021,966574,241230,1207804,COST
06079907205080000,2020,236408,230430,466838,COST
06079907205080000,2019,236408,230430,466838,COST
06079907205100000,2021,948241,153270,1101511,COST
06079907205100000,2020,454192,152280,606472,COST
06079907205100000,2019,452321,554479,1006800,INCOME
06079907205130000,2021,2149852,2847448,4997300,INCOME
06079907205130000,2020,1538757,3446543,4985300,INCOME
06079907205130000,2019,1538757,3446543,4985300,INCOME
06079907205150000,2021,1772878,1898122,3671000,INCOME
06079907205150000,2020,1416778,1498822,2915600,INCOME
06079907205150000,2019,1416778,1498822,2915600,INCOME
06079907205170000,2021,1251864,499436,1751300,INCOME
06079907205170000,2020,1220574,138626,1359200,INCOME
06079907205170000,2019,1220574,138626,1359200,INCOME
06079907205190000,2021,1363767,57733,1421500,INCOME
06079907205190000,2020,1266172,137420,1403592,COST
06079907205190000,2019,1266172,305620,1571792,COST
06079907205210000,2021,1101698,666202,1767900,INCOME
06079907205210000,2020,1155557,684610,1840167,COST
06079907205210000,2019,1155557,684610,1840167,COST
06079907205240000,2021,3195524,4135176,7330700,INCOME
06079907205240000,2020,1802475,4313520,6115995,COST
06079907205240000,2019,1802475,4313520,6115995,COST
06079907206010000,2021,6461713,7915187,14376900,INCOME
06079907206010000,2020,2465526,10758974,13224500,INCOME
06079907206010000,2019,2465526,10758974,13224500,INCOME
06079907206160000,2021,611296,21800,633096,COST
06079907206160000,2020,656463,21120,677583,COST
06079907206160000,2019,656463,21120,677583,COST
06079907206170000,2021,2320405,0,2320405,COST
06079907206170000,2020,1589912,0,1589912,COST
06079907206170000,2019,1589912,0,1589912,COST
06079907206250000,2021,585833,0,585833,COST
06079907206250000,2020,644607,0,644607,COST
06079907206250000,2019,644607,0,644607,COST
06079907206350000,2021,2545040,516220,3061260,COST
06079907206350000,2020,1654109,482191,2136300,INCOME
06079907206350000,2019,1654109,482191,2136300,INCOME
06079907206370000,2021,1852946,445454,2298400,INCOME
06079907206370000,2020,1443842,274358,1718200,INCOME
06079907206370000,2019,1443842,274358,1718200,INCOME
06079907206400000,2021,2490846,294854,2785700,INCOME
06079907206400000,2020,1638928,772972,2411900,INCOME
06079907206400000,2019,1638928,772972,2411900,INCOME
06079907206420000,2021,1424221,163510,1587731,COST
06079907206420000,2020,1058070,156650,1214720,COST
06079907206420000,2019,1289918,154680,1444598,COST
06079907206440000,2021,1424221,372079,1796300,INCOME
06079907206440000,2020,1289918,167182,1457100,INCOME
06079907206440000,2019,1289918,167182,1457100,INCOME
06079907206470000,2021,2419186,2028814,4448000,INCOME
06079907206470000,2020,1618561,2225739,3844300,INCOME
06079907206470000,2019,1618561,2225739,3844300,INCOME
06079907208010000,2021,1939817,109983,2049800,INCOME
06079907208010000,2020,1501283,385617,1886900,INCOME
06079907208010000,2019,1501283,385617,1886900,INCOME
06079907208100000,2021,2569720,1892480,4462200,INCOME
06079907208100000,2020,2064553,2201047,4265600,INCOME
06079907208100000,2019,2064553,2201047,4265600,INCOME
06079907208140000,2021,1405105,540495,1945600,INCOME
06079907208140000,2020,559836,1373664,1933500,INCOME
06079907208140000,2019,559836,1373664,1933500,INCOME
06079907208180000,2021,515536,20590,536126,COST
06079907208180000,2020,610258,22220,632478,COST
06079907208180000,2019,610258,22220,632478,COST
06079907208220000,2021,558413,274060,832473,COST
06079907208220000,2020,631505,258720,890225,COST
06079907208220000,2019,631505,258720,890225,COST
06079907209010000,2021,2072690,823210,2895900,INCOME
06079907209010000,2020,1514850,948850,2463700,INCOME
06079907209010000,2019,1514850,948850,2463700,INCOME
06079907209020000,2021,1515621,661979,2177600,INCOME
06079907209020000,2020,1324750,498950,1823700,INCOME
06079907209020000,2019,1324750,498950,1823700,INCOME
06079907209040000,2021,1199578,667160,1866738,COST
06079907209040000,2020,1198469,629480,1827949,COST
06079907209040000,2019,1198469,629480,1827949,COST
06079907209060000,2021,2042902,486230,2529132,COST
06079907209060000,2020,1505485,463420,1968905,COST
06079907209060000,2019,1505485,463420,1968905,COST
06079907209070000,2021,219665,0,219665,COST
06079907209070000,2020,291010,0,291010,COST
06079907209070000,2019,291010,0,291010,COST
06079907209107000,2021,2940159,201860,3142019,COST
06079907209107000,2020,1759598,195670,1955268,COST
06079907209107000,2019,1759598,195670,1955268,COST
06079907209150000,2021,1978248,66652,2044900,INCOME
06079907209150000,2020,648195,1251805,1900000,INCOME
06079907209150000,2019,648195,1251805,1900000,INCOME
06079907209180000,2021,244640,0,244640,COST
06079907209180000,2020,443438,0,443438,COST
06079907209180000,2019,442658,0,442658,COST
06079907209190000,2021,181119,49240,230359,COST
06079907209190000,2020,344602,48380,392982,COST
06079907209190000,2019,344602,48380,392982,COST
06079907209200000,2021,115796,22390,138186,COST
06079907209200000,2020,220320,21990,242310,COST
06079907209200000,2019,220320,21990,242310,COST
06079907209210000,2021,847929,278820,1126749,COST
06079907209210000,2020,528716,186284,715000,INCOME
06079907209210000,2019,528716,186284,715000,INCOME
06079907210010000,2021,1260939,450161,1711100,INCOME
06079907210010000,2020,1224357,251943,1476300,INCOME
06079907210010000,2019,1224357,251943,1476300,INCOME
06079907210067000,2021,2659016,0,2659016,COST
06079907210067000,2020,1685446,0,1685446,COST
06079907210067000,2019,1685446,0,1685446,COST
06079907210070000,2021,2020997,1049203,3070200,INCOME
06079907210070000,2020,1498549,1096251,2594800,INCOME
06079907210070000,2019,1498549,1096251,2594800,INCOME
06079907210090000,2021,2042902,2002150,4045052,COST
06079907210090000,2020,1505485,1884710,3390195,COST
06079907210090000,2019,1505485,1884710,3390195,COST
06079907210130000,2021,2374372,2616828,4991200,INCOME
06079907210130000,2020,1605648,2517752,4123400,INCOME
06079907210130000,2019,1605648,2517752,4123400,INCOME
06079907210150000,2021,1542136,1175930,2718066,COST
06079907210150000,2020,1334629,1128150,2462779,COST
06079907210150000,2019,1334629,1128150,2462779,COST
06079907210180000,2021,640080,200320,840400,INCOME
06079907210180000,2020,466684,310116,776800,INCOME
06079907210180000,2019,1094745,286780,1381525,COST
06079907210210000,2021,1398231,261369,1659600,INCOME
06079907210210000,2020,1304832,121768,1426600,INCOME
06079907210210000,2019,1304832,121768,1426600,INCOME
06079907210280000,2021,2110435,23251565,25362000,INCOME
06079907210280000,2020,1556489,15375150,16931639,COST
06079907210280000,2019,1556489,119980,1676469,COST
06079907210310000,2021,463386,9130,472516,COST
06079907210310000,2020,1361692,8830,1370522,COST
06079907210310000,2019,1361692,8830,1370522,COST
06079907211010000,2021,1941423,1000877,2942300,INCOME
06079907211010000,2020,1472983,1525240,2998223,COST
06079907211010000,2019,1472983,1525240,2998223,COST
06079907211050000,2021,1792354,840846,2633200,INCOME
06079907211050000,2020,1423424,957776,2381200,INCOME
06079907211050000,2019,1423424,957776,2381200,INCOME
06079907211077000,2021,1494567,0,1494567,COST
06079907211077000,2020,1316836,0,1316836,COST
06079907211077000,2019,1316836,0,1316836,COST
06079907211090000,2021,1551531,14669,1566200,INCOME
06079907211090000,2020,1338106,271780,1609886,COST
06079907211090000,2019,1338106,510800,1848906,COST
06079907211100000,2021,1376000,481000,1857000,INCOME
06079907211100000,2020,1271025,330390,1601415,COST
06079907211100000,2019,1271025,330390,1601415,COST
06079907211137000,2021,1714619,0,1714619,COST
06079907211137000,2020,1396643,0,1396643,COST
06079907211137000,2019,1396643,0,1396643,COST
06079907211150000,2021,1217321,654440,1871761,COST
06079907211150000,2020,1206031,483969,1690000,OVR
06079907211150000,2019,1206031,483969,1690000,OVR
06079907211180000,2021,2635435,3408365,6043800,INCOME
06079907211180000,2020,1679026,3224474,4903500,INCOME
06079907211180000,2019,1679026,3224474,4903500,INCOME
06079907211217000,2021,3024971,11670,3036641,COST
06079907211217000,2020,1816030,11290,1827320,COST
06079907211217000,2019,1816030,11290,1827320,COST
06079907212017000,2021,2060003,346600,2406603,COST
06079907212017000,2020,1510871,329740,1840611,COST
06079907212017000,2019,1510871,329740,1840611,COST
06079907212040000,2021,2207634,578766,2786400,INCOME
06079907212040000,2020,1556339,800161,2356500,INCOME
06079907212040000,2019,1556339,800161,2356500,INCOME
06079907212050000,2021,1406269,250800,1657069,COST
06079907212050000,2020,1052336,241840,1294176,COST
06079907212050000,2019,1052336,241840,1294176,COST
06079907212080000,2021,1406269,308730,1714999,COST
06079907212080000,2020,1052336,291750,1344086,COST
06079907212080000,2019,1052336,291750,1344086,COST
06079907212090000,2021,1303988,247140,1551128,COST
06079907212090000,2020,1242092,232840,1474932,COST
06079907212090000,2019,1242092,232840,1474932,COST
06079907212100000,2021,1250131,272340,1522471,COST
06079907212100000,2020,1000596,261360,1261956,COST
06079907212100000,2019,1000596,261360,1261956,COST
06079907212120000,2021,1406269,175631,1581900,INCOME
06079907212120000,2020,1282928,111372,1394300,INCOME
06079907212120000,2019,1282928,111372,1394300,INCOME
06079907212140000,2021,1406269,514331,1920600,INCOME
06079907212140000,2020,1282928,285472,1568400,INCOME
06079907212140000,2019,1282928,285472,1568400,INCOME
06079907212160000,2021,1551531,704969,2256500,INCOME
06079907212160000,2020,1338106,489794,1827900,INCOME
06079907212160000,2019,1338106,489794,1827900,INCOME
06079907212300000,2021,1085665,151635,1237300,INCOME
06079907212300000,2020,587764,623636,1211400,INCOME
06079907212300000,2019,587764,623636,1211400,INCOME
06079907212310000,2021,349740,0,349740,COST
06079907212310000,2020,516804,0,516804,COST
06079907212310000,2019,516804,0,516804,COST
06079907212320000,2021,300883,0,300883,COST
06079907212320000,2020,484542,0,484542,COST
06079907212320000,2019,484542,0,484542,COST
06079907212350000,2021,450072,0,450072,COST
06079907212350000,2020,575769,0,575769,COST
06079907212350000,2019,575769,0,575769,COST
06079907212390000,2021,217947,0,217947,COST
06079907212390000,2020,494840,0,494840,COST
06079907212390000,2019,494840,0,494840,COST
06079907212420000,2021,170272,0,170272,COST
06079907212420000,2020,445184,0,445184,COST
06079907212420000,2019,445184,0,445184,COST
06079907213010000,2021,2083171,308429,2391600,INCOME
06079907213010000,2020,1518127,400173,1918300,INCOME
06079907213010000,2019,1518127,856373,2374500,INCOME
06079907213060000,2021,2975666,4272234,7247900,INCOME
06079907213060000,2020,1768670,5735530,7504200,INCOME
06079907213060000,2019,1768670,5735530,7504200,INCOME
06079907213100000,2021,1410071,1606320,3016391,COST
06079907213100000,2020,1284413,1546660,2831073,COST
06079907213100000,2019,1284413,1546660,2831073,COST
06079907213120000,2021,1354133,1401030,2755163,COST
06079907213120000,2020,1262333,1352590,2614923,COST
06079907213120000,2019,1262333,1352590,2614923,COST
06079907213140000,2021,2143821,5780550,7924371,COST
06079907213140000,2020,1536906,3607960,5144866,COST
06079907213140000,2019,1536906,0,1536906,COST
06079907213180000,2021,1314078,462930,1777008,COST
06079907213180000,2020,1246200,436500,1682700,COST
06079907213180000,2019,1246200,436500,1682700,COST
06079907213200000,2021,1976541,542359,2518900,INCOME
06079907213200000,2020,1484338,810562,2294900,INCOME
06079907213200000,2019,1484338,810562,2294900,INCOME
06079907213220000,2021,1409671,106029,1515700,INCOME
06079907213220000,2020,1284257,14943,1299200,INCOME
06079907213220000,2019,1284257,14943,1299200,INCOME
06079907213240000,2021,2238127,51473,2289600,INCOME
06079907213240000,2020,1565512,1213150,2778662,COST
06079907213240000,2019,1565512,1213150,2778662,COST
06079907213287000,2021,2959650,0,2959650,COST
06079907213287000,2020,1764586,0,1764586,COST
06079907213287000,2019,1764586,0,1764586,COST
06079907213340000,2021,467168,10830,477998,COST
06079907213340000,2020,585038,10480,595518,COST
06079907213340000,2019,585038,10480,595518,COST
06079907213360000,2021,315746,278654,594400,INCOME
06079907213360000,2020,346288,365812,712100,INCOME
06079907213360000,2019,346288,365812,712100,INCOME
06079907213380000,2021,253904,0,253904,COST
06079907213380000,2020,450555,0,450555,COST
06079907213380000,2019,450555,0,450555,COST
06079907213390000,2021,604654,0,604654,COST
06079907213390000,2020,653398,0,653398,COST
06079907213390000,2019,653398,0,653398,COST
06079907213460000,2021,696865,152035,848900,INCOME
06079907213460000,2020,486094,109806,595900,INCOME
06079907213460000,2019,486094,109806,595900,INCOME
06079907213500000,2021,221843,0,221843,COST
06079907213500000,2020,498611,0,498611,COST
06079907213500000,2019,498611,0,498611,COST
06079907213520000,2021,510739,19890,530629,COST
06079907213520000,2020,425510,18320,443830,COST
06079907213520000,2019,425510,18320,443830,COST
06079907213540000,2021,593609,105750,699359,COST
06079907213540000,2020,453820,92980,546800,INCOME
06079907213540000,2019,453820,92980,546800,INCOME
06079907213580000,2021,792341,643370,1435711,COST
06079907213580000,2020,513580,545120,1058700,INCOME
06079907213580000,2019,513580,545120,1058700,INCOME
06079907213640000,2021,1199551,21249,1220800,INCOME
06079907213640000,2020,613426,439174,1052600,INCOME
06079907213640000,2019,613426,439174,1052600,INCOME
06079907215017000,2021,4658770,46810,4705580,COST
06079907215017000,2020,935533,45370,980903,COST
06079907215017000,2019,935533,45370,980903,COST
06079907215100000,2021,682893,182540,865433,COST
06079907215100000,2020,481894,89506,571400,INCOME
06079907215100000,2019,481894,89506,571400,INCOME
06079907215220000,2021,334946,173054,508000,MKT
06079907215220000,2020,254223,144277,398500,MKT
06079907215220000,2019,254223,144277,398500,MKT
06079907216010000,2021,792341,26259,818600,INCOME
06079907216010000,2020,513580,138420,652000,INCOME
06079907216010000,2019,513580,138420,652000,INCOME
06079907216057000,2021,1324420,195980,1520400,COST
06079907216057000,2020,640008,190990,830998,COST
06079907216057000,2019,640008,190990,830998,COST
06079907216120000,2021,2372407,195930,2568337,COST
06079907216120000,2020,700662,199380,900042,COST
06079907216120000,2019,700662,199380,900042,COST
06079907216140000,2021,847929,743830,1591759,COST
06079907216140000,2020,915099,713180,1628279,COST
06079907216140000,2019,915099,713180,1628279,COST
06079907216160000,2021,254379,5390,259769,COST
06079907216160000,2020,432950,5220,438170,COST
06079907216160000,2019,432950,5220,438170,COST
06079907216180000,2021,350369,194731,545100,MKT
06079907216180000,2020,260025,143575,403600,MKT
06079907216180000,2019,260025,143575,403600,MKT
06079907216240000,2021,640080,147650,787730,COST
06079907216240000,2020,383815,128540,512355,COST
06079907216240000,2019,383815,113180,496995,COST
06079907216270000,2021,303131,154269,457400,INCOME
06079907216270000,2020,241818,185482,427300,INCOME
06079907216270000,2019,241818,185482,427300,INCOME
06079907217010000,2021,572255,0,572255,COST
06079907217010000,2020,1490521,0,1490521,COST
06079907217010000,2019,1490521,0,1490521,COST
06079907217127000,2021,2816864,96570,2913434,COST
06079907217127000,2020,1761417,97280,1858697,COST
06079907217127000,2019,1761417,97280,1858697,COST
06079907217140000,2021,847929,113571,961500,INCOME
06079907217140000,2020,432950,418120,851070,COST
06079907217140000,2019,432950,418120,851070,COST
06079907217160000,2021,327010,137590,464600,MKT
06079907217160000,2020,251186,131514,382700,MKT
06079907217160000,2019,251186,131514,382700,MKT
06079907217180000,2021,327010,138690,465700,MKT
06079907217180000,2020,251186,132314,383500,MKT
06079907217180000,2019,251186,132314,383500,MKT
06079907217210000,2021,390537,219863,610400,MKT
06079907217210000,2020,274564,152436,427000,MKT
06079907217210000,2019,274564,152436,427000,MKT
06079907217240000,2021,347837,191563,539400,MKT
06079907217240000,2020,259082,147418,406500,MKT
06079907217240000,2019,259082,147418,406500,MKT
06079907217270000,2021,364436,233664,598100,MKT
06079907217270000,2020,265207,176593,441800,MKT
06079907217270000,2019,265207,176593,441800,MKT
06079907217290000,2021,252139,124661,376800,MKT
06079907217290000,2020,220491,113809,334300,MKT
06079907217290000,2019,220491,113809,334300,MKT
06079907217310000,2021,252139,142461,394600,MKT
06079907217310000,2020,220491,120509,341000,MKT
06079907217310000,2019,220491,120509,341000,MKT
06079907218010000,2021,1483875,0,1483875,COST
06079907218010000,2020,234780,102820,337600,MKT
06079907218010000,2019,234780,102820,337600,MKT
06079907218200000,2021,2733265,14884035,17617300,INCOME
06079907218200000,2020,1738831,15679469,17418300,INCOME
06079907218200000,2019,1738831,15679469,17418300,INCOME
06079907218270000,2021,1791087,30470,1821557,COST
06079907218270000,2020,596427,32980,629407,COST
06079907218270000,2019,596427,32980,629407,COST
06079907218320000,2021,316988,0,316988,COST
06079907218320000,2020,475745,0,475745,COST
06079907218320000,2019,475745,0,475745,COST
06079907218370000,2021,280383,0,280383,COST
06079907218370000,2020,451383,0,451383,COST
06079907218370000,2019,451383,0,451383,COST
06079907219010000,2021,1126268,510932,1637200,INCOME
06079907219010000,2020,597082,952718,1549800,INCOME
06079907219010000,2019,597082,952718,1549800,INCOME
06079907219060000,2021,1009875,291025,1300900,INCOME
06079907219060000,2020,569823,609377,1179200,INCOME
06079907219060000,2019,569823,609377,1179200,INCOME
06079907219120000,2021,629167,10150,639317,COST
06079907219120000,2020,664616,23870,688486,COST
06079907219120000,2019,664616,23870,688486,COST
06079907219190000,2021,883663,219500,1103163,COST
06079907219190000,2020,440674,207726,648400,INCOME
06079907219190000,2019,440674,207726,648400,INCOME
06079907219210000,2021,304821,109079,413900,MKT
06079907219210000,2020,242492,104308,346800,MKT
06079907219210000,2019,242492,104308,346800,MKT
06079907219230000,2021,250161,89839,340000,MKT
06079907219230000,2020,219622,57478,277100,MKT
06079907219230000,2019,219622,57478,277100,MKT
06079907219250000,2021,386842,113358,500200,MKT
06079907219250000,2020,273259,89441,362700,MKT
06079907219250000,2019,273259,89441,362700,MKT
06079907219300000,2021,883663,174970,1058633,COST
06079907219300000,2020,440674,154526,595200,INCOME
06079907219300000,2019,440674,154526,595200,INCOME
06079907219350000,2021,508347,349450,857797,COST
06079907219350000,2020,313357,303590,616947,COST
06079907219350000,2019,313357,303590,616947,COST
06079907220200000,2021,1528882,97518,1626400,INCOME
06079907220200000,2020,680603,474597,1155200,INCOME
06079907220200000,2019,680603,474597,1155200,INCOME
06079907220215001,2021,764933,72667,837600,INCOME
06079907220215001,2020,505893,264907,770800,INCOME
06079907220215001,2019,505893,264907,770800,INCOME
06079907220215002,2021,722534,185666,908200,INCOME
06079907220215002,2020,493685,329315,823000,INCOME
06079907220215002,2019,493685,329315,823000,INCOME
06079907220250000,2021,384394,13410,397804,COST
06079907220250000,2020,538148,14050,552198,COST
06079907220250000,2019,538148,14050,552198,COST
06079907220280000,2021,489927,11670,501597,COST
06079907220280000,2020,597082,11290,608372,COST
06079907220280000,2019,597082,11290,608372,COST
06079907220310000,2021,948181,184019,1132200,INCOME
06079907220310000,2020,554642,564358,1119000,INCOME
06079907220310000,2019,554642,564358,1119000,INCOME
06079907220330000,2021,522024,484276,1006300,INCOME
06079907220330000,2020,429513,443687,873200,INCOME
06079907220330000,2019,429513,443687,873200,INCOME
06079907220367000,2021,851354,5750,857104,COST
06079907220367000,2020,529630,6140,535770,COST
06079907220367000,2019,529630,6140,535770,COST
06079907220450000,2021,2703541,0,2703541,COST
06079907220450000,2020,711474,0,711474,COST
06079907220450000,2019,711474,0,711474,COST
06079907220520000,2021,297754,0,297754,COST
06079907220520000,2020,463158,0,463158,COST
06079907220520000,2019,463158,0,463158,COST
06079907220560000,2021,1342563,5585190,6927753,COST
06079907220560000,2020,339649,0,339649,COST
06079907220560000,2019,280363,165537,445900,INCOME
06079907221010000,2021,861111,0,861111,COST
06079907221010000,2020,318041,107460,425501,COST
06079907221010000,2019,318041,107460,425501,COST
06079907221080000,2021,555556,0,555556,COST
06079907221080000,2020,281637,150063,431700,MKT
06079907221080000,2019,281637,150063,431700,MKT
06079907221090000,2021,222222,0,222222,COST
06079907221090000,2020,218532,50568,269100,MKT
06079907221090000,2019,218532,50568,269100,MKT
06079907221110000,2021,277778,0,277778,COST
06079907221110000,2020,235900,156900,392800,OVR
06079907221110000,2019,235900,156900,392800,MKT
06079907221140000,2021,583333,0,583333,COST
06079907221140000,2020,286372,233100,519472,COST
06079907221140000,2019,286372,233100,519472,COST
06079907221200000,2021,1009875,26125,1036000,INCOME
06079907221200000,2020,466611,269189,735800,INCOME
06079907221200000,2019,466611,269189,735800,INCOME
06079907221300000,2021,326119,138781,464900,MKT
06079907221300000,2020,250842,143158,394000,MKT
06079907221300000,2019,250842,143158,394000,MKT
06079907222010000,2021,1080724,43576,1124300,INCOME
06079907222010000,2020,480364,387136,867500,INCOME
06079907222010000,2019,480364,387136,867500,INCOME
06079907222050000,2021,422343,13400,435743,COST
06079907222050000,2020,537973,12970,550943,COST
06079907222050000,2019,537973,12970,550943,COST
06079907222070000,2021,1611756,4321030,5932786,COST
06079907222070000,2020,1204926,3923390,5128316,COST
06079907222070000,2019,1204926,20140,1225066,COST
06079907223010000,2021,1350769,3507331,4858100,INCOME
06079907223010000,2020,1117110,2232690,3349800,INCOME
06079907223010000,2019,1117110,2232690,3349800,INCOME
06079907223030000,2021,2491723,4129380,6621103,COST
06079907223030000,2020,687037,3815410,4502447,COST
06079907223030000,2019,687037,3815410,4502447,COST
06079907224015001,2021,538104,1028900,1567004,COST
06079907224015001,2020,217910,1103390,1321300,OVR
06079907224015001,2019,217910,1103390,1321300,MKT
06079907224035002,2021,402640,761660,1164300,MKT
06079907224035002,2020,188426,904374,1092800,OVR
06079907224035002,2019,188426,904374,1092800,MKT
06079907224055003,2021,401298,731500,1132798,COST
06079907224055003,2020,188111,777789,965900,OVR
06079907224055003,2019,188111,777789,965900,MKT
06079907224075004,2021,399840,818260,1218100,MKT
06079907224075004,2020,187768,953432,1141200,OVR
06079907224075004,2019,187768,953432,1141200,MKT
06079907224105005,2021,398491,814509,1213000,MKT
06079907224105005,2020,187450,961350,1148800,OVR
06079907224105005,2019,187450,961350,1148800,MKT
06079907224135006,2021,397138,839262,1236400,MKT
06079907224135006,2020,187131,1066069,1253200,OVR
06079907224135006,2019,187131,1066069,1253200,MKT
06079907224155007,2021,395667,737733,1133400,MKT
06079907224155007,2020,186783,886917,1073700,OVR
06079907224155007,2019,186783,886917,1073700,MKT
06079907224175008,2021,394306,738794,1133100,MKT
06079907224175008,2020,186461,884139,1070600,OVR
06079907224175008,2019,186461,884139,1070600,MKT
06079907224195009,2021,392941,839459,1232400,MKT
06079907224195009,2020,186137,1065863,1252000,OVR
06079907224195009,2019,186137,1065863,1252000,MKT
06079907224215010,2021,525418,1015640,1541058,COST
06079907224215010,2020,215319,1088781,1304100,OVR
06079907224215010,2019,215319,1088781,1304100,MKT
06079907224235011,2021,513113,1093820,1606933,COST
06079907224235011,2020,212777,1097423,1310200,OVR
06079907224235011,2019,212777,1097423,1310200,MKT
06079907224255012,2021,392713,816887,1209600,MKT
06079907224255012,2020,186083,965917,1152000,OVR
06079907224255012,2019,186083,965917,1152000,MKT
06079907224275013,2021,394079,810821,1204900,MKT
06079907224275013,2020,186407,946593,1133000,OVR
06079907224275013,2019,186407,946593,1133000,MKT
06079907224295014,2021,403198,815302,1218500,MKT
06079907224295014,2020,188557,962943,1151500,OVR
06079907224295014,2019,188557,962943,1151500,MKT
06079907224316500,2021,61171,3620,64791,COST
06079907224316500,2020,64909,4340,69249,COST
06079907224316500,2019,64909,4340,69249,COST
06079907224335016,2021,455708,1261370,1717078,COST
06079907224335016,2020,200491,1159409,1359900,OVR
06079907224335016,2019,200491,1159409,1359900,MKT
06079907224355017,2021,401074,753226,1154300,MKT
06079907224355017,2020,188059,893441,1081500,OVR
06079907224355017,2019,188059,893441,1081500,MKT
06079907224375018,2021,402416,816284,1218700,MKT
06079907224375018,2020,188374,1070626,1259000,MKT
06079907224375018,2019,188374,966826,1155200,MKT
06079907224395019,2021,549598,1018210,1567808,COST
06079907224395019,2020,220231,1094069,1314300,OVR
06079907224395019,2019,220231,1094069,1314300,MKT
06079907225010000,2021,235276,180424,415700,MKT
06079907225010000,2020,232376,160724,393100,MKT
06079907225010000,2019,232376,160724,393100,MKT
06079907225020000,2021,230403,110897,341300,MKT
06079907225020000,2020,229950,88550,318500,MKT
06079907225020000,2019,229950,88550,318500,MKT
06079907225030000,2021,218005,111495,329500,MKT
06079907225030000,2020,223662,70138,293800,MKT
06079907225030000,2019,223662,70138,293800,MKT
06079907225040000,2021,222944,314390,537334,COST
06079907225040000,2020,226188,276312,502500,OVR
06079907225040000,2019,226188,276312,502500,MKT
06079907225050000,2021,599100,117100,716200,INCOME
06079907225050000,2020,234590,582760,817350,COST
06079907225050000,2019,234590,582760,817350,COST
06079907225060000,2021,534912,36288,571200,INCOME
06079907225060000,2020,222708,149992,372700,INCOME
06079907225060000,2019,222708,149992,372700,INCOME
06079907225070000,2021,256057,220743,476800,MKT
06079907225070000,2020,222202,186798,409000,MKT
06079907225070000,2019,222202,186798,409000,MKT
06079907225080000,2021,266398,8940,275338,COST
06079907225080000,2020,226655,8660,235315,COST
06079907225080000,2019,226655,8660,235315,COST
06079907225090000,2021,234052,2290,236342,COST
06079907225090000,2020,212415,2230,214645,COST
06079907225090000,2019,212415,2230,214645,COST
06079907225100000,2021,280774,198626,479400,MKT
06079907225100000,2020,232706,171894,404600,MKT
06079907225100000,2019,232706,171894,404600,MKT
06079907226010000,2021,407163,208237,615400,MKT
06079907226010000,2020,280363,171737,452100,MKT
06079907226010000,2019,280363,171737,452100,MKT
06079907226040000,2021,407163,146937,554100,MKT
06079907226040000,2020,280363,135437,415800,MKT
06079907226040000,2019,280363,135437,415800,MKT
06079907226080000,2021,480320,551480,1031800,INCOME
06079907226080000,2020,512323,451177,963500,INCOME
06079907226080000,2019,512323,451177,963500,INCOME
06079907227110000,2021,427182,198718,625900,MKT
06079907227110000,2020,313357,180643,494000,MKT
06079907227110000,2019,313357,180643,494000,MKT
06079907227140000,2021,196893,185107,382000,INCOME
06079907227140000,2020,257029,43071,300100,INCOME
06079907227140000,2019,257029,43071,300100,INCOME
06079907227170000,2021,335981,0,335981,COST
06079907227170000,2020,279627,0,279627,COST
06079907227170000,2019,279627,0,279627,COST
06079907228010000,2021,302842,473940,776782,COST
06079907228010000,2020,266681,0,266681,COST
06079907228010000,2019,266681,86119,352800,MKT
06079907228020000,2021,309654,88746,398400,MKT
06079907228020000,2020,266681,81219,347900,MKT
06079907228020000,2019,266681,81219,347900,MKT
06079907228030000,2021,309654,265900,575554,COST
06079907228030000,2020,266681,233320,500001,COST
06079907228030000,2019,266681,233320,500001,COST
06079907228040000,2021,309654,240646,550300,MKT
06079907228040000,2020,266681,186419,453100,MKT
06079907228040000,2019,266681,186419,453100,MKT
06079907228050000,2021,326239,190461,516700,MKT
06079907228050000,2020,273748,177752,451500,MKT
06079907228050000,2019,273748,174952,448700,MKT
06079907228060000,2021,292300,524290,816590,COST
06079907228060000,2020,259082,437080,696162,COST
06079907228060000,2019,259082,437080,696162,COST
06079907228070000,2021,328828,0,328828,COST
06079907228070000,2020,274835,107865,382700,MKT
06079907228070000,2019,274835,107865,382700,MKT
06079907228080000,2021,237305,214800,452105,COST
06079907228080000,2020,233378,191130,424508,COST
06079907228080000,2019,233378,191130,424508,COST
06079907228090000,2021,288470,387060,675530,COST
06079907228090000,2020,257374,417662,675036,MRA
06079907228090000,2019,257374,417662,675036,MRA
06079907228100000,2021,318746,194754,513500,MKT
06079907228100000,2020,270578,167022,437600,MKT
06079907228100000,2019,270578,167022,437600,MKT
06079907228110000,2021,406965,187435,594400,MKT
06079907228110000,2020,305833,147567,453400,MKT
06079907228110000,2019,305833,147567,453400,MKT
06079907229010000,2021,761460,114240,875700,INCOME
06079907229010000,2020,413454,461610,875064,COST
06079907229010000,2019,413454,461610,875064,COST
06079907229140000,2021,299839,86361,386200,MKT
06079907229140000,2020,262410,88690,351100,MKT
06079907229140000,2019,262410,88690,351100,MKT
06079907229160000,2021,298594,217906,516500,MKT
06079907229160000,2020,261863,193437,455300,MKT
06079907229160000,2019,261863,193437,455300,MKT
06079907229180000,2021,298594,216406,515000,MKT
06079907229180000,2020,261863,175037,436900,MKT
06079907229180000,2019,261863,175037,436900,MKT
06079907229200000,2021,298594,115706,414300,MKT
06079907229200000,2020,261863,121237,383100,MKT
06079907229200000,2019,261863,121237,383100,MKT
06079907229220000,2021,298594,107106,405700,MKT
06079907229220000,2020,261863,86337,348200,MKT
06079907229220000,2019,261863,86337,348200,MKT
06079907229240000,2021,297344,182656,480000,MKT
06079907229240000,2020,261313,119787,381100,MKT
06079907229240000,2019,261313,116187,377500,MKT
06079907230010000,2021,4530610,2890490,7421100,INCOME
06079907230010000,2020,1008624,6270476,7279100,INCOME
06079907230010000,2019,1008624,6270476,7279100,INCOME
06079907231010000,2021,1498184,177516,1675700,INCOME
06079907231010000,2020,552505,885895,1438400,INCOME
06079907231010000,2019,552505,885895,1438400,INCOME
06079907231130000,2021,318273,151027,469300,MKT
06079907231130000,2020,270377,131223,401600,MKT
06079907231130000,2019,270377,131223,401600,MKT
06079907231175001,2021,218604,506796,725400,MKT
06079907231175001,2020,230458,460140,690598,COST
06079907231175001,2019,230458,460140,690598,COST
06079907231185002,2021,176043,548657,724700,MKT
06079907231185002,2020,206438,441850,648288,COST
06079907231185002,2019,206438,441850,648288,COST
06079907231195003,2021,176085,572115,748200,MKT
06079907231195003,2020,206463,454640,661103,COST
06079907231195003,2019,206463,454640,661103,COST
06079907231215004,2021,176127,559873,736000,MKT
06079907231215004,2020,206488,425410,631898,COST
06079907231215004,2019,206488,425410,631898,COST
06079907231235005,2021,185577,516223,701800,MKT
06079907231235005,2020,212071,389990,602061,COST
06079907231235005,2019,212071,389990,602061,COST
06079907231245000,2021,78813,0,78813,COST
06079907231245000,2020,73676,0,73676,COST
06079907231245000,2019,73676,0,73676,COST
06079907231250000,2021,272169,157331,429500,MKT
06079907231250000,2020,249978,156622,406600,MKT
06079907231250000,2019,249978,156622,406600,MKT
06079907231290000,2021,285893,310807,596700,MKT
06079907231290000,2020,256219,243981,500200,MKT
06079907231290000,2019,256219,243981,500200,MKT
06079907231310000,2021,350978,923530,1274508,COST
06079907231310000,2020,283964,829200,1113164,COST
06079907231310000,2019,283964,827300,1111264,COST
06079907231330000,2021,285375,376225,661600,MKT
06079907231330000,2020,255986,256870,512856,OVR
06079907231330000,2019,255986,256870,512856,COST
06079907231340000,2021,341484,441516,783000,MKT
06079907231340000,2020,280088,374512,654600,MKT
06079907231340000,2019,280088,374512,654600,MKT
06079907231360000,2021,349776,463510,813286,COST
06079907231360000,2020,283476,408360,691836,COST
06079907231360000,2019,283476,408360,691836,COST
06079907232010000,2021,285375,164325,449700,MKT
06079907232010000,2020,255986,169214,425200,MKT
06079907232010000,2019,255986,169214,425200,MKT
06079907232060000,2021,301328,182972,484300,MKT
06079907232060000,2020,263063,140337,403400,MKT
06079907232060000,2019,263063,140337,403400,MKT
06079907232080000,2021,343489,143911,487400,MKT
06079907232080000,2020,280911,135589,416500,MKT
06079907232080000,2019,280911,135589,416500,MKT
06079907232100000,2021,343489,315860,659349,COST
06079907232100000,2020,280911,283620,564531,COST
06079907232100000,2019,280911,283620,564531,COST
06079907232120000,2021,428850,426190,855040,COST
06079907232120000,2020,313970,376730,690700,COST
06079907232120000,2019,313970,376730,690700,COST
06079907232160000,2021,442003,272397,714400,MKT
06079907232160000,2020,318760,225640,544400,MKT
06079907232160000,2019,318760,225640,544400,MKT
06079907232180000,2021,350104,797820,1147924,COST
06079907232180000,2020,283610,699380,982990,COST
06079907232180000,2019,283610,699380,982990,COST
06079907232200000,2021,297969,277931,575900,MKT
06079907232200000,2020,261589,247111,508700,MKT
06079907232200000,2019,261589,247111,508700,MKT
06079907232220000,2021,293441,183259,476700,MKT
06079907232220000,2020,259588,179612,439200,MKT
06079907232220000,2019,259588,179612,439200,MKT
06079907232240000,2021,340625,88475,429100,INCOME
06079907232240000,2020,281456,115144,396600,INCOME
06079907232240000,2019,281456,115144,396600,INCOME
06079907233010000,2021,304780,122820,427600,MKT
06079907233010000,2020,264569,86731,351300,MKT
06079907233010000,2019,264569,87231,351800,MKT
06079907233020000,2021,304780,181420,486200,MKT
06079907233020000,2020,264569,141631,406200,MKT
06079907233020000,2019,264569,141631,406200,MKT
06079907233030000,2021,351851,181449,533300,MKT
06079907233030000,2020,284318,131982,416300,MKT
06079907233030000,2019,284318,131982,416300,MKT
06079907233040000,2021,299839,166961,466800,MKT
06079907233040000,2020,262410,146990,409400,MKT
06079907233040000,2019,262410,146990,409400,MKT
06079907233050000,2021,265363,158437,423800,MKT
06079907233050000,2020,246825,152675,399500,MKT
06079907233050000,2019,246825,152675,399500,MKT
06079907233070000,2021,374353,132147,506500,MKT
06079907233070000,2020,293292,117108,410400,MKT
06079907233070000,2019,293292,117108,410400,MKT
06079907233090000,2021,358509,671670,1030179,COST
06079907233090000,2020,287003,482990,769993,COST
06079907233090000,2019,287003,482990,769993,COST
06079907233100000,2021,426068,34432,460500,INCOME
06079907233100000,2020,312947,105353,418300,INCOME
06079907233100000,2019,312947,105353,418300,INCOME
06079907233120000,2021,371571,4629,376200,INCOME
06079907233120000,2020,292197,46103,338300,INCOME
06079907233120000,2019,292197,46103,338300,INCOME
06079907233130000,2021,346148,82252,428400,MKT
06079907233130000,2020,281999,70601,352600,MKT
06079907233130000,2019,281999,70601,352600,MKT
06079907233140000,2021,393092,381550,774642,COST
06079907233140000,2020,300562,364938,665500,MKT
06079907233140000,2019,300562,364938,665500,MKT
06079907233170000,2021,325914,50186,376100,INCOME
06079907233170000,2020,273611,94189,367800,INCOME
06079907233170000,2019,273611,94189,367800,INCOME
06079907233190000,2021,370236,5164,375400,INCOME
06079907233190000,2020,291671,65729,357400,INCOME
06079907233190000,2019,291671,65729,357400,INCOME
06079907233210000,2021,304878,102622,407500,MKT
06079907233210000,2020,264611,91689,356300,MKT
06079907233210000,2019,264611,91689,356300,MKT
06079907233250000,2021,304878,95222,400100,MKT
06079907233250000,2020,264611,84089,348700,MKT
06079907233250000,2019,264611,84089,348700,MKT
06079907233290000,2021,304878,112022,416900,MKT
06079907233290000,2020,264611,80689,345300,MKT
06079907233290000,2019,264611,80689,345300,MKT
06079907233310000,2021,295486,295314,590800,MKT
06079907233310000,2020,260494,199606,460100,MKT
06079907233310000,2019,260494,199606,460100,MKT
06079907233320000,2021,304878,94322,399200,MKT
06079907233320000,2020,264611,79889,344500,MKT
06079907233320000,2019,264611,79889,344500,MKT
06079907233330000,2021,436453,99947,536400,MKT
06079907233330000,2020,316748,82752,399500,MKT
06079907233330000,2019,316748,82752,399500,MKT
06079907233360000,2021,364940,409850,774790,COST
06079907233360000,2020,289572,193728,483300,MKT
06079907233360000,2019,289572,193728,483300,MKT
06079907233390000,2021,396060,318540,714600,INCOME
06079907233390000,2020,301609,389391,691000,INCOME
06079907233390000,2019,301609,389391,691000,INCOME
06079907233410000,2021,304878,152922,457800,MKT
06079907233410000,2020,264611,131789,396400,MKT
06079907233410000,2019,264611,131789,396400,MKT
06079907233430000,2021,304976,188424,493400,MKT
06079907233430000,2020,264654,150946,415600,MKT
06079907233430000,2019,264654,150946,415600,MKT
06079907233450000,2021,297923,117177,415100,INCOME
06079907233450000,2020,264686,124114,388800,INCOME
06079907233450000,2019,264686,124114,388800,INCOME
06079907233470000,2021,304878,134022,438900,MKT
06079907233470000,2020,264611,118889,383500,MKT
06079907233470000,2019,264611,118889,383500,MKT
06079907233490000,2021,304878,169522,474400,MKT
06079907233490000,2020,264611,164989,429600,MKT
06079907233490000,2019,264611,164989,429600,MKT
06079907233520000,2021,388297,107303,495600,MKT
06079907233520000,2020,298718,95282,394000,MKT
06079907233520000,2019,298718,95282,394000,MKT
06079907233530000,2021,393092,181908,575000,MKT
06079907233530000,2020,300562,154438,455000,MKT
06079907233530000,2019,300562,154438,455000,MKT
06079907233540000,2021,346148,164352,510500,MKT
06079907233540000,2020,281999,127201,409200,MKT
06079907233540000,2019,281999,127201,409200,MKT
06079907233550000,2021,272546,239054,511600,MKT
06079907233550000,2020,250151,193149,443300,MKT
06079907233550000,2019,250151,193149,443300,MKT
06079907233560000,2021,401174,274690,675864,COST
06079907233560000,2020,303644,241230,544874,COST
06079907233560000,2019,303644,241230,544874,COST
06079907233570000,2021,426068,257732,683800,MKT
06079907233570000,2020,312947,230253,543200,MKT
06079907233570000,2019,312947,230253,543200,MKT
06079907233580000,2021,360478,121422,481900,MKT
06079907233580000,2020,287792,92208,380000,MKT
06079907233580000,2019,287792,92208,380000,MKT
06079907233590000,2021,299839,151361,451200,MKT
06079907233590000,2020,262410,159490,421900,MKT
06079907233590000,2019,262410,159490,421900,MKT
06079907233600000,2021,299839,444560,744399,COST
06079907233600000,2020,262410,271390,533800,INCOME
06079907233600000,2019,262410,271390,533800,INCOME
06079907233620000,2021,346148,421460,767608,COST
06079907233620000,2020,281999,375850,657849,COST
06079907233620000,2019,281999,375850,657849,COST
06079907233630000,2021,310622,128178,438800,MKT
06079907233630000,2020,267099,111301,378400,MKT
06079907233630000,2019,267099,111301,378400,MKT
06079907233640000,2021,310622,304778,615400,MKT
06079907233640000,2020,267099,245901,513000,MKT
06079907233640000,2019,267099,245901,513000,MKT
06079907233650000,2021,307517,189483,497000,MKT
06079907233650000,2020,265757,156243,422000,MKT
06079907233650000,2019,265757,156243,422000,MKT
06079907234010000,2021,485528,71372,556900,MKT
06079907234010000,2020,334127,120473,454600,MKT
06079907234010000,2019,334127,120473,454600,MKT
06079907234050000,2021,287467,81233,368700,MKT
06079907234050000,2020,256925,62875,319800,MKT
06079907234050000,2019,256925,62875,319800,MKT
06079907234090000,2021,376233,590770,967003,COST
06079907234090000,2020,294029,557423,851452,MRA
06079907234090000,2019,294029,557423,851452,MRA
06079907234100000,2021,153167,84630,237797,COST
06079907234100000,2020,151162,74560,225722,COST
06079907234100000,2019,151162,74560,225722,COST
06079907234170000,2021,803780,1050610,1854390,COST
06079907234170000,2020,430182,926700,1356882,COST
06079907234170000,2019,430182,926700,1356882,COST
06079907234230000,2021,347471,196929,544400,MKT
06079907234230000,2020,282538,177162,459700,MKT
06079907234230000,2019,282538,177162,459700,MKT
06079907234250000,2021,307615,139685,447300,MKT
06079907234250000,2020,265800,98300,364100,MKT
06079907234250000,2019,265800,98300,364100,MKT
06079907234270000,2021,303969,109631,413600,MKT
06079907234270000,2020,264216,85384,349600,MKT
06079907234270000,2019,264216,85384,349600,MKT
06079907234300000,2021,323866,135234,459100,MKT
06079907234300000,2020,272748,109252,382000,MKT
06079907234300000,2019,272748,109252,382000,MKT
06079907234310000,2021,227012,97488,324500,MKT
06079907234310000,2020,228248,77752,306000,MKT
06079907234310000,2019,228248,77752,306000,MKT
06079907234320000,2021,195906,117894,313800,MKT
06079907234320000,2020,211994,75206,287200,MKT
06079907234320000,2019,211994,75206,287200,MKT
06079907234350000,2021,274745,110555,385300,MKT
06079907234350000,2020,251161,93439,344600,MKT
06079907234350000,2019,251161,93439,344600,MKT
06079907234360000,2021,258016,97184,355200,MKT
06079907234360000,2020,243375,82325,325700,MKT
06079907234360000,2019,243375,82325,325700,MKT
06079907234380000,2021,303107,97193,400300,MKT
06079907234380000,2020,263840,85060,348900,MKT
06079907234380000,2019,263840,85060,348900,MKT
06079907234430000,2021,314658,116942,431600,MKT
06079907234430000,2020,268833,102667,371500,MKT
06079907234430000,2019,268833,102667,371500,MKT
06079907234440000,2021,318509,286291,604800,MKT
06079907234440000,2020,270477,188780,459257,COST
06079907234440000,2019,270477,188780,459257,COST
06079907234460000,2021,293026,349974,643000,INCOME
06079907234460000,2020,308445,300855,609300,INCOME
06079907234460000,2019,308445,300855,609300,INCOME
06079907234480000,2021,292783,160217,453000,MKT
06079907234480000,2020,259296,126304,385600,MKT
06079907234480000,2019,259296,126304,385600,MKT
06079907234490000,2021,278255,79345,357600,MKT
06079907234490000,2020,252765,57935,310700,MKT
06079907234490000,2019,252765,86435,339200,MKT
06079907234510000,2021,327997,724140,1052137,COST
06079907234510000,2020,274487,633620,908107,COST
06079907234510000,2019,274487,48413,322900,MKT
06079907234530000,2021,327997,119003,447000,MKT
06079907234530000,2020,274487,115613,390100,MKT
06079907234530000,2019,274487,115613,390100,MKT
06079907234560000,2021,409508,149592,559100,MKT
06079907234560000,2020,306790,109810,416600,MKT
06079907234560000,2019,306790,109810,416600,MKT
06079907234570000,2021,224433,108867,333300,MKT
06079907234570000,2020,226944,71256,298200,MKT
06079907234570000,2019,226944,71256,298200,MKT
06079907234590000,2021,327997,154003,482000,MKT
06079907234590000,2020,274487,129413,403900,MKT
06079907234590000,2019,274487,129413,403900,MKT
06079907234630000,2021,409700,301970,711670,COST
06079907234630000,2020,306862,265340,572202,COST
06079907234630000,2019,306790,265340,572130,COST
06079907234670000,2021,391479,206021,597500,MKT
06079907234670000,2020,297033,177567,474600,MKT
06079907234670000,2019,297033,177567,474600,MKT
06079907234700000,2021,364940,247560,612500,MKT
06079907234700000,2020,289572,207228,496800,MKT
06079907234700000,2019,290926,215774,506700,MKT
06079907234720000,2021,341640,601680,943320,COST
06079907234720000,2020,280152,520900,801052,COST
06079907234720000,2019,280152,520900,801052,COST
06079907234730000,2021,284597,382850,667447,COST
06079907234730000,2020,255636,344590,600226,COST
06079907234730000,2019,255636,344590,600226,COST
06079907234750000,2021,590958,630342,1221300,INCOME
06079907234750000,2020,362370,457630,820000,INCOME
06079907234750000,2019,362370,457630,820000,INCOME
06079907234770000,2021,265363,190737,456100,MKT
06079907234770000,2020,246825,148275,395100,MKT
06079907234770000,2019,246825,148275,395100,MKT
06079907234800000,2021,423981,36619,460600,INCOME
06079907234800000,2020,311181,143819,455000,OVR
06079907234800000,2019,311181,143819,455000,OVR
06079907234820000,2021,246307,33060,279367,COST
06079907234820000,2020,237775,28820,266595,COST
06079907234820000,2019,237775,28820,266595,COST
06079907234870000,2021,320397,70003,390400,MKT
06079907234870000,2020,271280,53420,324700,MKT
06079907234870000,2019,271280,53420,324700,MKT
06079907234900000,2021,316850,58550,375400,INCOME
06079907234900000,2020,269770,87630,357400,INCOME
06079907234900000,2019,269770,87630,357400,INCOME
06079907234930000,2021,337670,240550,578220,COST
06079907234930000,2020,278515,210940,489455,COST
06079907234930000,2019,278515,210940,489455,COST
06079907234950000,2021,289751,87749,377500,MKT
06079907234950000,2020,257947,69853,327800,MKT
06079907234950000,2019,257947,69853,327800,MKT
06079907236010000,2021,302318,399082,701400,MKT
06079907236010000,2020,263495,288205,551700,MKT
06079907236010000,2019,263495,283405,546900,MKT
06079907236040000,2021,302318,128282,430600,MKT
06079907236040000,2020,263495,118505,382000,MKT
06079907236040000,2019,263495,118505,382000,MKT
06079907236060000,2021,302318,119482,421800,MKT
06079907236060000,2020,263495,96205,359700,MKT
06079907236060000,2019,263495,96205,359700,MKT
06079907236080000,2021,302318,111082,413400,MKT
06079907236080000,2020,263495,96005,359500,MKT
06079907236080000,2019,263495,96005,359500,MKT
06079907236100000,2021,302318,116082,418400,MKT
06079907236100000,2020,263495,123605,387100,MKT
06079907236100000,2019,263495,123605,387100,MKT
06079907236120000,2021,302318,151282,453600,MKT
06079907236120000,2020,263495,136705,400200,MKT
06079907236120000,2019,263495,132205,395700,MKT
06079907236140000,2021,302318,127182,429500,MKT
06079907236140000,2020,263495,114805,378300,MKT
06079907236140000,2019,263495,114805,378300,MKT
06079907236160000,2021,302318,203382,505700,MKT
06079907236160000,2020,263495,173305,436800,MKT
06079907236160000,2019,263495,173305,436800,MKT
06079907236200000,2021,341305,235895,577200,MKT
06079907236200000,2020,280014,194386,474400,MKT
06079907236200000,2019,280014,194386,474400,MKT
06079907236210000,2021,304288,198612,502900,MKT
06079907236210000,2020,264355,182945,447300,MKT
06079907236210000,2019,264355,182945,447300,MKT
06079907236240000,2021,461669,268670,730339,COST
06079907236240000,2020,503809,258390,762199,COST
06079907236240000,2019,503809,258390,762199,COST
06079907236260000,2021,349710,185990,535700,MKT
06079907236260000,2020,283450,156650,440100,MKT
06079907236260000,2019,283450,156650,440100,MKT
06079907236280000,2021,308442,122258,430700,MKT
06079907236280000,2020,266157,89243,355400,MKT
06079907236280000,2019,266157,89243,355400,MKT
06079907236300000,2021,308442,200958,509400,MKT
06079907236300000,2020,266157,183243,449400,MKT
06079907236300000,2019,266157,183243,449400,MKT
06079907236320000,2021,307225,148875,456100,MKT
06079907236320000,2020,265631,148069,413700,MKT
06079907236320000,2019,265631,148069,413700,MKT
06079907236340000,2021,307225,131275,438500,MKT
06079907236340000,2020,265631,123569,389200,MKT
06079907236340000,2019,265631,123569,389200,MKT
06079907236360000,2021,306004,174496,480500,OVR
06079907236360000,2020,265101,170099,435200,MKT
06079907236360000,2019,265101,170099,435200,MKT
06079907236380000,2021,304780,115920,420700,MKT
06079907236380000,2020,264569,96131,360700,MKT
06079907236380000,2019,264569,96131,360700,MKT
06079907236400000,2021,304780,127020,431800,MKT
06079907236400000,2020,264569,102531,367100,MKT
06079907236400000,2019,264569,103531,368100,MKT
06079907237010000,2021,298594,155306,453900,MKT
06079907237010000,2020,261863,139837,401700,MKT
06079907237010000,2019,261863,139837,401700,MKT
06079907237040000,2021,298594,234306,532900,MKT
06079907237040000,2020,261863,183537,445400,MKT
06079907237040000,2019,261863,180437,442300,MKT
06079907237055001,2021,203664,537400,741064,COST
06079907237055001,2020,216162,229960,446122,OVR
06079907237065002,2021,203664,533580,737244,COST
06079907237065002,2020,216162,229210,445372,OVR
06079907237075003,2021,203698,554640,758338,COST
06079907237075003,2020,216180,217880,434060,COST
06079907237085004,2021,203698,534870,738568,COST
06079907237085004,2020,216180,229760,445940,OVR
06079907237095005,2021,203698,554640,758338,COST
06079907237095005,2020,216180,239010,455190,OVR
06079907237105006,2021,203698,534870,738568,COST
06079907237105006,2020,216180,229760,445940,OVR
06079907237115007,2021,203732,0,203732,COST
06079907237115007,2020,216198,0,216198,COST
06079907237125008,2021,203766,0,203766,COST
06079907237125008,2020,216216,0,216216,COST
06079907237130000,2021,203766,0,203766,COST
06079907237130000,2020,216216,0,216216,COST
06079907237140000,2021,203766,0,203766,COST
06079907237140000,2020,216216,0,216216,COST
06079907237150000,2021,203801,0,203801,COST
06079907237150000,2020,216234,0,216234,COST
06079907237160000,2021,203801,0,203801,COST
06079907237160000,2020,216234,0,216234,COST
06079907237170000,2021,203835,0,203835,COST
06079907237170000,2020,216253,0,216253,COST
06079907237180000,2021,203835,0,203835,COST
06079907237180000,2020,216253,0,216253,COST
06079907237190000,2021,203835,0,203835,COST
06079907237190000,2020,216253,0,216253,COST
06079907237200000,2021,257565,0,257565,COST
06079907237200000,2020,243162,0,243162,COST
06079907237200000,2019,710443,0,710443,COST
06079907237230000,2021,294276,240524,534800,MKT
06079907237230000,2020,259958,191242,451200,MKT
06079907237230000,2019,259958,191242,451200,MKT
06079907237240000,2021,274558,593700,868258,COST
06079907237240000,2020,251076,517160,768236,COST
06079907237240000,2019,251076,517160,768236,COST
06079907237260000,2021,378986,118014,497000,MKT
06079907237260000,2020,295106,96894,392000,MKT
06079907237260000,2019,295106,95894,391000,MKT
06079907237280000,2021,304780,211420,516200,MKT
06079907237280000,2020,264569,186731,451300,MKT
06079907237280000,2019,264569,186731,451300,MKT
06079907237300000,2021,303551,360870,664421,COST
06079907237300000,2020,264033,77167,341200,MKT
06079907237300000,2019,264033,77167,341200,MKT
06079907237320000,2021,303551,137349,440900,MKT
06079907237320000,2020,264033,134567,398600,MKT
06079907237320000,2019,264033,134567,398600,MKT
06079907237340000,2021,302318,258450,560768,COST
06079907237340000,2020,263495,238960,502455,COST
06079907237340000,2019,263495,238960,502455,COST
06079907237360000,2021,302318,309700,612018,COST
06079907237360000,2020,263495,273300,536795,COST
06079907237360000,2019,263495,273300,536795,COST
06079907237400000,2021,340321,175079,515400,MKT
06079907237400000,2020,279609,144691,424300,MKT
06079907237400000,2019,279609,144691,424300,MKT
06079907237440000,2021,257565,202635,460200,MKT
06079907237440000,2020,243162,148238,391400,MKT
06079907237440000,2019,243162,147038,390200,MKT
06079907238010000,2021,321573,255227,576800,MKT
06079907238010000,2020,271778,212322,484100,MKT
06079907238010000,2019,271778,212322,484100,MKT
06079907238050000,2021,394718,168482,563200,INCOME
06079907238050000,2020,301140,226960,528100,INCOME
06079907238050000,2019,301140,226960,528100,INCOME
06079907238080000,2021,345485,224715,570200,MKT
06079907238080000,2020,281728,152172,433900,MKT
06079907238080000,2019,281728,152172,433900,MKT
06079907238110000,2021,401487,152613,554100,MKT
06079907238110000,2020,303763,135837,439600,MKT
06079907238110000,2019,303763,135837,439600,MKT
06079907238150000,2021,321573,248727,570300,MKT
06079907238150000,2020,271778,208922,480700,MKT
06079907238150000,2019,271778,208922,480700,MKT
06079907238160000,2021,401487,228213,629700,MKT
06079907238160000,2020,303763,214237,518000,MKT
06079907238160000,2019,303763,214237,518000,MKT
06079907238190000,2021,401487,220213,621700,MKT
06079907238190000,2020,303763,204037,507800,MKT
06079907238190000,2019,303763,204037,507800,MKT
06079907238210000,2021,364940,176560,541500,MKT
06079907238210000,2020,289572,171728,461300,MKT
06079907238210000,2019,289572,171728,461300,MKT
06079907238230000,2021,359581,64119,423700,INCOME
06079907238230000,2020,287432,134868,422300,INCOME
06079907238230000,2019,287432,134868,422300,INCOME
06079907238250000,2021,316850,90350,407200,MKT
06079907238250000,2020,269770,87530,357300,MKT
06079907238250000,2019,269770,87530,357300,MKT
06079907238270000,2021,318036,154364,472400,MKT
06079907238270000,2020,270276,163224,433500,MKT
06079907238270000,2019,270276,163224,433500,MKT
06079907238290000,2021,319218,152382,471600,MKT
06079907238290000,2020,270779,150321,421100,MKT
06079907238290000,2019,270779,150321,421100,MKT
06079907238310000,2021,320397,141403,461800,MKT
06079907238310000,2020,271280,130220,401500,MKT
06079907238310000,2019,271280,130220,401500,MKT
06079907238330000,2021,321573,117527,439100,MKT
06079907238330000,2020,271778,90322,362100,MKT
06079907238330000,2019,271778,90322,362100,MKT
06079907238350000,2021,321573,246827,568400,MKT
06079907238350000,2020,271778,215622,487400,MKT
06079907238350000,2019,271778,215622,487400,MKT
06079907238370000,2021,322744,170956,493700,MKT
06079907238370000,2020,272274,148526,420800,MKT
06079907238370000,2019,272274,148526,420800,MKT
06079907238420000,2021,469176,116824,586000,INCOME
06079907238420000,2020,325977,227823,553800,INCOME
06079907238420000,2019,325977,227823,553800,INCOME
06079907239010000,2021,234119,112181,346300,MKT
06079907239010000,2020,231802,73898,305700,MKT
06079907239010000,2019,231802,73898,305700,MKT
06079907239060000,2021,292300,310660,602960,COST
06079907239060000,2020,259082,156018,415100,MKT
06079907239060000,2019,259082,156018,415100,MKT
06079907239090000,2021,342153,313990,656143,COST
06079907239090000,2020,280363,280710,561073,COST
06079907239090000,2019,280363,280710,561073,COST
06079907239120000,2021,397761,757930,1155691,COST
06079907239120000,2020,302346,662910,965256,COST
06079907239120000,2019,302346,662910,965256,COST
06079907239140000,2021,274049,167951,442000,MKT
06079907239140000,2020,250842,121858,372700,MKT
06079907239140000,2019,250842,121858,372700,MKT
06079907239160000,2021,316374,187926,504300,MKT
06079907239160000,2020,269567,168433,438000,MKT
06079907239160000,2019,269567,168433,438000,MKT
06079907239190000,2021,427182,230918,658100,MKT
06079907239190000,2020,313357,209743,523100,MKT
06079907239190000,2019,313357,209743,523100,MKT
06079907239210000,2021,342153,513280,855433,COST
06079907239210000,2020,280363,447450,727813,COST
06079907239210000,2019,280363,447450,727813,COST
06079907239240000,2021,372278,526790,899068,COST
06079907239240000,2020,292476,457540,750016,COST
06079907239240000,2019,292476,457540,750016,COST
06079907239260000,2021,357908,193392,551300,MKT
06079907239260000,2020,286761,167039,453800,MKT
06079907239260000,2019,286761,167039,453800,MKT
06079907239280000,2021,356175,544540,900715,COST
06079907239280000,2020,287278,475960,763238,COST
06079907239280000,2019,287278,475960,763238,COST
06079907239300000,2021,360478,326400,686878,COST
06079907239300000,2020,287792,285608,573400,MKT
06079907239300000,2019,287792,285608,573400,MKT
06079907239320000,2021,361758,119242,481000,MKT
06079907239320000,2020,288303,102997,391300,MKT
06079907239320000,2019,288303,102997,391300,MKT
06079907239340000,2021,327397,252803,580200,MKT
06079907239340000,2020,274235,227665,501900,OVR
06079907239340000,2019,274235,227665,501900,MKT
06079907239360000,2021,291792,177610,469402,COST
06079907239360000,2020,258856,154810,413666,COST
06079907239360000,2019,258856,154810,413666,COST
06079907239380000,2021,318273,157227,475500,MKT
06079907239380000,2020,270377,150023,420400,MKT
06079907239380000,2019,270377,150023,420400,MKT
06079907239400000,2021,342153,134647,476800,MKT
06079907239400000,2020,280363,135537,415900,MKT
06079907239400000,2019,280363,135537,415900,MKT
06079907239420000,2021,309654,123246,432900,MKT
06079907239420000,2020,266681,120519,387200,MKT
06079907239420000,2019,266681,120519,387200,MKT
06079907239440000,2021,315207,447020,762227,COST
06079907239440000,2020,269068,399780,668848,COST
06079907239440000,2019,269068,399780,668848,COST
06079907240016500,2021,384045,0,384045,COST
06079907240016500,2020,162857,0,162857,COST
06079907240016500,2019,162857,0,162857,COST
06079907243010000,2021,295713,318187,613900,MKT
06079907243010000,2020,260594,269506,530100,MKT
06079907243010000,2019,260594,269506,530100,MKT
06079907243020000,2021,295713,118687,414400,MKT
06079907243020000,2020,260594,126806,387400,MKT
06079907243020000,2019,260594,126806,387400,MKT
06079907243030000,2021,313269,132831,446100,MKT
06079907243030000,2020,268238,136462,404700,MKT
06079907243030000,2019,268238,136462,404700,MKT
06079907243040000,2021,313269,131331,444600,MKT
06079907243040000,2020,268238,128062,396300,MKT
06079907243040000,2019,268238,128062,396300,MKT
06079907243050000,2021,277248,171952,449200,MKT
06079907243050000,2020,252306,163994,416300,MKT
06079907243050000,2019,252306,163994,416300,MKT
06079907243060000,2021,235944,163856,399800,MKT
06079907243060000,2020,232706,148494,381200,MKT
06079907243060000,2019,232706,148494,381200,MKT
06079907243070000,2021,235944,161056,397000,MKT
06079907243070000,2020,232706,145994,378700,MKT
06079907243070000,2019,232706,145994,378700,MKT
06079907243080000,2021,441822,118578,560400,MKT
06079907243080000,2020,318695,101905,420600,MKT
06079907243080000,2019,318695,101905,420600,MKT
06079907243100000,2021,404214,587410,991624,COST
06079907243100000,2020,304795,0,304795,COST
06079907243100000,2019,304795,69205,374000,MKT
06079907243110000,2021,312116,161584,473700,MKT
06079907243110000,2020,267742,151758,419500,MKT
06079907243110000,2019,267742,151758,419500,MKT
06079907243130000,2021,308879,293320,602199,COST
06079907243130000,2020,266346,257580,523926,COST
06079907243130000,2019,266346,257580,523926,COST
06079907244010000,2021,314466,189034,503500,MKT
06079907244010000,2020,268751,184949,453700,MKT
06079907244010000,2019,268751,184949,453700,MKT
06079907244050000,2021,394105,215100,609205,COST
06079907244050000,2020,300950,189530,490480,COST
06079907244050000,2019,300950,189530,490480,COST
06079907244070000,2021,318036,114164,432200,MKT
06079907244070000,2020,270276,97124,367400,MKT
06079907244070000,2019,270276,97124,367400,MKT
06079907244100000,2021,349491,168509,518000,MKT
06079907244100000,2020,283361,173339,456700,MKT
06079907244100000,2019,283361,173339,456700,MKT
06079907244120000,2021,257847,166953,424800,MKT
06079907244120000,2020,243295,162805,406100,MKT
06079907244120000,2019,285912,155688,441600,MKT
06079907244130000,2021,228323,196300,424623,COST
06079907244130000,2020,228908,7800,236708,COST
06079907244150000,2021,359109,129791,488900,MKT
06079907244150000,2020,287243,113957,401200,MKT
06079907244150000,2019,287243,113957,401200,MKT
06079907244170000,2021,317230,499020,816250,COST
06079907244170000,2020,269932,439260,709192,COST
06079907244170000,2019,269932,439260,709192,COST
06079907244190000,2021,314275,296725,611000,MKT
06079907244190000,2020,268669,248031,516700,MKT
06079907244190000,2019,268669,248031,516700,MKT
06079907244210000,2021,289751,125549,415300,MKT
06079907244210000,2020,257947,117453,375400,MKT
06079907244210000,2019,257947,117453,375400,MKT
06079907244230000,2021,289751,167249,457000,MKT
06079907244230000,2020,257947,170853,428800,MKT
06079907244230000,2019,257947,170853,428800,MKT
06079907245010000,2021,321573,153327,474900,MKT
06079907245010000,2020,271778,128222,400000,MKT
06079907245010000,2019,271778,128222,400000,MKT
06079907245040000,2021,321573,119427,441000,MKT
06079907245040000,2020,271778,123422,395200,MKT
06079907245040000,2019,271778,123422,395200,MKT
06079907245060000,2021,321573,160327,481900,MKT
06079907245060000,2020,271778,155022,426800,MKT
06079907245060000,2019,271778,155022,426800,MKT
06079907245080000,2021,321573,110427,432000,MKT
06079907245080000,2020,271778,86922,358700,MKT
06079907245080000,2019,271778,86922,358700,MKT
06079907245100000,2021,321573,119427,441000,MKT
06079907245100000,2020,271778,92622,364400,MKT
06079907245100000,2019,271778,92622,364400,MKT
06079907245120000,2021,307225,127775,435000,MKT
06079907245120000,2020,265631,125569,391200,MKT
06079907245120000,2019,265631,125569,391200,MKT
06079907245160000,2021,277009,212791,489800,MKT
06079907245160000,2020,252197,181603,433800,MKT
06079907245160000,2019,252197,181603,433800,MKT
06079907245170000,2021,257565,390300,647865,COST
06079907245170000,2020,243162,399938,643100,MKT
06079907245170000,2019,243162,399938,643100,MKT
06079907245190000,2021,370333,270567,640900,INCOME
06079907245190000,2020,292460,298740,591200,INCOME
06079907245190000,2019,292460,298740,591200,INCOME
06079907245220000,2021,377447,178753,556200,MKT
06079907245220000,2020,294505,166395,460900,MKT
06079907245220000,2019,294505,166395,460900,MKT
06079907245250000,2021,392615,263185,655800,MKT
06079907245250000,2020,300379,228621,529000,MKT
06079907245250000,2019,300379,218721,519100,MKT
06079907246010000,2021,623442,1131858,1755300,INCOME
06079907246010000,2020,371373,1067627,1439000,INCOME
06079907246010000,2019,371373,1067627,1439000,INCOME
06079907246070000,2021,276185,234715,510900,MKT
06079907246070000,2020,251821,183279,435100,MKT
06079907246070000,2019,251821,183279,435100,MKT
06079907246090000,2021,258606,392900,651506,COST
06079907246090000,2020,243654,343520,587174,COST
06079907246090000,2019,243654,343520,587174,COST
06079907246100000,2021,237154,423020,660174,COST
06079907246100000,2020,233304,373800,607104,COST
06079907246100000,2019,233304,373800,607104,COST
06079907246110000,2021,300262,539438,839700,MKT
06079907246110000,2020,262596,464040,726636,COST
06079907246110000,2019,262596,464040,726636,COST
06079907246130000,2021,251643,177857,429500,MKT
06079907246130000,2020,240343,164757,405100,MKT
06079907246130000,2019,240343,164757,405100,MKT
06079907246140000,2021,226040,351050,577090,COST
06079907246140000,2020,227757,309760,537517,COST
06079907246140000,2019,227757,309760,537517,COST
06079907246150000,2021,295713,156387,452100,MKT
06079907246150000,2020,260594,155006,415600,MKT
06079907246150000,2019,260594,155006,415600,MKT
06079907246170000,2021,295713,258187,553900,MKT
06079907246170000,2020,260594,197806,458400,MKT
06079907246170000,2019,260594,197806,458400,MKT
06079907246190000,2021,315660,163940,479600,MKT
06079907246190000,2020,269262,153438,422700,MKT
06079907246190000,2019,269262,153438,422700,MKT
06079907246220000,2021,315660,125940,441600,MKT
06079907246220000,2020,269262,120338,389600,MKT
06079907246220000,2019,269262,120338,389600,MKT
06079907246240000,2021,315660,358770,674430,COST
06079907246240000,2020,269262,317060,586322,COST
06079907246240000,2019,269262,214538,483800,MKT
06079907247010000,2021,400509,376613,777122,OVR
06079907247010000,2020,303391,392509,695900,MKT
06079907247010000,2019,303391,359609,663000,MKT
06079907247040000,2021,275386,0,275386,COST
06079907247040000,2020,251455,0,251455,COST
06079907247040000,2019,251455,0,251455,COST
06079907247060000,2021,325914,107686,433600,MKT
06079907247060000,2020,273611,86189,359800,MKT
06079907247060000,2019,273611,86189,359800,MKT
06079907247080000,2021,342153,133447,475600,MKT
06079907247080000,2020,280363,106737,387100,MKT
06079907247080000,2019,280363,106737,387100,MKT
06079907247100000,2021,343845,168355,512200,MKT
06079907247100000,2020,281056,138144,419200,MKT
06079907247100000,2019,281056,138144,419200,MKT
06079907247110000,2021,234119,161181,395300,MKT
06079907247110000,2020,231802,150398,382200,MKT
06079907247110000,2019,231802,150398,382200,MKT
06079907247120000,2021,234119,231181,465300,MKT
06079907247120000,2020,231802,211998,443800,MKT
06079907247120000,2019,231802,211998,443800,MKT
06079907247140000,2021,342153,146447,488600,MKT
06079907247140000,2020,280363,130137,410500,MKT
06079907247140000,2019,280363,130137,410500,MKT
06079907247150000,2021,256152,94548,350700,MKT
06079907247150000,2020,242492,63608,306100,MKT
06079907247150000,2019,242492,63608,306100,MKT
06079907247160000,2021,280680,115220,395900,MKT
06079907247160000,2020,253867,116233,370100,MKT
06079907247160000,2019,253867,116233,370100,MKT
06079907247180000,2021,284597,118280,402877,COST
06079907247180000,2020,255636,104360,359996,COST
06079907247180000,2019,255636,104360,359996,COST
06079907247190000,2021,296717,92583,389300,MKT
06079907247190000,2020,261037,71863,332900,MKT
06079907247190000,2019,261037,71863,332900,MKT
06079907247200000,2021,300138,283662,583800,MKT
06079907247200000,2020,262541,255259,517800,MKT
06079907247200000,2019,262541,255259,517800,MKT
06079907247220000,2021,435869,191131,627000,MKT
06079907247220000,2020,316535,222765,539300,OVR
06079907247220000,2019,316535,222765,539300,MKT
06079907247230000,2021,344377,128723,473100,MKT
06079907247230000,2020,281275,98825,380100,MKT
06079907247230000,2019,281275,98825,380100,MKT
06079907247250000,2021,343267,217670,560937,COST
06079907247250000,2020,280820,191200,472020,COST
06079907247250000,2019,280820,191200,472020,COST
06079907247270000,2021,341037,210063,551100,MKT
06079907247270000,2020,279904,163496,443400,MKT
06079907247270000,2019,279904,163496,443400,MKT
06079907247280000,2021,283036,87364,370400,MKT
06079907247280000,2020,254932,71768,326700,MKT
06079907247280000,2019,254932,71768,326700,MKT
06079907247300000,2021,352199,166101,518300,MKT
06079907247300000,2020,284459,132941,417400,MKT
06079907247300000,2019,284459,132941,417400,MKT
06079907247330000,2021,403242,6650,409892,COST
06079907247330000,2020,304427,87173,391600,MKT
06079907247330000,2019,304427,87173,391600,MKT
06079907247360000,2021,277461,195439,472900,MKT
06079907247360000,2020,252403,163497,415900,MKT
06079907247360000,2019,252403,163497,415900,MKT
06079907247380000,2021,258494,494406,752900,MKT
06079907247380000,2020,243601,423098,666699,MRA
06079907247380000,2019,243601,423098,666699,MRA
06079907301010000,2021,470122,402130,872252,COST
06079907301010000,2020,398528,343100,741628,OVR
06079907301010000,2019,398528,343100,741628,COST
06079907301040000,2021,535158,92342,627500,MKT
06079907301040000,2020,425272,100828,526100,MKT
06079907301040000,2019,425272,100828,526100,MKT
06079907301060000,2021,530338,262162,792500,MKT
06079907301060000,2020,423348,214552,637900,MKT
06079907301060000,2019,423348,214552,637900,MKT
06079907301080000,2021,530338,131762,662100,MKT
06079907301080000,2020,423348,96052,519400,MKT
06079907301080000,2019,423348,96052,519400,MKT
06079907301100000,2021,492956,138344,631300,MKT
06079907301100000,2020,408117,102283,510400,MKT
06079907301100000,2019,409179,101221,510400,MKT
06079907301130000,2021,567947,293040,860987,COST
06079907301130000,2020,438140,196760,634900,MKT
06079907301130000,2019,438140,196760,634900,MKT
06079907301160000,2021,372244,241156,613400,MKT
06079907301160000,2020,354518,187780,542298,COST
06079907301160000,2019,354518,187780,542298,COST
06079907301190000,2021,534472,389040,923512,COST
06079907301190000,2020,424999,288501,713500,MKT
06079907301190000,2019,424999,288501,713500,MKT
06079907301220000,2021,503870,206920,710790,COST
06079907301220000,2020,412621,100979,513600,MKT
06079907301220000,2019,412621,100979,513600,MKT
06079907301250000,2021,556752,213530,770282,COST
06079907301250000,2020,433789,99111,532900,MKT
06079907301250000,2019,433789,99111,532900,MKT
06079907301280000,2021,631334,507070,1138404,COST
06079907301280000,2020,462006,404250,866256,COST
06079907301280000,2019,462006,404250,866256,COST
06079907301320000,2021,642769,798710,1441479,COST
06079907301320000,2020,466181,643320,1109501,COST
06079907301320000,2019,466181,643320,1109501,COST
06079907302010000,2021,770124,1138230,1908354,COST
06079907302010000,2020,510397,915130,1425527,COST
06079907302010000,2019,510397,915130,1425527,COST
06079907302070000,2021,587429,562900,1150329,COST
06079907302070000,2020,445610,445970,891580,COST
06079907302070000,2019,445610,445970,891580,COST
06079907302090000,2021,519884,322116,842000,MKT
06079907302090000,2020,419144,335956,755100,MKT
06079907302090000,2019,419144,335956,755100,MKT
06079907302120000,2021,649081,303319,952400,MKT
06079907302120000,2020,468471,304929,773400,MKT
06079907302120000,2019,468471,187329,655800,MKT
06079907302140000,2021,519884,882480,1402364,COST
06079907302140000,2020,419144,723490,1142634,COST
06079907302140000,2019,419144,723490,1142634,COST
06079907302160000,2021,556985,222420,779405,COST
06079907302160000,2020,433880,143420,577300,MKT
06079907302160000,2019,433880,143420,577300,MKT
06079907302180000,2021,480827,0,480827,COST
06079907302180000,2020,403052,0,403052,COST
06079907302180000,2019,403052,0,403052,COST
06079907302200000,2021,519884,258630,778514,COST
06079907302200000,2020,419144,193056,612200,MKT
06079907302200000,2019,419144,193056,612200,MKT
06079907302220000,2021,519884,49416,569300,MKT
06079907302220000,2020,419144,73356,492500,MKT
06079907302220000,2019,419144,73356,492500,MKT
06079907302240000,2021,454834,152166,607000,MKT
06079907302240000,2020,391978,124022,516000,MKT
06079907302240000,2019,391978,124022,516000,MKT
06079907303010000,2021,290108,628170,918278,COST
06079907303010000,2020,261479,261540,523019,COST
06079907303010000,2019,261479,258560,520039,COST
06079907303030000,2021,268320,461440,729760,COST
06079907303030000,2020,248200,390900,639100,MKT
06079907303030000,2019,248200,390900,639100,MKT
06079907303050000,2021,355323,342577,697900,MKT
06079907303050000,2020,285721,295879,581600,MKT
06079907303050000,2019,285721,295879,581600,MKT
06079907303070000,2021,355323,530177,885500,MKT
06079907303070000,2020,285721,413579,699300,MKT
06079907303070000,2019,285721,413579,699300,MKT
06079907303100000,2021,415924,440670,856594,COST
06079907303100000,2020,309190,403810,713000,MKT
06079907303100000,2019,309190,403810,713000,MKT
06079907303130000,2021,321573,233527,555100,MKT
06079907303130000,2020,271778,207822,479600,MKT
06079907303130000,2019,271778,207822,479600,MKT
06079907303150000,2021,355323,437077,792400,MKT
06079907303150000,2020,285721,368879,654600,MKT
06079907303150000,2019,285721,368879,654600,MKT
06079907303180000,2021,401487,264913,666400,MKT
06079907303180000,2020,303763,231637,535400,MKT
06079907303180000,2019,303763,231637,535400,MKT
06079907303210000,2021,331995,626405,958400,MKT
06079907303210000,2020,276159,413141,689300,MKT
06079907303210000,2019,276159,413141,689300,MKT
06079907303230000,2021,331995,396705,728700,MKT
06079907303230000,2020,276159,317041,593200,MKT
06079907303230000,2019,276159,317041,593200,MKT
06079907303250000,2021,355323,277277,632600,MKT
06079907303250000,2020,285721,262379,548100,MKT
06079907303250000,2019,285721,262379,548100,MKT
06079907303270000,2021,355323,703277,1058600,MKT
06079907303270000,2020,285721,557979,843700,MKT
06079907303270000,2019,285721,557979,843700,MKT
06079907303300000,2021,712344,845850,1558194,COST
06079907303300000,2020,490828,766810,1257638,COST
06079907303300000,2019,490828,766810,1257638,COST
06079907303330000,2021,941505,653720,1595225,COST
06079907303330000,2020,490828,500000,990828,OVR
06079907303330000,2019,490828,500000,990828,OVR
06079907303390000,2021,775062,593800,1368862,COST
06079907303390000,2020,512035,480360,992395,COST
06079907303390000,2019,512035,480360,992395,COST
06079907303430000,2021,712344,485960,1198304,COST
06079907303430000,2020,490828,416972,907800,MKT
06079907303430000,2019,490828,416972,907800,MKT
06079907303470000,2021,754636,808642,1563278,MRA
06079907303470000,2020,505226,712633,1217859,MRA
06079907303470000,2019,505226,712633,1217859,MRA
06079907303540000,2021,689354,671550,1360904,COST
06079907303540000,2020,587226,622690,1209916,COST
06079907303540000,2019,587226,622690,1209916,COST
06079907304017000,2021,486681,6940,493621,COST
06079907304017000,2020,125156,6820,131976,COST
06079907304017000,2019,125156,6820,131976,COST
06079907304070000,2021,428938,306000,734938,COST
06079907304070000,2020,312844,268470,581314,COST
06079907304070000,2019,312844,268470,581314,COST
06079907304090000,2021,341037,473140,814177,COST
06079907304090000,2020,279904,387030,666934,COST
06079907304090000,2019,279904,310610,590514,COST
06079907304110000,2021,341037,565750,906787,COST
06079907304110000,2020,279904,402760,682664,COST
06079907304110000,2019,279904,320596,600500,MKT
06079907304130000,2021,341037,226100,567137,COST
06079907304130000,2020,279904,180090,459994,COST
06079907304130000,2019,279904,180090,459994,COST
06079907304150000,2021,257565,325535,583100,MKT
06079907304150000,2020,243162,277938,521100,MKT
06079907304150000,2019,243162,277938,521100,MKT
06079907304170000,2021,253306,122294,375600,MKT
06079907304170000,2020,241138,80462,321600,MKT
06079907304170000,2019,241138,80462,321600,MKT
06079907304190000,2021,341037,578340,919377,COST
06079907304190000,2020,279904,470310,750214,COST
06079907304190000,2019,279904,470310,750214,COST
06079907304210000,2021,393264,0,393264,COST
06079907304210000,2020,300630,0,300630,COST
06079907304210000,2019,300630,0,300630,COST
06079907304230000,2021,325077,164749,489826,OVR
06079907304230000,2020,273259,108041,381300,OVR
06079907304230000,2019,273259,108041,381300,MKT
06079907304280000,2021,402014,168886,570900,MKT
06079907304280000,2020,303962,173038,477000,MKT
06079907304280000,2019,303962,173038,477000,MKT
06079907304310000,2021,366839,178561,545400,MKT
06079907304310000,2020,290326,133374,423700,MKT
06079907304310000,2019,290326,133374,423700,MKT
06079907304330000,2021,356402,999098,1355500,MKT
06079907304330000,2020,286156,763939,1050095,MRA
06079907304330000,2019,286156,763939,1050095,MRA
06079907304350000,2021,357478,256822,614300,MKT
06079907304350000,2020,286589,226111,512700,OVR
06079907304350000,2019,286589,226111,512700,MKT
06079907304370000,2021,358552,141048,499600,INCOME
06079907304370000,2020,287020,116280,403300,INCOME
06079907304370000,2019,287020,116280,403300,INCOME
06079907304390000,2021,367428,639710,1007138,COST
06079907304390000,2020,290560,515200,805760,COST
06079907304390000,2019,290560,515200,805760,COST
06079907305010000,2021,499812,146588,646400,MKT
06079907305010000,2020,339019,187581,526600,MKT
06079907305010000,2019,339019,187581,526600,MKT
06079907305050000,2021,339379,348390,687769,COST
06079907305050000,2020,279221,281310,560531,COST
06079907305050000,2019,279221,281310,560531,COST
06079907305110000,2021,399137,399790,798927,COST
06079907305110000,2020,302870,316330,619200,MKT
06079907305110000,2019,302870,316330,619200,MKT
06079907305170000,2021,398548,175352,573900,MKT
06079907305170000,2020,302646,212054,514700,MKT
06079907305170000,2019,302646,212054,514700,MKT
06079907311010000,2021,662133,515150,1177283,COST
06079907311010000,2020,473169,446720,919889,COST
06079907311010000,2019,473169,446720,919889,COST
06079907311050000,2021,530338,601220,1131558,COST
06079907311050000,2020,423348,515440,938788,OVR
06079907311050000,2019,423348,515440,938788,COST
06079907311080000,2021,662133,1030860,1692993,COST
06079907311080000,2020,473169,833430,1306599,COST
06079907311080000,2019,473169,833430,1306599,COST
06079907311100000,2021,530338,581090,1111428,COST
06079907311100000,2020,423348,482890,906238,COST
06079907311100000,2019,423348,482890,906238,COST
06079907311130000,2021,611692,300208,911900,MKT
06079907311130000,2020,448425,395775,844200,MKT
06079907311130000,2019,448425,395775,844200,MKT
06079907311160000,2021,534231,115369,649600,MKT
06079907311160000,2020,428786,118814,547600,MKT
06079907311160000,2019,428786,118814,547600,MKT
06079907311180000,2021,496616,201730,698346,COST
06079907311180000,2020,409633,143567,553200,MKT
06079907311180000,2019,409633,143567,553200,MKT
06079907311200000,2021,548737,84763,633500,MKT
06079907311200000,2020,430648,92452,523100,MKT
06079907311200000,2019,430648,92452,523100,MKT
06079907311220000,2021,550750,163650,714400,MKT
06079907311220000,2020,431439,182461,613900,MKT
06079907311220000,2019,431439,182461,613900,MKT
06079907312010000,2021,649081,244619,893700,MKT
06079907312010000,2020,468471,270129,738600,MKT
06079907312010000,2019,468471,270129,738600,MKT
06079907312060000,2021,653019,478650,1131669,COST
06079907312060000,2020,469894,395220,865114,COST
06079907312060000,2019,469894,395220,865114,COST
06079907312080000,2021,444135,305000,749135,COST
06079907312080000,2020,387329,264571,651900,MKT
06079907312080000,2019,387329,264571,651900,MKT
06079907312110000,2021,587429,726180,1313609,COST
06079907312110000,2020,445610,629860,1075470,OVR
06079907312110000,2019,445610,629860,1075470,COST
06079907312130000,2021,519884,660730,1180614,COST
06079907312130000,2020,419144,549480,968624,COST
06079907312130000,2019,419144,549480,968624,COST
06079907312150000,2021,519884,829990,1349874,COST
06079907312150000,2020,419144,676840,1095984,COST
06079907312150000,2019,419144,676840,1095984,COST
06079907312170000,2021,519884,154216,674100,MKT
06079907312170000,2020,419144,176356,595500,MKT
06079907312170000,2019,419144,176356,595500,MKT
06079907312190000,2021,330477,431323,761800,INCOME
06079907312190000,2020,436586,302514,739100,INCOME
06079907312190000,2019,436586,302514,739100,INCOME
06079907312210000,2021,519884,354816,874700,MKT
06079907312210000,2020,419144,364956,784100,MKT
06079907312210000,2019,419144,364956,784100,MKT
06079907314010000,2021,341037,529620,870657,COST
06079907314010000,2020,279904,421560,701464,COST
06079907314010000,2019,279904,421560,701464,COST
06079907314040000,2021,341037,205463,546500,MKT
06079907314040000,2020,279904,149096,429000,MKT
06079907314040000,2019,279904,149096,429000,MKT
06079907314060000,2021,341037,447690,788727,COST
06079907314060000,2020,279904,358980,638884,COST
06079907314060000,2019,279904,358980,638884,COST
06079907314080000,2021,341037,727980,1069017,COST
06079907314080000,2020,279904,361920,641824,COST
06079907314080000,2019,279904,218296,498200,MKT
06079907314110000,2021,425788,1011390,1437178,COST
06079907314110000,2020,312844,825570,1138414,COST
06079907314110000,2019,312844,825570,1138414,COST
06079907314125003,2021,153769,162731,316500,MKT
06079907314125003,2020,40193,225407,265600,MKT
06079907314125003,2019,40193,225407,265600,MKT
06079907314125004,2021,157914,167786,325700,MKT
06079907314125004,2020,41261,247339,288600,MKT
06079907314125004,2019,41261,247339,288600,MKT
06079907314126500,2021,87496,0,87496,COST
06079907314126500,2020,22664,0,22664,COST
06079907314126500,2019,22664,0,22664,COST
06079907314135002,2021,153769,162431,316200,MKT
06079907314135002,2020,40193,225207,265400,MKT
06079907314135002,2019,40193,225207,265400,MKT
06079907314145001,2021,157914,161486,319400,MKT
06079907314145001,2020,41261,245939,287200,MKT
06079907314145001,2019,41261,245939,287200,MKT
06079907314150000,2021,270060,223940,494000,MKT
06079907314150000,2020,249005,208295,457300,MKT
06079907314150000,2019,261754,208246,470000,MKT
06079907314160000,2021,250220,120080,370300,INCOME
06079907314160000,2020,244329,102271,346600,INCOME
06079907314160000,2019,258175,88425,346600,INCOME
06079907314170000,2021,288983,223500,512483,COST
06079907314170000,2020,257604,181360,438964,COST
06079907314170000,2019,227773,181360,409133,COST
06079907314190000,2021,341037,316363,657400,MKT
06079907314190000,2020,279904,263096,543000,MKT
06079907314190000,2019,279904,263096,543000,MKT
06079907314220000,2021,433796,0,433796,COST
06079907314220000,2020,490547,0,490547,COST
06079907314220000,2019,490547,0,490547,COST
06079907314350000,2021,1113387,0,1113387,COST
06079907314350000,2020,734585,0,734585,COST
06079907314350000,2019,734585,0,734585,COST
06079907315010000,2021,474948,88652,563600,MKT
06079907315010000,2020,330457,103543,434000,MKT
06079907315010000,2019,330267,103533,433800,MKT
06079907315160000,2021,474404,133196,607600,MKT
06079907315160000,2020,330267,149633,479900,MKT
06079907315160000,2019,330267,149633,479900,MKT
06079907315180000,2021,331099,331260,662359,COST
06079907315180000,2020,243556,276230,519786,COST
06079907315180000,2019,243556,276230,519786,COST
06079907315200000,2021,362514,205786,568300,MKT
06079907315200000,2020,254878,214422,469300,MKT
06079907315200000,2019,254878,214422,469300,MKT
06079907315240000,2021,332885,350315,683200,MKT
06079907315240000,2020,276530,267770,544300,MKT
06079907315240000,2019,276530,267770,544300,MKT
06079907315280000,2021,316588,152212,468800,MKT
06079907315280000,2020,269658,151942,421600,MKT
06079907315280000,2019,269658,151942,421600,MKT
06079907316010000,2021,326577,240123,566700,MKT
06079907316010000,2020,241883,185717,427600,MKT
06079907316010000,2019,241883,185717,427600,MKT
06079907316030000,2021,250893,230907,481800,MKT
06079907316030000,2020,211938,213662,425600,MKT
06079907316030000,2019,211938,213662,425600,MKT
06079907316060000,2021,342991,94409,437400,INCOME
06079907316060000,2020,249972,175128,425100,INCOME
06079907316060000,2019,249972,175128,425100,INCOME
06079907316080000,2021,335571,573610,909181,COST
06079907316080000,2020,245199,463150,708349,COST
06079907316080000,2019,245199,463150,708349,COST
06079907316100000,2021,354089,245511,599600,MKT
06079907316100000,2020,251891,193809,445700,MKT
06079907316100000,2019,251891,193809,445700,MKT
06079907316120000,2021,249492,209208,458700,MKT
06079907316120000,2020,211344,159956,371300,MKT
06079907316120000,2019,211344,159956,371300,MKT
06079907316140000,2021,249492,128510,378002,COST
06079907316140000,2020,211344,104130,315474,COST
06079907316140000,2019,211344,191356,402700,MKT
06079907316180000,2021,411042,378910,789952,COST
06079907316180000,2020,271446,292584,564030,MRA
06079907316180000,2019,271446,292584,564030,MRA
06079907316190000,2021,328844,135056,463900,MKT
06079907316190000,2020,242723,140677,383400,MKT
06079907316190000,2019,242723,140677,383400,MKT
06079907316200000,2021,311493,181207,492700,MKT
06079907316200000,2020,236216,156084,392300,MKT
06079907316200000,2019,236216,156084,392300,MKT
06079907316217000,2021,451545,0,451545,COST
06079907316217000,2020,334769,0,334769,COST
06079907316217000,2019,334769,0,334769,COST
06079907316230000,2021,56811,0,56811,COST
06079907316230000,2020,41145,0,41145,COST
06079907316230000,2019,41145,0,41145,COST
06079907316240000,2021,258782,762418,1021200,MKT
06079907316240000,2020,193374,632426,825800,MKT
06079907316240000,2019,193374,632426,825800,MKT
06079907316250000,2021,262403,321297,583700,MKT
06079907316250000,2020,189170,257230,446400,MKT
06079907316250000,2019,189170,257230,446400,MKT
06079907316260000,2021,304519,1151680,1456199,COST
06079907316260000,2020,227028,1138170,1365198,COST
06079907316260000,2019,227028,1138170,1365198,COST
06079907316277000,2021,271512,12530,284042,COST
06079907316277000,2020,202749,12130,214879,COST
06079907316277000,2019,202749,12130,214879,COST
06079907316290000,2021,401379,93021,494400,MKT
06079907316290000,2020,239979,103580,343559,COST
06079907316290000,2019,239979,103580,343559,COST
06079907316300000,2021,480994,47706,528700,MKT
06079907316300000,2020,360331,97240,457571,COST
06079907316300000,2019,360331,97240,457571,COST
06079907316330000,2021,686499,42319,728818,OVR
06079907316330000,2020,351030,207090,558120,COST
06079907316330000,2019,351030,207090,558120,COST
06079907316350000,2021,260847,0,260847,COST
06079907316350000,2020,383393,0,383393,COST
06079907316350000,2019,383393,0,383393,COST
06079907316370000,2021,621149,379451,1000600,MKT
06079907316370000,2020,333862,326120,659982,COST
06079907316370000,2019,333862,326120,659982,COST
06079907316390000,2021,635649,633660,1269309,COST
06079907316390000,2020,337747,523970,861717,COST
06079907316390000,2019,337747,523970,861717,COST
06079907316410000,2021,681993,493007,1175000,INCOME
06079907316410000,2020,342603,735597,1078200,INCOME
06079907316410000,2019,342603,735597,1078200,INCOME
06079907316430000,2021,304303,227497,531800,MKT
06079907316430000,2020,233467,193033,426500,MKT
06079907316430000,2019,233467,193033,426500,MKT
06079907316450000,2021,335571,240029,575600,MKT
06079907316450000,2020,245199,223301,468500,MKT
06079907316450000,2019,245199,160680,405879,COST
06079907316460000,2021,214131,0,214131,COST
06079907316460000,2020,107386,0,107386,COST
06079907316460000,2019,107386,0,107386,COST
06079907316470000,2021,285737,183463,469200,MKT
06079907316470000,2020,226215,169685,395900,MKT
06079907316470000,2019,226215,169685,395900,MKT
06079907316490000,2021,353012,620830,973842,COST
06079907316490000,2020,251507,492590,744097,COST
06079907316490000,2019,251507,492590,744097,COST
06079907316500000,2021,438579,0,438579,COST
06079907316500000,2020,313890,0,313890,COST
06079907316500000,2019,313890,0,313890,COST
06079907316500100,2021,215289,0,215289,COST
06079907316500100,2020,155640,0,155640,COST
06079907316500100,2019,155640,0,155640,COST
06079907318010000,2021,600608,7792,608400,INCOME
06079907318010000,2020,450080,19820,469900,INCOME
06079907318010000,2019,450080,19820,469900,INCOME
06079907318060000,2021,505670,266530,772200,COST
06079907318060000,2020,413360,175940,589300,MKT
06079907318060000,2019,413360,175940,589300,MKT
06079907318080000,2021,479964,598150,1078114,COST
06079907318080000,2020,402689,481280,883969,COST
06079907318080000,2019,402689,481280,883969,COST
06079907318120000,2021,795639,41061,836700,INCOME
06079907318120000,2020,512035,287265,799300,INCOME
06079907318120000,2019,512035,287265,799300,INCOME
06079907318130000,2021,538579,390600,929179,COST
06079907318130000,2020,426633,311070,737703,COST
06079907318130000,2019,426633,311070,737703,COST
06079907318160000,2021,540624,277976,818600,MKT
06079907318160000,2020,427444,280756,708200,MKT
06079907318160000,2019,427444,280756,708200,MKT
06079907318180000,2021,540624,351050,891674,COST
06079907318180000,2020,427444,293750,721194,COST
06079907318180000,2019,427444,293750,721194,COST
06079907318200000,2021,491117,276330,767447,COST
06079907318200000,2020,407353,201947,609300,MKT
06079907318200000,2019,407353,201947,609300,MKT
06079907318230000,2021,592650,243850,836500,MKT
06079907318230000,2020,447591,270009,717600,MKT
06079907318230000,2019,447591,270009,717600,MKT
06079907319010000,2021,557018,991930,1548948,COST
06079907319010000,2020,433893,800660,1234553,COST
06079907319010000,2019,433893,800660,1234553,COST
06079907319030000,2021,480339,289350,769689,COST
06079907319030000,2020,402847,278953,681800,OVR
06079907319030000,2019,402847,278953,681800,MKT
06079907319070000,2021,649081,642150,1291231,COST
06079907319070000,2020,468471,517970,986441,COST
06079907319070000,2019,468471,517970,986441,COST
06079907319100000,2021,649081,160393,809474,OVR
06079907319100000,2020,468471,316629,785100,MKT
06079907319100000,2019,468471,287029,755500,MKT
06079907319130000,2021,608553,1638599,2247152,MRA
06079907319130000,2020,453572,1557512,2011084,MRA
06079907319130000,2019,453572,1557512,2011084,MRA
06079907319170000,2021,620941,79059,700000,OVR
06079907319170000,2020,458177,212096,670273,OVR
06079907319170000,2019,458177,212096,670273,OVR
06079907319200000,2021,529300,426270,955570,COST
06079907319200000,2020,422932,330168,753100,MKT
06079907319200000,2019,422932,330168,753100,MKT
06079907319230000,2021,587429,252371,839800,MKT
06079907319230000,2020,445610,275590,721200,MKT
06079907319230000,2019,445610,371290,816900,MKT
06079907320010000,2021,401487,468213,869700,MKT
06079907320010000,2020,303763,378200,681963,COST
06079907320010000,2019,303763,378200,681963,COST
06079907320060000,2021,401487,486030,887517,COST
06079907320060000,2020,303763,391610,695373,COST
06079907320060000,2019,303763,391610,695373,COST
06079907320080000,2021,321573,674627,996200,MKT
06079907320080000,2020,271778,719222,991000,MKT
06079907320080000,2019,271778,719222,991000,MKT
06079907320110000,2021,321573,330827,652400,MKT
06079907320110000,2020,271778,346522,618300,MKT
06079907320110000,2019,271778,346522,618300,MKT
06079907320130000,2021,321573,544330,865903,COST
06079907320130000,2020,271778,513910,785688,COST
06079907320130000,2019,271778,513910,785688,COST
06079907320180000,2021,942171,1233540,2175711,COST
06079907320180000,2020,564683,1004670,1569353,COST
06079907320180000,2019,564683,1004670,1569353,COST
06079907320200000,2021,570555,380278,950833,OVR
06079907320200000,2020,439147,363353,802500,MKT
06079907320200000,2019,439147,363353,802500,MKT
06079907320230000,2021,712344,968431,1680775,OVR
06079907320230000,2020,490828,912220,1403048,COST
06079907320230000,2019,490828,912220,1403048,COST
06079907321010000,2021,254874,337726,592600,MKT
06079907321010000,2020,241885,299315,541200,MKT
06079907321010000,2019,241885,299315,541200,MKT
06079907321080000,2021,270006,263594,533600,MKT
06079907321080000,2020,248980,189920,438900,MKT
06079907321080000,2019,248980,189920,438900,MKT
06079907321127000,2021,254874,1640,256514,COST
06079907321127000,2020,241885,420670,662555,COST
06079907321127000,2019,241885,420670,662555,COST
06079907321140000,2021,258054,0,258054,COST
06079907321140000,2020,219390,0,219390,COST
06079907321140000,2019,219390,0,219390,COST
06079907321160000,2021,276715,174585,451300,MKT
06079907321160000,2020,222606,148394,371000,MKT
06079907321160000,2019,222606,148394,371000,MKT
06079907321200000,2021,278552,64170,342722,COST
06079907321200000,2020,227217,60650,287867,COST
06079907321200000,2019,227217,60650,287867,COST
06079907321220000,2021,331099,350980,682079,COST
06079907321220000,2020,243556,286070,529626,COST
06079907321220000,2019,243556,286070,529626,COST
06079907321250000,2021,331099,321501,652600,MKT
06079907321250000,2020,243556,288244,531800,MKT
06079907321250000,2019,243556,288244,531800,MKT
06079907321280000,2021,323137,336663,659800,MKT
06079907321280000,2020,240602,320298,560900,MKT
06079907321280000,2019,240602,320298,560900,MKT
06079907321310000,2021,372278,289922,662200,MKT
06079907321310000,2020,292476,279024,571500,MKT
06079907321310000,2019,292476,255824,548300,MKT
06079907325010000,2021,662133,1171110,1833243,COST
06079907325010000,2020,473169,940840,1414009,COST
06079907325010000,2019,473169,940840,1414009,COST
06079907325050000,2021,530338,86040,616378,COST
06079907325050000,2020,280363,50037,330400,MKT
06079907325050000,2019,280363,50037,330400,MKT
06079907325070000,2021,525545,112255,637800,INCOME
06079907325070000,2020,423348,177652,601000,INCOME
06079907325070000,2019,423348,177652,601000,INCOME
06079907325100000,2021,669831,11269,681100,INCOME
06079907325100000,2020,473169,145731,618900,INCOME
06079907325100000,2019,473169,145731,618900,INCOME
06079907325130000,2021,662133,554430,1216563,COST
06079907325130000,2020,473169,443560,916729,COST
06079907325130000,2019,473169,439460,912629,COST
06079907325150000,2021,530338,721750,1252088,COST
06079907325150000,2020,423348,582020,1005368,COST
06079907325150000,2019,423348,582020,1005368,COST
06079907325170000,2021,530338,591840,1122178,COST
06079907325170000,2020,423348,481490,904838,COST
06079907325170000,2019,423348,481490,904838,COST
06079907325200000,2021,568600,427900,996500,COST
06079907325200000,2020,438392,337690,776082,COST
06079907325200000,2019,438392,337690,776082,COST
06079907325230000,2021,319586,181114,500700,MKT
06079907325230000,2020,328423,75127,403550,OVR
06079907325230000,2019,328423,75127,403550,OVR
06079907326060000,2021,948600,1988950,2937550,COST
06079907326060000,2020,566611,1587920,2154531,OVR
06079907326060000,2019,566611,1587920,2154531,COST
06079907326080000,2021,560031,412290,972321,COST
06079907326080000,2020,288125,331660,619785,COST
06079907326080000,2019,288125,61020,349145,COST
06079907326100000,2021,477293,0,477293,COST
06079907326100000,2020,401564,0,401564,COST
06079907326100000,2019,401564,0,401564,COST
06079907326120000,2021,519884,241080,760964,COST
06079907326120000,2020,419144,138056,557200,MKT
06079907326120000,2019,419144,138056,557200,MKT
06079907326130000,2021,444255,707070,1151325,COST
06079907326130000,2020,387381,584290,971671,COST
06079907326130000,2019,387381,584290,971671,COST
06079907326150000,2021,444295,780670,1224965,COST
06079907326150000,2020,387399,647030,1034429,COST
06079907326150000,2019,387399,647030,1034429,COST
06079907326170000,2021,519884,175940,695824,COST
06079907326170000,2020,419144,83856,503000,MKT
06079907326170000,2019,419144,83856,503000,MKT
06079907326200000,2021,503870,376780,880650,COST
06079907326200000,2020,412621,324279,736900,MKT
06079907326200000,2019,412621,324279,736900,MKT
06079907326230000,2021,376852,186148,563000,MKT
06079907326230000,2020,356711,162770,519481,COST
06079907326230000,2019,356711,162770,519481,COST
06079907327010000,2021,321573,392400,713973,COST
06079907327010000,2020,271778,315100,586878,COST
06079907327010000,2019,271778,315100,586878,COST
06079907327040000,2021,321526,202774,524300,MKT
06079907327040000,2020,271758,198042,469800,MKT
06079907327040000,2019,271758,200942,472700,MKT
06079907327060000,2021,321619,160881,482500,MKT
06079907327060000,2020,271798,218602,490400,MKT
06079907327060000,2019,271798,218602,490400,MKT
06079907327080000,2021,355690,419710,775400,MKT
06079907327080000,2020,285869,363531,649400,MKT
06079907327080000,2019,285869,363531,649400,MKT
06079907327100000,2021,284883,1295000,1579883,COST
06079907327100000,2020,255765,1117460,1373225,OVR
06079907327100000,2019,255765,1117460,1373225,COST
06079907327120000,2021,321573,416670,738243,COST
06079907327120000,2020,271778,436522,708300,MKT
06079907327120000,2019,271778,436522,708300,MKT
06079907327140000,2021,570555,47845,618400,INCOME
06079907327140000,2020,439147,127553,566700,INCOME
06079907327140000,2019,439147,127553,566700,INCOME
06079907327160000,2021,570555,161745,732300,MKT
06079907327160000,2020,439147,142753,581900,MKT
06079907327160000,2019,439147,93553,532700,MKT
06079907327190000,2021,712344,453550,1165894,COST
06079907327190000,2020,490828,359780,850608,COST
06079907327190000,2019,490828,359780,850608,COST
06079907327220000,2021,711667,974060,1685727,COST
06079907327220000,2020,490594,784310,1274904,COST
06079907327220000,2019,490594,784310,1274904,COST
06079907328010000,2021,360153,663880,1024033,COST
06079907328010000,2020,288745,586655,875400,INCOME
06079907328010000,2019,288745,586655,875400,INCOME
06079907328020000,2021,382456,240544,623000,INCOME
06079907328020000,2020,296813,303587,600400,INCOME
06079907328020000,2019,296813,303587,600400,INCOME
06079907328080000,2021,267775,299625,567400,MKT
06079907328080000,2020,247947,206553,454500,MKT
06079907328080000,2019,247947,206553,454500,MKT
06079907328100000,2021,341037,504163,845200,MKT
06079907328100000,2020,279904,405796,685700,MKT
06079907328100000,2019,279904,405796,685700,MKT
06079907328120000,2021,341037,228563,569600,MKT
06079907328120000,2020,279904,239096,519000,MKT
06079907328120000,2019,279904,239096,519000,MKT
06079907328130000,2021,267119,166070,433189,COST
06079907328130000,2020,247642,242458,490100,OVR
06079907328130000,2019,247642,242458,490100,MKT
06079907328140000,2021,267119,202081,469200,MKT
06079907328140000,2020,247642,149058,396700,MKT
06079907328140000,2019,247642,149058,396700,MKT
06079907328150000,2021,309993,390420,700413,COST
06079907328150000,2020,266828,319880,586708,COST
06079907328150000,2019,266828,319880,586708,COST
06079907328180000,2021,412497,645990,1058487,COST
06079907328180000,2020,307910,531990,839900,COST
06079907328180000,2019,307910,531990,839900,COST
06079907328210000,2021,350192,635470,985662,COST
06079907328210000,2020,283645,0,283645,COST
06079907328210000,2019,283645,0,283645,COST
06079907328240000,2021,428938,177562,606500,INCOME
06079907328240000,2020,312844,256956,569800,INCOME
06079907328240000,2019,312844,256956,569800,INCOME
06079907328310000,2021,60075,0,60075,COST
06079907328310000,2020,117217,0,117217,COST
06079907328310000,2019,117217,0,117217,COST
06079907329010000,2021,348087,386113,734200,MKT
06079907329010000,2020,282789,331611,614400,OVR
06079907329010000,2019,282789,331611,614400,MKT
06079907329090000,2021,307529,185771,493300,INCOME
06079907329090000,2020,268566,193534,462100,INCOME
06079907329090000,2019,268566,193534,462100,INCOME
06079907329120000,2021,142652,0,142652,COST
06079907329120000,2020,180827,0,180827,COST
06079907329120000,2019,180827,0,180827,COST
06079907329140000,2021,243130,276670,519800,MKT
06079907329140000,2020,236232,234968,471200,MKT
06079907329140000,2019,236232,234968,471200,MKT
06079907329160000,2021,235155,234145,469300,MKT
06079907329160000,2020,232316,213684,446000,MKT
06079907329160000,2019,232316,213684,446000,MKT
06079907329170000,2021,213994,261906,475900,MKT
06079907329170000,2020,221590,197510,419100,MKT
06079907329170000,2019,221590,197510,419100,MKT
06079907329180000,2021,337219,253881,591100,MKT
06079907329180000,2020,278328,234872,513200,MKT
06079907329180000,2019,278328,234872,513200,MKT
06079907329190000,2021,193453,248620,442073,COST
06079907329190000,2020,210660,204050,414710,COST
06079907329190000,2019,210660,204050,414710,COST
06079907329220000,2021,318296,264604,582900,MKT
06079907329220000,2020,270387,231713,502100,MKT
06079907329220000,2019,270387,231713,502100,MKT
06079907329240000,2021,362269,283831,646100,MKT
06079907329240000,2020,288507,256393,544900,MKT
06079907329240000,2019,288507,256393,544900,MKT
06079907329280000,2021,467384,122116,589500,MKT
06079907329280000,2020,327808,187292,515100,MKT
06079907329280000,2019,327808,187292,515100,MKT
06079907330010000,2021,311586,260514,572100,MKT
06079907330010000,2020,267514,220686,488200,MKT
06079907330010000,2019,267514,220686,488200,MKT
06079907330040000,2021,281991,151909,433900,MKT
06079907330040000,2020,254460,105840,360300,MKT
06079907330040000,2019,254460,102740,357200,MKT
06079907330070000,2021,249566,420180,669746,COST
06079907330070000,2020,239347,341070,580417,COST
06079907330070000,2019,239347,341070,580417,COST
06079907330090000,2021,429720,381080,810800,INCOME
06079907330090000,2020,277199,501401,778600,INCOME
06079907330090000,2019,277199,501401,778600,INCOME
06079907330120000,2021,434934,340670,775604,COST
06079907330120000,2020,279243,324657,603900,MKT
06079907330120000,2019,279243,324657,603900,MKT
06079907330150000,2021,379937,214063,594000,MKT
06079907330150000,2020,260947,213553,474500,MKT
06079907330150000,2019,260947,213553,474500,MKT
06079907330180000,2021,361482,264518,626000,MKT
06079907330180000,2020,254514,234786,489300,MKT
06079907330180000,2019,254514,234786,489300,MKT
06079907330200000,2021,360423,331820,692243,COST
06079907330200000,2020,254140,100360,354500,MKT
06079907330200000,2019,254140,100360,354500,MKT
06079907330230000,2021,484235,173865,658100,INCOME
06079907330230000,2020,292807,334693,627500,INCOME
06079907330230000,2019,292807,334693,627500,INCOME
06079907330270000,2021,408202,0,408202,COST
06079907330270000,2020,270504,0,270504,COST
06079907330270000,2019,270504,0,270504,COST
06079907330300000,2021,635682,260618,896300,MKT
06079907330300000,2020,317684,471870,789554,COST
06079907330300000,2019,317684,471870,789554,COST
06079907330330000,2021,478096,265710,743806,COST
06079907330330000,2020,292807,318793,611600,MKT
06079907330330000,2019,292807,318793,611600,MKT
06079907330350000,2021,434934,57766,492700,INCOME
06079907330350000,2020,279243,190757,470000,INCOME
06079907330350000,2019,279243,190757,470000,INCOME
06079907330380000,2021,406391,180309,586700,INCOME
06079907330380000,2020,270193,301407,571600,INCOME
06079907330380000,2019,270193,301407,571600,INCOME
06079907330410000,2021,478096,538460,1016556,COST
06079907330410000,2020,292807,455000,747807,COST
06079907330410000,2019,292807,455000,747807,COST
06079907330450000,2021,361482,225818,587300,MKT
06079907330450000,2020,254514,203686,458200,MKT
06079907330450000,2019,254514,203686,458200,MKT
06079907330470000,2021,301858,274042,575900,INCOME
06079907330470000,2020,266283,284217,550500,INCOME
06079907330470000,2019,266283,284217,550500,INCOME
06079907330490000,2021,289188,195412,484600,MKT
06079907330490000,2020,257695,149805,407500,MKT
06079907330490000,2019,257695,149805,407500,MKT
06079907330530000,2021,346898,29302,376200,INCOME
06079907330530000,2020,282305,75095,357400,INCOME
06079907330530000,2019,282305,75095,357400,INCOME
06079907332010000,2021,655414,38686,694100,INCOME
06079907332010000,2020,468471,54829,523300,INCOME
06079907332010000,2019,468471,54829,523300,INCOME
06079907332060000,2021,649081,217019,866100,MKT
06079907332060000,2020,468471,267729,736200,MKT
06079907332060000,2019,468471,267729,736200,MKT
06079907332080000,2021,519884,62916,582800,MKT
06079907332080000,2020,419144,81156,500300,MKT
06079907332080000,2019,419144,81156,500300,MKT
06079907332100000,2021,514233,289967,804200,INCOME
06079907332100000,2020,419144,371556,790700,INCOME
06079907332100000,2019,419144,371556,790700,INCOME
06079907332140000,2021,485387,2798013,3283400,INCOME
06079907332140000,2020,514738,2677462,3192200,INCOME
06079907332140000,2019,514738,2677462,3192200,INCOME
06079907332160000,2021,502064,315720,817784,COST
06079907332160000,2020,411879,258120,669999,COST
06079907332160000,2019,411879,278100,689979,COST
06079907332180000,2021,552757,192943,745700,MKT
06079907332180000,2020,432226,254274,686500,OVR
06079907332180000,2019,432226,254274,686500,MKT
06079907332210000,2021,544693,401261,945954,OVR
06079907332210000,2020,429054,370846,799900,MKT
06079907332210000,2019,429054,355746,784800,MKT
06079907332240000,2021,385030,118670,503700,MKT
06079907332240000,2020,360571,114229,474800,MKT
06079907332240000,2019,360571,114229,474800,MKT
06079907333010000,2021,875760,313170,1188930,COST
06079907333010000,2020,544367,737260,1281627,COST
06079907333010000,2019,544367,737260,1281627,COST
06079907333070000,2021,530338,371920,902258,COST
06079907333070000,2020,423348,316352,739700,MKT
06079907333070000,2019,423348,316352,739700,MKT
06079907333100000,2021,599240,354460,953700,MKT
06079907333100000,2020,450080,380220,830300,MKT
06079907333100000,2019,450080,380220,830300,MKT
06079907333120000,2021,530338,280260,810598,COST
06079907333120000,2020,423348,250652,674000,MKT
06079907333120000,2019,423348,250652,674000,MKT
06079907333150000,2021,575418,497100,1072518,COST
06079907333150000,2020,441019,407781,848800,MKT
06079907333150000,2019,441019,407781,848800,MKT
06079907333180000,2021,509254,186846,696100,MKT
06079907333180000,2020,414826,153674,568500,MKT
06079907333180000,2019,414826,153674,568500,MKT
06079907333210000,2021,575418,51982,627400,MKT
06079907333210000,2020,441019,106581,547600,MKT
06079907333210000,2019,441019,106581,547600,MKT
06079907333230000,2021,429735,142965,572700,MKT
06079907333230000,2020,380982,123318,504300,MKT
06079907333230000,2019,380982,122318,503300,MKT
06079907333250000,2021,440320,80880,521200,MKT
06079907333250000,2020,385657,15343,401000,MKT
06079907333250000,2019,385657,15343,401000,MKT
06079907334010000,2021,370378,545222,915600,INCOME
06079907334010000,2020,292476,571624,864100,INCOME
06079907334010000,2019,292476,571624,864100,INCOME
06079907334080000,2021,327304,460796,788100,MKT
06079907334080000,2020,274196,381204,655400,MKT
06079907334080000,2019,274196,392304,666500,MKT
06079907334100000,2021,326239,276861,603100,MKT
06079907334100000,2020,273748,215852,489600,MKT
06079907334100000,2019,273748,215852,489600,MKT
06079907334120000,2021,337746,124554,462300,INCOME
06079907334120000,2020,280363,158437,438800,INCOME
06079907334120000,2019,280363,158437,438800,INCOME
06079907334140000,2021,342153,407347,749500,MKT
06079907334140000,2020,280363,388037,668400,MKT
06079907334140000,2019,280363,388037,668400,MKT
06079907334207000,2021,722189,0,722189,COST
06079907334207000,2020,225317,0,225317,COST
06079907334207000,2019,225317,0,225317,COST
06079907334250000,2021,666436,648580,1315016,COST
06079907334250000,2020,474708,521010,995718,COST
06079907334250000,2019,474708,521010,995718,COST
06079907335030000,2021,328551,609710,938261,COST
06079907335030000,2020,274719,493781,768500,MKT
06079907335030000,2019,274719,113581,388300,MKT
06079907335050000,2021,342153,283647,625800,MKT
06079907335050000,2020,280363,231637,512000,MKT
06079907335050000,2019,280363,231637,512000,MKT
06079907335060000,2021,345485,354490,699975,COST
06079907335060000,2020,281728,286690,568418,COST
06079907335060000,2019,281728,286690,568418,COST
06079907335070000,2021,342153,344510,686663,COST
06079907335070000,2020,280363,387137,667500,MKT
06079907335070000,2019,280363,387137,667500,MKT
06079907335080000,2021,433532,352568,786100,INCOME
06079907335080000,2020,314376,410224,724600,INCOME
06079907335080000,2019,314376,410224,724600,INCOME
06079907335090000,2021,338795,229405,568200,MKT
06079907335090000,2020,278980,169820,448800,MKT
06079907335090000,2019,278980,169820,448800,MKT
06079907335120000,2021,487694,230870,718564,COST
06079907335120000,2020,334873,245227,580100,MKT
06079907335120000,2019,334873,245227,580100,MKT
06079907335140000,2021,342153,312947,655100,MKT
06079907335140000,2020,280363,242137,522500,MKT
06079907335140000,2019,280363,242137,522500,MKT
06079907335160000,2021,342153,519347,861500,MKT
06079907335160000,2020,280363,275537,555900,MKT
06079907335160000,2019,280363,372037,652400,MKT
06079907335180000,2021,393350,254270,647620,COST
06079907335180000,2020,300661,204550,505211,COST
06079907335180000,2019,300661,204550,505211,COST
06079907335217000,2021,414401,0,414401,COST
06079907335217000,2020,106811,0,106811,COST
06079907335217000,2019,106811,0,106811,COST
06079907335230000,2021,383574,362770,746344,COST
06079907335230000,2020,296891,289930,586821,COST
06079907335230000,2019,296891,289930,586821,COST
06079907335240000,2021,62664,0,62664,COST
06079907335240000,2020,65698,0,65698,COST
06079907335240000,2019,65698,0,65698,COST
06079907335260000,2021,478775,373425,852200,INCOME
06079907335260000,2020,329020,501980,831000,INCOME
06079907335260000,2019,329020,501980,831000,INCOME
06079907335280000,2021,520934,271600,792534,COST
06079907335280000,2020,342004,242210,584214,COST
06079907335280000,2019,342004,242210,584214,COST
06079907335320000,2021,319029,263071,582100,MKT
06079907335320000,2020,270699,245901,516600,MKT
06079907335320000,2019,270699,245901,516600,MKT
06079907335340000,2021,292300,197900,490200,MKT
06079907335340000,2020,259082,188118,447200,MKT
06079907335340000,2019,259082,188118,447200,MKT
06079907336010000,2021,318438,251762,570200,MKT
06079907336010000,2020,270447,173953,444400,MKT
06079907336010000,2019,270447,173953,444400,MKT
06079907336030000,2021,308442,235758,544200,MKT
06079907336030000,2020,266157,200943,467100,MKT
06079907336030000,2019,266157,201043,467200,MKT
06079907336050000,2021,252562,170838,423400,MKT
06079907336050000,2020,240783,150217,391000,MKT
06079907336050000,2019,240783,150217,391000,MKT
06079907336070000,2021,306004,152296,458300,MKT
06079907336070000,2020,265101,191699,456800,MKT
06079907336070000,2019,265101,191699,456800,MKT
06079907336090000,2021,302318,207382,509700,MKT
06079907336090000,2020,263495,151605,415100,MKT
06079907336090000,2019,263495,151605,415100,MKT
06079907336110000,2021,251528,150672,402200,MKT
06079907336110000,2020,240288,120312,360600,MKT
06079907336110000,2019,240288,120312,360600,MKT
06079907336130000,2021,258016,163884,421900,MKT
06079907336130000,2020,243375,128825,372200,MKT
06079907336130000,2019,243375,128825,372200,MKT
06079907336150000,2021,265363,240537,505900,MKT
06079907336150000,2020,246825,165475,412300,MKT
06079907336150000,2019,246825,165475,412300,MKT
06079907336170000,2021,344688,109412,454100,MKT
06079907336170000,2020,281402,72098,353500,MKT
06079907336170000,2019,281402,72098,353500,MKT
06079907336190000,2021,346633,277267,623900,MKT
06079907336190000,2020,282197,287603,569800,MKT
06079907336190000,2019,282197,287603,569800,MKT
06079907336210000,2021,367112,224888,592000,INCOME
06079907336210000,2020,291291,279109,570400,INCOME
06079907336210000,2019,291291,279109,570400,INCOME
06079907336230000,2021,298594,173506,472100,MKT
06079907336230000,2020,261863,124137,386000,OVR
06079907336230000,2019,261863,124137,386000,MKT
06079907336250000,2021,307225,293475,600700,MKT
06079907336250000,2020,265631,227669,493300,MKT
06079907336250000,2019,265631,227669,493300,MKT
06079907336270000,2021,297344,263356,560700,MKT
06079907336270000,2020,261313,226687,488000,MKT
06079907336270000,2019,261313,226687,488000,MKT
06079907336290000,2021,297344,254056,551400,MKT
06079907336290000,2020,261313,182787,444100,MKT
06079907336290000,2019,261313,182787,444100,MKT
06079907336310000,2021,307225,210275,517500,MKT
06079907336310000,2020,265631,131069,396700,MKT
06079907336310000,2019,265631,131069,396700,MKT
06079907336330000,2021,243130,242570,485700,MKT
06079907336330000,2020,236232,198268,434500,OVR
06079907336330000,2019,236232,198268,434500,MKT
06079907336350000,2021,243130,225170,468300,MKT
06079907336350000,2020,236232,155368,391600,MKT
06079907336350000,2019,236232,155368,391600,MKT
06079907336400000,2021,1449025,15051050,16500075,COST
06079907336400000,2020,544664,10769336,11314000,INCOME
06079907336400000,2019,544664,0,544664,COST
06079907336440000,2021,284597,50703,335300,INCOME
06079907336440000,2020,255636,56264,311900,INCOME
06079907336440000,2019,255636,56264,311900,INCOME
06079907336460000,2021,302842,248458,551300,INCOME
06079907336460000,2020,266681,237919,504600,INCOME
06079907336460000,2019,266681,237919,504600,INCOME
06079907336480000,2021,307225,168375,475600,MKT
06079907336480000,2020,265631,106769,372400,MKT
06079907336480000,2019,265631,106769,372400,MKT
06079907336500000,2021,356078,335222,691300,MKT
06079907336500000,2020,286025,296375,582400,MKT
06079907336500000,2019,286025,296375,582400,MKT
06079907336520000,2021,443048,290130,733178,COST
06079907336520000,2020,319138,238310,557448,COST
06079907336520000,2019,319138,238310,557448,COST
06079907336560000,2021,424876,12424,437300,INCOME
06079907336560000,2020,312508,60592,373100,INCOME
06079907336560000,2019,312508,60592,373100,INCOME
06079907336580000,2021,364940,274060,639000,MKT
06079907336580000,2020,289572,234628,524200,MKT
06079907336580000,2019,289572,234628,524200,MKT
06079907336600000,2021,296090,292410,588500,MKT
06079907336600000,2020,260760,212340,473100,OVR
06079907336600000,2019,260760,212340,473100,MKT
06079907336620000,2021,332246,245354,577600,MKT
06079907336620000,2020,276263,214537,490800,MKT
06079907336620000,2019,276263,214537,490800,MKT
06079907336640000,2021,499730,335910,835640,COST
06079907336640000,2020,338991,285209,624200,MKT
06079907336640000,2019,338991,285209,624200,MKT
06079907336660000,2021,347751,107649,455400,INCOME
06079907336660000,2020,284141,143659,427800,INCOME
06079907336660000,2019,284141,143659,427800,INCOME
06079907336680000,2021,342153,371560,713713,COST
06079907336680000,2020,280363,300050,580413,COST
06079907336680000,2019,280363,300050,580413,COST
06079907336700000,2021,322978,218722,541700,MKT
06079907336700000,2020,272373,161127,433500,MKT
06079907336700000,2019,272373,161127,433500,MKT
06079907337010000,2021,407267,558250,965517,COST
06079907337010000,2020,270193,452110,722303,COST
06079907337010000,2019,270193,452110,722303,COST
06079907337040000,2021,381939,189661,571600,MKT
06079907337040000,2020,261635,216465,478100,MKT
06079907337040000,2019,261635,216465,478100,MKT
06079907337070000,2021,509645,191355,701000,MKT
06079907337070000,2020,302338,274490,576828,COST
06079907337070000,2019,302338,274490,576828,COST
06079907337080000,2021,331099,158501,489600,MKT
06079907337080000,2020,243556,173244,416800,MKT
06079907337080000,2019,243556,173244,416800,MKT
06079907337090000,2021,331099,164401,495500,MKT
06079907337090000,2020,243556,179544,423100,MKT
06079907337090000,2019,243556,179544,423100,MKT
06079907337100000,2021,331099,206001,537100,MKT
06079907337100000,2020,243556,197144,440700,MKT
06079907337100000,2019,243556,197144,440700,MKT
06079907337110000,2021,331099,349090,680189,COST
06079907337110000,2020,243556,285340,528896,COST
06079907337110000,2019,243556,285340,528896,COST
06079907337120000,2021,331099,104101,435200,MKT
06079907337120000,2020,243556,104844,348400,MKT
06079907337120000,2019,243556,104844,348400,MKT
06079907337130000,2021,331099,226501,557600,MKT
06079907337130000,2020,243556,211644,455200,MKT
06079907337130000,2019,243556,211644,455200,MKT
06079907337140000,2021,331099,168501,499600,MKT
06079907337140000,2020,243556,142944,386500,MKT
06079907337140000,2019,243556,142944,386500,MKT
06079907337150000,2021,267813,234087,501900,MKT
06079907337150000,2020,218987,203413,422400,OVR
06079907337150000,2019,218987,203413,422400,MKT
06079907337170000,2021,296997,289140,586137,COST
06079907337170000,2020,230641,241390,472031,COST
06079907337170000,2019,230641,241390,472031,COST
06079907337190000,2021,259293,414550,673843,COST
06079907337190000,2020,215466,337380,552846,COST
06079907337190000,2019,215466,337380,552846,COST
06079907337210000,2021,304303,164697,469000,MKT
06079907337210000,2020,233467,161233,394700,MKT
06079907337210000,2019,233467,161233,394700,MKT
06079907337230000,2021,297344,234956,532300,MKT
06079907337230000,2020,261313,202787,464100,MKT
06079907337230000,2019,261313,202787,464100,MKT
06079907337240000,2021,220037,264463,484500,INCOME
06079907337240000,2020,224705,239195,463900,INCOME
06079907337240000,2019,224705,239195,463900,INCOME
06079907337250000,2021,220037,172863,392900,MKT
06079907337250000,2020,224705,135495,360200,MKT
06079907337250000,2019,224705,135495,360200,MKT
06079907337260000,2021,309654,278746,588400,MKT
06079907337260000,2020,266681,215819,482500,MKT
06079907337260000,2019,266681,215819,482500,MKT
06079907337270000,2021,309654,262346,572000,MKT
06079907337270000,2020,266681,262919,529600,MKT
06079907337270000,2019,266681,262919,529600,MKT
06079907337280000,2021,309654,253650,563304,COST
06079907337280000,2020,266681,209410,476091,COST
06079907337280000,2019,266681,209410,476091,COST
06079907337290000,2021,309654,204046,513700,MKT
06079907337290000,2020,266681,154619,421300,MKT
06079907337290000,2019,266681,154619,421300,MKT
06079907337300000,2021,309654,252846,562500,MKT
06079907337300000,2020,266681,151019,417700,MKT
06079907337300000,2019,266681,151019,417700,MKT
06079907337310000,2021,309654,233646,543300,MKT
06079907337310000,2020,266681,220619,487300,MKT
06079907337310000,2019,266681,220619,487300,MKT
06079907337320000,2021,309654,192046,501700,MKT
06079907337320000,2020,266681,151819,418500,MKT
06079907337320000,2019,266681,151819,418500,MKT
06079907337340000,2021,452544,769070,1221614,COST
06079907337340000,2020,322549,604210,926759,COST
06079907337340000,2019,322549,604210,926759,COST
06079907337360000,2021,386607,189493,576100,MKT
06079907337360000,2020,298066,216334,514400,MKT
06079907337360000,2019,298066,216334,514400,MKT
06079907337380000,2021,386607,264393,651000,MKT
06079907337380000,2020,298066,225634,523700,MKT
06079907337380000,2019,298066,225634,523700,MKT
06079907337390000,2021,302515,371790,674305,COST
06079907337390000,2020,263582,305600,569182,OVR
06079907337390000,2019,263582,185640,449222,COST
06079907338010000,2021,473970,288840,762810,COST
06079907338010000,2020,274213,233880,508093,COST
06079907338010000,2019,274213,233880,508093,COST
06079907338030000,2021,465526,291960,757486,COST
06079907338030000,2020,271753,311647,583400,MKT
06079907338030000,2019,271753,311647,583400,MKT
06079907338040000,2021,463401,116999,580400,MKT
06079907338040000,2020,271130,161170,432300,MKT
06079907338040000,2019,271130,161170,432300,MKT
06079907338070000,2021,591747,564730,1156477,COST
06079907338070000,2020,306481,220420,526901,COST
06079907338070000,2019,306481,49520,356001,COST
06079907338080000,2021,473970,0,473970,COST
06079907338080000,2020,274213,0,274213,COST
06079907338080000,2019,274213,0,274213,COST
06079907338100000,2021,591747,343810,935557,COST
06079907338100000,2020,306481,249660,556141,COST
06079907338100000,2019,306481,229319,535800,MKT
06079907338110000,2021,420151,187649,607800,MKT
06079907338110000,2020,258136,212564,470700,MKT
06079907338110000,2019,258136,212564,470700,MKT
06079907338120000,2021,548644,145856,694500,MKT
06079907338120000,2020,295079,237221,532300,MKT
06079907338120000,2019,295079,237221,532300,MKT
06079907338140000,2021,379937,338663,718600,MKT
06079907338140000,2020,260947,288953,549900,MKT
06079907338140000,2019,260947,288953,549900,MKT
06079907338160000,2021,572332,168950,741282,COST
06079907338160000,2020,301398,155502,456900,MKT
06079907338160000,2019,301398,155502,456900,MKT
06079907338180000,2021,473970,85130,559100,MKT
06079907338180000,2020,274213,152687,426900,MKT
06079907338180000,2019,274213,152687,426900,MKT
06079907338200000,2021,364619,283681,648300,MKT
06079907338200000,2020,255619,237481,493100,OVR
06079907338200000,2019,255619,233681,489300,MKT
06079907338240000,2021,345470,198930,544400,MKT
06079907338240000,2020,248799,143301,392100,MKT
06079907338240000,2019,248799,143301,392100,MKT
06079907338260000,2021,387895,1010050,1397945,COST
06079907338260000,2020,263672,820710,1084382,OVR
06079907338260000,2019,263672,820710,1084382,COST
06079907340010000,2021,378986,628860,1007846,COST
06079907340010000,2020,295106,508570,803676,COST
06079907340010000,2019,295106,508570,803676,COST
06079907340060000,2021,378986,481914,860900,MKT
06079907340060000,2020,295106,478794,773900,MKT
06079907340060000,2019,295106,478794,773900,MKT
06079907340090000,2021,378986,466210,845196,COST
06079907340090000,2020,295106,438794,733900,MKT
06079907340090000,2019,295106,438794,733900,MKT
06079907340120000,2021,378986,455590,834576,COST
06079907340120000,2020,295106,359190,654296,COST
06079907340120000,2019,295106,359190,654296,COST
06079907340150000,2021,300175,275325,575500,INCOME
06079907340150000,2020,311874,234026,545900,INCOME
06079907340150000,2019,311874,234026,545900,INCOME
06079907340170000,2021,312188,159412,471600,MKT
06079907340170000,2020,267773,150427,418200,MKT
06079907340170000,2019,267773,128927,396700,MKT
06079907340200000,2021,299093,311907,611000,MKT
06079907340200000,2020,262082,280618,542700,MKT
06079907340200000,2019,262082,280618,542700,MKT
06079907340220000,2021,350104,473120,823224,COST
06079907340220000,2020,283610,441490,725100,MKT
06079907340220000,2019,283610,441490,725100,MKT
06079907340240000,2021,352721,415579,768300,MKT
06079907340240000,2020,284671,372929,657600,MKT
06079907340240000,2019,284671,372929,657600,MKT
06079907341010000,2021,419328,93872,513200,INCOME
06079907341010000,2020,310456,176744,487200,INCOME
06079907341010000,2019,310456,176744,487200,INCOME
06079907341060000,2021,213372,394428,607800,INCOME
06079907341060000,2020,420555,183045,603600,INCOME
06079907341060000,2019,420555,183045,603600,INCOME
06079907341090000,2021,267590,524510,792100,INCOME
06079907341090000,2020,463390,254310,717700,INCOME
06079907341090000,2019,463390,254310,717700,INCOME
06079907341120000,2021,303297,313100,616397,COST
06079907341120000,2020,488933,133367,622300,INCOME
06079907341120000,2019,488933,133367,622300,INCOME
06079907341150000,2021,417183,1201130,1618313,COST
06079907341150000,2020,560483,1122190,1682673,COST
06079907341150000,2019,560483,1122190,1682673,COST
06079907341210000,2021,371237,635470,1006707,COST
06079907341210000,2020,292066,521190,813256,COST
06079907341210000,2019,292066,501930,793996,COST
06079907341230000,2021,342153,475647,817800,MKT
06079907341230000,2020,280363,365237,645600,MKT
06079907341230000,2019,280363,365237,645600,MKT
06079907342010000,2021,342153,703070,1045223,COST
06079907342010000,2020,280363,863937,1144300,OVR
06079907342010000,2019,280363,863937,1144300,MKT
06079907342040000,2021,342153,319047,661200,MKT
06079907342040000,2020,280363,268337,548700,MKT
06079907342040000,2019,280363,268337,548700,MKT
06079907342060000,2021,292300,224530,516830,COST
06079907342060000,2020,259082,179630,438712,COST
06079907342060000,2019,259082,179630,438712,COST
06079907342080000,2021,292300,180800,473100,MKT
06079907342080000,2020,259082,177318,436400,MKT
06079907342080000,2019,259082,177318,436400,MKT
06079907342110000,2021,1126268,0,1126268,COST
06079907342110000,2020,488933,0,488933,COST
06079907342110000,2019,488933,0,488933,COST
06079907342130000,2021,246567,281733,528300,MKT
06079907342130000,2020,218035,189665,407700,MKT
06079907342130000,2019,218035,189665,407700,MKT
06079907342150000,2021,813818,120282,934100,INCOME
06079907342150000,2020,425401,428599,854000,INCOME
06079907342150000,2019,425401,428599,854000,INCOME
06079907342170000,2021,1233071,13830,1246901,COST
06079907342170000,2020,508282,13390,521672,COST
06079907342170000,2019,508282,13390,521672,COST
06079907342220000,2021,731145,18055,749200,INCOME
06079907342220000,2020,406321,188079,594400,INCOME
06079907342220000,2019,406321,188079,594400,INCOME
06079907342240000,2021,148362,316038,464400,INCOME
06079907342240000,2020,282807,168893,451700,INCOME
06079907342240000,2019,282807,168893,451700,INCOME
06079907342260000,2021,397564,285536,683100,MKT
06079907342260000,2020,302271,265429,567700,MKT
06079907342260000,2019,302271,265429,567700,MKT
06079907343010000,2021,1513454,1418500,2931954,COST
06079907343010000,2020,554910,1337490,1892400,COST
06079907343010000,2019,554910,1337490,1892400,COST
06079907343110000,2021,1637391,2097650,3735041,COST
06079907343110000,2020,573939,2214661,2788600,INCOME
06079907343110000,2019,573939,2214661,2788600,INCOME
06079907343140000,2021,249525,162975,412500,INCOME
06079907343140000,2020,219342,183358,402700,INCOME
06079907343140000,2019,219342,183358,402700,INCOME
06079907343170000,2021,995129,46771,1041900,INCOME
06079907343170000,2020,296062,229438,525500,INCOME
06079907343170000,2019,296062,229438,525500,INCOME
06079907343190000,2021,931878,176400,1108278,COST
06079907343190000,2020,450818,101782,552600,INCOME
06079907343190000,2019,450818,101782,552600,INCOME
06079907343220000,2021,1196986,15560,1212546,COST
06079907343220000,2020,501856,15060,516916,COST
06079907343220000,2019,501856,15060,516916,COST
06079907343240000,2021,234119,279881,514000,MKT
06079907343240000,2020,231802,226498,458300,MKT
06079907343240000,2019,231802,226498,458300,MKT
06079907343260000,2021,190433,266267,456700,MKT
06079907343260000,2020,209004,207296,416300,MKT
06079907343260000,2019,209004,207296,416300,MKT
06079907343280000,2021,167573,284527,452100,MKT
06079907343280000,2020,196027,200073,396100,MKT
06079907343280000,2019,196027,200073,396100,MKT
06079907348010000,2021,5660623,4316020,9976643,COST
06079907348010000,2020,2375219,4094790,6470009,COST
06079907348010000,2019,2375219,4094790,6470009,COST
06079907349010000,2021,1146522,2392500,3539022,COST
06079907349010000,2020,492681,2250890,2743571,COST
06079907349010000,2019,492681,2250890,2743571,COST
06079907349060000,2021,1510513,83487,1594000,INCOME
06079907349060000,2020,554448,673852,1228300,INCOME
06079907349060000,2019,554448,673852,1228300,INCOME
06079907349110000,2021,883663,9437,893100,INCOME
06079907349110000,2020,412271,210129,622400,INCOME
06079907349110000,2019,412271,210129,622400,INCOME
06079907349200000,2021,2362011,869270,3231281,COST
06079907349200000,2020,1633421,814810,2448231,COST
06079907349200000,2019,1633421,814810,2448231,COST
06079907349230000,2021,2314623,798610,3113233,COST
06079907349230000,2020,665677,753180,1418857,COST
06079907349230000,2019,665677,753180,1418857,COST
06079907350010000,2021,1332223,1051520,2383743,COST
06079907350010000,2020,525404,1026530,1551934,COST
06079907350010000,2019,525404,1026530,1551934,COST
06079907350060000,2021,883663,184550,1068213,COST
06079907350060000,2020,440674,168826,609500,INCOME
06079907350060000,2019,440674,168826,609500,INCOME
06079907350100000,2021,1943683,3231640,5175323,COST
06079907350100000,2020,1501283,1854617,3355900,INCOME
06079907350100000,2019,1501283,1854617,3355900,INCOME
06079907350140000,2021,2006206,2745530,4751736,COST
06079907350140000,2020,1523081,2630450,4153531,COST
06079907350140000,2019,1523081,2630450,4153531,COST
06079907350210000,2021,951179,41521,992700,INCOME
06079907350210000,2020,454794,288006,742800,INCOME
06079907350210000,2019,454794,288006,742800,INCOME
06079907350250000,2021,825732,222950,1048682,COST
06079907350250000,2020,428058,211910,639968,COST
06079907350250000,2019,428058,211910,639968,COST
06079907351010000,2021,3737773,0,3737773,COST
06079907351010000,2020,2331387,0,2331387,COST
06079907351010000,2019,2331387,0,2331387,COST
06079907352010000,2021,1279342,3308958,4588300,INCOME
06079907352010000,2020,516367,3822733,4339100,INCOME
06079907352010000,2019,516367,3822733,4339100,INCOME
06079907352060000,2021,1103600,37910,1141510,COST
06079907352060000,2020,484693,37770,522463,COST
06079907352060000,2019,484693,37770,522463,COST
06079907352090000,2021,303537,434163,737700,MKT
06079907352090000,2020,241980,329220,571200,MKT
06079907352090000,2019,241980,329220,571200,MKT
06079907352120000,2021,298393,145507,443900,MKT
06079907352120000,2020,239916,124484,364400,MKT
06079907352120000,2019,239916,124484,364400,MKT
06079907352160000,2021,308977,208323,517300,MKT
06079907352160000,2020,244144,151556,395700,MKT
06079907352160000,2019,244144,151556,395700,MKT
06079907352220000,2021,2589857,6922600,9512457,COST
06079907352220000,2020,727485,374120,1101605,COST
06079907352220000,2019,836747,2865453,3702200,INCOME
06079907352250000,2021,639417,16070,655487,COST
06079907352250000,2020,669233,15560,684793,COST
06079907353010000,2021,371237,208563,579800,MKT
06079907353010000,2020,292066,184134,476200,MKT
06079907353010000,2019,292066,184134,476200,MKT
06079907353070000,2021,418856,219044,637900,MKT
06079907353070000,2020,310281,217019,527300,MKT
06079907353070000,2019,310281,217019,527300,MKT
06079907353100000,2021,368752,147248,516000,MKT
06079907353100000,2020,257067,138733,395800,MKT
06079907353100000,2019,257067,138733,395800,MKT
06079907353120000,2021,344295,346900,691195,COST
06079907353120000,2020,248085,282280,530365,COST
06079907353120000,2019,248085,282280,530365,COST
06079907353130000,2021,343293,133207,476500,MKT
06079907353130000,2020,248012,122788,370800,MKT
06079907353130000,2019,248012,122788,370800,MKT
06079907353140000,2021,375906,413570,789476,COST
06079907353140000,2020,259555,401760,661315,COST
06079907353140000,2019,259555,401760,661315,COST
06079907353170000,2021,309121,272330,581451,COST
06079907353170000,2020,235313,282887,518200,MKT
06079907353170000,2019,235313,282887,518200,MKT
06079907353190000,2021,213121,179580,392701,COST
06079907353190000,2020,195294,144770,340064,COST
06079907353190000,2019,195294,144770,340064,COST
06079907353210000,2021,332235,223865,556100,MKT
06079907353210000,2020,243974,156526,400500,MKT
06079907353210000,2019,243974,156526,400500,MKT
06079907353230000,2021,343293,588770,932063,COST
06079907353230000,2020,248012,481040,729052,COST
06079907353230000,2019,248012,481040,729052,COST
06079907353250000,2021,1946409,78991,2025400,INCOME
06079907353250000,2020,754769,853150,1607919,COST
06079907353250000,2019,754769,853150,1607919,COST
06079907353350000,2021,1427285,271515,1698800,INCOME
06079907353350000,2020,660848,805852,1466700,INCOME
06079907353350000,2019,660848,805852,1466700,INCOME
06079907353370000,2021,408529,13970,422499,COST
06079907353370000,2020,552372,13520,565892,COST
06079907353370000,2019,552372,13520,565892,COST
06079907353380000,2021,414284,17920,432204,COST
06079907353380000,2020,555692,17350,573042,COST
06079907353380000,2019,555692,17350,573042,COST
06079907353400000,2021,277779,255221,533000,MKT
06079907353400000,2020,252548,144652,397200,MKT
06079907353400000,2019,252548,144652,397200,MKT
06079907353420000,2021,292300,133100,425400,MKT
06079907353420000,2020,259082,102918,362000,MKT
06079907353420000,2019,259082,102918,362000,MKT
06079907401017000,2021,367514,0,367514,COST
06079907401017000,2020,267981,0,267981,COST
06079907401017000,2019,267981,0,267981,COST
06079907401020000,2021,30138,0,30138,COST
06079907401020000,2020,22024,0,22024,COST
06079907401020000,2019,22024,0,22024,COST
06079907401050000,2021,298855,238345,537200,MKT
06079907401050000,2020,262365,205560,467925,COST
06079907401050000,2019,262365,205560,467925,COST
06079907401080000,2021,292120,137580,429700,MKT
06079907401080000,2020,256535,126700,383235,COST
06079907401080000,2019,256535,126700,383235,COST
06079907401120000,2021,296334,261566,557900,MKT
06079907401120000,2020,216737,210763,427500,MKT
06079907401120000,2019,216737,210763,427500,MKT
06079907401150000,2021,333191,153909,487100,MKT
06079907401150000,2020,243291,147190,390481,COST
06079907401150000,2019,243291,147190,390481,COST
06079907403140000,2021,405660,570040,975700,INCOME
06079907403140000,2020,287167,622733,909900,INCOME
06079907403140000,2019,287167,622733,909900,INCOME
06079907405010000,2021,3780,0,3780,COST
06079907405010000,2020,3518,0,3518,COST
06079907405010000,2019,3518,0,3518,COST
06079907409456500,2021,483813,0,483813,COST
06079907409456500,2020,339947,0,339947,COST
06079907409456500,2019,339947,0,339947,COST
06079907413310000,2021,211052,0,211052,COST
06079907413310000,2020,152620,0,152620,COST
06079907413310000,2019,152620,0,152620,COST
06079907414390000,2021,299255,0,299255,COST
06079907414390000,2020,215337,0,215337,COST
06079907414390000,2019,215337,0,215337,COST
06079907415015009,2021,147450,120350,267800,MKT
06079907415015009,2020,40121,212579,252700,MKT
06079907415015009,2019,40121,212579,252700,MKT
06079907415025010,2021,147450,123450,270900,MKT
06079907415025010,2020,40121,211679,251800,MKT
06079907415025010,2019,40121,211679,251800,MKT
06079907415035011,2021,147450,122150,269600,MKT
06079907415035011,2020,40121,208279,248400,MKT
06079907415035011,2019,40121,208279,248400,MKT
06079907415045012,2021,147450,123650,271100,MKT
06079907415045012,2020,40121,211079,251200,MKT
06079907415045012,2019,40121,211079,251200,MKT
06079907415055013,2021,147450,123950,271400,MKT
06079907415055013,2020,40121,212479,252600,MKT
06079907415055013,2019,40121,212479,252600,MKT
06079907415065014,2021,147450,120050,267500,MKT
06079907415065014,2020,40121,207779,247900,MKT
06079907415065014,2019,40121,207779,247900,MKT
06079907415075015,2021,147450,119750,267200,MKT
06079907415075015,2020,40121,211479,251600,MKT
06079907415075015,2019,40121,211479,251600,MKT
06079907416015001,2021,147450,120850,268300,MKT
06079907416015001,2020,40121,213179,253300,MKT
06079907416015001,2019,40121,213179,253300,MKT
06079907416016500,2021,264925,0,264925,COST
06079907416016500,2020,58017,0,58017,COST
06079907416016500,2019,58017,0,58017,COST
06079907416025002,2021,147450,124750,272200,MKT
06079907416025002,2020,40121,213679,253800,MKT
06079907416025002,2019,40121,213679,253800,MKT
06079907416035003,2021,147450,124450,271900,MKT
06079907416035003,2020,40121,212979,253100,MKT
06079907416035003,2019,40121,212979,253100,MKT
06079907416045004,2021,147450,123950,271400,MKT
06079907416045004,2020,40121,212079,252200,MKT
06079907416045004,2019,40121,212079,252200,MKT
06079907416055005,2021,147450,121150,268600,MKT
06079907416055005,2020,40121,213779,253900,MKT
06079907416055005,2019,40121,213779,253900,MKT
06079907417015006,2021,147450,119650,267100,MKT
06079907417015006,2020,40121,211679,251800,MKT
06079907417015006,2019,40121,211679,251800,MKT
06079907417025007,2021,147450,122150,269600,MKT
06079907417025007,2020,40121,209379,249500,MKT
06079907417025007,2019,40121,209379,249500,MKT
06079907417035008,2021,147450,118450,265900,MKT
06079907417035008,2020,40121,209179,249300,MKT
06079907417035008,2019,40121,209179,249300,MKT
06079907418010000,2021,295751,214049,509800,MKT
06079907418010000,2020,230155,167145,397300,MKT
06079907418010000,2019,230155,167145,397300,MKT
06079907418020000,2021,356211,154189,510400,MKT
06079907418020000,2020,252647,170053,422700,MKT
06079907418020000,2019,252647,170053,422700,MKT
06079907418030000,2021,359386,232314,591700,MKT
06079907418030000,2020,253773,229527,483300,OVR
06079907418030000,2019,253773,229527,483300,MKT
06079907418040000,2021,359386,242414,601800,MKT
06079907418040000,2020,253773,217427,471200,MKT
06079907418040000,2019,253773,217427,471200,MKT
06079907418050000,2021,455211,339070,794281,COST
06079907418050000,2020,285695,281310,567005,COST
06079907418050000,2019,285695,281310,567005,COST
06079907418080000,2021,548619,0,548619,COST
06079907418080000,2020,313715,0,313715,COST
06079907418080000,2019,313715,0,313715,COST
06079907418100000,2021,149070,0,149070,COST
06079907418100000,2020,89558,0,89558,COST
06079907418100000,2019,89558,0,89558,COST
06079907427010000,2021,286990,143010,430000,MKT
06079907427010000,2020,226712,156288,383000,MKT
06079907427010000,2019,226712,156288,383000,MKT
06079907427020000,2021,279313,209187,488500,MKT
06079907427020000,2020,223651,190849,414500,MKT
06079907427020000,2019,223651,190849,414500,MKT
06079907427030000,2021,279313,185587,464900,MKT
06079907427030000,2020,223651,155449,379100,MKT
06079907427030000,2019,223651,155449,379100,MKT
06079907427040000,2021,279313,156487,435800,MKT
06079907427040000,2020,223651,138149,361800,MKT
06079907427040000,2019,223651,138149,361800,MKT
06079907427050000,2021,279313,240587,519900,MKT
06079907427050000,2020,223651,172349,396000,MKT
06079907427050000,2019,223651,172349,396000,MKT
06079907427060000,2021,279313,147687,427000,MKT
06079907427060000,2020,223651,72949,296600,MKT
06079907427060000,2019,223651,95249,318900,MKT
06079907427070000,2021,267444,300070,567514,COST
06079907427070000,2020,218835,260690,479525,OVR
06079907427070000,2019,218835,260690,479525,COST
06079907427080000,2021,343293,186707,530000,MKT
06079907427080000,2020,248012,166488,414500,OVR
06079907427080000,2019,248012,166488,414500,MKT
06079907427090000,2021,343293,132107,475400,MKT
06079907427090000,2020,248012,120288,368300,MKT
06079907427090000,2019,248012,120288,368300,MKT
06079907427100000,2021,315010,210390,525400,MKT
06079907427100000,2020,237550,165350,402900,MKT
06079907427100000,2019,237550,165350,402900,MKT
06079907427130000,2021,338906,221794,560700,MKT
06079907427130000,2020,246418,223982,470400,MKT
06079907427130000,2019,246418,223982,470400,MKT
06079907427150000,2021,379937,197563,577500,MKT
06079907427150000,2020,260947,168253,429200,MKT
06079907427150000,2019,260947,168253,429200,MKT
06079907436016500,2021,798995,884080,1683075,COST
06079907436016500,2020,207784,0,207784,COST
06079907436016500,2019,207784,0,207784,COST
06079907436040000,2021,519265,626240,1145505,COST
06079907436040000,2020,302338,655062,957400,INCOME
06079907436040000,2019,302338,655062,957400,INCOME
06079907436100000,2021,596832,71068,667900,INCOME
06079907436100000,2020,322273,112727,435000,INCOME
06079907436100000,2019,322273,112727,435000,INCOME
06079907436140000,2021,466598,374470,841068,COST
06079907436140000,2020,272066,307900,579966,COST
06079907436140000,2019,272066,307900,579966,COST
06079907436170000,2021,412918,184782,597700,MKT
06079907436170000,2020,272066,192034,464100,MKT
06079907436170000,2019,272066,192034,464100,MKT
06079907437150000,2021,819948,530080,1350028,COST
06079907437150000,2020,360919,452450,813369,COST
06079907437150000,2019,360919,452450,813369,COST
06079907437180000,2021,250893,387905,638798,OVR
06079907437180000,2020,211938,262905,474843,MRA
06079907437180000,2019,211938,160890,372828,COST
06079907437200000,2021,290780,315420,606200,MKT
06079907437200000,2020,228207,271493,499700,MKT
06079907437200000,2019,228207,271493,499700,MKT
06079907437250000,2021,501724,256720,758444,COST
06079907437250000,2020,299974,284826,584800,MKT
06079907437250000,2019,299974,284826,584800,MKT
06079907437270000,2021,305520,172880,478400,MKT
06079907437270000,2020,233935,169765,403700,MKT
06079907437270000,2019,233935,169765,403700,MKT
06079907437280000,2021,305520,37480,343000,INCOME
06079907437280000,2020,233935,86465,320400,INCOME
06079907437280000,2019,233935,86465,320400,INCOME
06079907437290000,2021,381939,392120,774059,COST
06079907437290000,2020,261635,232220,493855,COST
06079907437290000,2019,261635,181465,443100,MKT
06079907437320000,2021,502419,7281,509700,INCOME
06079907437320000,2020,297800,124600,422400,INCOME
06079907437320000,2019,297800,124600,422400,INCOME
06079907437360000,2021,458677,54923,513600,MKT
06079907437360000,2020,286783,135917,422700,MKT
06079907437360000,2019,286783,135917,422700,MKT
06079907437380000,2021,426786,329680,756466,COST
06079907437380000,2020,276609,269400,546009,COST
06079907437380000,2019,276609,269400,546009,COST
06079907437400000,2021,504547,117953,622500,MKT
06079907437400000,2020,282942,149858,432800,MKT
06079907437400000,2019,282942,149858,432800,MKT
06079907437420000,2021,504547,752800,1257347,COST
06079907437420000,2020,282942,164858,447800,MKT
06079907437420000,2019,282942,164858,447800,MKT
06079907437440000,2021,504547,174000,678547,COST
06079907437440000,2020,282942,184258,467200,MKT
06079907437440000,2019,282942,184258,467200,MKT
06079907437460000,2021,403726,366500,770226,COST
06079907437460000,2020,253027,295910,548937,COST
06079907437460000,2019,253027,295910,548937,COST
06079907437480000,2021,403726,132174,535900,MKT
06079907437480000,2020,253027,184373,437400,OVR
06079907437480000,2019,253027,184373,437400,MKT
06079907437500000,2021,398294,849430,1247724,COST
06079907437500000,2020,251314,362860,614174,COST
06079907437500000,2019,251314,24170,275484,COST
06079907446017000,2021,2553715,15580,2569295,COST
06079907446017000,2020,694308,15060,709368,COST
06079907446017000,2019,694308,15060,709368,COST
06079907446130000,2021,292043,177457,469500,MKT
06079907446130000,2020,228704,160296,389000,MKT
06079907446130000,2019,228704,160296,389000,MKT
06079907446150000,2021,312660,258540,571200,MKT
06079907446150000,2020,236660,249940,486600,MKT
06079907446150000,2019,236660,249940,486600,MKT
06079907446170000,2021,312660,184040,496700,MKT
06079907446170000,2020,236660,154740,391400,MKT
06079907446170000,2019,236660,154740,391400,MKT
06079907446190000,2021,446502,105398,551900,MKT
06079907446190000,2020,282942,154260,437202,COST
06079907446190000,2019,282942,154260,437202,COST
06079907446210000,2021,446502,184498,631000,MKT
06079907446210000,2020,282942,190858,473800,MKT
06079907446210000,2019,282942,190858,473800,MKT
06079907446230000,2021,357280,158120,515400,MKT
06079907446230000,2020,253027,55927,308954,OVR
06079907446230000,2019,253027,55927,308954,OVR
06079907446250000,2021,404405,91395,495800,MKT
06079907446250000,2020,269240,92560,361800,MKT
06079907446250000,2019,269240,92560,361800,MKT
06079907448010000,2021,1551119,1385281,2936400,INCOME
06079907448010000,2020,560784,2075416,2636200,INCOME
06079907448010000,2019,560784,2075416,2636200,INCOME
06079907448070000,2021,839900,0,839900,COST
06079907448070000,2020,243219,0,243219,COST
06079907448070000,2019,243219,0,243219,COST
06079907449010000,2021,139715,306185,445900,MKT
06079907449010000,2020,99660,279840,379500,MKT
06079907449010000,2019,99660,279840,379500,MKT
06079907449020000,2021,134379,322121,456500,MKT
06079907449020000,2020,97797,260403,358200,MKT
06079907449020000,2019,97797,260403,358200,MKT
06079907449030000,2021,138179,296521,434700,MKT
06079907449030000,2020,100523,262377,362900,MKT
06079907449030000,2019,100523,262377,362900,MKT
06079907449040000,2021,136293,287107,423400,MKT
06079907449040000,2020,99170,242430,341600,MKT
06079907449040000,2019,99170,242430,341600,MKT
06079907449050000,2021,136293,189220,325513,COST
06079907449050000,2020,99170,188270,287440,COST
06079907449050000,2019,99170,188270,287440,COST
06079907449060000,2021,136293,352407,488700,MKT
06079907449060000,2020,99170,317530,416700,MKT
06079907449060000,2019,99170,317630,416800,MKT
06079907449070000,2021,136293,391307,527600,MKT
06079907449070000,2020,99170,302430,401600,MKT
06079907449070000,2019,99170,302430,401600,MKT
06079907449080000,2021,131749,363551,495300,MKT
06079907449080000,2020,95910,336890,432800,MKT
06079907449080000,2019,95910,336890,432800,MKT
06079907451010000,2021,132943,317057,450000,MKT
06079907451010000,2020,94896,309304,404200,MKT
06079907451010000,2019,94896,309304,404200,MKT
06079907451020000,2021,127187,369513,496700,MKT
06079907451020000,2020,90844,353656,444500,MKT
06079907451020000,2019,90844,353656,444500,MKT
06079907451030000,2021,127187,396813,524000,MKT
06079907451030000,2020,90844,321356,412200,MKT
06079907451030000,2019,90844,321356,412200,MKT
06079907451040000,2021,127187,387613,514800,MKT
06079907451040000,2020,90844,352956,443800,MKT
06079907451040000,2019,90844,352956,443800,MKT
06079907451050000,2021,127187,282613,409800,MKT
06079907451050000,2020,90844,314356,405200,MKT
06079907451050000,2019,90844,347856,438700,MKT
06079907451060000,2021,127187,409313,536500,MKT
06079907451060000,2020,90844,342656,433500,MKT
06079907451060000,2019,90844,342656,433500,MKT
06079907451070000,2021,121372,384428,505800,MKT
06079907451070000,2020,88458,333442,421900,MKT
06079907451070000,2019,88458,333442,421900,MKT
06079907451080000,2021,124693,364807,489500,MKT
06079907451080000,2020,90844,334056,424900,MKT
06079907451080000,2019,90844,334056,424900,MKT
06079907451090000,2021,124693,359007,483700,MKT
06079907451090000,2020,90844,328856,419700,MKT
06079907451090000,2019,90844,328856,419700,MKT
06079907451100000,2021,124693,377607,502300,MKT
06079907451100000,2020,90844,338356,429200,MKT
06079907451100000,2019,90844,338356,429200,MKT
06079907451110000,2021,124693,416607,541300,MKT
06079907451110000,2020,90844,353556,444400,MKT
06079907451110000,2019,90844,353556,444400,MKT
06079907451120000,2021,135377,384723,520100,MKT
06079907451120000,2020,96609,352991,449600,MKT
06079907451120000,2019,96609,352991,449600,MKT
06079907452010000,2021,132203,316397,448600,MKT
06079907452010000,2020,94375,306825,401200,MKT
06079907452010000,2019,94375,306825,401200,MKT
06079907452020000,2021,127102,394498,521600,MKT
06079907452020000,2020,92574,365726,458300,MKT
06079907452020000,2019,92574,365726,458300,MKT
06079907452030000,2021,127102,386498,513600,MKT
06079907452030000,2020,92574,346026,438600,MKT
06079907452030000,2019,92574,346026,438600,MKT
06079907452040000,2021,127102,346398,473500,MKT
06079907452040000,2020,92574,336526,429100,MKT
06079907452040000,2019,92574,336526,429100,MKT
06079907452050000,2021,127102,422998,550100,MKT
06079907452050000,2020,92574,326426,419000,MKT
06079907452050000,2019,92574,326426,419000,MKT
06079907452060000,2021,193595,377305,570900,MKT
06079907452060000,2020,140167,315633,455800,MKT
06079907452060000,2019,140167,315633,455800,MKT
06079907452070000,2021,193595,423205,616800,MKT
06079907452070000,2020,140167,346133,486300,MKT
06079907452070000,2019,140167,346133,486300,MKT
06079907454010000,2021,310486,144814,455300,MKT
06079907454010000,2020,235761,124339,360100,MKT
06079907454010000,2019,235761,124339,360100,MKT
06079907454080000,2021,310295,163405,473700,MKT
06079907454080000,2020,235761,137339,373100,MKT
06079907454080000,2019,235761,137339,373100,MKT
06079907454100000,2021,392812,140888,533700,MKT
06079907454100000,2020,265343,166457,431800,MKT
06079907454100000,2019,265343,166457,431800,MKT
06079907454130000,2021,492210,127990,620200,MKT
06079907454130000,2020,296815,191385,488200,MKT
06079907454130000,2019,296815,191385,488200,MKT
06079907454160000,2021,483393,377560,860953,COST
06079907454160000,2020,294429,306820,601249,COST
06079907454160000,2019,294429,306820,601249,COST
06079907454190000,2021,343293,317670,660963,COST
06079907454190000,2020,248012,262120,510132,COST
06079907454190000,2019,248012,262120,510132,COST
06079907454210000,2021,348255,152145,500400,MKT
06079907454210000,2020,251507,126593,378100,MKT
06079907454210000,2019,251507,126593,378100,MKT
06079907454230000,2021,256529,319390,575919,COST
06079907454230000,2020,214312,262510,476822,COST
06079907454230000,2019,214312,262510,476822,COST
06079907454270000,2021,534414,16120,550534,COST
06079907454270000,2020,507480,15600,523080,COST
06079907454270000,2019,507480,15600,523080,COST
06079907454330000,2021,327896,13990,341886,COST
06079907454330000,2020,411663,13770,425433,COST
06079907454330000,2019,411663,13770,425433,COST
06079907454360000,2021,1364309,625790,1990099,COST
06079907454360000,2020,530788,616920,1147708,COST
06079907454360000,2019,530788,616920,1147708,COST
06079907454400000,2021,935517,44783,980300,INCOME
06079907454400000,2020,451571,348950,800521,COST
06079907454400000,2019,451571,348950,800521,COST
06079907455010000,2021,274097,128003,402100,MKT
06079907455010000,2020,221548,126552,348100,MKT
06079907455010000,2019,221548,126552,348100,MKT
06079907455040000,2021,272765,247835,520600,MKT
06079907455040000,2020,221007,206193,427200,MKT
06079907455040000,2019,221007,206193,427200,MKT
06079907455060000,2021,337814,386510,724324,COST
06079907455060000,2020,246020,318960,564980,COST
06079907455060000,2019,246020,264340,510360,COST
06079907455080000,2021,283188,132612,415800,MKT
06079907455080000,2020,225201,101799,327000,MKT
06079907455080000,2019,225201,101799,327000,MKT
06079907455100000,2021,337814,136286,474100,MKT
06079907455100000,2020,246020,129380,375400,MKT
06079907455100000,2019,246020,129380,375400,MKT
06079907455140000,2021,1478001,4939320,6417321,COST
06079907455140000,2020,549304,486460,1035764,COST
06079907455140000,2019,549304,486460,1035764,COST
06079907455170000,2021,784323,195100,979423,COST
06079907455170000,2020,418727,190610,609337,COST
06079907455170000,2019,418727,190610,609337,COST
06079907455210000,2021,448315,183480,631795,COST
06079907455210000,2020,484907,171470,656377,COST
06079907455210000,2019,484907,204793,689700,INCOME
06079907455230000,2021,250893,0,250893,COST
06079907455230000,2020,211938,0,211938,COST
06079907455230000,2019,211938,0,211938,COST
06079907455240000,2021,379937,114490,494427,COST
06079907455240000,2020,260947,178600,439547,COST
06079907455240000,2019,260947,178600,439547,COST
06079907455250000,2021,294529,145271,439800,MKT
06079907455250000,2020,229678,137922,367600,MKT
06079907455250000,2019,229678,137922,367600,MKT
06079907455270000,2021,430439,101361,531800,MKT
06079907455270000,2020,277793,133407,411200,MKT
06079907455270000,2019,277793,133407,411200,MKT
06079907455290000,2021,279313,152387,431700,MKT
06079907455290000,2020,223651,114549,338200,MKT
06079907455290000,2019,223651,114549,338200,MKT
06079907455310000,2021,307915,151085,459000,MKT
06079907455310000,2020,234852,152148,387000,MKT
06079907455310000,2019,234852,152148,387000,MKT
06079907456200000,2021,638221,33879,672100,INCOME
06079907456200000,2020,216227,108373,324600,INCOME
06079907456200000,2019,216227,108373,324600,INCOME
06079907457010000,2021,11429016,6730580,18159596,COST
06079907457010000,2020,1611173,6570270,8181443,COST
06079907457010000,2019,1611173,6570270,8181443,COST
06079907458010000,2021,721786,0,721786,COST
06079907458010000,2020,359962,0,359962,COST
06079907458010000,2019,359962,0,359962,COST
06079907458030000,2021,640053,0,640053,COST
06079907458030000,2020,338917,0,338917,COST
06079907458030000,2019,338917,0,338917,COST
06079907468016500,2021,3253127,94300,3347427,COST
06079907468016500,2020,439760,0,439760,COST
06079907468016500,2019,439760,0,439760,COST
06079908101010000,2021,2821,0,2821,COST
06079908101010000,2020,2626,0,2626,COST
06079908101010000,2019,2626,0,2626,COST
06079908101030000,2021,252925,483675,736600,MKT
06079908101030000,2020,261412,306288,567700,MKT
06079908101030000,2019,261412,306288,567700,MKT
06079908101050000,2021,251221,62550,313771,COST
06079908101050000,2020,304786,40660,345446,COST
06079908101050000,2019,304786,40660,345446,COST
06079908101090000,2021,481606,633120,1114726,COST
06079908101090000,2020,504028,459410,963438,COST
06079908101090000,2019,504028,462010,966038,COST
06079908101130000,2021,327750,228980,556730,COST
06079908101130000,2020,321147,0,321147,COST
06079908101130000,2019,321147,0,321147,COST
06079908101150000,2021,327163,282510,609673,COST
06079908101150000,2020,320690,254200,574890,COST
06079908101150000,2019,320690,254200,574890,COST
06079908101170000,2021,328691,438520,767211,COST
06079908101170000,2020,321879,409320,731199,COST
06079908101170000,2019,321879,409320,731199,COST
06079908101210000,2021,1375,0,1375,COST
06079908101210000,2020,927,0,927,COST
06079908101210000,2019,927,0,927,COST
06079908101230000,2021,619,0,619,COST
06079908101230000,2020,578,0,578,COST
06079908101230000,2019,578,0,578,COST
06079908101250000,2021,1387,0,1387,COST
06079908101250000,2020,831,0,831,COST
06079908101250000,2019,831,0,831,COST
06079908101270000,2021,3041,0,3041,COST
06079908101270000,2020,1669,0,1669,COST
06079908101270000,2019,1669,0,1669,COST
06079908101290000,2021,4123,0,4123,COST
06079908101290000,2020,2217,0,2217,COST
06079908101290000,2019,2217,0,2217,COST
06079908101310000,2021,975,0,975,COST
06079908101310000,2020,906,0,906,COST
06079908101310000,2019,906,0,906,COST
06079908101330000,2021,984,0,984,COST
06079908101330000,2020,915,0,915,COST
06079908101330000,2019,915,0,915,COST
06079908101350000,2021,466,0,466,COST
06079908101350000,2020,434,0,434,COST
06079908101350000,2019,434,0,434,COST
06079908101370000,2021,397,0,397,COST
06079908101370000,2020,370,0,370,COST
06079908101370000,2019,370,0,370,COST
06079908201110000,2021,122234,350766,473000,MKT
06079908201110000,2020,89077,333923,423000,MKT
06079908201110000,2019,89077,333923,423000,MKT
06079908201140000,2021,122234,393466,515700,MKT
06079908201140000,2020,89077,339323,428400,MKT
06079908201140000,2019,89077,339323,428400,MKT
06079908201180000,2021,126418,364082,490500,MKT
06079908201180000,2020,92083,333717,425800,MKT
06079908201180000,2019,92083,333717,425800,MKT
06079908201200000,2021,685127,834973,1520100,INCOME
06079908201200000,2020,693194,654506,1347700,INCOME
06079908201200000,2019,693194,654506,1347700,INCOME
06079908201210000,2021,334330,411770,746100,INCOME
06079908201210000,2020,509769,307680,817449,COST
06079908201210000,2019,509769,307680,817449,COST
06079908201250000,2021,270944,420656,691600,INCOME
06079908201250000,2020,465869,170531,636400,INCOME
06079908201250000,2019,465869,170531,636400,INCOME
06079908201300000,2021,311602,453198,764800,INCOME
06079908201300000,2020,494625,198375,693000,INCOME
06079908201300000,2019,494625,198375,693000,INCOME
06079908201340000,2021,742904,271296,1014200,INCOME
06079908201340000,2020,613675,358140,971815,COST
06079908201340000,2019,613675,358140,971815,COST
06079908202120000,2021,265312,0,265312,COST
06079908202120000,2020,461696,0,461696,COST
06079908202120000,2019,461696,0,461696,COST
06079908203350000,2021,381835,229720,611555,COST
06079908203350000,2020,539624,219420,759044,COST
06079908203350000,2019,539624,219420,759044,COST
06079908204020000,2021,228468,0,228468,COST
06079908204020000,2020,119800,0,119800,COST
06079908204020000,2019,119800,0,119800,COST
06079908204080000,2021,286387,455630,742017,COST
06079908204080000,2020,477064,390036,867100,INCOME
06079908204080000,2019,477064,390036,867100,INCOME
06079908204150000,2021,1247663,627337,1875000,INCOME
06079908204150000,2020,764270,673730,1438000,INCOME
06079908204150000,2019,764270,673730,1438000,INCOME
06079908204200000,2021,691932,65940,757872,COST
06079908204200000,2020,593699,62590,656289,COST
06079908204200000,2019,593699,62590,656289,COST
06079908204300000,2021,566354,480900,1047254,COST
06079908204300000,2020,638903,458050,1096953,COST
06079908204300000,2019,638903,458050,1096953,COST
06079908204350000,2021,183524,735220,918744,COST
06079908204350000,2020,148617,674280,822897,COST
06079908204350000,2019,148617,674280,822897,COST
06079908204450000,2021,1137247,1316350,2453597,COST
06079908204450000,2020,978705,1290795,2269500,INCOME
06079908204450000,2019,978705,1290795,2269500,INCOME
06079908204500000,2021,426806,0,426806,COST
06079908204500000,2020,565985,0,565985,COST
06079908204500000,2019,565985,0,565985,COST
06079908205010000,2021,1301133,459500,1760633,COST
06079908205010000,2020,547522,456510,1004032,OVR
06079908205010000,2019,547522,456510,1004032,COST
06079908206010000,2021,1225323,0,1225323,COST
06079908206010000,2020,915829,0,915829,COST
06079908206010000,2019,915829,0,915829,COST
06079908207010000,2021,1728,0,1728,COST
06079908207010000,2020,1608,0,1608,COST
06079908207010000,2019,1245,0,1245,COST
06079908209170000,2021,376940,446060,823000,INCOME
06079908209170000,2020,536649,143220,679869,COST
06079908209170000,2019,536649,143220,679869,COST
06079908209270000,2021,603695,341205,944900,INCOME
06079908209270000,2020,656620,185780,842400,INCOME
06079908209270000,2019,656620,185780,842400,INCOME
06079908209300000,2021,538944,0,538944,COST
06079908209300000,2020,437951,0,437951,COST
06079908209300000,2019,437951,0,437951,COST
06079908215010000,2021,1064121,0,1064121,COST
06079908215010000,2020,968340,0,968340,COST
06079908215010000,2019,968340,0,968340,COST
06079908240010000,2021,613146,135550,748696,COST
06079908240010000,2020,5061,111870,116931,OVR
06079908240010000,2019,5061,111870,116931,COST
06079908240040000,2021,338676,320610,659286,COST
06079908240040000,2020,275909,320620,596529,COST
06079908240040000,2019,275909,320620,596529,COST
06079908250010000,2021,652679,50450,703129,COST
06079908250010000,2020,499866,51334,551200,INCOME
06079908250010000,2019,499866,51334,551200,INCOME
06079908255050000,2021,645,0,645,COST
06079908255050000,2020,251,0,251,COST
06079908255050000,2019,251,0,251,COST
06079908259010000,2021,334442,8200,342642,COST
06079908259010000,2020,271924,8250,280174,COST
06079908259010000,2019,271924,8250,280174,COST
06079908301010000,2021,2371,0,2371,COST
06079908301010000,2020,2206,0,2206,COST
06079908301010000,2019,2206,0,2206,COST
06079908302010000,2021,3598,0,3598,COST
06079908302010000,2020,3348,0,3348,COST
06079908302010000,2019,3348,0,3348,COST
06079908342010000,2021,133093,431407,564500,MKT
06079908342010000,2020,96875,353625,450500,MKT
06079908342010000,2019,96875,353625,450500,MKT
06079908342020000,2021,191390,332910,524300,MKT
06079908342020000,2020,143627,319273,462900,MKT
06079908342020000,2019,143627,186710,330337,COST
06079908342030000,2021,191533,341567,533100,MKT
06079908342030000,2020,143733,278967,422700,MKT
06079908342030000,2019,143733,278967,422700,MKT
06079908342040000,2021,210208,307192,517400,MKT
06079908342040000,2020,157540,314860,472400,MKT
06079908342040000,2019,157540,314860,472400,MKT
06079908342050000,2021,190541,244359,434900,MKT
06079908342050000,2020,142999,278901,421900,MKT
06079908342050000,2019,142999,278901,421900,MKT
06079908342060000,2021,187080,244020,431100,MKT
06079908342060000,2020,140438,210460,350898,COST
06079908342060000,2019,140438,194090,334528,COST
06079908342080000,2021,160038,0,160038,COST
06079908342080000,2020,116183,0,116183,COST
06079908342080000,2019,116183,0,116183,COST
06079908345016500,2021,1385613,209690,1595303,COST
06079908345016500,2020,432497,210940,643437,COST
06079908345016500,2019,432497,210940,643437,COST
06079908345050000,2021,790865,0,790865,COST
06079908345050000,2020,373919,0,373919,COST
06079908345050000,2019,373919,0,373919,COST
06079908345100000,2021,1245690,5957610,7203300,INCOME
06079908345100000,2020,822368,6090332,6912700,INCOME
06079908345100000,2019,822368,6090332,6912700,INCOME
06079908345150000,2021,595607,0,595607,COST
06079908345150000,2020,599503,0,599503,COST
06079908345150000,2019,599503,0,599503,COST
06079908345207000,2021,745077,0,745077,COST
06079908345207000,2020,659854,0,659854,COST
06079908345207000,2019,659854,0,659854,COST
06079908345257000,2021,687783,0,687783,COST
06079908345257000,2020,637619,0,637619,COST
06079908345257000,2019,637619,0,637619,COST
06079908345307000,2021,679250,362870,1042120,COST
06079908345307000,2020,634218,354860,989078,COST
06079908345307000,2019,634218,354860,989078,COST
06079908345350000,2021,693392,0,693392,COST
06079908345350000,2020,639842,0,639842,COST
06079908345350000,2019,639842,0,639842,COST
06079908345407000,2021,576731,72160,648891,COST
06079908345407000,2020,591289,74190,665479,COST
06079908345407000,2019,591289,74190,665479,COST
06079908349090000,2021,124679,300121,424800,MKT
06079908349090000,2020,90834,263266,354100,MKT
06079908349090000,2019,90834,263266,354100,MKT
06079908349100000,2021,144715,341185,485900,MKT
06079908349100000,2020,105209,322191,427400,MKT
06079908349100000,2019,105209,322191,427400,MKT
06079908349110000,2021,145946,307854,453800,MKT
06079908349110000,2020,106092,263808,369900,MKT
06079908349110000,2019,106092,263808,369900,MKT
06079908349120000,2021,123224,394876,518100,MKT
06079908349120000,2020,89788,352112,441900,OVR
06079908349120000,2019,89788,352112,441900,MKT
06079908349130000,2021,136534,392866,529400,MKT
06079908349130000,2020,99343,358857,458200,MKT
06079908349130000,2019,99343,358857,458200,MKT
06079908349140000,2021,140959,361441,502400,MKT
06079908349140000,2020,102516,290484,393000,MKT
06079908349140000,2019,102516,290484,393000,MKT
06079908349150000,2021,142213,371787,514000,MKT
06079908349150000,2020,103415,317885,421300,MKT
06079908349150000,2019,103415,309685,413100,MKT
06079908349160000,2021,145946,336254,482200,MKT
06079908349160000,2020,106092,279008,385100,MKT
06079908349160000,2019,106092,279008,385100,MKT
06079908350010000,2021,162774,242526,405300,MKT
06079908350010000,2020,118141,245659,363800,MKT
06079908350010000,2019,118141,245659,363800,MKT
06079908350020000,2021,147669,243431,391100,MKT
06079908350020000,2020,107326,162240,269566,COST
06079908350020000,2019,107326,162240,269566,COST
06079908350030000,2021,147669,270831,418500,MKT
06079908350030000,2020,107326,135500,242826,COST
06079908350030000,2019,107326,135500,242826,COST
06079908350040000,2021,300045,255280,555325,COST
06079908350040000,2020,486681,242470,729151,COST
06079908350040000,2019,486681,242470,729151,COST
06079908350050000,2021,150773,353527,504300,MKT
06079908350050000,2020,109549,340351,449900,MKT
06079908350050000,2019,109549,340351,449900,MKT
06079908350060000,2021,170738,0,170738,COST
06079908350060000,2020,123838,0,123838,COST
06079908350060000,2019,123838,0,123838,COST
06079908350070000,2021,161560,330140,491700,MKT
06079908350070000,2020,117273,285727,403000,MKT
06079908350070000,2019,117273,286427,403700,MKT
06079908350080000,2021,148377,383923,532300,MKT
06079908350080000,2020,107833,337267,445100,MKT
06079908350080000,2019,107833,351567,459400,MKT
06079908350090000,2021,147669,358631,506300,MKT
06079908350090000,2020,107326,333074,440400,MKT
06079908350090000,2019,107326,333074,440400,MKT
06079908350100000,2021,147669,339431,487100,MKT
06079908350100000,2020,107326,300474,407800,MKT
06079908350100000,2019,107326,300474,407800,MKT
06079908350110000,2021,147669,337031,484700,MKT
06079908350110000,2020,107326,334874,442200,MKT
06079908350110000,2019,107326,334874,442200,MKT
06079908350120000,2021,143467,351833,495300,MKT
06079908350120000,2020,104314,319286,423600,MKT
06079908350120000,2019,104314,319286,423600,MKT
06079908352080000,2021,158564,341636,500200,MKT
06079908352080000,2020,115129,328271,443400,MKT
06079908352080000,2019,115129,328271,443400,MKT
06079908352090000,2021,124693,360707,485400,MKT
06079908352090000,2020,90844,275356,366200,MKT
06079908352090000,2019,90844,275356,366200,MKT
06079908352100000,2021,124693,395707,520400,MKT
06079908352100000,2020,90844,336056,426900,MKT
06079908352100000,2019,90844,336656,427500,MKT
06079908352110000,2021,122850,398250,521100,MKT
06079908352110000,2020,89520,384380,473900,MKT
06079908352110000,2019,89520,384380,473900,MKT
06079908353017000,2021,404573,10180,414753,COST
06079908353017000,2020,280591,9860,290451,COST
06079908353017000,2019,280591,9860,290451,COST
06079908353030000,2021,611562,793738,1405300,INCOME
06079908353030000,2020,660272,799828,1460100,INCOME
06079908353030000,2019,660272,799828,1460100,INCOME
06079908353047000,2021,816345,919240,1735585,COST
06079908353047000,2020,747232,4999768,5747000,INCOME
06079908353047000,2019,747232,0,747232,COST
06079908353050000,2021,691763,2824437,3516200,INCOME
06079908353050000,2020,353077,2704023,3057100,INCOME
06079908353050000,2019,353077,2704023,3057100,INCOME
06079908353080000,2021,331668,0,331668,COST
06079908353080000,2020,257696,0,257696,COST
06079908353080000,2019,257696,0,257696,COST
06079908353100000,2021,407776,1227124,1634900,INCOME
06079908353100000,2020,281541,1200359,1481900,INCOME
06079908353100000,2019,281541,1200359,1481900,INCOME
06079908353120000,2021,392457,495443,887900,INCOME
06079908353120000,2020,276960,490420,767380,COST
06079908353120000,2019,276960,490420,767380,COST
06079908353200000,2021,1208903,84510,1293413,COST
06079908353200000,2020,754007,0,754007,COST
06079908353200000,2019,754007,5206893,5960900,INCOME
06079908353250000,2021,594955,1594245,2189200,INCOME
06079908353250000,2020,330996,1635604,1966600,INCOME
06079908353250000,2019,330996,1635604,1966600,INCOME
06079908353350000,2021,1052055,0,1052055,COST
06079908353350000,2020,710430,0,710430,COST
06079908353350000,2019,710430,0,710430,COST
06079908401060000,2021,989882,740118,1730000,OVR
06079908401060000,2020,732139,980161,1712300,INCOME
06079908401060000,2019,732139,980161,1712300,INCOME
06079908401080000,2021,355713,81987,437700,INCOME
06079908401080000,2020,250189,209611,459800,INCOME
06079908401080000,2019,250189,209611,459800,INCOME
06079908401100000,2021,306718,0,306718,COST
06079908401100000,2020,651179,0,651179,COST
06079908401100000,2019,707803,0,707803,COST
06079908402010000,2021,2473005,12265595,14738600,INCOME
06079908402010000,2020,1365132,12519068,13884200,INCOME
06079908402010000,2019,1365132,12519068,13884200,INCOME
06079908402030000,2021,185848,0,185848,COST
06079908402030000,2020,204666,0,204666,COST
06079908402030000,2019,204666,0,204666,COST
06079908403030000,2021,1351018,2401682,3752700,INCOME
06079908403030000,2020,1053652,1993048,3046700,INCOME
06079908403030000,2019,1053652,1993048,3046700,INCOME
06079908403060000,2021,821645,1741955,2563600,INCOME
06079908403060000,2020,749307,1603193,2352500,INCOME
06079908403060000,2019,749307,1603193,2352500,INCOME
06079908403100000,2021,2367432,3791468,6158900,INCOME
06079908403100000,2020,598084,4937116,5535200,INCOME
06079908403100000,2019,598084,4937116,5535200,INCOME
06079908403180000,2021,289569,82931,372500,INCOME
06079908403180000,2020,243139,84261,327400,INCOME
06079908403180000,2019,243139,84261,327400,INCOME
06079908403200000,2021,629406,0,629406,COST
06079908403200000,2020,455279,0,455279,COST
06079908403200000,2019,455279,0,455279,COST
06079908403220000,2021,389973,0,389973,COST
06079908403220000,2020,275528,0,275528,COST
06079908403220000,2019,275528,0,275528,COST
06079908403240000,2021,383879,0,383879,COST
06079908403240000,2020,271012,0,271012,COST
06079908403240000,2019,271012,0,271012,COST
06079908403260000,2021,410585,0,410585,COST
06079908403260000,2020,290826,0,290826,COST
06079908403260000,2019,290826,0,290826,COST
06079908403280000,2021,426809,0,426809,COST
06079908403280000,2020,302894,0,302894,COST
06079908403280000,2019,302894,0,302894,COST
06079908404010000,2021,806773,1428427,2235200,INCOME
06079908404010000,2020,743466,1220934,1964400,INCOME
06079908404010000,2019,743466,1220934,1964400,INCOME
06079908405010000,2021,265614,300586,566200,MKT
06079908405010000,2020,202331,254780,457111,COST
06079908405010000,2019,202331,254780,457111,COST
06079908405020000,2021,231338,332362,563700,MKT
06079908405020000,2020,172538,282062,454600,MKT
06079908405020000,2019,172538,282062,454600,MKT
06079908405030000,2021,224372,647370,871742,COST
06079908405030000,2020,166563,636760,803323,COST
06079908405030000,2019,166563,636760,803323,COST
06079908405040000,2021,244351,577760,822111,COST
06079908405040000,2020,183775,574180,757955,COST
06079908405040000,2019,183775,414030,597805,COST
06079908405060000,2021,242227,231873,474100,MKT
06079908405060000,2020,181934,240066,422000,MKT
06079908405060000,2019,181934,233066,415000,MKT
06079908405080000,2021,238475,293025,531500,MKT
06079908405080000,2020,178689,252711,431400,MKT
06079908405080000,2019,178689,252711,431400,MKT
06079908407030000,2021,81278,114830,196108,COST
06079908407030000,2020,106124,124176,230300,MKT
06079908407030000,2019,106124,124176,230300,MKT
06079908409010000,2021,271703,1338750,1610453,COST
06079908409010000,2020,404444,1208870,1613314,COST
06079908409010000,2019,404444,1208870,1613314,COST
06079908409070000,2021,566234,502900,1069134,COST
06079908409070000,2020,507796,467540,975336,COST
06079908409070000,2019,507796,467540,975336,COST
06079908409090000,2021,469845,696107,1165952,OVR
06079908409090000,2020,494228,306890,801118,COST
06079908409090000,2019,494228,306890,801118,COST
06079908409130000,2021,414202,516310,930512,COST
06079908409130000,2020,447153,468120,915273,COST
06079908409130000,2019,447153,468120,915273,COST
06079908409150000,2021,161872,767020,928892,COST
06079908409150000,2020,183405,709340,892745,COST
06079908409150000,2019,183405,709340,892745,COST
06079909101010000,2021,28719,0,28719,COST
06079909101010000,2020,25422,0,25422,COST
06079909101010000,2019,25422,0,25422,COST
06079909101020000,2021,185898,126330,312228,COST
06079909101020000,2020,299358,115620,414978,COST
06079909101020000,2019,299358,115620,414978,COST
06079909101040000,2021,384904,286570,671474,COST
06079909101040000,2020,421848,262670,684518,COST
06079909101040000,2019,421848,262670,684518,COST
06079909101050000,2021,440079,300310,740389,COST
06079909101050000,2020,469198,282250,751448,COST
06079909101050000,2019,469198,282250,751448,COST
06079909101060000,2021,6685,132040,138725,COST
06079909101060000,2020,6619,123090,129709,COST
06079909101060000,2019,6619,123090,129709,COST
06079909101070000,2021,5968,160290,166258,COST
06079909101070000,2020,5952,146320,152272,COST
06079909101070000,2019,5952,146320,152272,COST
06079909101080000,2021,325158,260820,585978,COST
06079909101080000,2020,462110,238170,700280,COST
06079909101080000,2019,462110,238170,700280,COST
06079909101100000,2021,7035,662810,669845,COST
06079909101100000,2020,7031,599870,606901,COST
06079909101100000,2019,6781,548430,555211,COST
06079909201100000,2021,924965,0,924965,COST
06079909201100000,2020,681848,3942952,4624800,INCOME
06079909201100000,2019,681848,3942952,4624800,INCOME
06079909201150000,2021,1138520,3276580,4415100,INCOME
06079909201150000,2020,847884,2897716,3745600,INCOME
06079909201150000,2019,847884,2897716,3745600,INCOME
06079909201300000,2021,715277,1172010,1887287,COST
06079909201300000,2020,508393,1130850,1639243,COST
06079909201300000,2019,508393,1130850,1639243,COST
06079909201400000,2021,982600,643710,1626310,COST
06079909201400000,2020,701113,621980,1323093,COST
06079909201400000,2019,701113,621980,1323093,COST
06079909201500000,2021,1080296,1053904,2134200,INCOME
06079909201500000,2020,802451,1028149,1830600,INCOME
06079909201500000,2019,802451,1028149,1830600,INCOME
06079909201600000,2021,1080296,0,1080296,COST
06079909201600000,2020,802451,0,802451,COST
06079909201600000,2019,802451,0,802451,COST
06079909301030000,2021,136557,119410,255967,COST
06079909301030000,2020,234103,110660,344763,COST
06079909301030000,2019,234103,110660,344763,COST
06079909302010000,2021,983633,3676867,4660500,INCOME
06079909302010000,2020,727291,0,727291,COST
06079909302010000,2019,727291,426709,1154000,INCOME
06079909302200000,2021,733690,1652310,2386000,COST
06079909302200000,2020,658495,1622180,2280675,COST
06079909302200000,2019,658495,1622180,2280675,COST
06079909302280000,2021,480108,1971770,2451878,COST
06079909302280000,2020,342695,1911580,2254275,COST
06079909302280000,2019,342695,1911580,2254275,COST
06079909302320000,2021,521106,2391730,2912836,COST
06079909302320000,2020,373459,2334730,2708189,COST
06079909302320000,2019,373459,2334730,2708189,COST
06079909302367000,2021,520723,24670,545393,COST
06079909302367000,2020,373171,0,373171,COST
06079909302367000,2019,373171,0,373171,COST
06079909302400000,2021,513586,0,513586,COST
06079909302400000,2020,367807,0,367807,COST
06079909302400000,2019,367807,0,367807,COST
06079909303010000,2021,359564,399536,759100,INCOME
06079909303010000,2020,253031,397769,650800,INCOME
06079909303010000,2019,253031,397769,650800,INCOME
06079909303020000,2021,343319,619481,962800,INCOME
06079909303020000,2020,241051,578349,819400,INCOME
06079909303020000,2019,241051,578349,819400,INCOME
06079909303037000,2021,992250,68010,1060260,COST
06079909303037000,2020,733977,69080,803057,COST
06079909303037000,2019,733977,69080,803057,COST
06079909303050000,2021,280755,384645,665400,INCOME
06079909303050000,2020,195185,376015,571200,INCOME
06079909303050000,2019,195185,376015,571200,INCOME
06079909401150000,2021,5448,271000,276448,COST
06079909401150000,2020,5470,248910,254380,COST
06079909401150000,2019,5470,248910,254380,COST
06079909406400000,2021,1987,0,1987,COST
06079909406400000,2020,1849,0,1849,COST
06079909406400000,2019,1849,0,1849,COST
06079910101010000,2021,13531,30780,44311,COST
06079910101010000,2020,13001,28420,41421,COST
06079910101010000,2019,13001,28420,41421,COST
06079910207070000,2021,49276,0,49276,COST
06079910207070000,2020,45837,3800,49637,COST
06079910207070000,2019,45837,3800,49637,COST
06079910301080000,2021,330548,190040,520588,COST
06079910301080000,2020,323321,209458,532779,OVR
06079910301080000,2019,323321,209458,532779,OVR
06079910301150000,2021,3874,473910,477784,COST
06079910301150000,2020,4010,443460,447470,COST
06079910301150000,2019,4010,443460,447470,COST
06079910301200000,2021,1209,800,2009,COST
06079910301200000,2020,1125,780,1905,COST
06079910301200000,2019,1125,780,1905,COST
06079910301300000,2021,542483,319130,861613,COST
06079910301300000,2020,553994,287100,841094,COST
06079910301300000,2019,553994,287100,841094,COST
06079910301400000,2021,6713,0,6713,COST
06079910301400000,2020,6233,0,6233,COST
06079910301400000,2019,6233,0,6233,COST
06079910301500000,2021,10247,0,10247,COST
06079910301500000,2020,9521,0,9521,COST
06079910301500000,2019,9521,0,9521,COST
06079910301600000,2021,139305,318600,457905,COST
06079910301600000,2020,162794,298590,461384,COST
06079910301600000,2019,162794,298590,461384,COST
06079910401010000,2021,4404,278540,282944,COST
06079910401010000,2020,4506,250470,254976,COST
06079910401010000,2019,4506,250470,254976,COST
06079910401020000,2021,113387,357013,470400,MKT
06079910401020000,2020,138241,228459,366700,MKT
06079910401020000,2019,138241,228459,366700,MKT
06079910401030000,2021,115415,184085,299500,MKT
06079910401030000,2020,138241,68900,207141,COST
06079910401030000,2019,138241,59130,197371,COST
06079910401040000,2021,150350,250750,401100,MKT
06079910401040000,2020,172960,169240,342200,MKT
06079910401040000,2019,172960,169240,342200,MKT
06079910401060000,2021,9066,104210,113276,COST
06079910401060000,2020,8844,95660,104504,COST
06079910401060000,2019,8844,95660,104504,COST
06079910401100000,2021,137700,309300,447000,MKT
06079910401100000,2020,161300,265900,427200,MKT
06079910401100000,2019,161300,265900,427200,MKT
06079910402010000,2021,9860,13860,23720,COST
06079910402010000,2020,9158,0,9158,COST
06079910402010000,2019,9158,0,9158,COST
06079911101010000,2021,470757,221320,692077,COST
06079911101010000,2020,354544,86330,440874,COST
06079911101010000,2019,354544,86330,440874,COST
06079911101050000,2021,2029,1380,3409,COST
06079911101050000,2020,1888,1420,3308,COST
06079911101050000,2019,1888,1420,3308,COST
06079911101100000,2021,2029,1660,3689,COST
06079911101100000,2020,1888,1860,3748,COST
06079911101100000,2019,1888,1860,3748,COST
06079911101150000,2021,239871,364829,604700,MKT
06079911101150000,2020,265106,236394,501500,MKT
06079911101150000,2019,265106,236394,501500,MKT
06079911101200000,2021,207789,532670,740459,COST
06079911101200000,2020,140415,460050,600465,COST
06079911101200000,2019,140415,460050,600465,COST
06079911201010000,2021,31114,0,31114,COST
06079911201010000,2020,28974,0,28974,COST
06079911201010000,2019,28974,0,28974,COST
06079911301030000,2021,203099,238201,441300,MKT
06079911301030000,2020,130966,202834,333800,MKT
06079911301030000,2019,130966,202834,333800,MKT
06079911401010000,2021,207890,920790,1128680,COST
06079911401010000,2020,140509,784580,925089,COST
06079911401010000,2019,140509,784580,925089,COST
06079911401100000,2021,2006,0,2006,COST
06079911401100000,2020,1867,0,1867,COST
06079911401100000,2019,1867,0,1867,COST
06079911401200000,2021,207837,514760,722597,COST
06079911401200000,2020,140460,428970,569430,COST
06079911401200000,2019,140460,428970,569430,COST
06079912101010000,2021,206883,623650,830533,COST
06079912101010000,2020,139572,528920,668492,COST
06079912101010000,2019,139572,365780,505352,COST
06079912101080000,2021,258904,1052990,1311894,COST
06079912101080000,2020,366390,889070,1255460,COST
06079912101080000,2019,366390,889070,1255460,COST
06079912101290000,2021,206115,656890,863005,COST
06079912101290000,2020,138857,548720,687577,COST
06079912101290000,2019,138857,548720,687577,COST
06079912101300000,2021,907,0,907,COST
06079912101300000,2020,844,0,844,COST
06079912101300000,2019,844,0,844,COST
06079912101320000,2021,1130,0,1130,COST
06079912101320000,2020,1052,0,1052,COST
06079912101320000,2019,1052,0,1052,COST
06079912101340000,2021,885,0,885,COST
06079912101340000,2020,824,0,824,COST
06079912101340000,2019,824,0,824,COST
06079912201300000,2021,206881,253110,459991,COST
06079912201300000,2020,139570,218270,357840,COST
06079912201300000,2019,139570,218270,357840,COST
06079912201400000,2021,206881,1364890,1571771,COST
06079912201400000,2020,139570,1155290,1294860,COST
06079912201400000,2019,139570,1134870,1274440,COST
06079912301070000,2021,258417,678283,936700,MKT
06079912301070000,2020,363475,340230,703705,COST
06079912301070000,2019,363475,241540,605015,COST
06079912302010000,2021,260681,282619,543300,MKT
06079912302010000,2020,377162,231630,608792,COST
06079912302010000,2019,377162,193070,570232,COST
06079912303030000,2021,256223,697477,953700,MKT
06079912303030000,2020,350580,566650,917230,COST
06079912303030000,2019,350580,566650,917230,COST
06079912340080000,2021,259805,337895,597700,MKT
06079912340080000,2020,371821,258080,629901,COST
06079912340080000,2019,371821,258080,629901,COST
06079912401010000,2021,258829,107210,366039,COST
06079912401010000,2020,365940,91920,457860,COST
06079912401010000,2019,365940,91920,457860,COST
06079912401030000,2021,256216,317690,573906,COST
06079912401030000,2020,350538,275610,626148,COST
06079912401030000,2019,350538,249830,600368,COST
06079912401050000,2021,205829,548330,754159,COST
06079912401050000,2020,138591,469650,608241,COST
06079912401050000,2019,138591,469650,608241,COST
06079912401060000,2021,67490,527000,594490,COST
06079912401060000,2020,51420,450060,501480,COST
06079912401060000,2019,51420,450060,501480,COST
06079912401070000,2021,256495,316005,572500,MKT
06079912401070000,2020,352157,237680,589837,COST
06079912401070000,2019,352157,237680,589837,COST
06079912401100000,2021,219854,0,219854,COST
06079912401100000,2020,183253,0,183253,COST
06079912401100000,2019,183253,0,183253,COST
06079912401150000,2021,247772,0,247772,COST
06079912401150000,2020,304129,0,304129,COST
06079912401150000,2019,304129,0,304129,COST
06079912401200000,2021,841,0,841,COST
06079912401200000,2020,783,0,783,COST
06079912401200000,2019,783,0,783,COST
06079912401270000,2021,1325,0,1325,COST
06079912401270000,2020,1233,0,1233,COST
06079912401270000,2019,1233,0,1233,COST
06079912401300000,2021,740,0,740,COST
06079912401300000,2020,690,0,690,COST
06079912401300000,2019,690,0,690,COST
06079912401400000,2021,618449,1362430,1980879,COST
06079912401400000,2020,416668,1149190,1565858,COST
06079912401400000,2019,416668,781070,1197738,COST
06079912404010000,2021,263837,259563,523400,MKT
06079912404010000,2020,396899,161200,558099,COST
06079912404010000,2019,396899,161200,558099,COST
06079912404060000,2021,258829,386371,645200,MKT
06079912404060000,2020,365940,301290,667230,COST
06079912404060000,2019,365940,301290,667230,COST
06079912404080000,2021,259177,270123,529300,MKT
06079912404080000,2020,368025,196080,564105,COST
06079912404080000,2019,368025,196080,564105,COST
06079913101010000,2021,115271,0,115271,COST
06079913101010000,2020,64578,0,64578,COST
06079913101010000,2019,64578,0,64578,COST
06079913301010000,2021,69179,181480,250659,COST
06079913301010000,2020,42930,159020,201950,COST
06079913301010000,2019,42930,159020,201950,COST
06079914101010000,2021,242164,342036,584200,MKT
06079914101010000,2020,276011,335300,611311,COST
06079914101010000,2019,276011,265730,541741,COST
06079914101020000,2021,205829,97770,303599,COST
06079914101020000,2020,138591,83830,222421,COST
06079914101020000,2019,138591,83830,222421,COST
06079914101030000,2021,219958,276942,496900,MKT
06079914101030000,2020,183621,231160,414781,COST
06079914101030000,2019,183621,231160,414781,COST
06079914101040000,2021,208925,235675,444600,MKT
06079914101040000,2020,147643,150950,298593,COST
06079914101040000,2019,147643,150950,298593,COST
06079914101050000,2021,207095,18980,226075,COST
06079914101050000,2020,139769,19060,158829,COST
06079914101050000,2019,139769,19060,158829,COST
06079914101060000,2021,206908,116880,323788,COST
06079914101060000,2020,139595,100760,240355,COST
06079914101060000,2019,139595,100760,240355,COST
06079914101070000,2021,238623,252377,491000,MKT
06079914101070000,2020,259307,168593,427900,MKT
06079914101070000,2019,259307,168593,427900,MKT
06079914101080000,2021,35108,245170,280278,COST
06079914101080000,2020,37802,208320,246122,COST
06079914101080000,2019,37802,208320,246122,COST
06079914101090000,2021,209227,88690,297917,COST
06079914101090000,2020,141754,76900,218654,COST
06079914101090000,2019,141754,76900,218654,COST
06079914101120000,2021,466082,69400,535482,COST
06079914101120000,2020,350538,19090,369628,COST
06079914101120000,2019,350538,19180,369718,COST
06079914101130000,2021,256990,0,256990,COST
06079914101130000,2020,393290,0,393290,COST
06079914101130000,2019,393290,0,393290,COST
06079914101160000,2021,581,0,581,COST
06079914101160000,2020,541,0,541,COST
06079914101160000,2019,541,0,541,COST
06079914101180000,2021,207443,216280,423723,COST
06079914101180000,2020,139627,66350,205977,COST
06079914101180000,2019,139627,66350,205977,COST
06079914101200000,2021,211540,319080,530620,COST
06079914101200000,2020,142583,132200,274783,COST
06079914101200000,2019,142583,132200,274783,COST
06079914102051001,2021,240613,20720,261333,COST
06079914102051001,2020,264871,165120,429991,COST
06079914102051001,2019,264871,165120,429991,COST
06079914102051002,2021,75253,171400,246653,COST
06079914102051002,2020,104299,0,104299,COST
06079914102051002,2019,104299,0,104299,COST
06079914102100000,2021,207800,431440,639240,COST
06079914102100000,2020,140271,373340,513611,COST
06079914102100000,2019,140271,362500,502771,COST
06079914102201001,2021,206427,163040,369467,COST
06079914102201001,2020,139147,147600,286747,COST
06079914102201001,2019,139147,147600,286747,COST
06079914102201002,2021,499,14380,14879,COST
06079914102201002,2020,465,14710,15175,COST
06079914102201002,2019,465,14710,15175,COST
06079914102251001,2021,206728,77840,284568,COST
06079914102251001,2020,139428,68810,208238,COST
06079914102251001,2019,139428,68810,208238,COST
06079914102251002,2021,918,0,918,COST
06079914102251002,2020,854,0,854,COST
06079914102251002,2019,854,0,854,COST
06079914102400000,2021,207093,515540,722633,COST
06079914102400000,2020,139768,434300,574068,COST
06079914102400000,2019,139768,434300,574068,COST
06079914201010000,2021,8274,298530,306804,COST
06079914201010000,2020,8567,258430,266997,COST
06079914201010000,2019,8567,258430,266997,COST
06079914201030000,2021,231240,334060,565300,MKT
06079914201030000,2020,226972,229980,456952,COST
06079914201030000,2019,226972,229980,456952,COST
06079914201100000,2021,1107,0,1107,COST
06079914201100000,2020,1030,0,1030,COST
06079914201100000,2019,1030,0,1030,COST
06079914301010000,2021,278021,222279,500300,MKT
06079914301010000,2020,213265,201135,414400,MKT
06079914301010000,2019,213265,201135,414400,MKT
06079914301060000,2021,169537,291463,461000,MKT
06079914301060000,2020,120578,225922,346500,MKT
06079914301060000,2019,120578,225922,346500,MKT
06079914301110000,2021,169537,93220,262757,COST
06079914301110000,2020,120578,91230,211808,COST
06079914301110000,2019,120578,91230,211808,COST
06079914301160000,2021,162824,111550,274374,COST
06079914301160000,2020,115091,108430,223521,COST
06079914301160000,2019,115091,108430,223521,COST
06079914301210000,2021,171751,110350,282101,COST
06079914301210000,2020,122396,108000,230396,COST
06079914301210000,2019,122396,108000,230396,COST
06079914301260000,2021,171751,12970,184721,COST
06079914301260000,2020,122396,13120,135516,COST
06079914301260000,2019,122396,13120,135516,COST
06079914301300000,2021,124404,64780,189184,COST
06079914301300000,2020,84390,63490,147880,COST
06079914301300000,2019,84390,63490,147880,COST
06079914301350000,2021,143516,285284,428800,MKT
06079914301350000,2020,99504,198496,298000,MKT
06079914301350000,2019,99504,198496,298000,MKT
06079914301400000,2021,171751,231549,403300,MKT
06079914301400000,2020,122396,272704,395100,MKT
06079914301400000,2019,122396,272704,395100,MKT
06079914301450000,2021,171751,189149,360900,MKT
06079914301450000,2020,122396,105900,228296,COST
06079914301450000,2019,122396,105900,228296,COST
06079914301470000,2021,171751,7410,179161,COST
06079914301470000,2020,122396,7520,129916,COST
06079914301470000,2019,122396,7520,129916,COST
06079914301550000,2021,171751,19050,190801,COST
06079914301550000,2020,122396,19060,141456,COST
06079914301550000,2019,122396,19060,141456,COST
06079914301830000,2021,68161,0,68161,COST
06079914301830000,2020,50631,0,50631,COST
06079914301830000,2019,50631,0,50631,COST
06079914301840000,2021,190029,0,190029,COST
06079914301840000,2020,142303,0,142303,COST
06079914301840000,2019,142303,0,142303,COST
06079914301850000,2021,190029,0,190029,COST
06079914301850000,2020,142303,0,142303,COST
06079914301850000,2019,142303,0,142303,COST
06079914301860000,2021,190029,0,190029,COST
06079914301860000,2020,142303,0,142303,COST
06079914301860000,2019,142303,0,142303,COST
06079914301870000,2021,190029,0,190029,COST
06079914301870000,2020,142303,0,142303,COST
06079914301870000,2019,142303,0,142303,COST
06079914301880000,2021,237537,0,237537,COST
06079914301880000,2020,177879,0,177879,COST
06079914301880000,2019,177879,0,177879,COST
06079914301890000,2021,237537,0,237537,COST
06079914301890000,2020,177879,0,177879,COST
06079914301890000,2019,177879,0,177879,COST
06079914301900000,2021,237537,199063,436600,MKT
06079914301900000,2020,177879,205121,383000,MKT
06079914301900000,2019,177879,205121,383000,MKT
06079914302050000,2021,2945,1100,4045,COST
06079914302050000,2020,2740,1130,3870,COST
06079914302050000,2019,2740,1130,3870,COST
06079914307010000,2021,216352,176748,393100,MKT
06079914307010000,2020,159718,209082,368800,MKT
06079914307010000,2019,159718,209082,368800,MKT
06079914307020000,2021,282005,252895,534900,MKT
06079914307020000,2020,216793,228790,445583,COST
06079914307020000,2019,216793,228630,445423,COST
06079914307030000,2021,213934,173266,387200,MKT
06079914307030000,2020,157662,133400,291062,COST
06079914307030000,2019,157662,133400,291062,COST
06079914310030000,2021,219500,262900,482400,MKT
06079914310030000,2020,162400,249785,412185,MRA
06079914310030000,2019,162400,249785,412185,MRA
06079914310040000,2021,171751,260840,432591,COST
06079914310040000,2020,122396,247090,369486,COST
06079914310040000,2019,122396,247090,369486,COST
06079914310050000,2021,171751,111300,283051,COST
06079914310050000,2020,122396,108540,230936,COST
06079914310050000,2019,122396,108540,230936,COST
06079914310060000,2021,205493,256980,462473,COST
06079914310060000,2020,150512,234960,385472,COST
06079914310060000,2019,150512,234960,385472,COST
06079914310070000,2021,289973,476300,766273,COST
06079914310070000,2020,215007,454480,669487,COST
06079914310070000,2019,218094,145506,363600,MKT
06079914310080000,2021,229918,261920,491838,COST
06079914310080000,2020,171318,259300,430618,COST
06079914310080000,2019,171318,258110,429428,COST
06079914310090000,2021,313544,460,314004,COST
06079914310090000,2020,244976,480,245456,COST
06079914310090000,2019,244976,480,245456,COST
06079914310100000,2021,246631,346500,593131,COST
06079914310100000,2020,158260,346070,504330,COST
06079914310100000,2019,158260,346070,504330,COST
06079914311020000,2021,370310,1134790,1505100,INCOME
06079914311020000,2020,241802,995698,1237500,INCOME
06079914311020000,2019,241802,914860,1156662,COST
06079914311030000,2021,349243,454757,804000,INCOME
06079914311030000,2020,232635,465665,698300,INCOME
06079914311030000,2019,232635,465665,698300,INCOME
06079914311050000,2021,326757,928140,1254897,COST
06079914311050000,2020,222639,628761,851400,INCOME
06079914311050000,2019,222639,628761,851400,INCOME
06079914330010000,2021,510564,175236,685800,INCOME
06079914330010000,2020,298883,384017,682900,INCOME
06079914330010000,2019,298883,384017,682900,INCOME
06079914330020000,2021,232712,339288,572000,INCOME
06079914330020000,2020,177965,331035,509000,INCOME
06079914330020000,2019,177965,331035,509000,INCOME
06079914330020900,2021,216138,396862,613000,INCOME
06079914330020900,2020,169496,385704,555200,INCOME
06079914330020900,2019,169496,385704,555200,INCOME
06079914330030000,2021,352888,431912,784800,INCOME
06079914330030000,2020,234234,497566,731800,INCOME
06079914330030000,2019,234234,497566,731800,INCOME
06079914330050000,2021,386698,430902,817600,INCOME
06079914330050000,2020,248811,513389,762200,INCOME
06079914330050000,2019,248811,513389,762200,INCOME
06079914330070000,2021,239698,1028902,1268600,INCOME
06079914330070000,2020,181472,1014928,1196400,INCOME
06079914330070000,2019,181472,1014928,1196400,INCOME
06079914330100000,2021,249416,169484,418900,INCOME
06079914330100000,2020,186294,173906,360200,INCOME
06079914330100000,2019,186294,173906,360200,INCOME
06079914401010000,2021,1107,0,1107,COST
06079914401010000,2020,1031,0,1031,COST
06079914401010000,2019,1031,0,1031,COST
06079914401200000,2021,1154,0,1154,COST
06079914401200000,2020,1074,0,1074,COST
06079914401200000,2019,1074,0,1074,COST
06079914401500000,2021,8094,382650,390744,COST
06079914401500000,2020,8841,335820,344661,COST
06079914401500000,2019,8841,335820,344661,COST
06079915101010000,2021,110889,0,110889,COST
06079915101010000,2020,103014,0,103014,COST
06079915101010000,2019,103014,0,103014,COST
06079915101020000,2021,118247,0,118247,COST
06079915101020000,2020,142925,0,142925,COST
06079915101020000,2019,142925,0,142925,COST
06079915401201001,2021,5376,0,5376,COST
06079915401201001,2020,4998,0,4998,COST
06079915401201001,2019,4998,0,4998,COST
06079915401201002,2021,408646,2122210,2530856,COST
06079915401201002,2020,333314,2034600,2367914,COST
06079915401201002,2019,333314,2034600,2367914,COST
06079916103010000,2021,283835,0,283835,COST
06079916103010000,2020,286477,0,286477,COST
06079916103010000,2019,286477,0,286477,COST
06079916105010000,2021,78741,85100,163841,COST
06079916105010000,2020,103485,137115,240600,MKT
06079916105010000,2019,103485,137115,240600,MKT
06079916105030000,2021,232780,0,232780,COST
06079916105030000,2020,244737,0,244737,COST
06079916105030000,2019,244737,0,244737,COST
06079916105040000,2021,270277,670940,941217,COST
06079916105040000,2020,275556,616530,892086,COST
06079916105040000,2019,275556,616530,892086,COST
06079916105050000,2021,146172,366450,512622,COST
06079916105050000,2020,169132,345210,514342,COST
06079916105050000,2019,169132,345210,514342,COST
06079916105060000,2021,230604,234060,464664,COST
06079916105060000,2020,242919,217760,460679,COST
06079916105060000,2019,242919,217760,460679,COST
06079916105080000,2021,139257,141230,280487,COST
06079916105080000,2020,162746,169754,332500,MKT
06079916105080000,2019,162746,169754,332500,MKT
06079916110010000,2021,242356,193644,436000,MKT
06079916110010000,2020,182047,154010,336057,COST
06079916110010000,2019,182047,154010,336057,COST
06079916111010000,2021,229561,321339,550900,MKT
06079916111010000,2020,171011,293489,464500,MKT
06079916111010000,2019,171011,293489,464500,MKT
06079916111020000,2021,223323,326377,549700,MKT
06079916111020000,2020,165665,277635,443300,MKT
06079916111020000,2019,165665,277635,443300,MKT
06079916111030000,2021,222568,325432,548000,MKT
06079916111030000,2020,165020,305680,470700,MKT
06079916111030000,2019,165020,305680,470700,MKT
06079916111040000,2021,221732,389168,610900,MKT
06079916111040000,2020,164305,379095,543400,MKT
06079916111040000,2019,164305,379095,543400,MKT
06079916111050000,2021,220429,547380,767809,COST
06079916111050000,2020,163192,533540,696732,COST
06079916111050000,2019,163192,533540,696732,COST
06079916111060000,2021,226664,334236,560900,MKT
06079916111060000,2020,168526,305274,473800,MKT
06079916111060000,2019,168526,305274,473800,MKT
06079916111070000,2021,227103,400097,627200,MKT
06079916111070000,2020,168902,411298,580200,MKT
06079916111070000,2019,168902,411298,580200,MKT
06079916111080000,2021,227686,475214,702900,MKT
06079916111080000,2020,169402,478898,648300,MKT
06079916111080000,2019,169402,478898,648300,MKT
06079916111090000,2021,231267,292433,523700,MKT
06079916111090000,2020,172477,273023,445500,MKT
06079916111090000,2019,172477,273023,445500,MKT
06079916111100000,2021,239804,596620,836424,COST
06079916111100000,2020,179838,579970,759808,COST
06079916111100000,2019,179838,579970,759808,COST
06079916111110000,2021,222265,335135,557400,MKT
06079916111110000,2020,164760,309240,474000,MKT
06079916111110000,2019,164760,309240,474000,MKT
06079916111120000,2021,222871,236929,459800,MKT
06079916111120000,2020,165278,253022,418300,MKT
06079916111120000,2019,165278,253022,418300,MKT
06079916111130000,2021,220043,334357,554400,MKT
06079916111130000,2020,162863,251260,414123,COST
06079916111130000,2019,162863,251260,414123,COST
06079916112050000,2021,231196,256604,487800,MKT
06079916112050000,2020,172417,263083,435500,MKT
06079916112050000,2019,172417,263083,435500,MKT
06079916112060000,2021,229489,0,229489,COST
06079916112060000,2020,170950,0,170950,COST
06079916112060000,2019,170950,0,170950,COST
06079916112070000,2021,230488,736312,966800,MKT
06079916112070000,2020,171808,698692,870500,MKT
06079916112070000,2019,171808,698692,870500,MKT
06079916112080000,2021,221197,275103,496300,MKT
06079916112080000,2020,163848,272752,436600,MKT
06079916112080000,2019,163848,272752,436600,MKT
06079916113010000,2021,224968,334132,559100,MKT
06079916113010000,2020,167073,339527,506600,MKT
06079916113010000,2019,167073,339527,506600,MKT
06079916113020000,2021,220506,315294,535800,MKT
06079916113020000,2020,163258,313642,476900,MKT
06079916113020000,2019,163258,313642,476900,MKT
06079916113030000,2021,220351,290249,510600,MKT
06079916113030000,2020,163126,263474,426600,OVR
06079916113030000,2019,163126,263474,426600,MKT
06079916113040000,2021,220737,297663,518400,MKT
06079916113040000,2020,163455,309945,473400,MKT
06079916113040000,2019,163455,309945,473400,MKT
06079916113050000,2021,222265,319435,541700,MKT
06079916113050000,2020,164760,308940,473700,MKT
06079916113050000,2019,164760,308940,473700,MKT
06079916113060000,2021,224596,420910,645506,COST
06079916113060000,2020,166754,357746,524500,MKT
06079916113060000,2019,166754,357746,524500,MKT
06079916113070000,2021,219810,175290,395100,MKT
06079916113070000,2020,162665,208435,371100,MKT
06079916113070000,2019,162665,208435,371100,MKT
06079916113080000,2021,219810,237790,457600,MKT
06079916113080000,2020,162665,243535,406200,MKT
06079916113080000,2019,162665,243535,406200,MKT
06079916113090000,2021,220197,227303,447500,MKT
06079916113090000,2020,162995,208305,371300,MKT
06079916113090000,2019,162995,208305,371300,MKT
06079916113100000,2021,219733,302667,522400,MKT
06079916113100000,2020,162599,306601,469200,MKT
06079916113100000,2019,162599,306601,469200,MKT
06079916113110000,2021,224073,365527,589600,MKT
06079916113110000,2020,166307,379493,545800,MKT
06079916113110000,2019,166307,379493,545800,MKT
06079916113120000,2021,230274,269126,499400,MKT
06079916113120000,2020,171624,283476,455100,MKT
06079916113120000,2019,171624,283476,455100,MKT
06079916113130000,2021,219888,298412,518300,MKT
06079916113130000,2020,162731,283869,446600,MKT
06079916113130000,2019,162731,283869,446600,MKT
06079916113140000,2021,221350,258350,479700,MKT
06079916113140000,2020,163979,262021,426000,MKT
06079916113140000,2019,163979,262021,426000,MKT
06079916114040000,2021,219500,318790,538290,COST
06079916114040000,2020,162400,289900,452300,MKT
06079916114040000,2019,162400,290100,452500,MKT
06079916114050000,2021,219500,436750,656250,COST
06079916114050000,2020,162400,407200,569600,MKT
06079916114050000,2019,162400,407200,569600,MKT
06079916114060000,2021,219500,266700,486200,MKT
06079916114060000,2020,162400,288100,450500,MKT
06079916114060000,2019,162400,288100,450500,MKT
06079916114070000,2021,219500,237100,456600,MKT
06079916114070000,2020,162400,216800,379200,MKT
06079916114070000,2019,162400,216800,379200,MKT
06079916116010000,2021,219500,339500,559000,MKT
06079916116010000,2020,162400,297600,460000,MKT
06079916116010000,2019,162400,297600,460000,MKT
06079916116020000,2021,219500,306600,526100,MKT
06079916116020000,2020,162400,289900,452300,MKT
06079916116020000,2019,162400,289900,452300,MKT
06079916116030000,2021,219500,364100,583600,MKT
06079916116030000,2020,162400,361800,524200,OVR
06079916116030000,2019,162400,361800,524200,MKT
06079916116040000,2021,219500,273500,493000,MKT
06079916116040000,2020,162400,264800,427200,MKT
06079916116040000,2019,162400,264800,427200,MKT
06079916116050000,2021,235230,268270,503500,MKT
06079916116050000,2020,175889,255611,431500,MKT
06079916116050000,2019,175889,255611,431500,MKT
06079916116060000,2021,222568,244532,467100,MKT
06079916116060000,2020,165020,216380,381400,MKT
06079916116060000,2019,165020,216380,381400,MKT
06079916116070000,2021,225856,220044,445900,MKT
06079916116070000,2020,167833,219267,387100,MKT
06079916116070000,2019,167833,219267,387100,MKT
06079916116080000,2021,227976,184224,412200,MKT
06079916116080000,2020,169651,210249,379900,MKT
06079916116080000,2019,169651,210249,379900,MKT
06079916116090000,2021,240331,449469,689800,MKT
06079916116090000,2020,180294,413006,593300,MKT
06079916116090000,2019,180294,413006,593300,MKT
06079916116100000,2021,238074,297626,535700,MKT
06079916116100000,2020,178343,273657,452000,MKT
06079916116100000,2019,178343,273657,452000,MKT
06079916116110000,2021,248749,263251,512000,MKT
06079916116110000,2020,187594,266706,454300,MKT
06079916116110000,2019,187594,266706,454300,MKT
06079916116120000,2021,240331,229969,470300,MKT
06079916116120000,2020,180294,239006,419300,MKT
06079916116120000,2019,180294,239006,419300,MKT
06079916116130000,2021,223022,243478,466500,MKT
06079916116130000,2020,165407,256093,421500,MKT
06079916116130000,2019,165407,256093,421500,MKT
06079916116140000,2021,227322,339740,567062,COST
06079916116140000,2020,169090,336310,505400,OVR
06079916116140000,2019,169090,336310,505400,MKT
06079916116150000,2021,345322,0,345322,COST
06079916116150000,2020,273816,0,273816,COST
06079916116150000,2019,273878,0,273878,COST
06079916130010000,2021,151836,47730,199566,COST
06079916130010000,2020,174316,43750,218066,COST
06079916130010000,2019,174316,43750,218066,COST
06079916148010000,2021,141389,0,141389,COST
06079916148010000,2020,164723,0,164723,COST
06079916148010000,2019,164723,0,164723,COST
06079916149010000,2021,96814,274586,371400,MKT
06079916149010000,2020,121938,196362,318300,MKT
06079916149010000,2019,121938,196362,318300,MKT
06079916149020000,2021,119511,283089,402600,MKT
06079916149020000,2020,144137,220163,364300,MKT
06079916149020000,2019,144137,220163,364300,MKT
06079916149030000,2021,119511,288989,408500,MKT
06079916149030000,2020,144137,224363,368500,MKT
06079916149030000,2019,144137,224363,368500,MKT
06079916149040000,2021,119511,304089,423600,MKT
06079916149040000,2020,144137,193763,337900,MKT
06079916149040000,2019,144137,193763,337900,MKT
06079916149050000,2021,112665,348235,460900,MKT
06079916149050000,2020,137541,346159,483700,MKT
06079916149050000,2019,137541,346159,483700,MKT
06079916149060000,2021,127274,261426,388700,MKT
06079916149060000,2020,151524,167076,318600,MKT
06079916149060000,2019,151524,167076,318600,MKT
06079916149070000,2021,146220,304980,451200,MKT
06079916149070000,2020,169176,244924,414100,MKT
06079916149070000,2019,169176,244924,414100,MKT
06079916149080000,2021,126857,0,126857,COST
06079916149080000,2020,151129,0,151129,COST
06079916149080000,2019,151129,0,151129,COST
06079916149090000,2021,100159,246741,346900,MKT
06079916149090000,2020,125272,209228,334500,MKT
06079916149090000,2019,125272,209228,334500,MKT
06079916149100000,2021,100159,283441,383600,MKT
06079916149100000,2020,125272,234128,359400,MKT
06079916149100000,2019,125272,234128,359400,MKT
06079916149110000,2021,100159,253841,354000,MKT
06079916149110000,2020,125272,212628,337900,MKT
06079916149110000,2019,125272,212628,337900,MKT
06079916201010000,2021,297669,300931,598600,MKT
06079916201010000,2020,230733,261767,492500,MKT
06079916201010000,2019,230733,261767,492500,MKT
06079916201050000,2021,219888,387412,607300,MKT
06079916201050000,2020,162731,348769,511500,MKT
06079916201050000,2019,162731,348769,511500,MKT
06079916210010000,2021,222265,220735,443000,MKT
06079916210010000,2020,164760,214940,379700,MKT
06079916210010000,2019,164760,214940,379700,MKT
06079916210020000,2021,222795,387380,610175,COST
06079916210020000,2020,165214,388500,553714,COST
06079916210020000,2019,165214,388500,553714,COST
06079916210030000,2021,222189,282911,505100,MKT
06079916210030000,2020,164695,297805,462500,MKT
06079916210030000,2019,164695,297805,462500,MKT
06079916210040000,2021,222037,332963,555000,MKT
06079916210040000,2020,164566,345934,510500,MKT
06079916210040000,2019,164566,345934,510500,MKT
06079916210050000,2021,248936,336864,585800,MKT
06079916210050000,2020,184532,341168,525700,MKT
06079916210050000,2019,184532,341168,525700,MKT
06079916210060000,2021,293697,0,293697,COST
06079916210060000,2020,223285,0,223285,COST
06079916210060000,2019,223285,0,223285,COST
06079916210070000,2021,274860,355140,630000,MKT
06079916210070000,2020,210472,341528,552000,MKT
06079916210070000,2019,210472,341528,552000,MKT
06079916210080000,2021,233159,497041,730200,MKT
06079916210080000,2020,174106,443994,618100,MKT
06079916210080000,2019,174106,443994,618100,MKT
06079916210090000,2021,234130,390570,624700,MKT
06079916210090000,2020,174941,410259,585200,MKT
06079916210090000,2019,174941,410259,585200,MKT
06079916210100000,2021,225782,347218,573000,MKT
06079916210100000,2020,167770,308630,476400,MKT
06079916210100000,2019,167770,308630,476400,MKT
06079916210110000,2021,225782,250018,475800,MKT
06079916210110000,2020,167770,265530,433300,MKT
06079916210110000,2019,167770,265530,433300,MKT
06079916210120000,2021,225782,301418,527200,MKT
06079916210120000,2020,167770,276230,444000,MKT
06079916210120000,2019,167770,276230,444000,MKT
06079916212010000,2021,225930,289070,515000,MKT
06079916212010000,2020,167896,271904,439800,MKT
06079916212010000,2019,167896,257204,425100,MKT
06079916212020000,2021,231055,350845,581900,MKT
06079916212020000,2020,172295,318005,490300,MKT
06079916212020000,2019,172295,318005,490300,MKT
06079916212030000,2021,230913,276987,507900,MKT
06079916212030000,2020,172173,273527,445700,OVR
06079916212030000,2019,172173,273527,445700,MKT
06079916212040000,2021,238675,322425,561100,MKT
06079916212040000,2020,178862,333238,512100,MKT
06079916212040000,2019,178862,333238,512100,MKT
06079916212090000,2021,221961,313839,535800,MKT
06079916212090000,2020,164501,299499,464000,MKT
06079916212090000,2019,164501,299499,464000,MKT
06079916212100000,2021,221961,247939,469900,MKT
06079916212100000,2020,164501,240799,405300,MKT
06079916212100000,2019,164501,240799,405300,MKT
06079916212110000,2021,224298,357702,582000,MKT
06079916212110000,2020,166499,320901,487400,MKT
06079916212110000,2019,166499,320901,487400,MKT
06079916214010000,2021,219500,285000,504500,MKT
06079916214010000,2020,162400,282300,444700,MKT
06079916214010000,2019,162400,282300,444700,MKT
06079916214020000,2021,219500,456870,676370,COST
06079916214020000,2020,162400,279100,441500,OVR
06079916214020000,2019,162400,279100,441500,MKT
06079916214030000,2021,219500,522810,742310,COST
06079916214030000,2020,162400,509190,671590,COST
06079916214030000,2019,162400,509190,671590,COST
06079916214080000,2021,219500,0,219500,COST
06079916214080000,2020,162400,0,162400,COST
06079916214080000,2019,162400,0,162400,COST
06079916214090000,2021,219500,278000,497500,MKT
06079916214090000,2020,162400,277200,439600,MKT
06079916214090000,2019,162400,277200,439600,MKT
06079916214100000,2021,223624,221076,444700,MKT
06079916214100000,2020,165922,224178,390100,MKT
06079916214100000,2019,165922,224178,390100,MKT
06079916220010000,2021,183199,249501,432700,MKT
06079916220010000,2020,131847,234453,366300,MKT
06079916220010000,2019,131847,234453,366300,MKT
06079916220020000,2021,194153,327147,521300,MKT
06079916220020000,2020,140977,308723,449700,MKT
06079916220020000,2019,140977,308723,449700,MKT
06079916220030000,2021,173915,368185,542100,MKT
06079916220030000,2020,124175,329125,453300,MKT
06079916220030000,2019,124175,329125,453300,MKT
06079916220040000,2021,173199,312601,485800,MKT
06079916220040000,2020,123586,232614,356200,MKT
06079916220040000,2019,123586,232614,356200,MKT
06079916220050000,2021,172478,218722,391200,MKT
06079916220050000,2020,122993,243507,366500,MKT
06079916220050000,2019,122993,243507,366500,MKT
06079916220060000,2021,181784,306516,488300,MKT
06079916220060000,2020,130674,291426,422100,MKT
06079916220060000,2019,130674,291426,422100,MKT
06079916220070000,2021,205493,397340,602833,COST
06079916220070000,2020,150512,379188,529700,MKT
06079916220070000,2019,150512,379188,529700,MKT
06079916220080000,2021,166757,349743,516500,MKT
06079916220080000,2020,118302,256050,374352,COST
06079916220080000,2019,118302,256050,374352,COST
06079916220090000,2021,166757,0,166757,COST
06079916220090000,2020,118302,0,118302,COST
06079916220090000,2019,118302,0,118302,COST
06079916220100000,2021,166757,284443,451200,MKT
06079916220100000,2020,118302,213630,331932,COST
06079916220100000,2019,118302,213630,331932,COST
06079916220110000,2021,167269,218731,386000,MKT
06079916220110000,2020,118720,237580,356300,MKT
06079916220110000,2019,118720,237580,356300,MKT
06079916220120000,2021,185865,324835,510700,MKT
06079916220120000,2020,134062,253390,387452,COST
06079916220120000,2019,134062,253390,387452,COST
06079916220130000,2021,174860,0,174860,COST
06079916220130000,2020,124953,0,124953,COST
06079916220130000,2019,124953,0,124953,COST
06079916220140000,2021,205580,369120,574700,MKT
06079916220140000,2020,150586,346914,497500,MKT
06079916220140000,2019,150586,319714,470300,MKT
06079916220150000,2021,178893,262607,441500,MKT
06079916220150000,2020,128281,227519,355800,MKT
06079916220150000,2019,128281,227519,355800,MKT
06079916220160000,2021,167524,274276,441800,MKT
06079916220160000,2020,118929,287271,406200,MKT
06079916220160000,2019,118929,287271,406200,MKT
06079916220170000,2021,167524,299576,467100,MKT
06079916220170000,2020,118929,253271,372200,MKT
06079916220170000,2019,118929,265971,384900,MKT
06079916220180000,2021,169163,288937,458100,MKT
06079916220180000,2020,120272,250528,370800,MKT
06079916220180000,2019,120272,250528,370800,MKT
06079916220190000,2021,176030,345370,521400,MKT
06079916220190000,2020,125917,322983,448900,MKT
06079916220190000,2019,125917,322983,448900,MKT
06079916220316500,2021,82814,0,82814,COST
06079916220316500,2020,63374,0,63374,COST
06079916220316500,2019,63374,0,63374,COST
06079916222010000,2021,190494,616606,807100,MKT
06079916222010000,2020,137919,549381,687300,MKT
06079916222010000,2019,137919,549381,687300,MKT
06079916222030000,2021,181014,293186,474200,MKT
06079916222030000,2020,130036,284864,414900,MKT
06079916222030000,2019,130036,284864,414900,MKT
06079916222050000,2021,181014,563386,744400,MKT
06079916222050000,2020,130036,569020,699056,OVR
06079916222050000,2019,130036,569020,699056,COST
06079916222070000,2021,181014,399386,580400,MKT
06079916222070000,2020,130036,354164,484200,MKT
06079916222070000,2019,130036,354164,484200,MKT
06079916222090000,2021,182112,365340,547452,COST
06079916222090000,2020,130946,348880,479826,COST
06079916222090000,2019,130946,348880,479826,COST
06079916222110000,2021,186389,508311,694700,MKT
06079916222110000,2020,134498,467702,602200,MKT
06079916222110000,2019,134498,467702,602200,MKT
06079916224010000,2021,219500,549000,768500,MKT
06079916224010000,2020,162400,471400,633800,MKT
06079916224010000,2019,162400,471400,633800,MKT
06079916224030000,2021,219500,581800,801300,MKT
06079916224030000,2020,162400,511000,673400,MKT
06079916224030000,2019,162400,511000,673400,MKT
06079916224050000,2021,219500,537860,757360,COST
06079916224050000,2020,162400,442800,605200,MKT
06079916224050000,2019,162400,442800,605200,MKT
06079916224066500,2021,73476,0,73476,COST
06079916224066500,2020,55209,0,55209,COST
06079916224066500,2019,55209,0,55209,COST
06079916224070000,2021,219500,444800,664300,MKT
06079916224070000,2020,162400,444500,606900,MKT
06079916224070000,2019,162400,444500,606900,MKT
06079916224090000,2021,188462,0,188462,COST
06079916224090000,2020,136224,0,136224,COST
06079916224090000,2019,136224,0,136224,COST
06079916224110000,2021,195409,546791,742200,MKT
06079916224110000,2020,142029,468971,611000,MKT
06079916224110000,2019,142029,468971,611000,MKT
06079916224116500,2021,122008,0,122008,COST
06079916224116500,2020,99066,0,99066,COST
06079916224116500,2019,99066,0,99066,COST
06079916224130000,2021,186389,465911,652300,MKT
06079916224130000,2020,134498,452802,587300,MKT
06079916224130000,2019,134498,452802,587300,MKT
06079916224190000,2021,200108,521192,721300,MKT
06079916224190000,2020,145974,496626,642600,MKT
06079916224190000,2019,145974,496626,642600,MKT
06079916224210000,2021,217936,468564,686500,MKT
06079916224210000,2020,161067,476333,637400,MKT
06079916224210000,2019,161067,476333,637400,MKT
06079916225090000,2021,214746,368654,583400,MKT
06079916225090000,2020,158352,364248,522600,MKT
06079916225090000,2019,158352,364248,522600,MKT
06079916225110000,2021,201023,409277,610300,MKT
06079916225110000,2020,146744,380356,527100,MKT
06079916225110000,2019,146744,380356,527100,MKT
06079916225130000,2021,187431,272269,459700,MKT
06079916225130000,2020,135365,288335,423700,MKT
06079916225130000,2019,135365,288335,423700,MKT
06079916225150000,2021,211078,352422,563500,MKT
06079916225150000,2020,152571,347429,500000,MKT
06079916225150000,2019,152571,347429,500000,MKT
06079916225170000,2021,208756,434144,642900,MKT
06079916225170000,2020,150638,386840,537478,COST
06079916225170000,2019,150638,386840,537478,COST
06079916225190000,2021,213354,615346,828700,MKT
06079916225190000,2020,154469,535931,690400,MKT
06079916225190000,2019,154469,535931,690400,MKT
06079916225210000,2021,209923,737477,947400,MKT
06079916225210000,2020,151609,806580,958189,COST
06079916225210000,2019,151609,806580,958189,COST
06079916226010000,2021,188462,0,188462,COST
06079916226010000,2020,136224,0,136224,COST
06079916226010000,2019,136224,0,136224,COST
06079916226030000,2021,274447,513790,788237,COST
06079916226030000,2020,210108,496030,706138,COST
06079916226030000,2019,210108,496030,706138,COST
06079916226050000,2021,171751,389749,561500,MKT
06079916226050000,2020,122396,371204,493600,MKT
06079916226050000,2019,122396,371204,493600,MKT
06079916226070000,2021,178780,383020,561800,MKT
06079916226070000,2020,128188,370212,498400,MKT
06079916226070000,2019,128188,370212,498400,MKT
06079916226090000,2021,176493,567207,743700,MKT
06079916226090000,2020,126300,517140,643440,COST
06079916226090000,2019,126300,517140,643440,COST
06079916226110000,2021,210632,570068,780700,MKT
06079916226110000,2020,154859,489041,643900,MKT
06079916226110000,2019,154859,489041,643900,MKT
06079916226216500,2021,72115,0,72115,COST
06079916226216500,2020,54032,0,54032,COST
06079916226216500,2019,54032,0,54032,COST
06079916227010000,2021,209791,437609,647400,MKT
06079916227010000,2020,154147,418553,572700,MKT
06079916227010000,2019,154147,418553,572700,MKT
06079916227030000,2021,192488,354312,546800,MKT
06079916227030000,2020,139584,330016,469600,MKT
06079916227030000,2019,139584,330016,469600,MKT
06079916227050000,2021,175330,338570,513900,MKT
06079916227050000,2020,125340,320660,446000,MKT
06079916227050000,2019,125340,320660,446000,MKT
06079916229010000,2021,178327,316073,494400,MKT
06079916229010000,2020,127813,298287,426100,MKT
06079916229010000,2019,127813,298287,426100,MKT
06079916229020000,2021,166757,308343,475100,MKT
06079916229020000,2020,118302,247698,366000,MKT
06079916229020000,2019,118302,247698,366000,MKT
06079916229030000,2021,166757,374643,541400,MKT
06079916229030000,2020,118302,317098,435400,MKT
06079916229030000,2019,118302,317098,435400,MKT
06079916229040000,2021,171630,261070,432700,MKT
06079916229040000,2020,122296,270304,392600,MKT
06079916229040000,2019,122296,270304,392600,MKT
06079916229050000,2021,164022,265878,429900,MKT
06079916229050000,2020,116068,282932,399000,MKT
06079916229050000,2019,116068,282932,399000,MKT
06079916229060000,2021,166885,249515,416400,MKT
06079916229060000,2020,118407,256593,375000,MKT
06079916229060000,2019,118407,256593,375000,MKT
06079916229070000,2021,166885,247615,414500,MKT
06079916229070000,2020,118407,276193,394600,MKT
06079916229070000,2019,118407,276193,394600,MKT
06079916229080000,2021,169288,267512,436800,MKT
06079916229080000,2020,120374,287026,407400,MKT
06079916229080000,2019,120374,287026,407400,MKT
06079916230010000,2021,191894,222306,414200,MKT
06079916230010000,2020,139088,240012,379100,MKT
06079916230010000,2019,139088,240012,379100,MKT
06079916230020000,2021,173915,272785,446700,MKT
06079916230020000,2020,124175,275925,400100,MKT
06079916230020000,2019,124175,275925,400100,MKT
06079916230030000,2021,170404,282596,453000,MKT
06079916230030000,2020,121290,265410,386700,MKT
06079916230030000,2019,121290,265410,386700,MKT
06079916230040000,2021,173438,362362,535800,MKT
06079916230040000,2020,123782,324918,448700,MKT
06079916230040000,2019,123782,324918,448700,MKT
06079916235010000,2021,229274,393126,622400,MKT
06079916235010000,2020,170765,353135,523900,MKT
06079916235010000,2019,170765,353135,523900,MKT
06079916235060000,2021,243132,198368,441500,MKT
06079916235060000,2020,182718,221582,404300,MKT
06079916235060000,2019,182718,221582,404300,MKT
06079916235080000,2021,247132,323668,570800,MKT
06079916235080000,2020,186189,313311,499500,MKT
06079916235080000,2019,186189,313311,499500,MKT
06079916240010000,2021,255210,446890,702100,MKT
06079916240010000,2020,193222,407278,600500,MKT
06079916240010000,2019,193222,407278,600500,MKT
06079916240040000,2021,266598,333202,599800,MKT
06079916240040000,2020,203195,304805,508000,MKT
06079916240040000,2019,203195,304805,508000,MKT
06079916240070000,2021,241641,396259,637900,MKT
06079916240070000,2020,181427,391273,572700,MKT
06079916240070000,2019,181427,391273,572700,MKT
06079916240080000,2021,233784,309516,543300,MKT
06079916240080000,2020,174643,301557,476200,MKT
06079916240080000,2019,174643,301557,476200,MKT
06079916240090000,2021,246191,317309,563500,MKT
06079916240090000,2020,185371,282929,468300,MKT
06079916240090000,2019,185371,282929,468300,MKT
06079916240120000,2021,230132,392268,622400,MKT
06079916240120000,2020,171502,380598,552100,OVR
06079916240120000,2019,171502,380598,552100,MKT
06079916240150000,2021,229202,126950,356152,COST
06079916240150000,2020,170703,126950,297653,COST
06079916240150000,2019,170703,126950,297653,COST
06079916240170000,2021,233090,328410,561500,MKT
06079916240170000,2020,174046,288154,462200,MKT
06079916240170000,2019,174046,288154,462200,MKT
06079916240200000,2021,235024,312576,547600,MKT
06079916240200000,2020,175712,283988,459700,MKT
06079916240200000,2019,175712,283988,459700,MKT
06079916240316500,2021,76568,0,76568,COST
06079916240316500,2020,57896,0,57896,COST
06079916240316500,2019,57896,0,57896,COST
06079916301010000,2021,305540,0,305540,COST
06079916301010000,2020,237781,0,237781,COST
06079916301010000,2019,237781,0,237781,COST
06079916301030000,2021,219655,328245,547900,MKT
06079916301030000,2020,224687,221013,445700,MKT
06079916301030000,2019,224687,212313,437000,MKT
06079916301050000,2021,259623,0,259623,COST
06079916301050000,2020,197079,0,197079,COST
06079916301050000,2019,197079,0,197079,COST
06079916301060000,2021,574626,96170,670796,COST
06079916301060000,2020,492525,152775,645300,INCOME
06079916301060000,2019,492525,152775,645300,INCOME
06079916301070000,2021,219578,609422,829000,MKT
06079916301070000,2020,150075,575425,725500,MKT
06079916301070000,2019,150075,575425,725500,MKT
06079916301080000,2021,387972,310710,698682,COST
06079916301080000,2020,313160,305120,618280,COST
06079916301080000,2019,313160,305120,618280,COST
06079916301090000,2021,403542,318040,721582,COST
06079916301090000,2020,327693,288007,615700,MKT
06079916301090000,2019,327693,288007,615700,MKT
06079916301100000,2021,266489,389040,655529,COST
06079916301100000,2020,203099,195910,399009,COST
06079916301100000,2019,203099,195910,399009,COST
06079916301120000,2021,246001,234999,481000,MKT
06079916301120000,2020,185207,225293,410500,MKT
06079916301120000,2019,185207,225293,410500,MKT
06079916301140000,2021,280523,180260,460783,COST
06079916301140000,2020,215480,176520,392000,COST
06079916301140000,2019,215480,175560,391040,COST
06079916301160000,2021,242356,354144,596500,MKT
06079916301160000,2020,182047,357053,539100,MKT
06079916301160000,2019,182047,357053,539100,MKT
06079916301200000,2021,207576,0,207576,COST
06079916301200000,2020,152272,0,152272,COST
06079916301200000,2019,152272,0,152272,COST
06079916302010000,2021,227831,596369,824200,MKT
06079916302010000,2020,169526,513074,682600,MKT
06079916302010000,2019,169526,513074,682600,MKT
06079916302040000,2021,219810,0,219810,COST
06079916302040000,2020,162665,0,162665,COST
06079916302040000,2019,162665,0,162665,COST
06079916302070000,2021,219810,369790,589600,MKT
06079916302070000,2020,162665,407235,569900,MKT
06079916302070000,2019,162665,407235,569900,MKT
06079916302100000,2021,237060,703740,940800,MKT
06079916302100000,2020,162400,643100,805500,MKT
06079916302100000,2019,162400,0,162400,COST
06079916302130000,2021,237060,220610,457670,COST
06079916302130000,2020,162400,0,162400,COST
06079916302130000,2019,162400,0,162400,COST
06079916302160000,2021,246292,350250,596542,COST
06079916302160000,2020,169713,0,169713,COST
06079916302160000,2019,169713,0,169713,COST
06079916302190000,2021,237060,0,237060,COST
06079916302190000,2020,162400,0,162400,COST
06079916302190000,2019,162400,0,162400,COST
06079916302220000,2021,237060,412810,649870,COST
06079916302220000,2020,162400,0,162400,COST
06079916302220000,2019,162400,0,162400,COST
06079916303010000,2021,254737,673560,928297,COST
06079916303010000,2020,184998,647980,832978,COST
06079916303010000,2019,184998,647980,832978,COST
06079916303030000,2021,197313,561487,758800,MKT
06079916303030000,2020,129093,549107,678200,MKT
06079916303030000,2019,129093,549107,678200,MKT
06079916303050000,2021,197313,672887,870200,MKT
06079916303050000,2020,129093,635807,764900,MKT
06079916303050000,2019,129093,635807,764900,MKT
06079916303070000,2021,197219,635081,832300,MKT
06079916303070000,2020,129006,595594,724600,MKT
06079916303070000,2019,129006,645950,774956,COST
06079916303090000,2021,406159,0,406159,COST
06079916303090000,2020,330144,0,330144,COST
06079916303090000,2019,330144,0,330144,COST
06079916305010000,2021,255092,547940,803032,COST
06079916305010000,2020,193119,521310,714429,COST
06079916305010000,2019,193119,521310,714429,COST
06079916305020000,2021,255033,288067,543100,MKT
06079916305020000,2020,193067,281333,474400,MKT
06079916305020000,2019,193067,281333,474400,MKT
06079916305030000,2021,254974,288126,543100,MKT
06079916305030000,2020,193016,289284,482300,MKT
06079916305030000,2019,193016,289284,482300,MKT
06079916305040000,2021,255269,275031,530300,MKT
06079916305040000,2020,193273,256327,449600,MKT
06079916305040000,2019,193273,256327,449600,MKT
06079916305050000,2021,255328,218772,474100,MKT
06079916305050000,2020,193325,220275,413600,MKT
06079916305050000,2019,193325,220275,413600,MKT
06079916305060000,2021,255387,302013,557400,MKT
06079916305060000,2020,193376,253524,446900,MKT
06079916305060000,2019,193376,253524,446900,MKT
06079916305150000,2021,362344,549280,911624,COST
06079916305150000,2020,289434,529290,818724,COST
06079916305150000,2019,289434,529290,818724,COST
06079916305160000,2021,179679,0,179679,COST
06079916305160000,2020,128932,0,128932,COST
06079916305160000,2019,128932,0,128932,COST
06079916305180000,2021,219810,527590,747400,MKT
06079916305180000,2020,162665,385690,548355,COST
06079916305180000,2019,162665,385690,548355,COST
06079916309010000,2021,251987,423513,675500,MKT
06079916309010000,2020,190412,399188,589600,MKT
06079916309010000,2019,190412,399188,589600,MKT
06079916309020000,2021,256560,369840,626400,MKT
06079916309020000,2020,194401,317899,512300,MKT
06079916309020000,2019,194401,317899,512300,MKT
06079916315020000,2021,387972,328570,716542,COST
06079916315020000,2020,313160,316690,629850,COST
06079916315020000,2019,313160,316690,629850,COST
06079916315040000,2021,330187,281413,611600,MKT
06079916315040000,2020,260027,220773,480800,MKT
06079916315040000,2019,260027,220773,480800,MKT
06079916315080000,2021,495832,283830,779662,COST
06079916315080000,2020,415514,282030,697544,COST
06079916315080000,2019,415514,282030,697544,COST
06079916315090000,2021,235776,551324,787100,MKT
06079916315090000,2020,176360,456340,632700,OVR
06079916315090000,2019,176360,456340,632700,MKT
06079916315100000,2021,387972,532100,920072,COST
06079916315100000,2020,313160,501740,814900,COST
06079916315100000,2019,313160,501740,814900,COST
06079916315110000,2021,387972,320450,708422,COST
06079916315110000,2020,313160,317200,630360,COST
06079916315110000,2019,313160,197670,510830,COST
06079916315120000,2021,415411,364389,779800,MKT
06079916315120000,2020,338829,363880,702709,COST
06079916315120000,2019,338829,363880,702709,COST
06079916315130000,2021,229131,310869,540000,MKT
06079916315130000,2020,170642,295558,466200,MKT
06079916315130000,2019,170642,295558,466200,MKT
06079916315140000,2021,237604,225896,463500,MKT
06079916315140000,2020,177937,269363,447300,MKT
06079916315140000,2019,177937,269363,447300,MKT
06079916315150000,2021,508508,74440,582948,COST
06079916315150000,2020,289348,70000,359348,COST
06079916315150000,2019,289348,70000,359348,COST
06079916315160000,2021,280523,1104160,1384683,COST
06079916315160000,2020,211912,1091560,1303472,COST
06079916315160000,2019,211912,1091560,1303472,COST
06079916318010000,2021,263069,270950,534019,COST
06079916318010000,2020,200098,242102,442200,MKT
06079916318010000,2019,200098,242102,442200,MKT
06079916318020000,2021,205843,173857,379700,MKT
06079916318020000,2020,150807,105580,256387,COST
06079916318020000,2019,150807,105580,256387,COST
06079916318030000,2021,205843,186857,392700,MKT
06079916318030000,2020,150807,186093,336900,MKT
06079916318030000,2019,150807,198093,348900,MKT
06079916318040000,2021,205843,201957,407800,MKT
06079916318040000,2020,150807,194193,345000,MKT
06079916318040000,2019,150807,194193,345000,MKT
06079916318050000,2021,205843,702957,908800,MKT
06079916318050000,2020,150807,650393,801200,MKT
06079916318050000,2019,150807,0,150807,COST
06079916320010000,2021,224968,230532,455500,MKT
06079916320010000,2020,167073,239427,406500,MKT
06079916320010000,2019,167073,239427,406500,MKT
06079916320020000,2021,230132,1001830,1231962,COST
06079916320020000,2020,171502,981690,1153192,COST
06079916320020000,2019,171502,1013780,1185282,COST
06079916320030000,2021,318062,662890,980952,COST
06079916320030000,2020,249050,656660,905710,COST
06079916320030000,2019,249050,656660,905710,COST
06079916320040000,2021,561442,428910,990352,COST
06079916320040000,2020,479520,411020,890540,COST
06079916320040000,2019,479520,411020,890540,COST
06079916324010000,2021,387972,271400,659372,COST
06079916324010000,2020,313160,293740,606900,MKT
06079916324010000,2019,313160,293740,606900,MKT
06079916327010000,2021,224447,536390,760837,COST
06079916327010000,2020,166627,522120,688747,COST
06079916327010000,2019,166627,522120,688747,COST
06079916327020000,2021,238942,131958,370900,MKT
06079916327020000,2020,179093,96720,275813,COST
06079916327020000,2019,179093,96720,275813,COST
06079916327030000,2021,263069,288331,551400,MKT
06079916327030000,2020,200098,258002,458100,MKT
06079916327030000,2019,200098,258002,458100,MKT
06079916327050000,2021,219500,335500,555000,MKT
06079916327050000,2020,162400,353900,516300,MKT
06079916327050000,2019,162400,353900,516300,MKT
06079916330010000,2021,220813,0,220813,COST
06079916330010000,2020,163521,0,163521,COST
06079916330010000,2019,163521,0,163521,COST
06079916330020000,2021,219500,240500,460000,MKT
06079916330020000,2020,162400,223700,386100,MKT
06079916330020000,2019,162400,223700,386100,MKT
06079916330030000,2021,313746,297654,611400,MKT
06079916330030000,2020,193222,296878,490100,MKT
06079916330030000,2019,193222,296878,490100,MKT
06079916330040000,2021,252289,408911,661200,MKT
06079916330040000,2020,190674,392426,583100,MKT
06079916330040000,2019,190674,392426,583100,MKT
06079916330050000,2021,225708,160692,386400,INCOME
06079916330050000,2020,167707,200793,368500,INCOME
06079916330050000,2019,167707,200793,368500,INCOME
06079916330060000,2021,219500,230300,449800,MKT
06079916330060000,2020,162400,234800,397200,MKT
06079916330060000,2019,162400,234800,397200,MKT
06079916330070000,2021,252228,171672,423900,INCOME
06079916330070000,2020,190622,163278,353900,INCOME
06079916330070000,2019,190622,163278,353900,INCOME
06079916335010000,2021,225856,589720,815576,COST
06079916335010000,2020,167833,588970,756803,COST
06079916335010000,2019,167833,588970,756803,COST
06079916335020000,2021,240265,376730,616995,COST
06079916335020000,2020,180237,359963,540200,MKT
06079916335020000,2019,180237,359963,540200,MKT
06079916335030000,2021,261836,220864,482700,MKT
06079916335030000,2020,199017,198683,397700,MKT
06079916335030000,2019,199017,198683,397700,MKT
06079916335040000,2021,227249,263451,490700,MKT
06079916335040000,2020,169027,300073,469100,MKT
06079916335040000,2019,169027,300073,469100,MKT
06079916335050000,2021,226664,327436,554100,MKT
06079916335050000,2020,168526,328974,497500,MKT
06079916335050000,2019,168526,320674,489200,MKT
06079916335060000,2021,219578,194422,414000,MKT
06079916335060000,2020,162466,202734,365200,MKT
06079916335060000,2019,162466,202734,365200,MKT
06079916335070000,2021,219578,375122,594700,MKT
06079916335070000,2020,162466,362834,525300,MKT
06079916335070000,2019,162466,362834,525300,MKT
06079916335080000,2021,219733,222567,442300,MKT
06079916335080000,2020,162599,233801,396400,MKT
06079916335080000,2019,162599,233801,396400,MKT
06079916335090000,2021,223323,254877,478200,MKT
06079916335090000,2020,165665,237835,403500,MKT
06079916335090000,2019,165665,237835,403500,MKT
06079916337010000,2021,226371,209310,435681,COST
06079916337010000,2020,168275,0,168275,COST
06079916337010000,2019,168275,0,168275,COST
06079916337020000,2021,221120,204580,425700,MKT
06079916337020000,2020,163783,217917,381700,MKT
06079916337020000,2019,163783,217917,381700,MKT
06079916337030000,2021,223624,217176,440800,MKT
06079916337030000,2020,165922,225778,391700,MKT
06079916337030000,2019,165922,225778,391700,MKT
06079916337040000,2021,223624,172276,395900,MKT
06079916337040000,2020,165922,177378,343300,MKT
06079916337040000,2019,165922,177378,343300,MKT
06079916401010000,2021,226884,0,226884,COST
06079916401010000,2020,157156,0,157156,COST
06079916401010000,2019,157156,0,157156,COST
06079916401016500,2021,95349,0,95349,COST
06079916401016500,2020,75717,0,75717,COST
06079916401016500,2019,75717,0,75717,COST
06079916401040000,2021,166757,0,166757,COST
06079916401040000,2020,101854,0,101854,COST
06079916401040000,2019,101854,0,101854,COST
06079916401100000,2021,184380,595620,780000,MKT
06079916401100000,2020,150000,582400,732400,MKT
06079916401100000,2019,150000,582400,732400,MKT
06079916401150000,2021,184380,178670,363050,COST
06079916401150000,2020,150000,0,150000,COST
06079916401150000,2019,150000,0,150000,COST
06079916401200000,2021,184380,530020,714400,MKT
06079916401200000,2020,150000,511800,661800,MKT
06079916401200000,2019,150000,511800,661800,MKT
06079916401300000,2021,184380,608720,793100,MKT
06079916401300000,2020,150000,599800,749800,MKT
06079916401300000,2019,150000,0,150000,COST
06079916401320000,2021,184380,512420,696800,MKT
06079916401320000,2020,150000,534900,684900,MKT
06079916401320000,2019,150000,534900,684900,MKT
06079916401340000,2021,198965,945680,1144645,COST
06079916401340000,2020,166979,901960,1068939,COST
06079916401340000,2019,166979,0,166979,COST
06079916401360000,2021,192530,635070,827600,MKT
06079916401360000,2020,159423,606477,765900,MKT
06079916401360000,2019,159423,0,159423,COST
06079916401380000,2021,219500,591800,811300,MKT
06079916401380000,2020,171000,529900,700900,MKT
06079916401380000,2019,171000,529900,700900,MKT
06079916401400000,2021,220274,485226,705500,MKT
06079916401400000,2020,171850,472750,644600,MKT
06079916401400000,2019,171850,472750,644600,MKT
06079916401420000,2021,220274,606026,826300,MKT
06079916401420000,2020,171850,647450,819300,MKT
06079916401420000,2019,171850,647450,819300,MKT
06079916401440000,2021,219500,710500,930000,MKT
06079916401440000,2020,171000,680000,851000,MKT
06079916401440000,2019,171000,680000,851000,MKT
06079916401460000,2021,219500,574400,793900,MKT
06079916401460000,2020,171000,553300,724300,MKT
06079916401460000,2019,171000,553300,724300,MKT
06079916401480000,2021,219500,857190,1076690,COST
06079916401480000,2020,171000,780900,951900,MKT
06079916401480000,2019,171000,780900,951900,MKT
06079916401500000,2021,219500,604500,824000,MKT
06079916401500000,2020,171000,597040,768040,COST
06079916401500000,2019,171000,597040,768040,COST
06079916401520000,2021,219500,655800,875300,MKT
06079916401520000,2020,171000,675700,846700,MKT
06079916401520000,2019,171000,675700,846700,MKT
06079916401540000,2021,219500,638800,858300,MKT
06079916401540000,2020,171000,671000,842000,MKT
06079916401540000,2019,171000,671000,842000,MKT
06079916401560000,2021,219500,594000,813500,MKT
06079916401560000,2020,150000,504200,654200,MKT
06079916401560000,2019,150000,504200,654200,MKT
06079916401580000,2021,219500,380600,600100,MKT
06079916401580000,2020,150000,378800,528800,MKT
06079916401580000,2019,150000,378800,528800,MKT
06079916401600000,2021,219500,394500,614000,MKT
06079916401600000,2020,150000,360400,510400,MKT
06079916401600000,2019,150000,360400,510400,MKT
06079916401620000,2021,219500,600200,819700,MKT
06079916401620000,2020,150000,578500,728500,MKT
06079916401620000,2019,150000,578500,728500,MKT
06079916401640000,2021,179903,802097,982000,MKT
06079916401640000,2020,113343,217150,330493,COST
06079916401640000,2019,113343,0,113343,COST
06079916401660000,2021,219500,470700,690200,MKT
06079916401660000,2020,150000,456400,606400,MKT
06079916401660000,2019,150000,456400,606400,MKT
06079916401680000,2021,184380,0,184380,COST
06079916401680000,2020,150000,0,150000,COST
06079916401680000,2019,150000,0,150000,COST
06079916401700000,2021,187591,0,187591,COST
06079916401700000,2020,153693,0,153693,COST
06079916401700000,2019,153693,0,153693,COST
06079916401720000,2021,229202,613898,843100,MKT
06079916401720000,2020,181742,576258,758000,MKT
06079916401720000,2019,181742,576258,758000,MKT
06079916401740000,2021,219500,588700,808200,MKT
06079916401740000,2020,171000,546600,717600,MKT
06079916401740000,2019,171000,546600,717600,MKT
06079916401760000,2021,233437,536263,769700,MKT
06079916401760000,2020,186490,553430,739920,COST
06079916401760000,2019,186490,450660,637150,COST
06079916401780000,2021,191317,722283,913600,MKT
06079916401780000,2020,158010,694590,852600,MKT
06079916401780000,2019,158010,694590,852600,MKT
06079916401800000,2021,185030,551470,736500,MKT
06079916401800000,2020,150746,548554,699300,MKT
06079916401800000,2019,150746,548554,699300,MKT
06079916401820000,2021,212377,0,212377,COST
06079916401820000,2020,163236,0,163236,COST
06079916401820000,2019,163236,0,163236,COST
06079916401840000,2021,220043,190700,410743,COST
06079916401840000,2020,171596,0,171596,COST
06079916401840000,2019,171596,0,171596,COST
06079916401860000,2021,220043,0,220043,COST
06079916401860000,2020,171596,0,171596,COST
06079916401860000,2019,171596,0,171596,COST
06079916401880000,2021,220043,0,220043,COST
06079916401880000,2020,171596,0,171596,COST
06079916401880000,2019,171596,0,171596,COST
06079916401900000,2021,220043,0,220043,COST
06079916401900000,2020,171596,0,171596,COST
06079916401900000,2019,171596,0,171596,COST
06079916401920000,2021,211466,639300,850766,COST
06079916401920000,2020,162250,283280,445530,COST
06079916401920000,2019,162250,0,162250,COST
06079916401940000,2021,223849,209150,432999,COST
06079916401940000,2020,175791,0,175791,COST
06079916401940000,2019,175791,0,175791,COST
06079916402010000,2021,220043,0,220043,COST
06079916402010000,2020,150523,0,150523,COST
06079916402010000,2019,150523,0,150523,COST
06079916402040000,2021,220043,406890,626933,COST
06079916402040000,2020,150523,0,150523,COST
06079916402040000,2019,150523,0,150523,COST
06079916402070000,2021,220043,0,220043,COST
06079916402070000,2020,171596,0,171596,COST
06079916402070000,2019,171596,0,171596,COST
06079916402100000,2021,220043,0,220043,COST
06079916402100000,2020,171596,0,171596,COST
06079916402100000,2019,171596,0,171596,COST
06079916402130000,2021,220043,0,220043,COST
06079916402130000,2020,171596,0,171596,COST
06079916402130000,2019,171596,0,171596,COST
06079916402166500,2021,91540,0,91540,COST
06079916402166500,2020,71491,0,71491,COST
06079916402166500,2019,71491,0,71491,COST
06079916403010000,2021,308528,506472,815000,MKT
06079916403010000,2020,276230,493120,769350,COST
06079916403010000,2019,276230,0,276230,COST
06079916403040000,2021,300845,631270,932115,COST
06079916403040000,2020,266590,215190,481780,COST
06079916403040000,2019,266590,0,266590,COST
06079916403070000,2021,207232,0,207232,COST
06079916403070000,2020,157693,0,157693,COST
06079916403070000,2019,157693,0,157693,COST
06079916403100000,2021,212377,598823,811200,MKT
06079916403100000,2020,163236,529310,692546,COST
06079916403100000,2019,163236,392920,556156,COST
06079916403136500,2021,132413,0,132413,COST
06079916403136500,2020,120249,0,120249,COST
06079916403136500,2019,120249,0,120249,COST
06079916430010000,2021,349422,277400,626822,COST
06079916430010000,2020,277567,268640,546207,COST
06079916430010000,2019,277567,268640,546207,COST
06079916430016500,2021,59801,0,59801,COST
06079916430016500,2020,43541,0,43541,COST
06079916430016500,2019,43541,0,43541,COST
06079916430070000,2021,224819,446981,671800,MKT
06079916430070000,2020,166945,440655,607600,MKT
06079916430070000,2019,166945,440655,607600,MKT
06079916430090000,2021,221044,336756,557800,MKT
06079916430090000,2020,163717,374783,538500,MKT
06079916430090000,2019,163717,374783,538500,MKT
06079916430110000,2021,222568,0,222568,COST
06079916430110000,2020,165020,0,165020,COST
06079916430110000,2019,165020,0,165020,COST
06079916430130000,2021,221808,301092,522900,MKT
06079916430130000,2020,164370,300930,465300,MKT
06079916430130000,2019,164370,300930,465300,MKT
06079916430150000,2021,225561,566910,792471,COST
06079916430150000,2020,167580,540280,707860,COST
06079916430150000,2019,167580,540280,707860,COST
06079916430170000,2021,236863,358237,595100,MKT
06079916430170000,2020,177297,373203,550500,MKT
06079916430170000,2019,177297,373203,550500,MKT
06079916430190000,2021,240200,448100,688300,MKT
06079916430190000,2020,180180,471820,652000,MKT
06079916430190000,2019,180180,471820,652000,MKT
06079916430210000,2021,248502,313798,562300,MKT
06079916430210000,2020,187378,307922,495300,MKT
06079916430210000,2019,187378,307922,495300,MKT
06079916432010000,2021,230630,320870,551500,MKT
06079916432010000,2020,171930,318000,489930,COST
06079916432010000,2019,171930,318000,489930,COST
06079916432030000,2021,262997,624703,887700,MKT
06079916432030000,2020,196599,624810,821409,COST
06079916432030000,2019,196599,613530,810129,COST
06079916432050000,2021,265286,424314,689600,MKT
06079916432050000,2020,198573,473727,672300,MKT
06079916432050000,2019,198573,473727,672300,MKT
06079916432070000,2021,271221,278979,550200,MKT
06079916432070000,2020,203703,241197,444900,MKT
06079916432070000,2019,203703,241197,444900,MKT
06079916432090000,2021,263764,306236,570000,MKT
06079916432090000,2020,197260,304440,501700,MKT
06079916432090000,2019,197260,304440,501700,MKT
06079916432116500,2021,130140,0,130140,COST
06079916432116500,2020,106717,0,106717,COST
06079916432116500,2019,106717,0,106717,COST
06079916432180000,2021,249276,323024,572300,MKT
06079916432180000,2020,174376,324524,498900,MKT
06079916432180000,2019,174376,324524,498900,MKT
06079916432200000,2021,270492,572708,843200,MKT
06079916432200000,2020,195639,530661,726300,MKT
06079916432200000,2019,195639,527761,723400,MKT
06079916432220000,2021,255900,637560,893460,COST
06079916432220000,2020,180939,623320,804259,COST
06079916432220000,2019,180939,623320,804259,COST
06079916432240000,2021,269760,563040,832800,MKT
06079916432240000,2020,194893,556707,751600,MKT
06079916432240000,2019,194893,556707,751600,MKT
06079916432260000,2021,227030,571670,798700,MKT
06079916432260000,2020,157299,582801,740100,MKT
06079916432260000,2019,157299,582801,740100,MKT
06079916432280000,2021,231338,331662,563000,MKT
06079916432280000,2020,161519,324081,485600,MKT
06079916432280000,2019,161519,324081,485600,MKT
06079916432300000,2021,234818,610082,844900,MKT
06079916432300000,2020,164953,597347,762300,MKT
06079916432300000,2019,164953,597347,762300,MKT
06079916432320000,2021,221044,631256,852300,MKT
06079916432320000,2020,151488,597212,748700,MKT
06079916432320000,2019,151488,582512,734000,MKT
06079916432340000,2021,246707,601993,848700,MKT
06079916432340000,2020,171850,568650,740500,MKT
06079916432340000,2019,171850,568650,740500,MKT
06079916432360000,2021,245840,0,245840,COST
06079916432360000,2020,171000,0,171000,COST
06079916432360000,2019,171000,0,171000,COST
06079916432380000,2021,262997,565140,828137,COST
06079916432380000,2020,196599,527601,724200,MKT
06079916432380000,2019,196599,527601,724200,MKT
06079916432400000,2021,233437,538463,771900,MKT
06079916432400000,2020,163588,510712,674300,MKT
06079916432400000,2019,163588,510712,674300,MKT
06079916432420000,2021,223323,694377,917700,MKT
06079916432420000,2020,153693,694207,847900,MKT
06079916432420000,2019,153693,694207,847900,MKT
06079916432440000,2021,219578,630522,850100,MKT
06079916432440000,2020,150075,655125,805200,MKT
06079916432440000,2019,150075,655125,805200,MKT
06079916432460000,2021,221808,364392,586200,MKT
06079916432460000,2020,152227,361273,513500,MKT
06079916432460000,2019,152227,361273,513500,MKT
06079916432480000,2021,229202,436098,665300,MKT
06079916432480000,2020,159423,414577,574000,MKT
06079916432480000,2019,159423,414577,574000,MKT
06079916432500000,2021,246631,1131669,1378300,MKT
06079916432500000,2020,176760,935157,1111917,MRA
06079916432500000,2019,176760,935157,1111917,MRA
06079916432520000,2021,240200,324400,564600,MKT
06079916432520000,2020,170302,316698,487000,MKT
06079916432520000,2019,170302,316698,487000,MKT
06079916432560000,2021,274963,661737,936700,MKT
06079916432560000,2020,206019,586481,792500,MKT
06079916432560000,2019,206019,586481,792500,MKT
06079916432580000,2021,303281,493719,797000,OVR
06079916432580000,2020,229852,567148,797000,OVR
06079916432580000,2019,229852,658890,888742,COST
06079916434010000,2021,238208,332892,571100,MKT
06079916434010000,2020,178458,302842,481300,MKT
06079916434010000,2019,178458,302842,481300,MKT
06079916434030000,2021,234818,0,234818,COST
06079916434030000,2020,175534,0,175534,COST
06079916434030000,2019,175534,0,175534,COST
06079916434050000,2021,256326,645574,901900,MKT
06079916434050000,2020,194196,635640,829836,COST
06079916434050000,2019,194196,635640,829836,COST
06079916434070000,2021,255740,293860,549600,MKT
06079916434070000,2020,193684,286016,479700,MKT
06079916434070000,2019,193684,280416,474100,MKT
06079916434090000,2021,255740,374560,630300,MKT
06079916434090000,2020,193684,351516,545200,MKT
06079916434090000,2019,193684,351516,545200,MKT
06079916434110000,2021,236185,275715,511900,MKT
06079916434110000,2020,176713,265687,442400,MKT
06079916434110000,2019,176713,265687,442400,MKT
06079916434130000,2021,241511,624189,865700,MKT
06079916434130000,2020,181315,564398,745713,OVR
06079916434130000,2019,181315,564398,745713,MRA
06079916434150000,2021,233437,311363,544800,MKT
06079916434150000,2020,174345,319755,494100,OVR
06079916434150000,2019,174345,319755,494100,MKT
06079916434170000,2021,229918,329782,559700,MKT
06079916434170000,2020,171318,357482,528800,MKT
06079916434170000,2019,171318,357482,528800,MKT
06079916434190000,2021,235503,334497,570000,MKT
06079916434190000,2020,176125,332875,509000,MKT
06079916434190000,2019,176125,332875,509000,MKT
06079916434210000,2021,232041,432759,664800,MKT
06079916434210000,2020,173143,414557,587700,MKT
06079916434210000,2019,173143,414557,587700,MKT
06079916434230000,2021,249120,318780,567900,MKT
06079916434230000,2020,187916,358884,546800,MKT
06079916434230000,2019,187916,358884,546800,MKT
06079916434250000,2021,240265,403035,643300,MKT
06079916434250000,2020,180237,359963,540200,MKT
06079916434250000,2019,180237,359963,540200,MKT
06079916434270000,2021,238275,313925,552200,MKT
06079916434270000,2020,178516,289484,468000,MKT
06079916434270000,2019,178516,289484,468000,MKT
06079916434290000,2021,240200,413000,653200,MKT
06079916434290000,2020,180180,348920,529100,MKT
06079916434290000,2019,180180,348920,529100,MKT
06079917101010000,2021,197848,198570,396418,COST
06079917101010000,2020,207166,191330,398496,COST
06079917101010000,2019,207192,191330,398522,COST
06079917101040000,2021,226298,233602,459900,MKT
06079917101040000,2020,168212,234988,403200,MKT
06079917101040000,2019,168212,234988,403200,MKT
06079917101050000,2021,286702,435040,721742,COST
06079917101050000,2020,220961,418690,639651,COST
06079917101050000,2019,220961,418690,639651,COST
06079917101090000,2021,280523,425177,705700,MKT
06079917101090000,2020,215480,351220,566700,MKT
06079917101090000,2019,215480,351220,566700,MKT
06079917102010000,2021,219500,235600,455100,MKT
06079917102010000,2020,162400,228900,391300,MKT
06079917102010000,2019,162400,228900,391300,MKT
06079917103010000,2021,221579,210421,432000,MKT
06079917103010000,2020,164175,213625,377800,MKT
06079917103010000,2019,164175,223125,387300,MKT
06079917103020000,2021,241250,299550,540800,MKT
06079917103020000,2020,181088,278612,459700,MKT
06079917103020000,2019,181088,278612,459700,MKT
06079917103030000,2021,245433,292567,538000,MKT
06079917103030000,2020,184713,232880,417593,COST
06079917103030000,2019,184713,108880,293593,COST
06079917103040000,2021,220120,312580,532700,MKT
06079917103040000,2020,162929,288171,451100,MKT
06079917103040000,2019,162929,288171,451100,MKT
06079917103060000,2021,234337,343763,578100,MKT
06079917103060000,2020,175119,295481,470600,MKT
06079917103060000,2019,175119,295481,470600,MKT
06079917104010000,2021,1368327,2456750,3825077,COST
06079917104010000,2020,472901,2380870,2853771,COST
06079917104010000,2019,472901,2380870,2853771,COST
06079917104057000,2021,551042,0,551042,COST
06079917104057000,2020,393108,0,393108,COST
06079917104057000,2019,393108,0,393108,COST
06079917104100000,2021,339751,928349,1268100,INCOME
06079917104100000,2020,176062,984038,1160100,INCOME
06079917104100000,2019,176062,984038,1160100,INCOME
06079917201010000,2021,4091133,139955890,144047023,COST
06079917201010000,2020,1926050,126758420,128684470,COST
06079917201010000,2019,1925776,110173250,112099026,COST
06079917301010000,2021,126418,311582,438000,MKT
06079917301010000,2020,92083,316117,408200,MKT
06079917301010000,2019,92083,275117,367200,MKT
06079917301020000,2021,126418,0,126418,COST
06079917301020000,2020,92083,0,92083,COST
06079917301020000,2019,92083,0,92083,COST
06079917301030000,2021,126418,295982,422400,MKT
06079917301030000,2020,92083,262917,355000,MKT
06079917301030000,2019,92083,261317,353400,MKT
06079917301040000,2021,126418,300882,427300,MKT
06079917301040000,2020,92083,240117,332200,OVR
06079917301040000,2019,92083,240117,332200,MKT
06079917301050000,2021,126418,362282,488700,MKT
06079917301050000,2020,92083,301017,393100,MKT
06079917301050000,2019,92083,301017,393100,MKT
06079917301060000,2021,126418,287782,414200,MKT
06079917301060000,2020,92083,269517,361600,OVR
06079917301060000,2019,92083,269517,361600,MKT
06079917301070000,2021,126418,324782,451200,MKT
06079917301070000,2020,92083,300317,392400,MKT
06079917301070000,2019,92083,300317,392400,MKT
06079917301080000,2021,126418,302682,429100,MKT
06079917301080000,2020,92083,268917,361000,OVR
06079917301080000,2019,92083,268917,361000,MKT
06079917301090000,2021,126418,309382,435800,MKT
06079917301090000,2020,92083,283017,375100,MKT
06079917301090000,2019,92083,257417,349500,MKT
06079917301100000,2021,126418,344382,470800,MKT
06079917301100000,2020,92083,319717,411800,OVR
06079917301100000,2019,92083,319717,411800,MKT
06079917302010000,2021,126418,347682,474100,MKT
06079917302010000,2020,92083,329817,421900,OVR
06079917302010000,2019,92083,329817,421900,MKT
06079917302020000,2021,126418,245982,372400,MKT
06079917302020000,2020,92083,229117,321200,OVR
06079917302020000,2019,92083,229117,321200,MKT
06079917302030000,2021,126418,309382,435800,MKT
06079917302030000,2020,92083,256317,348400,MKT
06079917302030000,2019,92083,256317,348400,MKT
06079917302040000,2021,126418,257082,383500,MKT
06079917302040000,2020,92083,251017,343100,MKT
06079917302040000,2019,92083,251017,343100,MKT
06079917302050000,2021,126418,329182,455600,MKT
06079917302050000,2020,92083,309417,401500,OVR
06079917302050000,2019,92083,309417,401500,MKT
06079917302060000,2021,126418,248682,375100,MKT
06079917302060000,2020,92083,234317,326400,MKT
06079917302060000,2019,92083,231017,323100,MKT
06079917302070000,2021,126418,269482,395900,MKT
06079917302070000,2020,92083,239517,331600,OVR
06079917302070000,2019,92083,239517,331600,MKT
06079917302080000,2021,126418,282782,409200,MKT
06079917302080000,2020,92083,235917,328000,MKT
06079917302080000,2019,92083,235917,328000,MKT
06079917302090000,2021,126418,247182,373600,MKT
06079917302090000,2020,92083,231617,323700,MKT
06079917302090000,2019,92083,231617,323700,MKT
06079917302100000,2021,126418,258682,385100,MKT
06079917302100000,2020,92083,235717,327800,MKT
06079917302100000,2019,92083,235717,327800,MKT
06079917302110000,2021,144487,322813,467300,MKT
06079917302110000,2020,108861,330439,439300,MKT
06079917302110000,2019,108861,330439,439300,MKT
06079917302130000,2021,202629,355771,558400,MKT
06079917302130000,2020,151938,296662,448600,MKT
06079917302130000,2019,151938,296662,448600,MKT
06079917302140000,2021,144487,384513,529000,MKT
06079917302140000,2020,108861,253670,362531,COST
06079917302140000,2019,108861,308439,417300,MKT
06079917302150000,2021,144487,430513,575000,MKT
06079917302150000,2020,108861,350739,459600,MKT
06079917302150000,2019,108861,350739,459600,MKT
06079917302160000,2021,144487,345913,490400,MKT
06079917302160000,2020,108861,306339,415200,MKT
06079917302160000,2019,108861,306339,415200,MKT
06079917303016500,2021,2425,0,2425,COST
06079917303016500,2020,2257,0,2257,COST
06079917303016500,2019,2257,0,2257,COST
06079917310010000,2021,115659,245141,360800,MKT
06079917310010000,2020,84352,240348,324700,OVR
06079917310010000,2019,84352,240348,324700,MKT
06079917310020000,2021,115659,258841,374500,MKT
06079917310020000,2020,84352,253748,338100,MKT
06079917310020000,2019,84352,241348,325700,MKT
06079917310030000,2021,115659,260841,376500,MKT
06079917310030000,2020,84352,257348,341700,OVR
06079917310030000,2019,84352,257348,341700,MKT
06079917310040000,2021,115659,332541,448200,MKT
06079917310040000,2020,84352,316848,401200,OVR
06079917310040000,2019,84352,316848,401200,MKT
06079917310050000,2021,115659,355641,471300,MKT
06079917310050000,2020,84352,316348,400700,MKT
06079917310050000,2019,84352,248448,332800,MKT
06079917310060000,2021,115659,311041,426700,MKT
06079917310060000,2020,84352,219462,303814,OVR
06079917310060000,2019,84352,276348,360700,MKT
06079917310070000,2021,115659,213441,329100,MKT
06079917310070000,2020,84352,199548,283900,MKT
06079917310070000,2019,84352,199548,283900,MKT
06079917310080000,2021,115659,310641,426300,MKT
06079917310080000,2020,84352,276448,360800,MKT
06079917310080000,2019,84352,276448,360800,MKT
06079917310090000,2021,115659,265341,381000,MKT
06079917310090000,2020,84352,240448,324800,OVR
06079917310090000,2019,84352,240448,324800,MKT
06079917310100000,2021,121121,316979,438100,MKT
06079917310100000,2020,88278,284122,372400,MKT
06079917310100000,2019,88278,284622,372900,MKT
06079917310110000,2021,130436,338164,468600,MKT
06079917310110000,2020,94967,297833,392800,MKT
06079917310110000,2019,94967,290533,385500,MKT
06079917310120000,2021,130436,281664,412100,MKT
06079917310120000,2020,94967,261233,356200,MKT
06079917310120000,2019,94967,261233,356200,MKT
06079917310130000,2021,130436,300564,431000,MKT
06079917310130000,2020,94967,274833,369800,MKT
06079917310130000,2019,94967,274833,369800,MKT
06079917310140000,2021,114281,283119,397400,MKT
06079917310140000,2020,83361,283939,367300,MKT
06079917310140000,2019,83361,283939,367300,MKT
06079917310160000,2021,115659,390341,506000,MKT
06079917310160000,2020,84352,320448,404800,MKT
06079917310160000,2019,84352,315148,399500,MKT
06079917310170000,2021,115659,354041,469700,MKT
06079917310170000,2020,84352,337148,421500,OVR
06079917310170000,2019,84352,337148,421500,MKT
06079917310180000,2021,115659,361441,477100,MKT
06079917310180000,2020,84352,283848,368200,OVR
06079917310180000,2019,84352,283848,368200,MKT
06079917310190000,2021,115659,324641,440300,MKT
06079917310190000,2020,84352,253648,338000,OVR
06079917310190000,2019,84352,253648,338000,MKT
06079917310200000,2021,115659,326441,442100,MKT
06079917310200000,2020,84352,313648,398000,MKT
06079917310200000,2019,84352,313648,398000,MKT
06079917310210000,2021,115659,364041,479700,MKT
06079917310210000,2020,84352,320248,404600,MKT
06079917310210000,2019,84352,312248,396600,MKT
06079917310230000,2021,119794,390806,510600,MKT
06079917310230000,2020,87325,344975,432300,MKT
06079917310230000,2019,87325,344975,432300,MKT
06079917310240000,2021,122447,336253,458700,MKT
06079917310240000,2020,89230,275670,364900,OVR
06079917310240000,2019,89230,275670,364900,MKT
06079917310250000,2021,127578,393122,520700,MKT
06079917310250000,2020,92916,329584,422500,MKT
06079917310250000,2019,92916,329584,422500,MKT
06079917310260000,2021,120452,391148,511600,MKT
06079917310260000,2020,87797,321603,409400,MKT
06079917310260000,2019,87797,321603,409400,MKT
06079917310270000,2021,120452,347848,468300,MKT
06079917310270000,2020,87797,315803,403600,OVR
06079917310270000,2019,87797,315803,403600,MKT
06079917310280000,2021,120452,457948,578400,MKT
06079917310280000,2020,87797,366103,453900,MKT
06079917310280000,2019,87797,366103,453900,MKT
06079917311010000,2021,115659,237341,353000,MKT
06079917311010000,2020,84352,233148,317500,OVR
06079917311010000,2019,84352,233148,317500,MKT
06079917311020000,2021,115659,240241,355900,MKT
06079917311020000,2020,84352,228648,313000,MKT
06079917311020000,2019,84352,228648,313000,MKT
06079917311030000,2021,115659,351341,467000,MKT
06079917311030000,2020,84352,268548,352900,MKT
06079917311030000,2019,84352,268548,352900,MKT
06079917311040000,2021,115659,238641,354300,MKT
06079917311040000,2020,84352,240848,325200,OVR
06079917311040000,2019,84352,240848,325200,MKT
06079917311050000,2021,115659,318341,434000,MKT
06079917311050000,2020,84352,259948,344300,OVR
06079917311050000,2019,84352,259948,344300,MKT
06079917311060000,2021,115659,246041,361700,MKT
06079917311060000,2020,84352,231548,315900,MKT
06079917311060000,2019,84352,231548,315900,MKT
06079917311070000,2021,115659,272941,388600,MKT
06079917311070000,2020,84352,251148,335500,OVR
06079917311070000,2019,84352,251148,335500,MKT
06079917311080000,2021,115659,292041,407700,MKT
06079917311080000,2020,84352,243948,328300,OVR
06079917311080000,2019,84352,243948,328300,MKT
06079917311090000,2021,112862,248838,361700,MKT
06079917311090000,2020,82340,238660,321000,OVR
06079917311090000,2019,82340,238660,321000,MKT
06079917311100000,2021,112862,251338,364200,MKT
06079917311100000,2020,82340,234560,316900,MKT
06079917311100000,2019,82340,234560,316900,MKT
06079917311110000,2021,112862,397838,510700,MKT
06079917311110000,2020,82340,391660,474000,MKT
06079917311110000,2019,82340,391660,474000,MKT
06079917311120000,2021,112862,398838,511700,MKT
06079917311120000,2020,82340,308560,390900,MKT
06079917311120000,2019,82340,308560,390900,MKT
06079917311130000,2021,138466,305234,443700,MKT
06079917311130000,2020,100729,290871,391600,MKT
06079917311130000,2019,100729,290871,391600,MKT
06079917311150000,2021,137554,347046,484600,MKT
06079917311150000,2020,100074,326926,427000,OVR
06079917311150000,2019,100074,326926,427000,MKT
06079917312010000,2021,149052,370348,519400,MKT
06079917312010000,2020,112251,343149,455400,MKT
06079917312010000,2019,112251,336949,449200,MKT
06079917312020000,2021,149174,295826,445000,MKT
06079917312020000,2020,112341,310459,422800,MKT
06079917312020000,2019,112341,310459,422800,MKT
06079917312030000,2021,149174,367626,516800,MKT
06079917312030000,2020,112341,346459,458800,MKT
06079917312030000,2019,112341,346459,458800,MKT
06079917312040000,2021,149174,439426,588600,MKT
06079917312040000,2020,112341,412259,524600,MKT
06079917312040000,2019,112341,412259,524600,MKT
06079917312050000,2021,149174,430126,579300,MKT
06079917312050000,2020,112341,422759,535100,MKT
06079917312050000,2019,112341,422759,535100,MKT
06079917312060000,2021,149174,378926,528100,MKT
06079917312060000,2020,112341,379559,491900,MKT
06079917312060000,2019,112341,379559,491900,MKT
06079917312070000,2021,149174,390726,539900,MKT
06079917312070000,2020,112341,365659,478000,MKT
06079917312070000,2019,112341,365659,478000,MKT
06079917312080000,2021,160579,389021,549600,MKT
06079917312080000,2020,120805,329695,450500,OVR
06079917312080000,2019,120805,329695,450500,MKT
06079917312090000,2021,162424,276376,438800,MKT
06079917312090000,2020,122173,250227,372400,OVR
06079917312090000,2019,120805,251595,372400,MKT
06079917312100000,2021,155231,350369,505600,MKT
06079917312100000,2020,116837,301063,417900,MKT
06079917312100000,2019,116837,254363,371200,MKT
06079917312110000,2021,155231,357569,512800,MKT
06079917312110000,2020,116837,311563,428400,MKT
06079917312110000,2019,116837,304863,421700,MKT
06079917312120000,2021,149174,340826,490000,MKT
06079917312120000,2020,112341,329859,442200,OVR
06079917312120000,2019,112341,329859,442200,MKT
06079917312130000,2021,149174,301326,450500,MKT
06079917312130000,2020,112341,263459,375800,MKT
06079917312130000,2019,112341,263459,375800,MKT
06079917312140000,2021,149174,337426,486600,MKT
06079917312140000,2020,112341,324059,436400,MKT
06079917312140000,2019,112341,324059,436400,MKT
06079917312150000,2021,149174,343226,492400,MKT
06079917312150000,2020,112341,285259,397600,MKT
06079917312150000,2019,112341,285259,397600,MKT
06079917312160000,2021,149174,384126,533300,MKT
06079917312160000,2020,112341,339059,451400,OVR
06079917312160000,2019,112341,339059,451400,MKT
06079917312170000,2021,149174,384226,533400,MKT
06079917312170000,2020,112341,343759,456100,OVR
06079917312170000,2019,112341,343759,456100,MKT
06079917312180000,2021,149174,327726,476900,MKT
06079917312180000,2020,112341,271159,383500,OVR
06079917312180000,2019,112341,271159,383500,MKT
06079917312190000,2021,149174,393626,542800,MKT
06079917312190000,2020,112341,361159,473500,MKT
06079917312190000,2019,112341,361159,473500,MKT
06079917312200000,2021,149174,472926,622100,MKT
06079917312200000,2020,112341,431859,544200,MKT
06079917312200000,2019,112341,431859,544200,MKT
06079917312210000,2021,149174,378026,527200,MKT
06079917312210000,2020,112341,332059,444400,MKT
06079917312210000,2019,112341,332059,444400,MKT
06079917312220000,2021,194299,324801,519100,MKT
06079917312220000,2020,97264,326836,424100,MKT
06079917312220000,2019,97264,326836,424100,MKT
06079917312240000,2021,147547,339753,487300,MKT
06079917312240000,2020,111134,293366,404500,MKT
06079917312240000,2019,111134,295466,406600,MKT
06079917312250000,2021,155502,398398,553900,MKT
06079917312250000,2020,117039,373361,490400,MKT
06079917312250000,2019,117039,373361,490400,MKT
06079917312260000,2021,128887,409013,537900,MKT
06079917312260000,2020,97264,357736,455000,OVR
06079917312260000,2019,97264,357736,455000,MKT
06079917312270000,2021,149174,380426,529600,MKT
06079917312270000,2020,112341,321559,433900,MKT
06079917312270000,2019,112341,321559,433900,MKT
06079917312280000,2021,149174,358726,507900,MKT
06079917312280000,2020,112341,359959,472300,MKT
06079917312280000,2019,112341,359959,472300,MKT
06079917312290000,2021,149174,394926,544100,MKT
06079917312290000,2020,112341,350259,462600,MKT
06079917312290000,2019,112341,350259,462600,MKT
06079917312300000,2021,149174,375926,525100,MKT
06079917312300000,2020,112341,381359,493700,OVR
06079917312300000,2019,112341,381359,493700,MKT
06079917312310000,2021,149174,270726,419900,MKT
06079917312310000,2020,112341,268759,381100,MKT
06079917312310000,2019,112341,268759,381100,MKT
06079917312320000,2021,149174,358026,507200,MKT
06079917312320000,2020,112341,355859,468200,MKT
06079917312320000,2019,112341,355859,468200,MKT
06079917312330000,2021,149174,338726,487900,MKT
06079917312330000,2020,112341,352459,464800,OVR
06079917312330000,2019,112341,352459,464800,MKT
06079917312340000,2021,126418,334382,460800,MKT
06079917312340000,2020,92083,325717,417800,MKT
06079917312340000,2019,92083,325717,417800,MKT
06079917312350000,2021,121786,397114,518900,MKT
06079917312350000,2020,88755,387345,476100,MKT
06079917312350000,2019,88755,387345,476100,MKT
06079917312360000,2021,145254,420346,565600,MKT
06079917312360000,2020,109431,366669,476100,MKT
06079917312360000,2019,109431,366669,476100,MKT
06079917319010000,2021,126418,262082,388500,MKT
06079917319010000,2020,92083,229417,321500,MKT
06079917319010000,2019,92083,229417,321500,MKT
06079917319020000,2021,126418,257782,384200,MKT
06079917319020000,2020,92083,232917,325000,OVR
06079917319020000,2019,92083,232917,325000,MKT
06079917319030000,2021,126418,318382,444800,MKT
06079917319030000,2020,92083,249817,341900,MKT
06079917319030000,2019,92083,249817,341900,MKT
06079917319040000,2021,126418,292782,419200,MKT
06079917319040000,2020,92083,258317,350400,OVR
06079917319040000,2019,92083,258317,350400,MKT
06079917319050000,2021,126418,286482,412900,MKT
06079917319050000,2020,92083,253517,345600,MKT
06079917319050000,2019,92083,253517,345600,MKT
06079917319060000,2021,126418,365782,492200,MKT
06079917319060000,2020,92083,330617,422700,MKT
06079917319060000,2019,92083,330617,422700,MKT
06079917319070000,2021,126418,293682,420100,MKT
06079917319070000,2020,92083,270717,362800,MKT
06079917319070000,2019,92083,270717,362800,MKT
06079917319080000,2021,126418,337582,464000,MKT
06079917319080000,2020,92083,295617,387700,MKT
06079917319080000,2019,92083,295617,387700,MKT
06079917319090000,2021,138416,363084,501500,MKT
06079917319090000,2020,100693,282707,383400,MKT
06079917319090000,2019,100693,282707,383400,MKT
06079917319100000,2021,138416,330384,468800,MKT
06079917319100000,2020,100693,287007,387700,MKT
06079917319100000,2019,100693,287007,387700,MKT
06079917319110000,2021,126418,314582,441000,MKT
06079917319110000,2020,92083,292817,384900,OVR
06079917319110000,2019,92083,292817,384900,MKT
06079917319120000,2021,126418,286182,412600,MKT
06079917319120000,2020,92083,267017,359100,OVR
06079917319120000,2019,92083,267017,359100,MKT
06079917319130000,2021,126418,289682,416100,MKT
06079917319130000,2020,92083,269617,361700,MKT
06079917319130000,2019,92083,269617,361700,MKT
06079917319140000,2021,126418,268682,395100,MKT
06079917319140000,2020,92083,262617,354700,MKT
06079917319140000,2019,92083,262617,354700,MKT
06079917319150000,2021,126418,285582,412000,MKT
06079917319150000,2020,92083,269817,361900,MKT
06079917319150000,2019,92083,269817,361900,MKT
06079917319160000,2021,126418,300882,427300,MKT
06079917319160000,2020,92083,299517,391600,MKT
06079917319160000,2019,92083,299517,391600,MKT
06079917319170000,2021,126418,285282,411700,MKT
06079917319170000,2020,92083,269717,361800,MKT
06079917319170000,2019,92083,269717,361800,MKT
06079917319180000,2021,126418,327482,453900,MKT
06079917319180000,2020,92083,268017,360100,OVR
06079917319180000,2019,92083,268017,360100,MKT
06079917328010000,2021,126418,329682,456100,MKT
06079917328010000,2020,92083,302117,394200,OVR
06079917328010000,2019,92083,302117,394200,MKT
06079917328020000,2021,126418,376782,503200,MKT
06079917328020000,2020,92083,338617,430700,OVR
06079917328020000,2019,92083,338617,430700,MKT
06079917328030000,2021,115659,326241,441900,MKT
06079917328030000,2020,84352,314048,398400,MKT
06079917328030000,2019,84352,314048,398400,MKT
06079917328040000,2021,115659,273041,388700,MKT
06079917328040000,2020,84352,270448,354800,MKT
06079917328040000,2019,84352,270448,354800,MKT
06079917328050000,2021,115659,303841,419500,MKT
06079917328050000,2020,84352,284748,369100,OVR
06079917328050000,2019,84352,284748,369100,MKT
06079917328060000,2021,115659,316441,432100,MKT
06079917328060000,2020,84352,287948,372300,MKT
06079917328060000,2019,84352,287948,372300,MKT
06079917328070000,2021,115659,322341,438000,MKT
06079917328070000,2020,84352,280948,365300,OVR
06079917328070000,2019,84352,280948,365300,MKT
06079917328080000,2021,115659,322641,438300,MKT
06079917328080000,2020,84352,291948,376300,OVR
06079917328080000,2019,84352,291948,376300,MKT
06079917328090000,2021,112862,391038,503900,MKT
06079917328090000,2020,82340,299860,382200,OVR
06079917328090000,2019,82340,299860,382200,MKT
06079917329010000,2021,115659,363941,479600,MKT
06079917329010000,2020,84352,334648,419000,MKT
06079917329010000,2019,84352,334648,419000,MKT
06079917329020000,2021,115659,291641,407300,MKT
06079917329020000,2020,84352,272148,356500,MKT
06079917329020000,2019,84352,272148,356500,MKT
06079917329030000,2021,115659,372941,488600,MKT
06079917329030000,2020,84352,319448,403800,MKT
06079917329030000,2019,84352,319448,403800,MKT
06079917329040000,2021,115659,287241,402900,MKT
06079917329040000,2020,84352,259548,343900,OVR
06079917329040000,2019,84352,259548,343900,MKT
06079917329050000,2021,115659,430941,546600,MKT
06079917329050000,2020,84352,376248,460600,MKT
06079917329050000,2019,84352,376248,460600,MKT
06079917329060000,2021,115659,315741,431400,MKT
06079917329060000,2020,84352,299748,384100,MKT
06079917329060000,2019,84352,299748,384100,MKT
06079917329070000,2021,115659,435641,551300,MKT
06079917329070000,2020,84352,342448,426800,OVR
06079917329070000,2019,84352,342448,426800,MKT
06079917329080000,2021,115659,345341,461000,MKT
06079917329080000,2020,84352,330148,414500,MKT
06079917329080000,2019,84352,330148,414500,MKT
06079917329090000,2021,115659,281541,397200,MKT
06079917329090000,2020,84352,250948,335300,MKT
06079917329090000,2019,84352,250948,335300,MKT
06079917329100000,2021,136293,288207,424500,MKT
06079917329100000,2020,99170,275430,374600,MKT
06079917329100000,2019,99170,275430,374600,MKT
06079917329110000,2021,111416,360384,471800,MKT
06079917329110000,2020,81301,341399,422700,OVR
06079917329110000,2019,81301,341399,422700,MKT
06079917329120000,2021,111416,484984,596400,MKT
06079917329120000,2020,81301,409699,491000,MKT
06079917329120000,2019,81301,409699,491000,MKT
06079917329130000,2021,111416,447784,559200,MKT
06079917329130000,2020,81301,397599,478900,MKT
06079917329130000,2019,81301,397599,478900,MKT
06079917329140000,2021,111416,442684,554100,MKT
06079917329140000,2020,81301,362499,443800,MKT
06079917329140000,2019,81301,362499,443800,MKT
06079917329150000,2021,111416,419584,531000,MKT
06079917329150000,2020,81301,359999,441300,OVR
06079917329150000,2019,81301,359999,441300,MKT
06079917337010000,2021,126418,357582,484000,MKT
06079917337010000,2020,92083,292417,384500,OVR
06079917337010000,2019,92083,292417,384500,MKT
06079917337020000,2021,126418,365682,492100,MKT
06079917337020000,2020,92083,334017,426100,OVR
06079917337020000,2019,92083,334017,426100,MKT
06079917337030000,2021,126418,323282,449700,MKT
06079917337030000,2020,92083,276017,368100,MKT
06079917337030000,2019,92083,276017,368100,MKT
06079917337040000,2021,126418,357282,483700,MKT
06079917337040000,2020,92083,355017,447100,MKT
06079917337040000,2019,92083,355017,447100,MKT
06079917337050000,2021,126418,331782,458200,MKT
06079917337050000,2020,92083,276417,368500,MKT
06079917337050000,2019,92083,266717,358800,MKT
06079917337060000,2021,126418,319382,445800,MKT
06079917337060000,2020,92083,292017,384100,MKT
06079917337060000,2019,92083,292017,384100,MKT
06079917337070000,2021,126418,316782,443200,MKT
06079917337070000,2020,92083,279317,371400,MKT
06079917337070000,2019,92083,269917,362000,MKT
06079917337080000,2021,126418,352182,478600,MKT
06079917337080000,2020,92083,287117,379200,OVR
06079917337080000,2019,92083,287117,379200,MKT
06079917337090000,2021,126418,351782,478200,MKT
06079917337090000,2020,92083,331517,423600,MKT
06079917337090000,2019,92083,331517,423600,MKT
06079917337100000,2021,126418,313182,439600,MKT
06079917337100000,2020,92083,244217,336300,OVR
06079917337100000,2019,92083,244217,336300,MKT
06079917337110000,2021,138416,318284,456700,MKT
06079917337110000,2020,100693,337607,438300,MKT
06079917337110000,2019,100693,337607,438300,MKT
06079917337130000,2021,138416,392884,531300,MKT
06079917337130000,2020,100693,336807,437500,MKT
06079917337130000,2019,100693,336807,437500,MKT
06079917337140000,2021,140959,363741,504700,MKT
06079917337140000,2020,102516,336484,439000,OVR
06079917337140000,2019,102516,336484,439000,MKT
06079917337150000,2021,126418,282782,409200,MKT
06079917337150000,2020,92083,261417,353500,MKT
06079917337150000,2019,92083,268917,361000,MKT
06079917337160000,2021,126418,269882,396300,MKT
06079917337160000,2020,92083,244517,336600,OVR
06079917337160000,2019,92083,244517,336600,MKT
06079917337170000,2021,126418,336882,463300,MKT
06079917337170000,2020,92083,334817,426900,MKT
06079917337170000,2019,92083,334817,426900,MKT
06079917337180000,2021,126418,306082,432500,MKT
06079917337180000,2020,92083,288217,380300,OVR
06079917337180000,2019,92083,288217,380300,MKT
06079917337190000,2021,126418,328382,454800,MKT
06079917337190000,2020,92083,311817,403900,OVR
06079917337190000,2019,92083,311817,403900,MKT
06079917337200000,2021,126418,330982,457400,MKT
06079917337200000,2020,92083,290617,382700,MKT
06079917337200000,2019,92083,290617,382700,MKT
06079917337210000,2021,126418,340382,466800,MKT
06079917337210000,2020,92083,296417,388500,MKT
06079917337210000,2019,92083,296417,388500,MKT
06079917337220000,2021,126418,345982,472400,MKT
06079917337220000,2020,92083,304017,396100,MKT
06079917337220000,2019,92083,289817,381900,MKT
06079917337230000,2021,126418,306782,433200,MKT
06079917337230000,2020,92083,294717,386800,MKT
06079917337230000,2019,92083,294717,386800,MKT
06079917345010000,2021,115659,321941,437600,MKT
06079917345010000,2020,84352,276448,360800,OVR
06079917345010000,2019,84352,276448,360800,MKT
06079917345020000,2021,115659,357841,473500,MKT
06079917345020000,2020,84352,273548,357900,OVR
06079917345020000,2019,84352,273548,357900,MKT
06079917345040000,2021,126418,378882,505300,MKT
06079917345040000,2020,92083,334717,426800,OVR
06079917345040000,2019,92083,334717,426800,MKT
06079917345050000,2021,126418,269782,396200,MKT
06079917345050000,2020,92083,258017,350100,MKT
06079917345050000,2019,92083,258017,350100,MKT
06079917345060000,2021,115659,360141,475800,MKT
06079917345060000,2020,84352,330448,414800,OVR
06079917345060000,2019,84352,330448,414800,MKT
06079917345070000,2021,115659,340441,456100,MKT
06079917345070000,2020,84352,315148,399500,OVR
06079917345070000,2019,84352,315148,399500,MKT
06079917345080000,2021,115659,364641,480300,MKT
06079917345080000,2020,84352,383948,468300,MKT
06079917345080000,2019,84352,383948,468300,MKT
06079917345090000,2021,115659,980,116639,COST
06079917345090000,2020,84352,1100,85452,COST
06079917345090000,2019,84352,1100,85452,COST
06079917345100000,2021,115659,345141,460800,MKT
06079917345100000,2020,84352,280048,364400,OVR
06079917345100000,2019,84352,280048,364400,MKT
06079917345110000,2021,111416,394384,505800,MKT
06079917345110000,2020,81301,317399,398700,OVR
06079917345110000,2019,81301,317399,398700,MKT
06079917345120000,2021,111416,377884,489300,MKT
06079917345120000,2020,81301,357599,438900,MKT
06079917345120000,2019,81301,357599,438900,MKT
06079917345130000,2021,111416,356784,468200,MKT
06079917345130000,2020,81301,289399,370700,OVR
06079917345130000,2019,81301,289399,370700,MKT
06079917345140000,2021,111416,423584,535000,MKT
06079917345140000,2020,81301,348999,430300,MKT
06079917345140000,2019,81301,348999,430300,MKT
06079917345150000,2021,111416,388784,500200,MKT
06079917345150000,2020,81301,347199,428500,OVR
06079917345150000,2019,81301,347199,428500,MKT
06079917346010000,2021,115659,398141,513800,MKT
06079917346010000,2020,84352,332748,417100,MKT
06079917346010000,2019,84352,332748,417100,MKT
06079917346020000,2021,115659,433541,549200,MKT
06079917346020000,2020,84352,345148,429500,MKT
06079917346020000,2019,84352,345148,429500,MKT
06079917346030000,2021,115659,326341,442000,MKT
06079917346030000,2020,84352,300048,384400,OVR
06079917346030000,2019,84352,300048,384400,MKT
06079917346050000,2021,115659,301941,417600,MKT
06079917346050000,2020,84352,284648,369000,MKT
06079917346050000,2019,84352,284648,369000,MKT
06079917346060000,2021,115659,342341,458000,MKT
06079917346060000,2020,84352,297048,381400,MKT
06079917346060000,2019,84352,297048,381400,MKT
06079917346070000,2021,115659,352241,467900,MKT
06079917346070000,2020,84352,342548,426900,MKT
06079917346070000,2019,84352,342548,426900,MKT
06079917346080000,2021,115659,364141,479800,MKT
06079917346080000,2020,84352,307948,392300,MKT
06079917346080000,2019,84352,307948,392300,MKT
06079917346090000,2021,115659,334341,450000,MKT
06079917346090000,2020,84352,288448,372800,MKT
06079917346090000,2019,84352,288448,372800,MKT
06079917346100000,2021,115659,345141,460800,MKT
06079917346100000,2020,84352,319148,403500,MKT
06079917346100000,2019,84352,319148,403500,MKT
06079917346110000,2021,119111,320989,440100,MKT
06079917346110000,2020,86833,279467,366300,OVR
06079917346110000,2019,86833,279467,366300,MKT
06079917346120000,2021,119111,323289,442400,MKT
06079917346120000,2020,86833,320667,407500,MKT
06079917346120000,2019,86833,320667,407500,MKT
06079917347010000,2021,115659,313641,429300,MKT
06079917347010000,2020,84352,283448,367800,MKT
06079917347010000,2019,84352,283448,367800,MKT
06079917347020000,2021,115659,290441,406100,MKT
06079917347020000,2020,84352,273148,357500,MKT
06079917347020000,2019,84352,273148,357500,MKT
06079917347030000,2021,115659,321441,437100,MKT
06079917347030000,2020,84352,279048,363400,MKT
06079917347030000,2019,84352,279048,363400,MKT
06079917347040000,2021,115659,293441,409100,MKT
06079917347040000,2020,84352,274048,358400,MKT
06079917347040000,2019,84352,274048,358400,MKT
06079917347050000,2021,115659,308241,423900,MKT
06079917347050000,2020,84352,270048,354400,OVR
06079917347050000,2019,84352,270048,354400,MKT
06079917347060000,2021,115659,358741,474400,MKT
06079917347060000,2020,84352,303348,387700,MKT
06079917347060000,2019,84352,303348,387700,MKT
06079917347070000,2021,115659,321841,437500,MKT
06079917347070000,2020,84352,277048,361400,OVR
06079917347070000,2019,84352,277048,361400,MKT
06079917347080000,2021,115659,309441,425100,MKT
06079917347080000,2020,84352,275648,360000,MKT
06079917347080000,2019,84352,275648,360000,MKT
06079917347090000,2021,115659,343941,459600,MKT
06079917347090000,2020,84352,284648,369000,MKT
06079917347090000,2019,84352,284648,369000,MKT
06079917347100000,2021,115659,350141,465800,MKT
06079917347100000,2020,84352,294948,379300,OVR
06079917347100000,2019,84352,294948,379300,MKT
06079917347110000,2021,117064,360636,477700,MKT
06079917347110000,2020,85362,305238,390600,OVR
06079917347110000,2019,85362,305238,390600,MKT
06079917347130000,2021,117064,382236,499300,MKT
06079917347130000,2020,85362,286738,372100,MKT
06079917347130000,2019,85362,286738,372100,MKT
06079917347140000,2021,115659,304641,420300,MKT
06079917347140000,2020,84352,280148,364500,OVR
06079917347140000,2019,84352,280148,364500,MKT
06079917347150000,2021,115659,315841,431500,MKT
06079917347150000,2020,84352,273048,357400,OVR
06079917347150000,2019,84352,273048,357400,MKT
06079917347160000,2021,115659,372241,487900,MKT
06079917347160000,2020,84352,334948,419300,OVR
06079917347160000,2019,84352,334948,419300,MKT
06079917347170000,2021,115659,323941,439600,MKT
06079917347170000,2020,84352,285148,369500,MKT
06079917347170000,2019,84352,285148,369500,MKT
06079917347180000,2021,115659,285741,401400,MKT
06079917347180000,2020,84352,270548,354900,MKT
06079917347180000,2019,84352,270548,354900,MKT
06079917347190000,2021,115659,286841,402500,MKT
06079917347190000,2020,84352,262248,346600,OVR
06079917347190000,2019,84352,262248,346600,MKT
06079917347200000,2021,115659,410241,525900,MKT
06079917347200000,2020,84352,319548,403900,MKT
06079917347200000,2019,84352,319548,403900,MKT
06079917347210000,2021,115659,305041,420700,MKT
06079917347210000,2020,84352,274748,359100,MKT
06079917347210000,2019,84352,274748,359100,MKT
06079917347220000,2021,115659,292541,408200,MKT
06079917347220000,2020,84352,273348,357700,MKT
06079917347220000,2019,84352,273348,357700,MKT
06079917347230000,2021,115659,408141,523800,MKT
06079917347230000,2020,84352,338748,423100,OVR
06079917347230000,2019,84352,338748,423100,MKT
06079917349016500,2021,31065,0,31065,COST
06079917349016500,2020,22692,0,22692,COST
06079917349016500,2019,22692,0,22692,COST
06079917349030000,2021,119736,395364,515100,MKT
06079917349030000,2020,87283,337017,424300,OVR
06079917349030000,2019,87283,337017,424300,MKT
06079917349050000,2021,127340,423260,550600,MKT
06079917349050000,2020,92745,392255,485000,MKT
06079917349050000,2019,92745,392255,485000,MKT
06079917349070000,2021,120149,452951,573100,MKT
06079917349070000,2020,87580,412220,499800,MKT
06079917349070000,2019,87580,412220,499800,MKT
06079917349090000,2021,119038,440862,559900,MKT
06079917349090000,2020,86781,351119,437900,MKT
06079917349090000,2019,86781,351119,437900,MKT
06079917349110000,2021,130350,336850,467200,MKT
06079917349110000,2020,94906,382694,477600,OVR
06079917349110000,2019,94906,382694,477600,MKT
06079917349130000,2021,165793,454707,620500,MKT
06079917349130000,2020,120301,388799,509100,MKT
06079917349130000,2019,120301,389899,510200,MKT
06079917349150000,2021,148099,505201,653300,MKT
06079917349150000,2020,107634,454466,562100,MKT
06079917349150000,2019,107634,432466,540100,MKT
06079917349170000,2021,169296,361204,530500,MKT
06079917349170000,2020,122807,417593,540400,MKT
06079917349170000,2019,122807,417593,540400,MKT
06079917355010000,2021,115659,336841,452500,MKT
06079917355010000,2020,84352,283148,367500,MKT
06079917355010000,2019,84352,283148,367500,MKT
06079917355020000,2021,115659,286841,402500,MKT
06079917355020000,2020,84352,253248,337600,OVR
06079917355020000,2019,84352,253248,337600,MKT
06079917355030000,2021,115659,411241,526900,MKT
06079917355030000,2020,84352,333448,417800,MKT
06079917355030000,2019,84352,333448,417800,MKT
06079917355040000,2021,115659,351941,467600,MKT
06079917355040000,2020,84352,326348,410700,MKT
06079917355040000,2019,84352,326448,410800,MKT
06079917355050000,2021,115659,294741,410400,MKT
06079917355050000,2020,84352,258948,343300,MKT
06079917355050000,2019,84352,258948,343300,MKT
06079917355060000,2021,115659,307441,423100,MKT
06079917355060000,2020,84352,285348,369700,MKT
06079917355060000,2019,84352,285348,369700,MKT
06079917355070000,2021,115659,321241,436900,MKT
06079917355070000,2020,84352,302148,386500,OVR
06079917355070000,2019,84352,302148,386500,MKT
06079917355080000,2021,115659,274341,390000,MKT
06079917355080000,2020,84352,252648,337000,OVR
06079917355080000,2019,84352,252648,337000,MKT
06079917355090000,2021,115659,384541,500200,MKT
06079917355090000,2020,84352,328548,412900,MKT
06079917355090000,2019,84352,328548,412900,MKT
06079917355100000,2021,115659,295241,410900,MKT
06079917355100000,2020,84352,260148,344500,OVR
06079917355100000,2019,84352,260148,344500,MKT
06079917355110000,2021,125040,330060,455100,MKT
06079917355110000,2020,91093,337607,428700,MKT
06079917355110000,2019,91093,337607,428700,MKT
06079917355130000,2021,119111,295189,414300,MKT
06079917355130000,2020,86833,237267,324100,MKT
06079917355130000,2019,86833,237267,324100,MKT
06079917355140000,2021,119111,301889,421000,MKT
06079917355140000,2020,86833,279867,366700,MKT
06079917355140000,2019,86833,265167,352000,MKT
06079917355160000,2021,119111,0,119111,COST
06079917355160000,2020,86833,0,86833,COST
06079917355160000,2019,86833,0,86833,COST
06079917356010000,2021,115659,302741,418400,MKT
06079917356010000,2020,84352,272348,356700,MKT
06079917356010000,2019,84352,272348,356700,MKT
06079917356020000,2021,115659,359341,475000,MKT
06079917356020000,2020,84352,308648,393000,MKT
06079917356020000,2019,84352,308648,393000,MKT
06079917356030000,2021,115659,353941,469600,MKT
06079917356030000,2020,84352,314748,399100,MKT
06079917356030000,2019,84352,314748,399100,MKT
06079917356040000,2021,115659,295441,411100,MKT
06079917356040000,2020,84352,255548,339900,MKT
06079917356040000,2019,84352,255548,339900,MKT
06079917356050000,2021,115659,369641,485300,MKT
06079917356050000,2020,84352,338748,423100,MKT
06079917356050000,2019,84352,338748,423100,MKT
06079917356060000,2021,115659,313241,428900,MKT
06079917356060000,2020,84352,293848,378200,MKT
06079917356060000,2019,84352,293848,378200,MKT
06079917356070000,2021,115659,279641,395300,MKT
06079917356070000,2020,84352,278648,363000,MKT
06079917356070000,2019,84352,278648,363000,MKT
06079917356080000,2021,115659,289441,405100,MKT
06079917356080000,2020,84352,279548,363900,MKT
06079917356080000,2019,84352,279548,363900,MKT
06079917356090000,2021,115659,340741,456400,MKT
06079917356090000,2020,84352,280848,365200,OVR
06079917356090000,2019,84352,280848,365200,MKT
06079917356100000,2021,115659,392141,507800,MKT
06079917356100000,2020,84352,298148,382500,MKT
06079917356100000,2019,84352,298148,382500,MKT
06079917356120000,2021,115659,359541,475200,MKT
06079917356120000,2020,84352,351148,435500,MKT
06079917356120000,2019,84352,351148,435500,MKT
06079917356130000,2021,115659,339141,454800,MKT
06079917356130000,2020,84352,299448,383800,OVR
06079917356130000,2019,84352,299448,383800,MKT
06079917356150000,2021,117064,357136,474200,MKT
06079917356150000,2020,85362,358838,444200,OVR
06079917356150000,2019,85362,358838,444200,MKT
06079917356160000,2021,119794,370206,490000,MKT
06079917356160000,2020,87325,316075,403400,OVR
06079917356160000,2019,87325,316075,403400,MKT
06079917356170000,2021,119794,319006,438800,MKT
06079917356170000,2020,87325,278775,366100,OVR
06079917356170000,2019,87325,278775,366100,MKT
06079917356180000,2021,119794,297606,417400,MKT
06079917356180000,2020,87325,282575,369900,MKT
06079917356180000,2019,87325,282575,369900,MKT
06079917359010000,2021,142134,314666,456800,MKT
06079917359010000,2020,107113,314187,421300,MKT
06079917359010000,2019,107113,314187,421300,MKT
06079917359020000,2021,144487,288513,433000,MKT
06079917359020000,2020,108861,275039,383900,MKT
06079917359020000,2019,108861,275039,383900,MKT
06079917359030000,2021,171303,321097,492400,MKT
06079917359030000,2020,128755,323245,452000,MKT
06079917359030000,2019,128755,323245,452000,MKT
06079917359040000,2021,149174,350626,499800,MKT
06079917359040000,2020,112341,279559,391900,MKT
06079917359040000,2019,112341,279559,391900,MKT
06079917359050000,2021,149174,394126,543300,MKT
06079917359050000,2020,112341,330959,443300,MKT
06079917359050000,2019,112341,330959,443300,MKT
06079917359060000,2021,149174,320826,470000,MKT
06079917359060000,2020,112341,290059,402400,OVR
06079917359060000,2019,112341,290059,402400,MKT
06079917359070000,2021,149174,369426,518600,MKT
06079917359070000,2020,112341,327059,439400,OVR
06079917359070000,2019,112341,327059,439400,MKT
06079917359080000,2021,149174,334326,483500,MKT
06079917359080000,2020,112341,282459,394800,MKT
06079917359080000,2019,112341,282459,394800,MKT
06079917359090000,2021,149174,308226,457400,MKT
06079917359090000,2020,112341,278759,391100,OVR
06079917359090000,2019,112341,278759,391100,MKT
06079917359100000,2021,149174,342426,491600,MKT
06079917359100000,2020,112341,337559,449900,OVR
06079917359100000,2019,112341,337559,449900,MKT
06079917359110000,2021,149174,369426,518600,MKT
06079917359110000,2020,112341,339959,452300,OVR
06079917359110000,2019,112341,339959,452300,MKT
06079917359120000,2021,149174,331226,480400,MKT
06079917359120000,2020,112341,268159,380500,MKT
06079917359120000,2019,112341,268159,380500,MKT
06079917359130000,2021,149174,359126,508300,MKT
06079917359130000,2020,112341,312859,425200,MKT
06079917359130000,2019,112341,311759,424100,MKT
06079917359140000,2021,128887,430613,559500,MKT
06079917359140000,2020,97264,414236,511500,MKT
06079917359140000,2019,97264,406236,503500,MKT
06079917359160000,2021,206920,257080,464000,MKT
06079917359160000,2020,111134,280466,391600,MKT
06079917359160000,2019,111134,280466,391600,MKT
06079917359170000,2021,147547,416753,564300,MKT
06079917359170000,2020,111134,336566,447700,MKT
06079917359170000,2019,111134,336566,447700,MKT
06079917359180000,2021,128887,483813,612700,MKT
06079917359180000,2020,97264,383736,481000,MKT
06079917359180000,2019,97264,383736,481000,MKT
06079917359190000,2021,149174,372526,521700,MKT
06079917359190000,2020,112341,326559,438900,MKT
06079917359190000,2019,112341,326559,438900,MKT
06079917359200000,2021,149174,420726,569900,MKT
06079917359200000,2020,112341,404159,516500,MKT
06079917359200000,2019,112341,404159,516500,MKT
06079917359210000,2021,149174,330026,479200,MKT
06079917359210000,2020,112341,285959,398300,MKT
06079917359210000,2019,112341,285959,398300,MKT
06079917359220000,2021,149174,362826,512000,MKT
06079917359220000,2020,112341,340259,452600,OVR
06079917359220000,2019,112341,340259,452600,MKT
06079917359230000,2021,149174,431226,580400,MKT
06079917359230000,2020,112341,379859,492200,MKT
06079917359230000,2019,112341,379859,492200,MKT
06079917359240000,2021,149174,363226,512400,MKT
06079917359240000,2020,112341,338159,450500,MKT
06079917359240000,2019,112341,338159,450500,MKT
06079917359250000,2021,149174,406126,555300,MKT
06079917359250000,2020,112341,375959,488300,MKT
06079917359250000,2019,112341,375959,488300,MKT
06079917359260000,2021,149174,303426,452600,MKT
06079917359260000,2020,112341,297359,409700,MKT
06079917359260000,2019,112341,297359,409700,MKT
06079917359270000,2021,149174,332526,481700,MKT
06079917359270000,2020,112341,267159,379500,OVR
06079917359270000,2019,112341,267159,379500,MKT
06079917359280000,2021,178274,333426,511700,MKT
06079917359280000,2020,133919,290181,424100,OVR
06079917359280000,2019,133919,290181,424100,MKT
06079917364010000,2021,131273,314927,446200,MKT
06079917364010000,2020,93243,315357,408600,MKT
06079917364010000,2019,93243,315357,408600,MKT
06079917364020000,2021,136477,301323,437800,MKT
06079917364020000,2020,102909,311691,414600,MKT
06079917364020000,2019,102909,311691,414600,MKT
06079917364030000,2021,136477,325523,462000,MKT
06079917364030000,2020,102909,258091,361000,MKT
06079917364030000,2019,102909,258091,361000,MKT
06079917364040000,2021,136477,371223,507700,MKT
06079917364040000,2020,102909,333491,436400,MKT
06079917364040000,2019,102909,333391,436300,MKT
06079917364050000,2021,136477,543623,680100,MKT
06079917364050000,2020,102909,543540,646449,COST
06079917364050000,2019,102909,543540,646449,COST
06079917364060000,2021,136477,301723,438200,MKT
06079917364060000,2020,102909,272991,375900,MKT
06079917364060000,2019,102909,337491,440400,MKT
06079917364070000,2021,136477,300623,437100,MKT
06079917364070000,2020,102909,274691,377600,MKT
06079917364070000,2019,102909,274691,377600,MKT
06079917364080000,2021,136477,316423,452900,MKT
06079917364080000,2020,102909,274691,377600,MKT
06079917364080000,2019,102909,274691,377600,MKT
06079917364090000,2021,136477,345123,481600,MKT
06079917364090000,2020,102909,314591,417500,MKT
06079917364090000,2019,102909,314591,417500,MKT
06079917364100000,2021,136477,352023,488500,MKT
06079917364100000,2020,102909,290291,393200,MKT
06079917364100000,2019,102909,290291,393200,MKT
06079917364110000,2021,136477,300723,437200,MKT
06079917364110000,2020,102909,283291,386200,OVR
06079917364110000,2019,102909,283291,386200,MKT
06079917365010000,2021,196552,309948,506500,MKT
06079917365010000,2020,147445,294555,442000,MKT
06079917365010000,2019,147445,294555,442000,MKT
06079917365020000,2021,182199,360701,542900,MKT
06079917365020000,2020,136825,288475,425300,MKT
06079917365020000,2019,136825,288475,425300,MKT
06079917365040000,2021,182199,323101,505300,MKT
06079917365040000,2020,136825,284375,421200,OVR
06079917365040000,2019,136825,284375,421200,MKT
06079917365050000,2021,160579,408921,569500,MKT
06079917365050000,2020,120805,398995,519800,MKT
06079917365050000,2019,120805,398995,519800,MKT
06079917366010000,2021,146017,412583,558600,MKT
06079917366010000,2020,109997,334803,444800,MKT
06079917366010000,2019,109997,334803,444800,MKT
06079917366020000,2021,130064,356836,486900,MKT
06079917366020000,2020,94700,349600,444300,OVR
06079917366020000,2019,94700,349600,444300,MKT
06079917366030000,2021,122399,0,122399,COST
06079917366030000,2020,92436,0,92436,COST
06079917366030000,2019,92436,0,92436,COST
06079917366040000,2021,191396,310504,501900,MKT
06079917366040000,2020,143631,275669,419300,OVR
06079917366040000,2019,143631,275669,419300,MKT
06079917366060000,2021,191396,395804,587200,MKT
06079917366060000,2020,143631,349469,493100,MKT
06079917366060000,2019,143631,349469,493100,MKT
06079917366070000,2021,203448,0,203448,COST
06079917366070000,2020,152544,0,152544,COST
06079917366070000,2019,152544,0,152544,COST
06079918101010000,2021,286234,206866,493100,MKT
06079918101010000,2020,206097,183603,389700,MKT
06079918101010000,2019,206097,183603,389700,MKT
06079918101050000,2021,279947,239070,519017,COST
06079918101050000,2020,197735,204330,402065,COST
06079918101050000,2019,197735,204330,402065,COST
06079918101100000,2021,341184,195316,536500,MKT
06079918101100000,2020,240316,244810,485126,COST
06079918101100000,2019,240316,244810,485126,COST
06079918101120000,2021,73906,16800,90706,COST
06079918101120000,2020,53327,16960,70287,COST
06079918101120000,2019,53327,16960,70287,COST
06079918101140000,2021,433288,332512,765800,MKT
06079918101140000,2020,310156,308244,618400,MKT
06079918101140000,2019,310156,308244,618400,MKT
