id,year,land,building,total,method
06079801363395001,2021,95236,253464,348700,MKT
06079801363395001,2020,67756,241044,308800,MKT
06079801363395001,2019,67756,241044,308800,MKT
06079801363415002,2021,77508,228492,306000,MKT
06079801363415002,2020,53392,210008,263400,MKT
06079801363415002,2019,53392,210008,263400,MKT
06079801363435003,2021,77508,225992,303500,MKT
06079801363435003,2020,53392,208008,261400,MKT
06079801363435003,2019,53392,208008,261400,MKT
06079801363455004,2021,92737,239363,332100,MKT
06079801363455004,2020,65703,218597,284300,MKT
06079801363455004,2019,65703,218597,284300,MKT
06079801364015001,2021,105881,241419,347300,MKT
06079801364015001,2020,76591,223109,299700,MKT
06079801364015001,2019,76591,223109,299700,MKT
06079801364035002,2021,82752,225548,308300,MKT
06079801364035002,2020,57592,207108,264700,MKT
06079801364035002,2019,57592,207108,264700,MKT
06079801364055003,2021,82893,225607,308500,MKT
06079801364055003,2020,57706,207094,264800,MKT
06079801364055003,2019,57706,207094,264800,MKT
06079801364075004,2021,102103,241397,343500,MKT
06079801364075004,2020,73438,222962,296400,MKT
06079801364075004,2019,73438,222962,296400,MKT
06079801364095001,2021,102393,239307,341700,MKT
06079801364095001,2020,73680,218420,292100,MKT
06079801364095001,2019,73680,218420,292100,MKT
06079801364115002,2021,83525,226875,310400,MKT
06079801364115002,2020,58215,227685,285900,OVR
06079801364115002,2019,58215,227685,285900,MKT
06079801364135003,2021,83497,226803,310300,MKT
06079801364135003,2020,58193,227707,285900,OVR
06079801364135003,2019,58193,227707,285900,MKT
06079801364155004,2021,115521,239179,354700,MKT
06079801364155004,2020,84713,218787,303500,MKT
06079801364155004,2019,84713,218787,303500,MKT
06079801364175001,2021,109066,239234,348300,MKT
06079801364175001,2020,79262,218638,297900,MKT
06079801364175001,2019,79262,218638,297900,MKT
06079801364195002,2021,85408,226892,312300,MKT
06079801364195002,2020,59735,208065,267800,MKT
06079801364195002,2019,59735,208065,267800,MKT
06079801364215003,2021,88206,226994,315200,MKT
06079801364215003,2020,62005,208195,270200,MKT
06079801364215003,2019,62005,208195,270200,MKT
06079801364235004,2021,105516,239284,344800,MKT
06079801364235004,2020,76285,218515,294800,MKT
06079801364235004,2019,76285,218515,294800,MKT
06079801371010000,2021,127313,0,127313,COST
06079801371010000,2020,94668,0,94668,COST
06079801371010000,2019,94668,0,94668,COST
06079801371026500,2021,121150,0,121150,COST
06079801371026500,2020,107948,0,107948,COST
06079801371026500,2019,107948,0,107948,COST
06079801371035001,2021,101404,308896,410300,MKT
06079801371035001,2020,72857,358643,431500,OVR
06079801371035001,2019,72857,358643,431500,MKT
06079801371055002,2021,101404,332096,433500,MKT
06079801371055002,2020,72857,358543,431400,OVR
06079801371055002,2019,72857,358543,431400,MKT
06079801371070000,2021,120781,0,120781,COST
06079801371070000,2020,89073,0,89073,COST
06079801371070000,2019,89073,0,89073,COST
06079801371095001,2021,101404,308696,410100,MKT
06079801371095001,2020,72857,263943,336800,MKT
06079801371095001,2019,72857,263943,336800,MKT
06079801371115002,2021,101404,308696,410100,MKT
06079801371115002,2020,72857,263943,336800,MKT
06079801371115002,2019,72857,263943,336800,MKT
06079801371130000,2021,120781,299819,420600,MKT
06079801371130000,2020,89073,264627,353700,MKT
06079801371130000,2019,89073,264627,353700,MKT
06079801371150000,2021,120781,350019,470800,MKT
06079801371150000,2020,89073,381027,470100,MKT
06079801371150000,2019,89073,381027,470100,MKT
06079801371170000,2021,120781,290119,410900,MKT
06079801371170000,2020,89073,254127,343200,MKT
06079801371170000,2019,89073,254127,343200,MKT
06079801371190000,2021,120781,304319,425100,MKT
06079801371190000,2020,89073,270127,359200,MKT
06079801371190000,2019,89073,270127,359200,MKT
06079801371215001,2021,101404,273696,375100,MKT
06079801371215001,2020,72857,254343,327200,MKT
06079801371215001,2019,72857,254343,327200,MKT
06079801371235002,2021,101404,273696,375100,MKT
06079801371235002,2020,72857,254343,327200,MKT
06079801371235002,2019,72857,254343,327200,MKT
06079801371250000,2021,120781,299919,420700,MKT
06079801371250000,2020,89073,264627,353700,MKT
06079801371250000,2019,89073,264627,353700,MKT
06079801371275001,2021,101404,317396,418800,MKT
06079801371275001,2020,72857,266443,339300,MKT
06079801371275001,2019,72857,266443,339300,MKT
06079801371295002,2021,101404,320896,422300,MKT
06079801371295002,2020,72857,269743,342600,MKT
06079801371295002,2019,72857,269743,342600,MKT
06079801371300000,2021,129009,304391,433400,MKT
06079801371300000,2020,96128,270772,366900,MKT
06079801371300000,2019,96128,270772,366900,MKT
06079801372010000,2021,116617,365083,481700,MKT
06079801372010000,2020,85530,346670,432200,MKT
06079801372010000,2019,85530,346670,432200,MKT
06079801372035001,2021,94797,281603,376400,MKT
06079801372035001,2020,67395,261205,328600,MKT
06079801372035001,2019,67395,256905,324300,MKT
06079801372055002,2021,94797,273203,368000,MKT
06079801372055002,2020,67395,256905,324300,MKT
06079801372055002,2019,67395,256905,324300,MKT
06079801372070000,2021,112219,265481,377700,MKT
06079801372070000,2020,81811,226589,308400,MKT
06079801372070000,2019,81811,226589,308400,MKT
06079801372095001,2021,94797,259903,354700,MKT
06079801372095001,2020,67395,239405,306800,MKT
06079801372095001,2019,67395,239405,306800,MKT
06079801372115002,2021,94797,258903,353700,MKT
06079801372115002,2020,67395,239305,306700,MKT
06079801372115002,2019,67395,239305,306700,MKT
06079801372130000,2021,114887,422613,537500,MKT
06079801372130000,2020,84065,483240,567305,OVR
06079801372130000,2019,84065,483240,567305,COST
06079801372150000,2021,114887,276913,391800,MKT
06079801372150000,2020,84065,242135,326200,MKT
06079801372150000,2019,84065,242135,326200,MKT
06079801372175001,2021,94797,272503,367300,MKT
06079801372175001,2020,67395,255605,323000,MKT
06079801372175001,2019,67395,255605,323000,MKT
06079801372195002,2021,94797,272403,367200,MKT
06079801372195002,2020,67395,255505,322900,MKT
06079801372195002,2019,67395,255505,322900,MKT
06079801372210000,2021,112219,264781,377000,MKT
06079801372210000,2020,81811,225889,307700,MKT
06079801372210000,2019,81811,225889,307700,MKT
06079801372235001,2021,94797,274903,369700,MKT
06079801372235001,2020,67395,256905,324300,MKT
06079801372235001,2019,67395,256905,324300,MKT
06079801372255002,2021,94797,274903,369700,MKT
06079801372255002,2020,67395,256905,324300,MKT
06079801372255002,2019,67395,256905,324300,MKT
06079801372270000,2021,116617,253583,370200,MKT
06079801372270000,2020,85530,215070,300600,MKT
06079801372270000,2019,85530,215070,300600,MKT
06079801373010000,2021,112219,267981,380200,MKT
06079801373010000,2020,81811,228889,310700,MKT
06079801373010000,2019,81811,225089,306900,MKT
06079801373026500,2021,75451,0,75451,COST
06079801373026500,2020,62420,0,62420,COST
06079801373026500,2019,62420,0,62420,COST
06079801373035001,2021,92437,278863,371300,MKT
06079801373035001,2020,65458,258142,323600,MKT
06079801373035001,2019,65458,253942,319400,MKT
06079801373055002,2021,92437,271063,363500,MKT
06079801373055002,2020,65458,254342,319800,MKT
06079801373055002,2019,65458,254342,319800,MKT
06079801373070000,2021,112219,267781,380000,MKT
06079801373070000,2020,81811,228489,310300,MKT
06079801373070000,2019,81811,228489,310300,MKT
06079801373095001,2021,92437,270563,363000,MKT
06079801373095001,2020,65458,253842,319300,MKT
06079801373095001,2019,65458,253842,319300,MKT
06079801373115002,2021,92437,278763,371200,MKT
06079801373115002,2020,65458,258042,323500,MKT
06079801373115002,2019,65458,258042,323500,MKT
06079801373130000,2021,116932,291168,408100,MKT
06079801373130000,2020,85798,251002,336800,MKT
06079801373130000,2019,85798,251002,336800,MKT
06079801373150000,2021,117009,267291,384300,MKT
06079801373150000,2020,85863,227637,313500,MKT
06079801373150000,2019,85863,227637,313500,MKT
06079801373175001,2021,92437,270163,362600,MKT
06079801373175001,2020,65458,253142,318600,MKT
06079801373175001,2019,65458,253142,318600,MKT
06079801373195002,2021,92437,270163,362600,MKT
06079801373195002,2020,65458,253142,318600,MKT
06079801373195002,2019,65458,253142,318600,MKT
06079801373210000,2021,112219,267781,380000,MKT
06079801373210000,2020,81811,228489,310300,MKT
06079801373210000,2019,81811,228489,310300,MKT
06079801373235001,2021,92437,274863,367300,MKT
06079801373235001,2020,65458,256942,322400,MKT
06079801373235001,2019,65458,256942,322400,MKT
06079801373255002,2021,92437,274863,367300,MKT
06079801373255002,2020,65458,256942,322400,MKT
06079801373255002,2019,65458,256942,322400,MKT
06079801373270000,2021,112219,266081,378300,MKT
06079801373270000,2020,81811,226289,308100,MKT
06079801373270000,2019,81811,226289,308100,MKT
06079801374017000,2021,1026328,65060,1091388,COST
06079801374017000,2020,860692,71220,931912,COST
06079801374017000,2019,860692,71220,931912,COST
06079801374030000,2021,1016335,11291770,12308105,COST
06079801374030000,2020,932694,7496006,8428700,INCOME
06079801374030000,2019,932694,7496006,8428700,INCOME
06079801374110000,2021,1094125,0,1094125,COST
06079801374110000,2020,884603,0,884603,COST
06079801374110000,2019,884603,0,884603,COST
06079801374150000,2021,1035715,11294470,12330185,COST
06079801374150000,2020,940271,7488429,8428700,INCOME
06079801374150000,2019,940271,7488429,8428700,INCOME
06079801401010000,2021,530567,793110,1323677,COST
06079801401010000,2020,447802,807810,1255612,COST
06079801401010000,2019,447802,806230,1254032,COST
06079801401070000,2021,1990,7630,9620,COST
06079801401070000,2020,1852,7720,9572,COST
06079801401070000,2019,1852,7720,9572,COST
06079801401157000,2021,337641,101170,438811,COST
06079801401157000,2020,1293233,2363767,3657000,INCOME
06079801401157000,2019,1293233,2363767,3657000,INCOME
06079801405060000,2021,250223,61750,311973,COST
06079801405060000,2020,425758,58300,484058,COST
06079801405060000,2019,425758,58300,484058,COST
06079801405070000,2021,145719,257081,402800,MKT
06079801405070000,2020,110818,226682,337500,MKT
06079801405070000,2019,110818,226682,337500,MKT
06079801405090000,2021,174468,298032,472500,MKT
06079801405090000,2020,136478,240222,376700,MKT
06079801405090000,2019,136478,240222,376700,MKT
06079801405290000,2021,187901,163699,351600,MKT
06079801405290000,2020,148705,146795,295500,MKT
06079801405290000,2019,148705,146795,295500,MKT
06079801405320000,2021,427829,458571,886400,INCOME
06079801405320000,2020,535736,267564,803300,INCOME
06079801405320000,2019,535736,267564,803300,INCOME
06079801405330000,2021,682599,571201,1253800,INCOME
06079801405330000,2020,654436,466864,1121300,INCOME
06079801405330000,2019,654436,466864,1121300,INCOME
06079801405340000,2021,639705,935995,1575700,INCOME
06079801405340000,2020,636492,793108,1429600,INCOME
06079801405340000,2019,636492,793108,1429600,INCOME
06079801405370000,2021,488129,144850,632979,COST
06079801405370000,2020,566868,136600,703468,COST
06079801405370000,2019,566868,136600,703468,COST
06079801405380000,2021,488051,851349,1339400,INCOME
06079801405380000,2020,566829,531260,1098089,COST
06079801405380000,2019,566829,531260,1098089,COST
06079801405400000,2021,502615,552785,1055400,INCOME
06079801405400000,2020,574014,318270,892284,COST
06079801405400000,2019,574014,318270,892284,COST
06079801405497000,2021,641950,18290,660240,COST
06079801405497000,2020,324123,19090,343213,COST
06079801405497000,2019,324123,19090,343213,COST
06079801405500000,2021,456252,297160,753412,COST
06079801405500000,2020,550703,293780,844483,COST
06079801405500000,2019,550703,293780,844483,COST
06079801405527000,2021,446111,356670,802781,COST
06079801405527000,2020,545426,11760,557186,COST
06079801405527000,2019,545426,11760,557186,COST
06079801405540000,2021,603631,394769,998400,INCOME
06079801405540000,2020,620861,245630,866491,COST
06079801405540000,2019,620861,245630,866491,COST
06079801418010000,2021,1623722,4338878,5962600,INCOME
06079801418010000,2020,1077963,4484637,5562600,INCOME
06079801418010000,2019,1077963,4484637,5562600,INCOME
06079801419040000,2021,1048789,6526180,7574969,COST
06079801419040000,2020,786629,4942471,5729100,INCOME
06079801419040000,2019,786629,4942471,5729100,INCOME
06079801419100000,2021,406906,837400,1244306,COST
06079801419100000,2020,244300,722300,966600,INCOME
06079801419100000,2019,244300,722300,966600,INCOME
06079801419150000,2021,3318,0,3318,COST
06079801419150000,2020,3080,0,3080,COST
06079801419150000,2019,3080,0,3080,COST
06079801419167000,2021,520441,14860,535301,COST
06079801419167000,2020,653654,0,653654,COST
06079801419167000,2019,524352,0,524352,COST
06079801419220000,2021,397089,0,397089,COST
06079801419220000,2020,420657,0,420657,COST
06079801419220000,2019,420657,0,420657,COST
06079801419240000,2021,430610,0,430610,COST
06079801419240000,2020,461997,0,461997,COST
06079801419240000,2019,461997,0,461997,COST
06079801419245000,2021,79128,0,79128,COST
06079801419245000,2020,59857,0,59857,COST
06079801419245000,2019,59857,0,59857,COST
06079801419245403,2021,117662,100638,218300,MKT
06079801419245403,2020,78351,136349,214700,MKT
06079801419245403,2019,78351,136349,214700,MKT
06079801419245405,2021,117662,104438,222100,MKT
06079801419245405,2020,78351,139849,218200,MKT
06079801419245405,2019,78351,139849,218200,MKT
06079801419245407,2021,117662,102338,220000,MKT
06079801419245407,2020,78351,139349,217700,MKT
06079801419245407,2019,78351,139349,217700,MKT
06079801419245409,2021,117662,102138,219800,MKT
06079801419245409,2020,78351,139449,217800,MKT
06079801419245409,2019,78351,139449,217800,MKT
06079801419245501,2021,117662,101938,219600,MKT
06079801419245501,2020,78351,139249,217600,MKT
06079801419245501,2019,78351,139249,217600,MKT
06079801419245502,2021,117662,106238,223900,MKT
06079801419245502,2020,78351,140849,219200,MKT
06079801419245502,2019,78351,140849,219200,MKT
06079801419245503,2021,117662,100238,217900,MKT
06079801419245503,2020,78351,135849,214200,MKT
06079801419245503,2019,78351,135849,214200,MKT
06079801419245504,2021,117662,101538,219200,MKT
06079801419245504,2020,78351,138449,216800,MKT
06079801419245504,2019,78351,138449,216800,MKT
06079801419245505,2021,117662,101938,219600,MKT
06079801419245505,2020,78351,139149,217500,MKT
06079801419245505,2019,78351,139149,217500,MKT
06079801419245506,2021,117662,101738,219400,MKT
06079801419245506,2020,78351,138849,217200,MKT
06079801419245506,2019,78351,138849,217200,MKT
06079801419245507,2021,117662,100338,218000,MKT
06079801419245507,2020,78351,136149,214500,MKT
06079801419245507,2019,78351,136149,214500,MKT
06079801419260000,2021,3010,0,3010,COST
06079801419260000,2020,2794,0,2794,COST
06079801419260000,2019,2794,0,2794,COST
06079801419306500,2021,164735,0,164735,COST
06079801419306500,2020,154229,0,154229,COST
06079801419306500,2019,154229,0,154229,COST
06079801424010000,2021,461097,747703,1208800,INCOME
06079801424010000,2020,553201,526099,1079300,INCOME
06079801424010000,2019,553201,526099,1079300,INCOME
06079801424030000,2021,146738,248362,395100,MKT
06079801424030000,2020,111715,213885,325600,MKT
06079801424030000,2019,111715,211485,323200,MKT
06079801424040000,2021,132288,258012,390300,MKT
06079801424040000,2020,99091,224509,323600,MKT
06079801424040000,2019,99091,224509,323600,MKT
06079801430010000,2021,156950,319750,476700,MKT
06079801430010000,2020,120756,270844,391600,OVR
06079801430010000,2019,120756,270844,391600,MKT
06079801430020000,2021,145824,254876,400700,MKT
06079801430020000,2020,110910,213790,324700,MKT
06079801430020000,2019,110910,213790,324700,MKT
06079801430030000,2021,145824,336676,482500,MKT
06079801430030000,2020,110910,274690,385600,MKT
06079801430030000,2019,110910,274690,385600,MKT
06079801430040000,2021,157738,293162,450900,MKT
06079801430040000,2020,121458,254042,375500,MKT
06079801430040000,2019,121458,254042,375500,MKT
06079801430050000,2021,147277,262323,409600,MKT
06079801430050000,2020,112189,232211,344400,MKT
06079801430050000,2019,112189,232211,344400,MKT
06079801430060000,2021,162057,224543,386600,MKT
06079801430060000,2020,125313,186287,311600,MKT
06079801430060000,2019,125313,186287,311600,MKT
06079801430080000,2021,166962,262438,429400,MKT
06079801430080000,2020,129710,223290,353000,MKT
06079801430080000,2019,129710,223290,353000,MKT
06079801430100000,2021,159893,224007,383900,MKT
06079801430100000,2020,123378,195622,319000,MKT
06079801430100000,2019,123378,195622,319000,MKT
06079801430110000,2021,136166,252134,388300,MKT
06079801430110000,2020,102459,218241,320700,MKT
06079801430110000,2019,102459,218241,320700,MKT
06079801430120000,2021,136976,289124,426100,MKT
06079801430120000,2020,103164,254236,357400,MKT
06079801430120000,2019,103164,254236,357400,MKT
06079801430130000,2021,146617,233983,380600,MKT
06079801430130000,2020,111608,220092,331700,MKT
06079801430130000,2019,111608,220092,331700,MKT
06079801431080000,2021,200635,281965,482600,MKT
06079801431080000,2020,160423,234377,394800,OVR
06079801431080000,2019,160423,234377,394800,MKT
06079801431090000,2021,144572,272328,416900,MKT
06079801431090000,2020,109810,249190,359000,MKT
06079801431090000,2019,109810,249190,359000,MKT
06079801431100000,2021,136828,271372,408200,MKT
06079801431100000,2020,103035,232265,335300,MKT
06079801431100000,2019,103035,232265,335300,MKT
06079801431110000,2021,152420,269280,421700,MKT
06079801431110000,2020,116733,237367,354100,MKT
06079801431110000,2019,116733,237367,354100,MKT
06079801431120000,2021,165300,300000,465300,MKT
06079801431120000,2020,128218,237082,365300,MKT
06079801431120000,2019,128218,241015,369233,OVR
06079801431130000,2021,163422,238478,401900,MKT
06079801431130000,2020,126534,203566,330100,MKT
06079801431130000,2019,126534,203566,330100,MKT
06079801431140000,2021,153997,242503,396500,MKT
06079801431140000,2020,118132,202168,320300,MKT
06079801431140000,2019,118132,202168,320300,MKT
06079801431150000,2021,139620,214380,354000,MKT
06079801431150000,2020,105471,179629,285100,MKT
06079801431150000,2019,105471,179629,285100,MKT
06079801431160000,2021,161984,271916,433900,MKT
06079801431160000,2020,125247,232653,357900,MKT
06079801431160000,2019,125247,232653,357900,MKT
06079801431170000,2021,150672,264428,415100,MKT
06079801431170000,2020,115186,237214,352400,MKT
06079801431170000,2019,115186,237214,352400,MKT
06079801431207000,2021,1488954,0,1488954,COST
06079801431207000,2020,951973,0,951973,COST
06079801431207000,2019,951973,0,951973,COST
06079801432030000,2021,706654,0,706654,COST
06079801432030000,2020,691781,0,691781,COST
06079801432030000,2019,691781,0,691781,COST
06079801432050000,2021,1184892,15590,1200482,COST
06079801432050000,2020,863233,36650,899883,COST
06079801432050000,2019,863233,36650,899883,COST
06079801432090000,2021,4030528,137780,4168308,COST
06079801432090000,2020,1458447,260400,1718847,COST
06079801432090000,2019,1458447,260400,1718847,COST
06079801432110000,2021,1197121,0,1197121,COST
06079801432110000,2020,709992,0,709992,COST
06079801432110000,2019,709992,0,709992,COST
06079801433016500,2021,106475,0,106475,COST
06079801433016500,2020,93095,0,93095,COST
06079801433016500,2019,93095,0,93095,COST
06079802101050000,2021,381202,208720,589922,COST
06079802101050000,2020,344361,186050,530411,COST
06079802101050000,2019,344361,186050,530411,COST
06079802101077000,2021,380416,34910,415326,COST
06079802101077000,2020,658393,42610,701003,COST
06079802101077000,2019,658393,42610,701003,COST
06079802101100000,2021,389648,0,389648,COST
06079802101100000,2020,689941,0,689941,COST
06079802101100000,2019,689941,0,689941,COST
06079802101150000,2021,1159726,3244474,4404200,INCOME
06079802101150000,2020,986946,2538654,3525600,INCOME
06079802101150000,2019,986946,2538654,3525600,INCOME
06079802101156500,2021,155984,0,155984,COST
06079802101156500,2020,209975,0,209975,COST
06079802101156500,2019,209975,0,209975,COST
06079802101300000,2021,428271,0,428271,COST
06079802101300000,2020,829717,0,829717,COST
06079802101300000,2019,829717,0,829717,COST
06079802102010000,2021,1512352,10400520,11912872,COST
06079802102010000,2020,439548,0,439548,COST
06079802102010000,2019,439548,0,439548,COST
06079802102040000,2021,236147,0,236147,COST
06079802102040000,2020,259598,0,259598,COST
06079802102040000,2019,259598,0,259598,COST
06079802102070000,2021,261642,0,261642,COST
06079802102070000,2020,317109,0,317109,COST
06079802102070000,2019,317109,0,317109,COST
06079802102106500,2021,42274,0,42274,COST
06079802102106500,2020,24734,0,24734,COST
06079802102106500,2019,24734,0,24734,COST
06079802102126500,2021,137284,0,137284,COST
06079802102126500,2020,246466,0,246466,COST
06079802102126500,2019,246466,0,246466,COST
06079802102306500,2021,75971,0,75971,COST
06079802102306500,2020,77657,0,77657,COST
06079802102306500,2019,77657,0,77657,COST
06079802102350000,2021,2072057,13497780,15569837,COST
06079802102350000,2020,1435981,12881070,14317051,COST
06079802102350000,2019,1435981,12881070,14317051,COST
06079802102400000,2021,1157462,986230,2143692,COST
06079802102400000,2020,906188,960980,1867168,COST
06079802102400000,2019,906188,960980,1867168,COST
06079802102406500,2021,778736,0,778736,COST
06079802102406500,2020,418128,0,418128,COST
06079802102406500,2019,418128,0,418128,COST
06079802102420000,2021,1583064,863136,2446200,INCOME
06079802102420000,2020,1036273,1103927,2140200,INCOME
06079802102420000,2019,1036273,1103927,2140200,INCOME
06079802102440000,2021,1192369,2253131,3445500,INCOME
06079802102440000,2020,917796,2265540,3183336,COST
06079802102440000,2019,917796,2265540,3183336,COST
06079802102450000,2021,945253,455620,1400873,COST
06079802102450000,2020,830880,447330,1278210,COST
06079802102450000,2019,830880,447330,1278210,COST
06079802102460000,2021,740372,764428,1504800,INCOME
06079802102460000,2020,748321,589679,1338000,INCOME
06079802102460000,2019,748321,589679,1338000,INCOME
06079802102480000,2021,1086406,2946380,4032786,COST
06079802102480000,2020,881925,2874410,3756335,COST
06079802102480000,2019,881925,2874410,3756335,COST
06079802102500000,2021,4406624,7667276,12073900,INCOME
06079802102500000,2020,1606703,7282230,8888933,COST
06079802102500000,2019,1606703,7282230,8888933,COST
06079802102520000,2021,881310,470390,1351700,INCOME
06079802102520000,2020,806320,218980,1025300,INCOME
06079802102520000,2019,806320,218980,1025300,INCOME
06079802102540000,2021,1931301,3611599,5542900,INCOME
06079802102540000,2020,1128407,3657193,4785600,INCOME
06079802102540000,2019,1128407,3657193,4785600,INCOME
06079802102560000,2021,3505587,10899213,14404800,INCOME
06079802102560000,2020,1456726,9522974,10979700,INCOME
06079802102560000,2019,1456726,9522974,10979700,INCOME
06079802102587000,2021,283802,694190,977992,COST
06079802102587000,2020,814298,0,814298,COST
06079802102587000,2019,814298,0,814298,COST
06079802102600000,2021,1127587,1909410,3036997,COST
06079802102600000,2020,896093,0,896093,COST
06079802102600000,2019,896093,0,896093,COST
06079802190010000,2021,1039110,366190,1405300,INCOME
06079802190010000,2020,865268,500290,1365558,COST
06079802190010000,2019,865268,500290,1365558,COST
06079802190080000,2021,1347872,1727640,3075512,COST
06079802190080000,2020,967280,1669350,2636630,COST
06079802190080000,2019,967280,1669350,2636630,COST
06079802192010000,2021,2138615,11336385,13475000,INCOME
06079802192010000,2020,1178787,11764213,12943000,INCOME
06079802192010000,2019,1178787,11764213,12943000,INCOME
06079802192150000,2021,1376529,1573300,2949829,COST
06079802192150000,2020,976037,1605363,2581400,INCOME
06079802192150000,2019,976037,1605363,2581400,INCOME
06079802192170000,2021,1137596,2175304,3312900,INCOME
06079802192170000,2020,899492,1613408,2512900,INCOME
06079802192170000,2019,899492,1613408,2512900,INCOME
06079802201106500,2021,63152,0,63152,COST
06079802201106500,2020,74807,0,74807,COST
06079802201106500,2019,74807,0,74807,COST
06079802202016500,2021,79988,0,79988,COST
06079802202016500,2020,118654,0,118654,COST
06079802202016500,2019,118654,0,118654,COST
06079802202056500,2021,58758,0,58758,COST
06079802202056500,2020,64986,0,64986,COST
06079802202056500,2019,64986,0,64986,COST
06079802202076500,2021,68197,0,68197,COST
06079802202076500,2020,86916,0,86916,COST
06079802202076500,2019,86916,0,86916,COST
06079802203015001,2021,119150,298450,417600,MKT
06079802203015001,2020,70654,333646,404300,MKT
06079802203015001,2019,70654,333646,404300,MKT
06079802203035002,2021,104181,286419,390600,MKT
06079802203035002,2020,63178,326222,389400,MKT
06079802203035002,2019,63178,326222,389400,MKT
06079802203055001,2021,104181,271219,375400,MKT
06079802203055001,2020,63178,284822,348000,MKT
06079802203055001,2019,63178,284822,348000,MKT
06079802203075002,2021,104181,295819,400000,MKT
06079802203075002,2020,63178,281622,344800,MKT
06079802203075002,2019,63178,284822,348000,MKT
06079802203090000,2021,104181,0,104181,COST
06079802203090000,2020,63178,0,63178,COST
06079802203090000,2019,63178,0,63178,COST
06079802203110000,2021,109356,0,109356,COST
06079802203110000,2020,69448,0,69448,COST
06079802203110000,2019,69448,0,69448,COST
06079802203137000,2021,221857,4270,226127,COST
06079802203137000,2020,276269,5160,281429,COST
06079802203137000,2019,276269,5160,281429,COST
06079802204010000,2021,754899,3829201,4584100,INCOME
06079802204010000,2020,722599,2757601,3480200,INCOME
06079802204010000,2019,722599,2757601,3480200,INCOME
06079802205010000,2021,110389,279511,389900,MKT
06079802205010000,2020,70734,296266,367000,MKT
06079802205010000,2019,70734,296266,367000,MKT
06079802205030000,2021,107783,288317,396100,MKT
06079802205030000,2020,67512,280588,348100,MKT
06079802205030000,2019,67512,280588,348100,MKT
06079802205050000,2021,107783,255317,363100,MKT
06079802205050000,2020,67512,264988,332500,MKT
06079802205050000,2019,67512,264988,332500,MKT
06079802205070000,2021,107783,271517,379300,MKT
06079802205070000,2020,67512,260288,327800,MKT
06079802205070000,2019,67512,260288,327800,MKT
06079802205090000,2021,107783,281717,389500,MKT
06079802205090000,2020,67512,274388,341900,MKT
06079802205090000,2019,67512,274388,341900,MKT
06079802205110000,2021,107783,288717,396500,MKT
06079802205110000,2020,67512,280988,348500,MKT
06079802205110000,2019,67512,280988,348500,MKT
06079802205130000,2021,107783,255617,363400,MKT
06079802205130000,2020,67512,255488,323000,MKT
06079802205130000,2019,67512,255488,323000,MKT
06079802205150000,2021,130362,295038,425400,MKT
06079802205150000,2020,97861,277739,375600,MKT
06079802205150000,2019,97861,277739,375600,MKT
06079802205175001,2021,123742,223958,347700,MKT
06079802205175001,2020,76065,254035,330100,MKT
06079802205175001,2019,76065,254035,330100,MKT
06079802205195002,2021,96757,256243,353000,MKT
06079802205195002,2020,54689,298211,352900,MKT
06079802205195002,2019,54689,298211,352900,MKT
06079802205210000,2021,96757,0,96757,COST
06079802205210000,2020,54689,0,54689,COST
06079802205210000,2019,54689,0,54689,COST
06079802205230000,2021,98216,0,98216,COST
06079802205230000,2020,56311,0,56311,COST
06079802205230000,2019,56311,0,56311,COST
06079802205245001,2021,104401,239499,343900,MKT
06079802205245001,2020,63438,260562,324000,MKT
06079802205245001,2019,63438,260562,324000,MKT
06079802205265002,2021,95218,237382,332600,MKT
06079802205265002,2020,53004,256696,309700,MKT
06079802205265002,2019,53004,256696,309700,MKT
06079802205285001,2021,95218,238482,333700,MKT
06079802205285001,2020,53004,257996,311000,MKT
06079802205285001,2019,53004,257996,311000,MKT
06079802205305002,2021,95218,238482,333700,MKT
06079802205305002,2020,53004,257996,311000,MKT
06079802205305002,2019,53004,257996,311000,MKT
06079802205325001,2021,95218,238482,333700,MKT
06079802205325001,2020,53004,257996,311000,MKT
06079802205325001,2019,53004,257996,311000,MKT
06079802205335002,2021,95218,238482,333700,MKT
06079802205335002,2020,53004,257996,311000,MKT
06079802205335002,2019,53004,257996,311000,MKT
06079802205355001,2021,95218,211482,306700,MKT
06079802205355001,2020,53004,220796,273800,MKT
06079802205355001,2019,53004,220796,273800,MKT
06079802205375002,2021,95218,211482,306700,MKT
06079802205375002,2020,53004,220896,273900,MKT
06079802205375002,2019,53004,220896,273900,MKT
06079802205395001,2021,95218,207882,303100,MKT
06079802205395001,2020,53004,225496,278500,MKT
06079802205395001,2019,53004,225496,278500,MKT
06079802205415002,2021,95218,213382,308600,MKT
06079802205415002,2020,53004,223096,276100,MKT
06079802205415002,2019,53004,223096,276100,MKT
06079802205435001,2021,95218,211482,306700,MKT
06079802205435001,2020,53004,220796,273800,MKT
06079802205435001,2019,53004,220796,273800,MKT
06079802205455002,2021,95218,211482,306700,MKT
06079802205455002,2020,53004,220896,273900,MKT
06079802205455002,2019,53004,220896,273900,MKT
06079802205475001,2021,95218,208482,303700,MKT
06079802205475001,2020,53004,220696,273700,MKT
06079802205475001,2019,53004,220696,273700,MKT
06079802205495002,2021,95218,208482,303700,MKT
06079802205495002,2020,53004,220696,273700,MKT
06079802205495002,2019,53004,220696,273700,MKT
06079802205515001,2021,95218,208482,303700,MKT
06079802205515001,2020,53004,220696,273700,MKT
06079802205515001,2019,53004,220696,273700,MKT
06079802205535002,2021,95218,208482,303700,MKT
06079802205535002,2020,53004,220696,273700,MKT
06079802205535002,2019,53004,220696,273700,MKT
06079802205555001,2021,95218,208482,303700,MKT
06079802205555001,2020,53004,220696,273700,MKT
06079802205555001,2019,53004,220696,273700,MKT
06079802205575002,2021,103289,210311,313600,MKT
06079802205575002,2020,62127,220873,283000,MKT
06079802205575002,2019,62127,220873,283000,MKT
06079802206010000,2021,128752,254748,383500,MKT
06079802206010000,2020,82193,245107,327300,MKT
06079802206010000,2019,82193,245107,327300,MKT
06079802206030000,2021,126736,314764,441500,MKT
06079802206030000,2020,79699,322001,401700,MKT
06079802206030000,2019,79699,322001,401700,MKT
06079802206040000,2021,124974,287326,412300,MKT
06079802206040000,2020,77551,296049,373600,MKT
06079802206040000,2019,77551,296049,373600,MKT
06079802206060000,2021,120874,316426,437300,MKT
06079802206060000,2020,72663,323137,395800,MKT
06079802206060000,2019,72663,323137,395800,MKT
06079802206080000,2021,117944,345656,463600,MKT
06079802206080000,2020,69264,340236,409500,MKT
06079802206080000,2019,69264,340836,410100,MKT
06079802206100000,2021,116597,282303,398900,MKT
06079802206100000,2020,67729,276471,344200,MKT
06079802206100000,2019,67729,276571,344300,MKT
06079802206120000,2021,116406,307694,424100,MKT
06079802206120000,2020,67512,296388,363900,MKT
06079802206120000,2019,67512,296388,363900,MKT
06079802206140000,2021,117799,280001,397800,MKT
06079802206140000,2020,80298,274802,355100,MKT
06079802206140000,2019,80298,274802,355100,MKT
06079802206160000,2021,107783,257617,365400,MKT
06079802206160000,2020,67512,259188,326700,MKT
06079802206160000,2019,67512,259188,326700,MKT
06079802206180000,2021,118678,308722,427400,MKT
06079802206180000,2020,81472,299728,381200,MKT
06079802206180000,2019,81472,299728,381200,MKT
06079802206200000,2021,116778,302622,419400,MKT
06079802206200000,2020,78945,273755,352700,MKT
06079802206200000,2019,78945,273755,352700,MKT
06079802206220000,2021,116975,346225,463200,MKT
06079802206220000,2020,79205,314395,393600,MKT
06079802206220000,2019,79205,314395,393600,MKT
06079802206240000,2021,119254,298546,417800,MKT
06079802206240000,2020,82245,313955,396200,MKT
06079802206240000,2019,82245,313955,396200,MKT
06079802207016500,2021,40931,0,40931,COST
06079802207016500,2020,32088,0,32088,COST
06079802207016500,2019,32088,0,32088,COST
06079802207030000,2021,130473,329127,459600,MKT
06079802207030000,2020,84351,341749,426100,MKT
06079802207030000,2019,84351,341749,426100,MKT
06079802207050000,2021,134296,366504,500800,MKT
06079802207050000,2020,89242,352058,441300,MKT
06079802207050000,2019,89242,352058,441300,MKT
06079802207070000,2021,132904,345696,478600,MKT
06079802207070000,2020,87445,353555,441000,MKT
06079802207070000,2019,87445,353555,441000,MKT
06079802207090000,2021,132904,388496,521400,MKT
06079802207090000,2020,87445,369855,457300,MKT
06079802207090000,2019,87445,369855,457300,MKT
06079802207110000,2021,132904,457796,590700,MKT
06079802207110000,2020,87445,414155,501600,MKT
06079802207110000,2019,87445,414155,501600,MKT
06079802207130000,2021,132904,347796,480700,MKT
06079802207130000,2020,87445,348455,435900,MKT
06079802207130000,2019,87445,348455,435900,MKT
06079802207150000,2021,137403,323097,460500,MKT
06079802207150000,2020,93317,329883,423200,MKT
06079802207150000,2019,93317,329883,423200,MKT
06079802207170000,2021,118276,356524,474800,MKT
06079802207170000,2020,80934,353366,434300,MKT
06079802207170000,2019,80934,353366,434300,MKT
06079802207190000,2021,107783,278917,386700,MKT
06079802207190000,2020,67512,267888,335400,MKT
06079802207190000,2019,67512,267888,335400,MKT
06079802207210000,2021,107783,281317,389100,MKT
06079802207210000,2020,67512,278288,345800,MKT
06079802207210000,2019,67512,278288,345800,MKT
06079802207230000,2021,107783,289517,397300,MKT
06079802207230000,2020,67512,284488,352000,MKT
06079802207230000,2019,67512,284488,352000,MKT
06079802207250000,2021,114474,322126,436600,MKT
06079802207250000,2020,75933,298767,374700,MKT
06079802207250000,2019,75933,298767,374700,MKT
06079802207270000,2021,114629,371471,486100,MKT
06079802207270000,2020,76134,346866,423000,MKT
06079802207270000,2019,76134,344966,421100,MKT
06079802208016500,2021,39711,0,39711,COST
06079802208016500,2020,30248,0,30248,COST
06079802208016500,2019,30248,0,30248,COST
06079802208030000,2021,114961,266339,381300,MKT
06079802208030000,2020,76566,265134,341700,MKT
06079802208030000,2019,76566,265134,341700,MKT
06079802208050000,2021,117960,244740,362700,MKT
06079802208050000,2020,80513,245787,326300,MKT
06079802208050000,2019,80513,245787,326300,MKT
06079802208070000,2021,107783,291017,398800,MKT
06079802208070000,2020,67512,282188,349700,MKT
06079802208070000,2019,67512,282188,349700,MKT
06079802208090000,2021,114807,330193,445000,MKT
06079802208090000,2020,76366,317534,393900,MKT
06079802208090000,2019,76366,317534,393900,MKT
06079802208110000,2021,115900,505200,621100,MKT
06079802208110000,2020,77791,438309,516100,MKT
06079802208110000,2019,77791,438309,516100,MKT
06079802208135001,2021,98105,235895,334000,MKT
06079802208135001,2020,56186,247814,304000,MKT
06079802208135001,2019,56186,247814,304000,MKT
06079802208155002,2021,94590,240110,334700,MKT
06079802208155002,2020,52324,263576,315900,MKT
06079802208155002,2019,52324,263576,315900,MKT
06079802208175001,2021,94590,233010,327600,MKT
06079802208175001,2020,52324,244876,297200,MKT
06079802208175001,2019,52324,244876,297200,MKT
06079802208195002,2021,94590,233010,327600,MKT
06079802208195002,2020,52324,244876,297200,MKT
06079802208195002,2019,52324,244876,297200,MKT
06079802208215001,2021,94590,234210,328800,MKT
06079802208215001,2020,52324,244476,296800,MKT
06079802208215001,2019,52324,244476,296800,MKT
06079802208235002,2021,94590,233010,327600,MKT
06079802208235002,2020,52324,244476,296800,OVR
06079802208235002,2019,52324,244476,296800,MKT
06079802208255001,2021,94590,234210,328800,MKT
06079802208255001,2020,52324,244476,296800,MKT
06079802208255001,2019,52324,244476,296800,MKT
06079802208275002,2021,94590,234210,328800,MKT
06079802208275002,2020,52324,244476,296800,MKT
06079802208275002,2019,52324,244476,296800,MKT
06079802208295001,2021,94590,220310,314900,MKT
06079802208295001,2020,52324,233776,286100,MKT
06079802208295001,2019,52324,233776,286100,MKT
06079802208315002,2021,94648,221452,316100,MKT
06079802208315002,2020,52387,233813,286200,MKT
06079802208315002,2019,52387,233813,286200,MKT
06079802209016500,2021,40815,0,40815,COST
06079802209016500,2020,31910,0,31910,COST
06079802209016500,2019,31910,0,31910,COST
06079802209030000,2021,754899,3829201,4584100,INCOME
06079802209030000,2020,722599,2757601,3480200,INCOME
06079802209030000,2019,722599,2757601,3480200,INCOME
06079802210016500,2021,77441,0,77441,COST
06079802210016500,2020,111392,0,111392,COST
06079802210016500,2019,111392,0,111392,COST
06079802210016501,2021,93074,0,93074,COST
06079802210016501,2020,159485,0,159485,COST
06079802210016501,2019,159485,0,159485,COST
06079802210020000,2021,126936,290064,417000,MKT
06079802210020000,2020,79945,285555,365500,MKT
06079802210020000,2019,79945,285555,365500,MKT
06079802210040000,2021,123783,262817,386600,MKT
06079802210040000,2020,76115,235085,311200,MKT
06079802210040000,2019,76115,235085,311200,MKT
06079802210060000,2021,123783,343717,467500,MKT
06079802210060000,2020,76115,310985,387100,MKT
06079802210060000,2019,76115,310985,387100,MKT
06079802210080000,2021,123783,318417,442200,MKT
06079802210080000,2020,76115,324585,400700,MKT
06079802210080000,2019,76115,324585,400700,MKT
06079802210100000,2021,123783,324217,448000,MKT
06079802210100000,2020,76115,315685,391800,MKT
06079802210100000,2019,76115,315685,391800,MKT
06079802210120000,2021,123783,355417,479200,MKT
06079802210120000,2020,76115,352785,428900,MKT
06079802210120000,2019,76115,352785,428900,MKT
06079802210140000,2021,124816,309284,434100,MKT
06079802210140000,2020,77360,320140,397500,MKT
06079802210140000,2019,77360,320140,397500,MKT
06079802210160000,2021,127019,270081,397100,MKT
06079802210160000,2020,80047,259953,340000,MKT
06079802210160000,2019,80047,259953,340000,MKT
06079802210180000,2021,128569,0,128569,COST
06079802210180000,2020,81965,0,81965,COST
06079802210180000,2019,81965,0,81965,COST
06079802210205001,2021,113183,188217,301400,MKT
06079802210205001,2020,63912,200288,264200,MKT
06079802210205001,2019,63912,200288,264200,MKT
06079802210205002,2021,97278,187922,285200,MKT
06079802210205002,2020,55265,198335,253600,MKT
06079802210205002,2019,55265,198335,253600,MKT
06079802210225001,2021,101221,187979,289200,MKT
06079802210225001,2020,59722,200278,260000,MKT
06079802210225001,2019,59722,200278,260000,MKT
06079802210225002,2021,100317,187983,288300,MKT
06079802210225002,2020,58685,198215,256900,MKT
06079802210225002,2019,58685,198215,256900,MKT
06079802210245001,2021,97278,207322,304600,MKT
06079802210245001,2020,55265,221535,276800,MKT
06079802210245001,2019,55265,221535,276800,MKT
06079802210245002,2021,97278,207322,304600,MKT
06079802210245002,2020,55265,221535,276800,MKT
06079802210245002,2019,55265,221535,276800,MKT
06079802210265001,2021,97278,207322,304600,MKT
06079802210265001,2020,55265,221535,276800,MKT
06079802210265001,2019,55265,221535,276800,MKT
06079802210265002,2021,97278,207322,304600,MKT
06079802210265002,2020,55265,221535,276800,MKT
06079802210265002,2019,55265,221535,276800,MKT
06079802210285001,2021,97278,230722,328000,MKT
06079802210285001,2020,55265,237135,292400,MKT
06079802210285001,2019,55265,237335,292600,MKT
06079802210285002,2021,97278,229922,327200,MKT
06079802210285002,2020,55265,237335,292600,MKT
06079802210285002,2019,55265,237335,292600,MKT
06079802210305001,2021,97278,226222,323500,MKT
06079802210305001,2020,55265,237535,292800,MKT
06079802210305001,2019,55265,237535,292800,MKT
06079802210305002,2021,97278,218222,315500,MKT
06079802210305002,2020,55265,233535,288800,MKT
06079802210305002,2019,55265,233535,288800,MKT
06079802210315001,2021,97278,225122,322400,MKT
06079802210315001,2020,55265,236835,292100,MKT
06079802210315001,2019,55265,236835,292100,MKT
06079802210315002,2021,97278,225122,322400,MKT
06079802210315002,2020,55265,236835,292100,MKT
06079802210315002,2019,55265,236835,292100,MKT
06079802210325001,2021,97278,219922,317200,MKT
06079802210325001,2020,55265,235635,290900,MKT
06079802210325001,2019,55265,235635,290900,MKT
06079802210325002,2021,97278,218322,315600,MKT
06079802210325002,2020,55265,233635,288900,MKT
06079802210325002,2019,55265,233635,288900,MKT
06079802210345001,2021,97278,255422,352700,MKT
06079802210345001,2020,55265,273335,328600,MKT
06079802210345001,2019,55265,273335,328600,MKT
06079802210345002,2021,104300,254200,358500,MKT
06079802210345002,2020,63320,291780,355100,MKT
06079802210345002,2019,63320,291780,355100,MKT
06079802211025001,2021,118675,228625,347300,MKT
06079802211025001,2020,84547,250053,334600,MKT
06079802211025001,2019,84547,250053,334600,MKT
06079802211025002,2021,107916,235284,343200,MKT
06079802211025002,2020,70233,252567,322800,MKT
06079802211025002,2019,70233,252567,322800,MKT
06079802211045001,2021,107956,226844,334800,MKT
06079802211045001,2020,70285,236015,306300,MKT
06079802211045001,2019,70285,236015,306300,MKT
06079802211045002,2021,107956,243844,351800,MKT
06079802211045002,2020,70285,254015,324300,MKT
06079802211045002,2019,70285,254015,324300,MKT
06079802211065001,2021,107239,264361,371600,MKT
06079802211065001,2020,69376,286024,355400,MKT
06079802211065001,2019,69376,286024,355400,MKT
06079802211065002,2021,107006,264594,371600,MKT
06079802211065002,2020,69082,287318,356400,MKT
06079802211065002,2019,69082,287318,356400,MKT
06079802211085001,2021,107006,264094,371100,MKT
06079802211085001,2020,69082,286618,355700,MKT
06079802211085001,2019,69082,286618,355700,MKT
06079802211085002,2021,125059,274541,399600,MKT
06079802211085002,2020,93652,284848,378500,MKT
06079802211085002,2019,93652,284848,378500,MKT
06079802212025001,2021,106245,219755,326000,MKT
06079802212025001,2020,65645,239055,304700,MKT
06079802212025001,2019,65645,239055,304700,MKT
06079802212025002,2021,97430,222770,320200,MKT
06079802212025002,2020,55434,239066,294500,MKT
06079802212025002,2019,55434,239066,294500,MKT
06079802212045001,2021,97430,312170,409600,MKT
06079802212045001,2020,55434,342766,398200,MKT
06079802212045001,2019,55434,342766,398200,MKT
06079802212045002,2021,97430,270670,368100,MKT
06079802212045002,2020,55434,279466,334900,MKT
06079802212045002,2019,55434,279466,334900,MKT
06079802212065001,2021,97430,262770,360200,MKT
06079802212065001,2020,55434,297366,352800,MKT
06079802212065001,2019,55434,297366,352800,MKT
06079802212065002,2021,97430,243170,340600,MKT
06079802212065002,2020,55434,262966,318400,MKT
06079802212065002,2019,55434,263166,318600,MKT
06079802212105001,2021,97430,263570,361000,MKT
06079802212105001,2020,55434,297466,352900,MKT
06079802212105001,2019,55434,297466,352900,MKT
06079802212105002,2021,97430,244770,342200,MKT
06079802212105002,2020,55434,263266,318700,MKT
06079802212105002,2019,55434,263266,318700,MKT
06079802212125001,2021,97430,218770,316200,MKT
06079802212125001,2020,55434,233566,289000,MKT
06079802212125001,2019,55434,233566,289000,MKT
06079802212125002,2021,110773,218727,329500,MKT
06079802212125002,2020,71216,233684,304900,MKT
06079802212125002,2019,71216,233684,304900,MKT
06079802212140000,2021,114904,275696,390600,MKT
06079802212140000,2020,76491,257809,334300,MKT
06079802212140000,2019,76491,257809,334300,MKT
06079802212160000,2021,107783,280617,388400,MKT
06079802212160000,2020,67512,270188,337700,OVR
06079802212160000,2019,67512,270188,337700,MKT
06079802212180000,2021,107783,297417,405200,MKT
06079802212180000,2020,67512,294088,361600,OVR
06079802212180000,2019,67512,294088,361600,MKT
06079802212200000,2021,107783,281317,389100,MKT
06079802212200000,2020,67512,265988,333500,MKT
06079802212200000,2019,67512,265988,333500,MKT
06079802212220000,2021,107783,250017,357800,MKT
06079802212220000,2020,67512,250188,317700,MKT
06079802212220000,2019,67512,250188,317700,MKT
06079802212240000,2021,107783,249917,357700,MKT
06079802212240000,2020,67512,249988,317500,MKT
06079802212240000,2019,67512,249988,317500,MKT
06079802212260000,2021,115319,288281,403600,MKT
06079802212260000,2020,77032,270668,347700,MKT
06079802212260000,2019,77032,270668,347700,MKT
06079802213025001,2021,112693,192507,305200,MKT
06079802213025001,2020,73645,212355,286000,MKT
06079802213025001,2019,73645,217155,290800,MKT
06079802213025002,2021,100057,201743,301800,MKT
06079802213025002,2020,58389,217111,275500,OVR
06079802213025002,2019,58389,217111,275500,MKT
06079802213045001,2021,100057,219443,319500,MKT
06079802213045001,2020,58389,234711,293100,MKT
06079802213045001,2019,58389,234711,293100,MKT
06079802213045002,2021,100057,226743,326800,MKT
06079802213045002,2020,58389,237511,295900,MKT
06079802213045002,2019,58389,237511,295900,MKT
06079802213065001,2021,100057,220543,320600,MKT
06079802213065001,2020,58389,219511,277900,MKT
06079802213065001,2019,58389,218411,276800,MKT
06079802213065002,2021,100057,230843,330900,MKT
06079802213065002,2020,58389,222411,280800,MKT
06079802213065002,2019,58389,222411,280800,MKT
06079802213085002,2021,100057,185743,285800,MKT
06079802213085002,2020,58389,184711,243100,MKT
06079802213085002,2019,58389,184711,243100,MKT
06079802213105001,2021,100057,220443,320500,MKT
06079802213105001,2020,58389,235211,293600,MKT
06079802213105001,2019,58389,235211,293600,MKT
06079802213105002,2021,100057,218643,318700,MKT
06079802213105002,2020,58389,233211,291600,MKT
06079802213105002,2019,58389,233211,291600,MKT
06079802213125001,2021,101823,245377,347200,MKT
06079802213125001,2020,60417,265083,325500,MKT
06079802213125001,2019,60417,265083,325500,MKT
06079802213125002,2021,121307,255693,377000,MKT
06079802213125002,2020,85032,265868,350900,MKT
06079802213125002,2019,85032,265868,350900,MKT
06079802213145001,2021,120506,246494,367000,MKT
06079802213145001,2020,83939,263861,347800,MKT
06079802213145001,2019,83939,263861,347800,MKT
06079802213145002,2021,100609,245291,345900,MKT
06079802213145002,2020,59019,263481,322500,MKT
06079802213145002,2019,59019,263481,322500,MKT
06079802213165001,2021,101648,238052,339700,MKT
06079802213165001,2020,60215,243585,303800,MKT
06079802213165001,2019,60215,243585,303800,MKT
06079802213165002,2021,101472,238028,339500,MKT
06079802213165002,2020,60012,243588,303600,MKT
06079802213165002,2019,60012,243588,303600,MKT
06079802213185001,2021,101289,238011,339300,MKT
06079802213185001,2020,59801,243599,303400,MKT
06079802213185001,2019,59801,243599,303400,MKT
06079802213185002,2021,106548,238052,344600,MKT
06079802213185002,2020,66011,243689,309700,MKT
06079802213185002,2019,66011,243689,309700,MKT
06079802214025001,2021,105759,241041,346800,MKT
06079802214025001,2020,65060,247140,312200,MKT
06079802214025001,2019,65060,247140,312200,MKT
06079802214025002,2021,94615,232285,326900,MKT
06079802214025002,2020,52351,242849,295200,MKT
06079802214025002,2019,52351,242849,295200,MKT
06079802214045001,2021,98768,232332,331100,MKT
06079802214045001,2020,56929,242871,299800,MKT
06079802214045001,2019,56929,242871,299800,MKT
06079802214045002,2021,98768,232332,331100,MKT
06079802214045002,2020,56929,242871,299800,MKT
06079802214045002,2019,56929,242871,299800,MKT
06079802214065001,2021,98768,229032,327800,MKT
06079802214065001,2020,56929,240171,297100,MKT
06079802214065001,2019,56929,240171,297100,MKT
06079802214065002,2021,98768,229032,327800,MKT
06079802214065002,2020,56929,240171,297100,MKT
06079802214065002,2019,56929,240171,297100,MKT
06079802214085001,2021,98768,232332,331100,MKT
06079802214085001,2020,56929,242871,299800,MKT
06079802214085001,2019,56929,242871,299800,MKT
06079802214085002,2021,105034,232566,337600,MKT
06079802214085002,2020,64192,242808,307000,MKT
06079802214085002,2019,64192,242808,307000,MKT
06079802214100000,2021,117039,260761,377800,MKT
06079802214100000,2020,79290,245310,324600,MKT
06079802214100000,2019,79290,245310,324600,MKT
06079802214120000,2021,107783,259017,366800,MKT
06079802214120000,2020,67512,249888,317400,MKT
06079802214120000,2019,67512,249888,317400,MKT
06079802214140000,2021,114152,278148,392300,MKT
06079802214140000,2020,75518,268782,344300,OVR
06079802214140000,2019,75518,268782,344300,MKT
06079802214160000,2021,107783,278617,386400,MKT
06079802214160000,2020,67512,268188,335700,MKT
06079802214160000,2019,67512,268188,335700,MKT
06079802214180000,2021,116436,259064,375500,MKT
06079802214180000,2020,78495,256805,335300,MKT
06079802214180000,2019,78495,256805,335300,MKT
06079802216020000,2021,119703,254197,373900,MKT
06079802216020000,2020,82850,245250,328100,OVR
06079802216020000,2019,82850,245250,328100,MKT
06079802216040000,2021,107783,274117,381900,MKT
06079802216040000,2020,67512,257288,324800,MKT
06079802216040000,2019,67512,256588,324100,MKT
06079802216060000,2021,107783,256517,364300,MKT
06079802216060000,2020,67512,247188,314700,MKT
06079802216060000,2019,67512,247188,314700,MKT
06079802216080000,2021,107783,264217,372000,MKT
06079802216080000,2020,67512,253788,321300,MKT
06079802216080000,2019,67512,253788,321300,MKT
06079802216100000,2021,119137,258163,377300,MKT
06079802216100000,2020,82088,246612,328700,OVR
06079802216100000,2019,82088,246612,328700,MKT
06079802216125001,2021,102349,302451,404800,MKT
06079802216125001,2020,61028,345172,406200,MKT
06079802216125001,2019,61028,345172,406200,MKT
06079802216125002,2021,98768,271332,370100,MKT
06079802216125002,2020,56929,280671,337600,MKT
06079802216125002,2019,56929,280671,337600,MKT
06079802216145001,2021,98768,227132,325900,MKT
06079802216145001,2020,56929,241971,298900,MKT
06079802216145001,2019,56929,240771,297700,MKT
06079802216145002,2021,98768,226832,325600,MKT
06079802216145002,2020,56929,240971,297900,OVR
06079802216145002,2019,56929,240971,297900,MKT
06079802216165001,2021,98768,226032,324800,MKT
06079802216165001,2020,56929,240771,297700,MKT
06079802216165001,2019,56929,240771,297700,MKT
06079802216165002,2021,98768,230432,329200,MKT
06079802216165002,2020,56929,242571,299500,MKT
06079802216165002,2019,56929,242571,299500,MKT
06079802216185001,2021,98768,228732,327500,MKT
06079802216185001,2020,56929,245471,302400,MKT
06079802216185001,2019,56929,245471,302400,MKT
06079802216185002,2021,101493,227607,329100,MKT
06079802216185002,2020,60035,242165,302200,MKT
06079802216185002,2019,60035,242165,302200,MKT
06079802218025001,2021,104294,212206,316500,MKT
06079802218025001,2020,63312,240088,303400,MKT
06079802218025001,2019,63312,240088,303400,MKT
06079802218025002,2021,100394,216706,317100,MKT
06079802218025002,2020,58773,245627,304400,MKT
06079802218025002,2019,58773,245627,304400,MKT
06079802218045001,2021,100212,211688,311900,MKT
06079802218045001,2020,58565,239035,297600,MKT
06079802218045001,2019,58565,239035,297600,MKT
06079802218045002,2021,100022,211678,311700,MKT
06079802218045002,2020,58349,239051,297400,MKT
06079802218045002,2019,58349,239051,297400,MKT
06079802218065001,2021,99839,211761,311600,MKT
06079802218065001,2020,58140,239060,297200,MKT
06079802218065001,2019,58140,239060,297200,MKT
06079802218065002,2021,99647,211953,311600,MKT
06079802218065002,2020,57923,239177,297100,MKT
06079802218065002,2019,57923,239177,297100,MKT
06079802218085001,2021,99454,201946,301400,MKT
06079802218085001,2020,57704,220096,277800,MKT
06079802218085001,2019,57704,220096,277800,MKT
06079802218085002,2021,101963,173237,275200,MKT
06079802218085002,2020,60580,189420,250000,MKT
06079802218085002,2019,60580,189420,250000,MKT
06079802220025001,2021,102455,255745,358200,MKT
06079802220025001,2020,61151,266849,328000,MKT
06079802220025001,2019,61151,268749,329900,MKT
06079802220025002,2021,99382,255718,355100,MKT
06079802220025002,2020,57623,266877,324500,MKT
06079802220025002,2019,57623,268777,326400,MKT
06079802220045001,2021,99382,176518,275900,MKT
06079802220045001,2020,57623,185577,243200,OVR
06079802220045001,2019,57623,185577,243200,MKT
06079802220045002,2021,99382,185818,285200,MKT
06079802220045002,2020,57623,199277,256900,OVR
06079802220045002,2019,57623,199277,256900,MKT
06079802220055001,2021,99382,169018,268400,MKT
06079802220055001,2020,57623,169077,226700,MKT
06079802220055001,2019,57623,169077,226700,MKT
06079802220055002,2021,102017,168883,270900,MKT
06079802220055002,2020,60642,168958,229600,MKT
06079802220055002,2019,60642,168958,229600,MKT
06079802220065001,2021,99382,168818,268200,MKT
06079802220065001,2020,57623,168877,226500,MKT
06079802220065001,2019,57623,168877,226500,MKT
06079802220065002,2021,99382,168918,268300,MKT
06079802220065002,2020,57623,168977,226600,MKT
06079802220065002,2019,57623,168977,226600,MKT
06079802220100000,2021,226011,0,226011,COST
06079802220100000,2020,286456,0,286456,COST
06079802220100000,2019,286456,0,286456,COST
06079802220150000,2021,251150,8062080,8313230,COST
06079802220150000,2020,351933,5629267,5981200,INCOME
06079802220150000,2019,351933,5629267,5981200,INCOME
06079802222016500,2021,34098,0,34098,COST
06079802222016500,2020,22465,0,22465,COST
06079802222016500,2019,22465,0,22465,COST
06079802222026500,2021,38658,0,38658,COST
06079802222026500,2020,28702,0,28702,COST
06079802222026500,2019,28702,0,28702,COST
06079802222050000,2021,2096520,20503400,22599920,COST
06079802222050000,2020,1384947,20362390,21747337,COST
06079802222050000,2019,1384947,20362390,21747337,COST
06079802223010000,2021,130671,321729,452400,MKT
06079802223010000,2020,102031,297469,399500,MKT
06079802223010000,2019,102031,288669,390700,MKT
06079802223030000,2021,125026,365174,490200,MKT
06079802223030000,2020,93604,325396,419000,MKT
06079802223030000,2019,93604,325396,419000,MKT
06079802223050000,2021,125026,279874,404900,MKT
06079802223050000,2020,93604,269796,363400,MKT
06079802223050000,2019,93604,269796,363400,MKT
06079802223070000,2021,125026,259774,384800,MKT
06079802223070000,2020,93604,234396,328000,MKT
06079802223070000,2019,93604,234396,328000,MKT
06079802223090000,2021,125026,254374,379400,MKT
06079802223090000,2020,93604,240996,334600,MKT
06079802223090000,2019,93604,240996,334600,MKT
06079802223110000,2021,124737,341663,466400,MKT
06079802223110000,2020,93182,324718,417900,OVR
06079802223110000,2019,93182,324718,417900,MKT
06079802223130000,2021,126277,258523,384800,MKT
06079802223130000,2020,95442,238558,334000,MKT
06079802223130000,2019,95442,238558,334000,MKT
06079802223150000,2021,126277,258523,384800,MKT
06079802223150000,2020,95442,244458,339900,MKT
06079802223150000,2019,95442,244458,339900,MKT
06079802223170000,2021,118561,277139,395700,MKT
06079802223170000,2020,84390,271310,355700,MKT
06079802223170000,2019,84390,271310,355700,MKT
06079802230010000,2021,116385,0,116385,COST
06079802230010000,2020,78428,0,78428,COST
06079802230010000,2019,78428,0,78428,COST
06079802230030000,2021,107414,0,107414,COST
06079802230030000,2020,67062,0,67062,COST
06079802230030000,2019,67062,0,67062,COST
06079802230050000,2021,107484,0,107484,COST
06079802230050000,2020,67147,0,67147,COST
06079802230050000,2019,67147,0,67147,COST
06079802230070000,2021,107553,0,107553,COST
06079802230070000,2020,67231,0,67231,COST
06079802230070000,2019,67231,0,67231,COST
06079802230090000,2021,107616,0,107616,COST
06079802230090000,2020,67308,0,67308,COST
06079802230090000,2019,67308,0,67308,COST
06079802230110000,2021,107685,0,107685,COST
06079802230110000,2020,67393,0,67393,COST
06079802230110000,2019,67393,0,67393,COST
06079802230130000,2021,107754,0,107754,COST
06079802230130000,2020,67477,0,67477,COST
06079802230130000,2019,67477,0,67477,COST
06079802230150000,2021,116469,0,116469,COST
06079802230150000,2020,78538,0,78538,COST
06079802230150000,2019,78538,0,78538,COST
06079802231017000,2021,262160,0,262160,COST
06079802231017000,2020,382675,0,382675,COST
06079802231017000,2019,382675,0,382675,COST
06079802232010000,2021,1346872,4684460,6031332,COST
06079802232010000,2020,1052266,4547220,5599486,COST
06079802232010000,2019,1052266,4547220,5599486,COST
06079802233016500,2021,86518,0,86518,COST
06079802233016500,2020,138294,0,138294,COST
06079802233016500,2019,138294,0,138294,COST
06079802233030000,2021,128049,317251,445300,MKT
06079802233030000,2020,98073,367827,465900,MKT
06079802233030000,2019,98073,367827,465900,MKT
06079802233050000,2021,128049,307751,435800,MKT
06079802233050000,2020,98073,286627,384700,MKT
06079802233050000,2019,98073,286627,384700,MKT
06079802233070000,2021,128049,269951,398000,MKT
06079802233070000,2020,98073,256927,355000,MKT
06079802233070000,2019,98073,256927,355000,MKT
06079802233090000,2021,128049,309351,437400,MKT
06079802233090000,2020,98073,305527,403600,MKT
06079802233090000,2019,98073,305527,403600,MKT
06079802233110000,2021,128339,242761,371100,MKT
06079802233110000,2020,98507,233393,331900,MKT
06079802233110000,2019,98507,233393,331900,MKT
06079802234016500,2021,61051,0,61051,COST
06079802234016500,2020,70027,0,70027,COST
06079802234016500,2019,70027,0,70027,COST
06079802235010000,2021,117803,0,117803,COST
06079802235010000,2020,80304,0,80304,COST
06079802235010000,2019,80304,0,80304,COST
06079802235030000,2021,110049,0,110049,COST
06079802235030000,2020,70310,0,70310,COST
06079802235030000,2019,70310,0,70310,COST
06079802235050000,2021,110049,0,110049,COST
06079802235050000,2020,70310,0,70310,COST
06079802235050000,2019,70310,0,70310,COST
06079802235070000,2021,110049,136810,246859,COST
06079802235070000,2020,70310,0,70310,COST
06079802235070000,2019,70310,0,70310,COST
06079802235090000,2021,110049,194820,304869,COST
06079802235090000,2020,70310,0,70310,COST
06079802235090000,2019,70310,0,70310,COST
06079802235110000,2021,110049,366530,476579,COST
06079802235110000,2020,70310,0,70310,COST
06079802235110000,2019,70310,0,70310,COST
06079802235130000,2021,110049,254560,364609,COST
06079802235130000,2020,70310,0,70310,COST
06079802235130000,2019,70310,0,70310,COST
06079802235155001,2021,100547,160953,261500,MKT
06079802235155001,2020,58948,166952,225900,MKT
06079802235155001,2019,58948,0,58948,COST
06079802235175002,2021,99625,160675,260300,MKT
06079802235175002,2020,57898,166702,224600,MKT
06079802235175002,2019,57898,0,57898,COST
06079802235195001,2021,99625,160675,260300,MKT
06079802235195001,2020,57898,166702,224600,MKT
06079802235195001,2019,57898,0,57898,COST
06079802235215002,2021,100547,160953,261500,MKT
06079802235215002,2020,58948,167052,226000,MKT
06079802235215002,2019,58948,0,58948,COST
06079802235230000,2021,110049,0,110049,COST
06079802235230000,2020,70310,0,70310,COST
06079802235230000,2019,70310,0,70310,COST
06079802235250000,2021,110049,0,110049,COST
06079802235250000,2020,70310,0,70310,COST
06079802235250000,2019,70310,0,70310,COST
06079802235270000,2021,110049,0,110049,COST
06079802235270000,2020,70310,0,70310,COST
06079802235270000,2019,70310,0,70310,COST
06079802235290000,2021,110049,0,110049,COST
06079802235290000,2020,70310,0,70310,COST
06079802235290000,2019,70310,0,70310,COST
06079802235310000,2021,110049,0,110049,COST
06079802235310000,2020,70310,0,70310,COST
06079802235310000,2019,70310,0,70310,COST
06079802235330000,2021,110049,0,110049,COST
06079802235330000,2020,70310,0,70310,COST
06079802235330000,2019,70310,0,70310,COST
06079802235350000,2021,117803,0,117803,COST
06079802235350000,2020,80304,0,80304,COST
06079802235350000,2019,80304,0,80304,COST
06079802236010000,2021,118227,479773,598000,MKT
06079802236010000,2020,80869,0,80869,COST
06079802236010000,2019,80869,0,80869,COST
06079802236030000,2021,110335,341165,451500,MKT
06079802236030000,2020,70667,0,70667,COST
06079802236030000,2019,70667,0,70667,COST
06079802236050000,2021,110244,336856,447100,MKT
06079802236050000,2020,70553,0,70553,COST
06079802236050000,2019,70553,0,70553,COST
06079802236070000,2021,110147,338353,448500,MKT
06079802236070000,2020,70432,0,70432,COST
06079802236070000,2019,70432,0,70432,COST
06079802236090000,2021,110055,326945,437000,MKT
06079802236090000,2020,70317,0,70317,COST
06079802236090000,2019,70317,0,70317,COST
06079802236110000,2021,109963,473737,583700,MKT
06079802236110000,2020,70202,0,70202,COST
06079802236110000,2019,70202,0,70202,COST
06079802236130000,2021,109865,347935,457800,MKT
06079802236130000,2020,70081,0,70081,COST
06079802236130000,2019,70081,0,70081,COST
06079802236155002,2021,99682,160718,260400,MKT
06079802236155002,2020,57963,164437,222400,MKT
06079802236155002,2019,57963,0,57963,COST
06079802236175001,2021,99959,160441,260400,MKT
06079802236175001,2020,58277,166223,224500,MKT
06079802236175001,2019,58277,0,58277,COST
06079802236195002,2021,98957,160443,259400,MKT
06079802236195002,2020,57142,166258,223400,MKT
06079802236195002,2019,57142,0,57142,COST
06079802236215001,2021,100665,160735,261400,MKT
06079802236215001,2020,59083,166517,225600,MKT
06079802236215001,2019,59083,0,59083,COST
06079802236230000,2021,109865,456335,566200,MKT
06079802236230000,2020,70081,0,70081,COST
06079802236230000,2019,70081,0,70081,COST
06079802236250000,2021,109963,327037,437000,MKT
06079802236250000,2020,70202,0,70202,COST
06079802236250000,2019,70202,0,70202,COST
06079802236270000,2021,110055,347945,458000,MKT
06079802236270000,2020,70317,0,70317,COST
06079802236270000,2019,70317,0,70317,COST
06079802236290000,2021,110147,336953,447100,MKT
06079802236290000,2020,70432,0,70432,COST
06079802236290000,2019,70432,0,70432,COST
06079802236310000,2021,110244,482156,592400,MKT
06079802236310000,2020,70553,0,70553,COST
06079802236310000,2019,70553,0,70553,COST
06079802236330000,2021,110335,338965,449300,MKT
06079802236330000,2020,70667,0,70667,COST
06079802236330000,2019,70667,0,70667,COST
06079802236350000,2021,118227,336773,455000,MKT
06079802236350000,2020,80869,0,80869,COST
06079802236350000,2019,80869,0,80869,COST
06079802237015001,2021,91606,227894,319500,MKT
06079802237015001,2020,58084,236416,294500,MKT
06079802237015001,2019,58084,0,58084,COST
06079802237035002,2021,87358,249242,336600,MKT
06079802237035002,2020,52942,266758,319700,MKT
06079802237035002,2019,52942,0,52942,COST
06079802237055003,2021,87454,251646,339100,MKT
06079802237055003,2020,53056,273544,326600,MKT
06079802237055003,2019,53056,0,53056,COST
06079802237075004,2021,91924,252176,344100,MKT
06079802237075004,2020,58477,265123,323600,MKT
06079802237075004,2019,58477,0,58477,COST
06079802237095001,2021,92040,252160,344200,MKT
06079802237095001,2020,58621,265179,323800,MKT
06079802237095001,2019,58621,0,58621,COST
06079802237115002,2021,87771,251629,339400,MKT
06079802237115002,2020,53432,273368,326800,MKT
06079802237115002,2019,53432,0,53432,COST
06079802237135003,2021,87866,251634,339500,MKT
06079802237135003,2020,53545,273355,326900,MKT
06079802237135003,2019,53545,0,53545,COST
06079802237155004,2021,92353,252147,344500,MKT
06079802237155004,2020,59012,265088,324100,MKT
06079802237155004,2019,59012,0,59012,COST
06079802237175001,2021,92467,247633,340100,MKT
06079802237175001,2020,59154,0,59154,COST
06079802237175001,2019,59154,0,59154,COST
06079802237195002,2021,88178,248122,336300,MKT
06079802237195002,2020,53917,0,53917,COST
06079802237195002,2019,53917,0,53917,COST
06079802237215003,2021,88272,248028,336300,MKT
06079802237215003,2020,54029,0,54029,COST
06079802237215003,2019,54029,0,54029,COST
06079802237235004,2021,92777,257223,350000,MKT
06079802237235004,2020,59541,0,59541,COST
06079802237235004,2019,59541,0,59541,COST
06079802237255001,2021,92550,247550,340100,MKT
06079802237255001,2020,59257,0,59257,COST
06079802237255001,2019,59257,0,59257,COST
06079802237275002,2021,88077,248123,336200,MKT
06079802237275002,2020,53796,0,53796,COST
06079802237275002,2019,53796,0,53796,COST
06079802237295003,2021,87587,248113,335700,MKT
06079802237295003,2020,53214,0,53214,COST
06079802237295003,2019,53214,0,53214,COST
06079802237315004,2021,90548,247552,338100,MKT
06079802237315004,2020,56781,0,56781,COST
06079802237315004,2019,56781,0,56781,COST
06079802237336500,2021,32652,0,32652,COST
06079802237336500,2020,20644,0,20644,COST
06079802237336500,2019,20644,0,20644,COST
06079802238015002,2021,103903,163830,267733,COST
06079802238015002,2020,62849,0,62849,COST
06079802238015002,2019,62849,0,62849,COST
06079802238035001,2021,97769,163830,261599,COST
06079802238035001,2020,55811,0,55811,COST
06079802238035001,2019,55811,0,55811,COST
06079802238055002,2021,97769,144300,242069,COST
06079802238055002,2020,55811,0,55811,COST
06079802238055002,2019,55811,0,55811,COST
06079802238075001,2021,97769,144090,241859,COST
06079802238075001,2020,55811,0,55811,COST
06079802238075001,2019,55811,0,55811,COST
06079802238095002,2021,97769,0,97769,COST
06079802238095002,2020,55811,0,55811,COST
06079802238095002,2019,55811,0,55811,COST
06079802238115001,2021,103501,0,103501,COST
06079802238115001,2020,62376,0,62376,COST
06079802238115001,2019,62376,0,62376,COST
06079802239010000,2021,116801,0,116801,COST
06079802239010000,2020,78975,0,78975,COST
06079802239010000,2019,78975,0,78975,COST
06079802239030000,2021,109174,0,109174,COST
06079802239030000,2020,69223,0,69223,COST
06079802239030000,2019,69223,0,69223,COST
06079802239050000,2021,109174,0,109174,COST
06079802239050000,2020,69223,0,69223,COST
06079802239050000,2019,69223,0,69223,COST
06079802239070000,2021,109174,0,109174,COST
06079802239070000,2020,69223,0,69223,COST
06079802239070000,2019,69223,0,69223,COST
06079802239090000,2021,109174,0,109174,COST
06079802239090000,2020,69223,0,69223,COST
06079802239090000,2019,69223,0,69223,COST
06079802239110000,2021,116897,0,116897,COST
06079802239110000,2020,79102,0,79102,COST
06079802239110000,2019,79102,0,79102,COST
06079802240010000,2021,117112,353288,470400,MKT
06079802240010000,2020,79386,338414,417800,MKT
06079802240010000,2019,79386,338214,417600,MKT
06079802240030000,2021,113511,308689,422200,MKT
06079802240030000,2020,74692,291608,366300,MKT
06079802240030000,2019,74692,291608,366300,MKT
06079802240050000,2021,113506,292194,405700,MKT
06079802240050000,2020,74686,296914,371600,MKT
06079802240050000,2019,74686,296914,371600,MKT
06079802240070000,2021,107783,277117,384900,MKT
06079802240070000,2020,67512,281788,349300,MKT
06079802240070000,2019,67512,281788,349300,MKT
06079802240090000,2021,113506,287794,401300,MKT
06079802240090000,2020,74686,290814,365500,MKT
06079802240090000,2019,74686,290814,365500,MKT
06079802240110000,2021,113511,296889,410400,MKT
06079802240110000,2020,74692,295008,369700,MKT
06079802240110000,2019,74692,295008,369700,MKT
06079802240130000,2021,116787,304113,420900,MKT
06079802240130000,2020,78957,334443,413400,MKT
06079802240130000,2019,78957,334443,413400,MKT
06079802240150000,2021,116938,420562,537500,MKT
06079802240150000,2020,79157,376243,455400,MKT
06079802240150000,2019,79157,376243,455400,MKT
06079802240170000,2021,113027,262573,375600,MKT
06079802240170000,2020,74071,253029,327100,MKT
06079802240170000,2019,74071,253029,327100,MKT
06079802240190000,2021,113027,282973,396000,MKT
06079802240190000,2020,74071,287929,362000,MKT
06079802240190000,2019,74071,286029,360100,MKT
06079802240210000,2021,107800,262700,370500,MKT
06079802240210000,2020,67533,266367,333900,MKT
06079802240210000,2019,67533,266367,333900,MKT
06079802240230000,2021,113027,325773,438800,MKT
06079802240230000,2020,74071,299029,373100,MKT
06079802240230000,2019,74071,294529,368600,MKT
06079802240250000,2021,113027,271473,384500,MKT
06079802240250000,2020,74071,267529,341600,MKT
06079802240250000,2019,74071,267529,341600,MKT
06079802240270000,2021,117821,374779,492600,MKT
06079802240270000,2020,80328,371872,452200,MKT
06079802240270000,2019,80328,371872,452200,MKT
06079802241010000,2021,122555,306045,428600,MKT
06079802241010000,2020,86748,277352,364100,MKT
06079802241010000,2019,86748,274152,360900,MKT
06079802241030000,2021,122555,301445,424000,MKT
06079802241030000,2020,86748,287852,374600,MKT
06079802241030000,2019,86748,287852,374600,MKT
06079802241050000,2021,122555,299645,422200,MKT
06079802241050000,2020,86748,286152,372900,MKT
06079802241050000,2019,86748,286152,372900,MKT
06079802241070000,2021,122483,329017,451500,MKT
06079802241070000,2020,86648,306252,392900,MKT
06079802241070000,2019,86648,313750,400398,COST
06079802241096500,2021,34645,0,34645,COST
06079802241096500,2020,23175,0,23175,COST
06079802241096500,2019,23175,0,23175,COST
06079802241110000,2021,294103,0,294103,COST
06079802241110000,2020,478953,0,478953,COST
06079802241110000,2019,478953,0,478953,COST
06079802241156500,2021,64254,0,64254,COST
06079802241156500,2020,77377,0,77377,COST
06079802241156500,2019,77377,0,77377,COST
06079802242017000,2021,262438,0,262438,COST
06079802242017000,2020,383469,0,383469,COST
06079802242017000,2019,383469,0,383469,COST
06079802250010000,2021,126016,349284,475300,MKT
06079802250010000,2020,91594,330206,421800,MKT
06079802250010000,2019,91594,330206,421800,MKT
06079802250030000,2021,121104,279896,401000,MKT
06079802250030000,2020,84754,280446,365200,MKT
06079802250030000,2019,84754,280446,365200,MKT
06079802250046500,2021,61242,0,61242,COST
06079802250046500,2020,70455,0,70455,COST
06079802250046500,2019,70455,0,70455,COST
06079802250050000,2021,122143,309157,431300,MKT
06079802250050000,2020,86179,292721,378900,MKT
06079802250050000,2019,86179,292721,378900,MKT
06079802250070000,2021,122131,317669,439800,MKT
06079802250070000,2020,86163,298337,384500,MKT
06079802250070000,2019,86163,298337,384500,MKT
06079802250076500,2021,77651,0,77651,COST
06079802250076500,2020,111981,0,111981,COST
06079802250076500,2019,111981,0,111981,COST
06079802250090000,2021,122131,264169,386300,MKT
06079802250090000,2020,86163,250237,336400,MKT
06079802250090000,2019,86163,250237,336400,MKT
06079802250110000,2021,122131,258569,380700,MKT
06079802250110000,2020,86163,255037,341200,MKT
06079802250110000,2019,86163,255037,341200,MKT
06079802250130000,2021,122184,312816,435000,MKT
06079802250130000,2020,86235,293465,379700,MKT
06079802250130000,2019,86235,293465,379700,MKT
06079802250150000,2021,124421,304379,428800,MKT
06079802250150000,2020,89345,288055,377400,MKT
06079802250150000,2019,89345,288055,377400,MKT
06079802250170000,2021,114861,424339,539200,MKT
06079802250170000,2020,86075,388825,474900,MKT
06079802250170000,2019,86075,388825,474900,MKT
06079802250190000,2021,111150,327450,438600,MKT
06079802250190000,2020,80729,293871,374600,MKT
06079802250190000,2019,80729,299871,380600,MKT
06079802250210000,2021,118888,275812,394700,MKT
06079802250210000,2020,81754,261246,343000,MKT
06079802250210000,2019,81754,261246,343000,MKT
06079802250230000,2021,118757,376443,495200,MKT
06079802250230000,2020,81578,356022,437600,MKT
06079802250230000,2019,81578,356022,437600,MKT
06079802250250000,2021,119797,382303,502100,MKT
06079802250250000,2020,82978,376422,459400,MKT
06079802250250000,2019,82978,376422,459400,MKT
06079802250270000,2021,118757,271543,390300,MKT
06079802250270000,2020,81578,261822,343400,MKT
06079802250270000,2019,81578,259822,341400,MKT
06079802250290000,2021,119797,371903,491700,MKT
06079802250290000,2020,82978,350422,433400,MKT
06079802250290000,2019,82978,350422,433400,MKT
06079802250310000,2021,118757,267743,386500,MKT
06079802250310000,2020,81578,256722,338300,MKT
06079802250310000,2019,81578,256722,338300,MKT
06079802250330000,2021,124069,0,124069,COST
06079802250330000,2020,88852,0,88852,COST
06079802250330000,2019,88852,0,88852,COST
06079802251010000,2021,120379,269121,389500,MKT
06079802251010000,2020,83767,252333,336100,MKT
06079802251010000,2019,83767,252333,336100,MKT
06079802251030000,2021,116874,273826,390700,MKT
06079802251030000,2020,79072,266928,346000,MKT
06079802251030000,2019,79072,266928,346000,MKT
06079802251050000,2021,116874,262726,379600,MKT
06079802251050000,2020,79072,251728,330800,MKT
06079802251050000,2019,79072,251728,330800,MKT
06079802251070000,2021,111343,324657,436000,MKT
06079802251070000,2020,71933,310367,382300,MKT
06079802251070000,2019,71933,310367,382300,MKT
06079802251090000,2021,116851,262749,379600,MKT
06079802251090000,2020,79042,251758,330800,MKT
06079802251090000,2019,79042,251758,330800,MKT
06079802251110000,2021,116874,291326,408200,MKT
06079802251110000,2020,79072,289228,368300,MKT
06079802251110000,2019,79072,289228,368300,MKT
06079802251130000,2021,120829,273271,394100,MKT
06079802251130000,2020,84379,265021,349400,MKT
06079802251130000,2019,84379,265021,349400,MKT
06079802251150000,2021,118858,327342,446200,MKT
06079802251150000,2020,81713,296787,378500,MKT
06079802251150000,2019,81713,296787,378500,MKT
06079802251170000,2021,115191,266909,382100,MKT
06079802251170000,2020,76864,262236,339100,MKT
06079802251170000,2019,76864,262236,339100,MKT
06079802251190000,2021,115167,329233,444400,MKT
06079802251190000,2020,76833,317967,394800,MKT
06079802251190000,2019,76833,317967,394800,MKT
06079802251210000,2021,109740,303160,412900,MKT
06079802251210000,2020,69925,288275,358200,MKT
06079802251210000,2019,69925,288275,358200,MKT
06079802251230000,2021,115191,335109,450300,MKT
06079802251230000,2020,76864,315236,392100,MKT
06079802251230000,2019,76864,315236,392100,MKT
06079802251250000,2021,115191,269709,384900,MKT
06079802251250000,2020,76864,261736,338600,MKT
06079802251250000,2019,76864,261736,338600,MKT
06079802251270000,2021,117763,334237,452000,MKT
06079802251270000,2020,80250,323150,403400,MKT
06079802251270000,2019,80250,323150,403400,MKT
06079802252010000,2021,118748,313652,432400,MKT
06079802252010000,2020,81566,314534,396100,MKT
06079802252010000,2019,81566,314534,396100,MKT
06079802252030000,2021,114128,280872,395000,MKT
06079802252030000,2020,75486,307114,382600,MKT
06079802252030000,2019,75486,307114,382600,MKT
06079802252050000,2021,114128,293872,408000,MKT
06079802252050000,2020,75486,290514,366000,MKT
06079802252050000,2019,75486,290514,366000,MKT
06079802252070000,2021,114128,274072,388200,MKT
06079802252070000,2020,75486,271814,347300,MKT
06079802252070000,2019,75486,271814,347300,MKT
06079802252090000,2021,121547,316553,438100,MKT
06079802252090000,2020,85360,321140,406500,MKT
06079802252090000,2019,85360,321140,406500,MKT
06079802252110000,2021,128332,362668,491000,MKT
06079802252110000,2020,94908,353692,448600,MKT
06079802252110000,2019,94908,353692,448600,MKT
06079802252130000,2021,123253,317147,440400,MKT
06079802252130000,2020,87715,299585,387300,MKT
06079802252130000,2019,87715,299585,387300,MKT
06079802252150000,2021,121312,281488,402800,MKT
06079802252150000,2020,85038,274362,359400,MKT
06079802252150000,2019,85038,274362,359400,MKT
06079802252170000,2021,121312,333188,454500,MKT
06079802252170000,2020,85038,330362,415400,MKT
06079802252170000,2019,85038,330362,415400,MKT
06079802252190000,2021,124870,379030,503900,MKT
06079802252190000,2020,89975,376325,466300,MKT
06079802252190000,2019,89975,376325,466300,MKT
06079802253010000,2021,124709,466891,591600,MKT
06079802253010000,2020,93142,407358,500500,MKT
06079802253010000,2019,93142,407358,500500,MKT
06079802253030000,2021,124698,367102,491800,MKT
06079802253030000,2020,93126,346974,440100,MKT
06079802253030000,2019,93126,346974,440100,MKT
06079802253050000,2021,127866,373134,501000,MKT
06079802253050000,2020,97798,348902,446700,MKT
06079802253050000,2019,97798,348902,446700,MKT
06079802253070000,2021,128788,515212,644000,MKT
06079802253070000,2020,99180,466220,565400,MKT
06079802253070000,2019,99180,466220,565400,MKT
06079802253090000,2021,128788,421712,550500,MKT
06079802253090000,2020,99180,396720,495900,MKT
06079802253090000,2019,99180,396720,495900,MKT
06079802253110000,2021,132124,282176,414300,MKT
06079802253110000,2020,104256,272144,376400,MKT
06079802253110000,2019,104256,272144,376400,MKT
06079802254010000,2021,126578,485022,611600,MKT
06079802254010000,2020,95886,412414,508300,MKT
06079802254010000,2019,95886,412414,508300,MKT
06079802254030000,2021,125233,472267,597500,MKT
06079802254030000,2020,93906,400494,494400,MKT
06079802254030000,2019,93906,386094,480000,MKT
06079802254050000,2021,121575,345425,467000,MKT
06079802254050000,2020,88627,342973,431600,MKT
06079802254050000,2019,88627,342973,431600,MKT
06079802254070000,2021,127340,292860,420200,MKT
06079802254070000,2020,97016,314884,411900,MKT
06079802254070000,2019,97016,314884,411900,MKT
06079802254090000,2021,127860,372840,500700,MKT
06079802254090000,2020,97791,345809,443600,MKT
06079802254090000,2019,97791,345809,443600,MKT
06079802254110000,2021,123767,0,123767,COST
06079802254110000,2020,91773,0,91773,COST
06079802254110000,2019,91773,0,91773,COST
06079802254130000,2021,123845,266155,390000,MKT
06079802254130000,2020,91887,248713,340600,MKT
06079802254130000,2019,91887,238513,330400,MKT
06079802254150000,2021,123840,402060,525900,MKT
06079802254150000,2020,91879,371821,463700,MKT
06079802254150000,2019,91879,371821,463700,MKT
06079802254170000,2021,123834,481866,605700,MKT
06079802254170000,2020,91871,431929,523800,MKT
06079802254170000,2019,91871,431929,523800,MKT
06079802255010000,2021,117736,382864,500600,MKT
06079802255010000,2020,80214,363386,443600,MKT
06079802255010000,2019,80214,361486,441700,MKT
06079802255030000,2021,112526,354074,466600,MKT
06079802255030000,2020,73432,330968,404400,MKT
06079802255030000,2019,73432,330968,404400,MKT
06079802255050000,2021,109007,271593,380600,MKT
06079802255050000,2020,69017,271083,340100,MKT
06079802255050000,2019,69017,271083,340100,MKT
06079802255070000,2021,112526,342174,454700,MKT
06079802255070000,2020,73432,322868,396300,MKT
06079802255070000,2019,73432,322868,396300,MKT
06079802255090000,2021,119823,311877,431700,MKT
06079802255090000,2020,83012,324088,407100,MKT
06079802255090000,2019,83012,324088,407100,MKT
06079802255110000,2021,116814,328486,445300,MKT
06079802255110000,2020,78993,322707,401700,MKT
06079802255110000,2019,78993,322707,401700,MKT
06079802255130000,2021,112526,354374,466900,MKT
06079802255130000,2020,73432,335768,409200,MKT
06079802255130000,2019,73432,330168,403600,MKT
06079802255150000,2021,109007,265793,374800,MKT
06079802255150000,2020,69017,259183,328200,MKT
06079802255150000,2019,69017,259183,328200,MKT
06079802255170000,2021,112526,282374,394900,MKT
06079802255170000,2020,73432,273868,347300,MKT
06079802255170000,2019,73432,273868,347300,MKT
06079802255190000,2021,117538,291362,408900,MKT
06079802255190000,2020,79951,297649,377600,MKT
06079802255190000,2019,79951,297649,377600,MKT
06079802256010000,2021,124935,277165,402100,MKT
06079802256010000,2020,90066,294134,384200,MKT
06079802256010000,2019,90066,294134,384200,MKT
06079802256030000,2021,119638,325562,445200,MKT
06079802256030000,2020,82763,302737,385500,MKT
06079802256030000,2019,82763,302737,385500,MKT
06079802256050000,2021,119024,285976,405000,MKT
06079802256050000,2020,81936,278564,360500,MKT
06079802256050000,2019,81936,278564,360500,MKT
06079802256070000,2021,122583,356517,479100,MKT
06079802256070000,2020,86787,326413,413200,MKT
06079802256070000,2019,86787,326413,413200,MKT
06079802256090000,2021,123186,449614,572800,MKT
06079802256090000,2020,87621,398379,486000,MKT
06079802256090000,2019,87621,398379,486000,MKT
06079802256110000,2021,118413,302087,420500,MKT
06079802256110000,2020,81118,288782,369900,MKT
06079802256110000,2019,81118,288782,369900,MKT
06079802256130000,2021,121225,302875,424100,MKT
06079802256130000,2020,84919,283381,368300,MKT
06079802256130000,2019,84919,283381,368300,MKT
06079802256150000,2021,124038,355662,479700,MKT
06079802256150000,2020,88808,332792,421600,MKT
06079802256150000,2019,88808,332792,421600,MKT
06079802257010000,2021,116311,276089,392400,MKT
06079802257010000,2020,78330,269370,347700,MKT
06079802257010000,2019,78330,269370,347700,MKT
06079802257030000,2021,111490,370810,482300,MKT
06079802257030000,2020,72118,349482,421600,MKT
06079802257030000,2019,72118,349482,421600,MKT
06079802257050000,2021,110922,282578,393500,MKT
06079802257050000,2020,71403,276697,348100,MKT
06079802257050000,2019,71403,276697,348100,MKT
06079802257070000,2021,110720,332080,442800,MKT
06079802257070000,2020,71149,328551,399700,MKT
06079802257070000,2019,71149,328551,399700,MKT
06079802257090000,2021,115519,327581,443100,MKT
06079802257090000,2020,77292,312208,389500,MKT
06079802257090000,2019,77292,336708,414000,MKT
06079802258010000,2021,118796,263704,382500,MKT
06079802258010000,2020,81630,256870,338500,MKT
06079802258010000,2019,81630,256870,338500,MKT
06079802258030000,2021,116041,355159,471200,MKT
06079802258030000,2020,77976,334524,412500,MKT
06079802258030000,2019,77976,0,77976,COST
06079802258050000,2021,116041,360259,476300,MKT
06079802258050000,2020,77976,349024,427000,MKT
06079802258050000,2019,77976,349024,427000,MKT
06079802258070000,2021,116041,310359,426400,MKT
06079802258070000,2020,77976,288024,366000,MKT
06079802258070000,2019,77976,288024,366000,MKT
06079802258090000,2021,116041,318659,434700,MKT
06079802258090000,2020,77976,334324,412300,MKT
06079802258090000,2019,77976,334324,412300,MKT
06079802258110000,2021,121125,287975,409100,MKT
06079802258110000,2020,84783,307117,391900,MKT
06079802258110000,2019,84783,307117,391900,MKT
06079802258130000,2021,127388,329612,457000,MKT
06079802258130000,2020,93550,337050,430600,MKT
06079802258130000,2019,93550,337050,430600,MKT
06079802258150000,2021,116041,377859,493900,MKT
06079802258150000,2020,77976,352024,430000,MKT
06079802258150000,2019,77976,352024,430000,MKT
06079802258170000,2021,116041,367359,483400,MKT
06079802258170000,2020,77976,342724,420700,MKT
06079802258170000,2019,77976,0,77976,COST
06079802258190000,2021,116041,301959,418000,MKT
06079802258190000,2020,77976,319824,397800,MKT
06079802258190000,2019,77976,319824,397800,MKT
06079802258210000,2021,116041,275559,391600,MKT
06079802258210000,2020,77976,273524,351500,MKT
06079802258210000,2019,77976,273524,351500,MKT
06079802258230000,2021,119037,342863,461900,MKT
06079802258230000,2020,81953,342747,424700,MKT
06079802258230000,2019,81953,0,81953,COST
06079802259010000,2021,122927,360973,483900,MKT
06079802259010000,2020,87263,335237,422500,MKT
06079802259010000,2019,87263,335237,422500,MKT
06079802259030000,2021,119492,310308,429800,MKT
06079802259030000,2020,82566,315734,398300,MKT
06079802259030000,2019,82566,315734,398300,MKT
06079802259050000,2021,119492,299708,419200,MKT
06079802259050000,2020,82566,318734,401300,MKT
06079802259050000,2019,82566,318734,401300,MKT
06079802259070000,2021,119496,328004,447500,MKT
06079802259070000,2020,82572,303928,386500,MKT
06079802259070000,2019,82572,303928,386500,MKT
06079802259090000,2021,119496,0,119496,COST
06079802259090000,2020,82572,0,82572,COST
06079802259090000,2019,82572,0,82572,COST
06079802259110000,2021,123792,405408,529200,MKT
06079802259110000,2020,88465,376635,465100,MKT
06079802259110000,2019,88465,376635,465100,MKT
06079802259130000,2021,123360,317440,440800,MKT
06079802259130000,2020,87863,332437,420300,MKT
06079802259130000,2019,87863,332437,420300,MKT
06079802259150000,2021,119496,339804,459300,MKT
06079802259150000,2020,82572,318028,400600,MKT
06079802259150000,2019,82572,318028,400600,MKT
06079802259170000,2021,119500,335800,455300,MKT
06079802259170000,2020,82577,309023,391600,MKT
06079802259170000,2019,82577,309023,391600,MKT
06079802259190000,2021,119500,339000,458500,MKT
06079802259190000,2020,82577,330623,413200,MKT
06079802259190000,2019,82577,330623,413200,MKT
06079802259210000,2021,119500,298500,418000,MKT
06079802259210000,2020,82577,317823,400400,MKT
06079802259210000,2019,82577,317823,400400,MKT
06079802259230000,2021,122342,368358,490700,MKT
06079802259230000,2020,86453,347547,434000,MKT
06079802259230000,2019,86453,347547,434000,MKT
06079802260010000,2021,117871,168710,286581,COST
06079802260010000,2020,80394,0,80394,COST
06079802260010000,2019,80394,0,80394,COST
06079802260030000,2021,115575,294925,410500,MKT
06079802260030000,2020,77366,295034,372400,MKT
06079802260030000,2019,77366,295034,372400,MKT
06079802260050000,2021,115571,372729,488300,MKT
06079802260050000,2020,77360,348740,426100,MKT
06079802260050000,2019,77360,0,77360,COST
06079802260070000,2021,115571,331129,446700,MKT
06079802260070000,2020,77360,307440,384800,MKT
06079802260070000,2019,77360,299940,377300,MKT
06079802260090000,2021,115571,271129,386700,MKT
06079802260090000,2020,77360,259340,336700,MKT
06079802260090000,2019,77360,259340,336700,MKT
06079802260110000,2021,118036,346964,465000,MKT
06079802260110000,2020,80614,317386,398000,MKT
06079802260110000,2019,80614,317386,398000,MKT
06079802260136500,2021,59923,0,59923,COST
06079802260136500,2020,67525,0,67525,COST
06079802260136500,2019,67525,0,67525,COST
06079802301050000,2021,419628,0,419628,COST
06079802301050000,2020,383563,0,383563,COST
06079802301050000,2019,383563,0,383563,COST
06079802321010000,2021,148579,241021,389600,MKT
06079802321010000,2020,109058,241742,350800,MKT
06079802321010000,2019,109058,241742,350800,MKT
06079802326010000,2021,121900,245500,367400,MKT
06079802326010000,2020,80417,231583,312000,MKT
06079802326010000,2019,80417,231583,312000,MKT
06079802326030000,2021,119046,273954,393000,MKT
06079802326030000,2020,76783,263217,340000,MKT
06079802326030000,2019,76783,256917,333700,MKT
06079802326050000,2021,116594,262106,378700,MKT
06079802326050000,2020,73727,246873,320600,MKT
06079802326050000,2019,73727,246873,320600,MKT
06079802326070000,2021,115714,268186,383900,MKT
06079802326070000,2020,72644,243956,316600,MKT
06079802326070000,2019,72644,243956,316600,MKT
06079802326090000,2021,115714,267086,382800,MKT
06079802326090000,2020,72644,250856,323500,MKT
06079802326090000,2019,72644,250856,323500,MKT
06079802326110000,2021,115714,266986,382700,MKT
06079802326110000,2020,72644,250956,323600,MKT
06079802326110000,2019,72644,250956,323600,MKT
06079802326130000,2021,115714,241086,356800,MKT
06079802326130000,2020,72644,239956,312600,MKT
06079802326130000,2019,72644,239956,312600,MKT
06079802326150000,2021,115714,235886,351600,MKT
06079802326150000,2020,72644,233956,306600,MKT
06079802326150000,2019,72644,233956,306600,MKT
06079802326170000,2021,115714,227886,343600,MKT
06079802326170000,2020,72644,233756,306400,MKT
06079802326170000,2019,72644,233756,306400,MKT
06079802326190000,2021,115714,220686,336400,MKT
06079802326190000,2020,72644,229456,302100,MKT
06079802326190000,2019,72644,229456,302100,MKT
06079802326210000,2021,115714,226186,341900,MKT
06079802326210000,2020,72644,231056,303700,MKT
06079802326210000,2019,72644,231056,303700,MKT
06079802326230000,2021,115714,241286,357000,MKT
06079802326230000,2020,72644,240156,312800,MKT
06079802326230000,2019,72644,240156,312800,MKT
06079802326250000,2021,117767,227433,345200,MKT
06079802326250000,2020,75181,237019,312200,MKT
06079802326250000,2019,75181,237019,312200,MKT
06079802327010000,2021,129390,275510,404900,MKT
06079802327010000,2020,80226,280374,360600,MKT
06079802327010000,2019,80226,280374,360600,MKT
06079802327030000,2021,129464,281736,411200,MKT
06079802327030000,2020,80316,288484,368800,MKT
06079802327030000,2019,80316,288484,368800,MKT
06079802327050000,2021,129469,264331,393800,MKT
06079802327050000,2020,80322,254678,335000,MKT
06079802327050000,2019,80322,254678,335000,MKT
06079802327070000,2021,133273,264327,397600,MKT
06079802327070000,2020,84993,269407,354400,MKT
06079802327070000,2019,84993,269407,354400,MKT
06079802327090000,2021,142478,283022,425500,MKT
06079802327090000,2020,96827,283473,380300,MKT
06079802327090000,2019,96827,283473,380300,MKT
06079802327110000,2021,139516,257984,397500,MKT
06079802327110000,2020,92937,248963,341900,MKT
06079802327110000,2019,92937,248963,341900,MKT
06079802327130000,2021,135543,286557,422100,MKT
06079802327130000,2020,87841,284859,372700,MKT
06079802327130000,2019,87841,284859,372700,MKT
06079802327150000,2021,133427,304073,437500,MKT
06079802327150000,2020,85185,284115,369300,MKT
06079802327150000,2019,85185,284115,369300,MKT
06079802327170000,2021,133427,275073,408500,MKT
06079802327170000,2020,85185,276115,361300,MKT
06079802327170000,2019,85185,276115,361300,MKT
06079802327190000,2021,128383,280217,408600,MKT
06079802327190000,2020,79012,276388,355400,MKT
06079802327190000,2019,79012,276388,355400,MKT
06079802327210000,2021,136233,327567,463800,MKT
06079802327210000,2020,88716,328184,416900,MKT
06079802327210000,2019,88716,328184,416900,MKT
06079802327230000,2021,134401,308199,442600,MKT
06079802327230000,2020,86403,287397,373800,MKT
06079802327230000,2019,86403,287397,373800,MKT
06079802327250000,2021,127280,288120,415400,MKT
06079802327250000,2020,77693,299107,376800,MKT
06079802327250000,2019,77693,299107,376800,MKT
06079802327270000,2021,133309,325491,458800,MKT
06079802327270000,2020,85038,346962,432000,MKT
06079802327270000,2019,85038,346962,432000,MKT
06079802327290000,2021,133649,261351,395000,MKT
06079802327290000,2020,85461,252039,337500,MKT
06079802327290000,2019,85461,252039,337500,MKT
06079802327310000,2021,138529,303171,441700,MKT
06079802327310000,2020,91657,300043,391700,MKT
06079802327310000,2019,91657,300043,391700,MKT
06079802327330000,2021,140066,295934,436000,MKT
06079802327330000,2020,93654,305646,399300,MKT
06079802327330000,2019,93654,305646,399300,MKT
06079802327350000,2021,140634,297666,438300,MKT
06079802327350000,2020,94396,308004,402400,MKT
06079802327350000,2019,94396,308004,402400,MKT
06079802327376500,2021,28313,0,28313,COST
06079802327376500,2020,13000,0,13000,COST
06079802327376500,2019,13000,0,13000,COST
06079802327396500,2021,33051,0,33051,COST
06079802327396500,2020,17584,0,17584,COST
06079802327396500,2019,17584,0,17584,COST
06079802328010000,2021,131926,240274,372200,MKT
06079802328010000,2020,83324,243176,326500,MKT
06079802328010000,2019,83324,243176,326500,MKT
06079802328030000,2021,135094,241306,376400,MKT
06079802328030000,2020,87274,252126,339400,MKT
06079802328030000,2019,87274,252126,339400,MKT
06079802328050000,2021,131926,282374,414300,MKT
06079802328050000,2020,83324,300576,383900,MKT
06079802328050000,2019,83324,300576,383900,MKT
06079802328070000,2021,132090,293510,425600,MKT
06079802328070000,2020,83526,298574,382100,MKT
06079802328070000,2019,83526,298574,382100,MKT
06079802328090000,2021,130800,282300,413100,MKT
06079802328090000,2020,81941,298959,380900,MKT
06079802328090000,2019,81941,298959,380900,MKT
06079802328110000,2021,146351,234649,381000,MKT
06079802328110000,2020,102031,251869,353900,MKT
06079802328110000,2019,102031,251869,353900,MKT
06079802328130000,2021,131870,230130,362000,MKT
06079802328130000,2020,83255,244445,327700,MKT
06079802328130000,2019,83255,244445,327700,MKT
06079802328150000,2021,134610,237690,372300,MKT
06079802328150000,2020,86664,240636,327300,MKT
06079802328150000,2019,86664,240636,327300,MKT
06079802328170000,2021,149940,220860,370800,MKT
06079802328170000,2020,106972,220828,327800,MKT
06079802328170000,2019,106972,220828,327800,MKT
06079802328190000,2021,153942,226658,380600,MKT
06079802328190000,2020,112616,218184,330800,MKT
06079802328190000,2019,112616,218184,330800,MKT
06079802328210000,2021,131626,255174,386800,MKT
06079802328210000,2020,82955,259945,342900,MKT
06079802328210000,2019,82955,259945,342900,MKT
06079802328230000,2021,148986,225414,374400,MKT
06079802328230000,2020,105647,223353,329000,MKT
06079802328230000,2019,105647,223353,329000,MKT
06079802328250000,2021,134632,228968,363600,MKT
06079802328250000,2020,86692,239708,326400,MKT
06079802328250000,2019,86692,239708,326400,MKT
06079802328270000,2021,131903,233397,365300,MKT
06079802328270000,2020,83296,239704,323000,MKT
06079802328270000,2019,83296,239704,323000,MKT
06079802330016500,2021,79496,0,79496,COST
06079802330016500,2020,97524,0,97524,COST
06079802330016500,2019,97524,0,97524,COST
06079802330070000,2021,146138,301662,447800,MKT
06079802330070000,2020,105588,306612,412200,MKT
06079802330070000,2019,105588,306612,412200,MKT
06079802330090000,2021,146138,309362,455500,MKT
06079802330090000,2020,105588,316712,422300,MKT
06079802330090000,2019,105588,316712,422300,MKT
06079802330110000,2021,146138,225862,372000,MKT
06079802330110000,2020,105588,224112,329700,MKT
06079802330110000,2019,105588,224112,329700,MKT
06079802330130000,2021,146138,245662,391800,MKT
06079802330130000,2020,105588,262112,367700,MKT
06079802330130000,2019,105588,262112,367700,MKT
06079802330150000,2021,145961,321739,467700,MKT
06079802330150000,2020,105338,359162,464500,MKT
06079802330150000,2019,105338,359162,464500,MKT
06079802330170000,2021,147355,316045,463400,MKT
06079802330170000,2020,107311,310589,417900,MKT
06079802330170000,2019,107311,310589,417900,MKT
06079802330190000,2021,149274,256026,405300,MKT
06079802330190000,2020,110055,261845,371900,MKT
06079802330190000,2019,110055,261845,371900,MKT
06079802330210000,2021,152798,269402,422200,MKT
06079802330210000,2020,115184,269316,384500,MKT
06079802330210000,2019,115184,269316,384500,MKT
06079802330250000,2021,145590,300210,445800,MKT
06079802330250000,2020,104817,295383,400200,MKT
06079802330250000,2019,104817,295383,400200,MKT
06079802330270000,2021,143287,314213,457500,MKT
06079802330270000,2020,101604,340896,442500,MKT
06079802330270000,2019,101604,340896,442500,MKT
06079802330290000,2021,143287,284913,428200,MKT
06079802330290000,2020,101604,290096,391700,MKT
06079802330290000,2019,101604,290096,391700,MKT
06079802330310000,2021,143287,316313,459600,MKT
06079802330310000,2020,101604,301796,403400,MKT
06079802330310000,2019,101604,301796,403400,MKT
06079802330330000,2021,143287,267013,410300,MKT
06079802330330000,2020,101604,286896,388500,MKT
06079802330330000,2019,101604,286896,388500,MKT
06079802330350000,2021,143207,303793,447000,MKT
06079802330350000,2020,101493,329207,430700,MKT
06079802330350000,2019,101493,329207,430700,MKT
06079802330370000,2021,145052,321448,466500,MKT
06079802330370000,2020,104062,344738,448800,MKT
06079802330370000,2019,104062,344738,448800,MKT
06079802330390000,2021,145052,284448,429500,MKT
06079802330390000,2020,104062,313538,417600,MKT
06079802330390000,2019,104062,313538,417600,MKT
06079802330410000,2021,131865,289535,421400,MKT
06079802330410000,2020,83249,287551,370800,MKT
06079802330410000,2019,83249,287551,370800,MKT
06079802330430000,2021,131865,277835,409700,MKT
06079802330430000,2020,83249,277251,360500,MKT
06079802330430000,2019,83249,277251,360500,MKT
06079802330450000,2021,114684,269516,384200,MKT
06079802330450000,2020,71388,257912,329300,MKT
06079802330450000,2019,71388,257912,329300,MKT
06079802330470000,2021,111990,297210,409200,MKT
06079802330470000,2020,68151,282049,350200,MKT
06079802330470000,2019,68151,282049,350200,MKT
06079802331010000,2021,137304,267896,405200,MKT
06079802331010000,2020,90082,264418,354500,MKT
06079802331010000,2019,90082,264418,354500,MKT
06079802331040000,2021,143185,229515,372700,MKT
06079802331040000,2020,97766,234834,332600,MKT
06079802331040000,2019,97766,234834,332600,MKT
06079802331070000,2021,132267,284933,417200,MKT
06079802331070000,2020,83744,299556,383300,MKT
06079802331070000,2019,83744,299556,383300,MKT
06079802331090000,2021,129528,285972,415500,MKT
06079802331090000,2020,80394,275106,355500,MKT
06079802331090000,2019,80394,275106,355500,MKT
06079802331110000,2021,131532,226568,358100,MKT
06079802331110000,2020,82839,235961,318800,MKT
06079802331110000,2019,82839,235961,318800,MKT
06079802332010000,2021,131926,263674,395600,MKT
06079802332010000,2020,83324,251876,335200,MKT
06079802332010000,2019,83324,251876,335200,MKT
06079802332030000,2021,129528,249072,378600,MKT
06079802332030000,2020,80394,249906,330300,MKT
06079802332030000,2019,80394,249906,330300,MKT
06079802332050000,2021,131926,243074,375000,MKT
06079802332050000,2020,83324,248276,331600,MKT
06079802332050000,2019,83324,248276,331600,MKT
06079802332070000,2021,132160,249640,381800,MKT
06079802332070000,2020,83612,240088,323700,MKT
06079802332070000,2019,83612,240088,323700,MKT
06079802332090000,2021,129680,236020,365700,MKT
06079802332090000,2020,80578,240722,321300,MKT
06079802332090000,2019,80578,240722,321300,MKT
06079802332110000,2021,132001,292999,425000,MKT
06079802332110000,2020,83417,294783,378200,MKT
06079802332110000,2019,83417,288683,372100,MKT
06079802333010000,2021,131847,244353,376200,MKT
06079802333010000,2020,83226,250874,334100,MKT
06079802333010000,2019,83226,250874,334100,MKT
06079802333030000,2021,129375,235925,365300,MKT
06079802333030000,2020,80209,242491,322700,MKT
06079802333030000,2019,80209,242491,322700,MKT
06079802333050000,2021,131692,229508,361200,MKT
06079802333050000,2020,83036,237864,320900,MKT
06079802333050000,2019,83036,237864,320900,MKT
06079802333070000,2021,131926,298574,430500,MKT
06079802333070000,2020,83324,322576,405900,MKT
06079802333070000,2019,83324,322576,405900,MKT
06079802333090000,2021,129528,246072,375600,MKT
06079802333090000,2020,80394,241206,321600,MKT
06079802333090000,2019,80394,241206,321600,MKT
06079802333110000,2021,131926,309074,441000,MKT
06079802333110000,2020,83324,334876,418200,MKT
06079802333110000,2019,83324,334876,418200,MKT
06079802334010000,2021,131926,283674,415600,MKT
06079802334010000,2020,83324,280976,364300,MKT
06079802334010000,2019,83324,280976,364300,MKT
06079802334030000,2021,129528,268472,398000,MKT
06079802334030000,2020,80394,251506,331900,MKT
06079802334030000,2019,80394,251506,331900,MKT
06079802334050000,2021,131926,239474,371400,MKT
06079802334050000,2020,83324,253776,337100,MKT
06079802334050000,2019,83324,253776,337100,MKT
06079802334070000,2021,131926,247174,379100,MKT
06079802334070000,2020,83324,252776,336100,MKT
06079802334070000,2019,83324,252776,336100,MKT
06079802334090000,2021,129528,277172,406700,MKT
06079802334090000,2020,80394,274806,355200,MKT
06079802334090000,2019,80394,274806,355200,MKT
06079802334110000,2021,131926,243474,375400,MKT
06079802334110000,2020,83324,251076,334400,MKT
06079802334110000,2019,83324,251076,334400,MKT
06079802335070000,2021,148420,301880,450300,MKT
06079802335070000,2020,108830,306870,415700,MKT
06079802335070000,2019,108830,306870,415700,MKT
06079802335090000,2021,144508,238492,383000,MKT
06079802335090000,2020,103302,234198,337500,MKT
06079802335090000,2019,103302,234198,337500,MKT
06079802335110000,2021,145093,305707,450800,MKT
06079802335110000,2020,104119,311081,415200,MKT
06079802335110000,2019,104119,311081,415200,MKT
06079802335130000,2021,145580,329420,475000,MKT
06079802335130000,2020,104802,319298,424100,MKT
06079802335130000,2019,104802,319298,424100,MKT
06079802335150000,2021,144638,311062,455700,MKT
06079802335150000,2020,103483,308117,411600,MKT
06079802335150000,2019,103483,308117,411600,MKT
06079802335170000,2021,145580,266620,412200,MKT
06079802335170000,2020,104802,270298,375100,MKT
06079802335170000,2019,104802,270298,375100,MKT
06079802335190000,2021,144902,315598,460500,MKT
06079802335190000,2020,103852,314548,418400,MKT
06079802335190000,2019,103852,314548,418400,MKT
06079802335256500,2021,80088,0,80088,COST
06079802335256500,2020,98945,0,98945,COST
06079802335256500,2019,98945,0,98945,COST
06079802335310000,2021,138252,436848,575100,MKT
06079802335310000,2020,94752,404348,499100,MKT
06079802335310000,2019,94752,404348,499100,MKT
06079802335330000,2021,141497,314403,455900,MKT
06079802335330000,2020,99142,355858,455000,MKT
06079802335330000,2019,99142,355858,455000,MKT
06079802335350000,2021,141497,314103,455600,MKT
06079802335350000,2020,99142,319358,418500,MKT
06079802335350000,2019,99142,319358,418500,MKT
06079802335370000,2021,141497,271103,412600,MKT
06079802335370000,2020,99142,271658,370800,MKT
06079802335370000,2019,99142,271658,370800,MKT
06079802335390000,2021,141497,314403,455900,MKT
06079802335390000,2020,99142,302458,401600,MKT
06079802335390000,2019,99142,302458,401600,MKT
06079802335410000,2021,140082,434718,574800,MKT
06079802335410000,2020,97216,373284,470500,MKT
06079802335410000,2019,97216,365384,462600,MKT
06079802335430000,2021,149359,235141,384500,MKT
06079802335430000,2020,110178,233322,343500,MKT
06079802335430000,2019,110178,233322,343500,MKT
06079802337010000,2021,136387,264013,400400,MKT
06079802337010000,2020,88911,266489,355400,MKT
06079802337010000,2019,88911,266489,355400,MKT
06079802337030000,2021,132885,243115,376000,MKT
06079802337030000,2020,84510,251690,336200,MKT
06079802337030000,2019,84510,251690,336200,MKT
06079802337050000,2021,135312,294688,430000,MKT
06079802337050000,2020,87550,284550,372100,MKT
06079802337050000,2019,87550,284550,372100,MKT
06079802337070000,2021,132853,233047,365900,MKT
06079802337070000,2020,84470,234730,319200,MKT
06079802337070000,2019,84470,234730,319200,MKT
06079802337090000,2021,132853,245647,378500,MKT
06079802337090000,2020,84470,250330,334800,MKT
06079802337090000,2019,84470,250330,334800,MKT
06079802337110000,2021,132853,237447,370300,MKT
06079802337110000,2020,84470,254030,338500,MKT
06079802337110000,2019,84470,254030,338500,MKT
06079802337130000,2021,134596,324104,458700,MKT
06079802337130000,2020,86648,330352,417000,MKT
06079802337130000,2019,86648,330352,417000,MKT
06079802337150000,2021,135072,284528,419600,MKT
06079802337150000,2020,87246,276754,364000,MKT
06079802337150000,2019,87246,276754,364000,MKT
06079802337170000,2021,134605,269895,404500,MKT
06079802337170000,2020,86659,274241,360900,MKT
06079802337170000,2019,86659,274241,360900,MKT
06079802337190000,2021,134232,288068,422300,MKT
06079802337190000,2020,86191,279309,365500,MKT
06079802337190000,2019,86191,279309,365500,MKT
06079802337210000,2021,135282,280818,416100,MKT
06079802337210000,2020,87511,280689,368200,MKT
06079802337210000,2019,87511,280689,368200,MKT
06079802337230000,2021,134773,269027,403800,MKT
06079802337230000,2020,86870,258130,345000,MKT
06079802337230000,2019,86870,258130,345000,MKT
06079802337250000,2021,133572,270528,404100,MKT
06079802337250000,2020,85365,282035,367400,MKT
06079802337250000,2019,85365,282035,367400,MKT
06079802337270000,2021,130105,257395,387500,MKT
06079802337270000,2020,81094,267306,348400,MKT
06079802337270000,2019,81094,267306,348400,MKT
06079802337290000,2021,131452,263448,394900,MKT
06079802337290000,2020,82740,267760,350500,MKT
06079802337290000,2019,82740,267760,350500,MKT
06079802337310000,2021,132853,259547,392400,MKT
06079802337310000,2020,84470,257130,341600,MKT
06079802337310000,2019,84470,257130,341600,MKT
06079802337330000,2021,135312,267188,402500,MKT
06079802337330000,2020,87550,255250,342800,OVR
06079802337330000,2019,87550,255250,342800,MKT
06079802337350000,2021,132350,296050,428400,MKT
06079802337350000,2020,83848,329052,412900,MKT
06079802337350000,2019,83848,329052,412900,MKT
06079802337370000,2021,129128,417472,546600,MKT
06079802337370000,2020,79909,339491,419400,MKT
06079802337370000,2019,79909,339491,419400,MKT
06079802337390000,2021,130810,349790,480600,MKT
06079802337390000,2020,81953,330647,412600,MKT
06079802337390000,2019,81953,330647,412600,MKT
06079802337410000,2021,133482,317518,451000,MKT
06079802337410000,2020,85253,295947,381200,MKT
06079802337410000,2019,85253,295947,381200,MKT
06079802337430000,2021,133482,302818,436300,MKT
06079802337430000,2020,85253,294747,380000,MKT
06079802337430000,2019,85253,294747,380000,MKT
06079802337450000,2021,133482,293918,427400,MKT
06079802337450000,2020,85253,288847,374100,MKT
06079802337450000,2019,85253,288847,374100,MKT
06079802337470000,2021,133482,265218,398700,MKT
06079802337470000,2020,85253,271847,357100,MKT
06079802337470000,2019,85253,271847,357100,MKT
06079802337496500,2021,31816,0,31816,COST
06079802337496500,2020,16325,0,16325,COST
06079802337496500,2019,16325,0,16325,COST
06079802339010000,2021,135312,233188,368500,MKT
06079802339010000,2020,87550,252350,339900,MKT
06079802339010000,2019,87550,252350,339900,MKT
06079802339030000,2021,132853,250747,383600,MKT
06079802339030000,2020,84470,257630,342100,MKT
06079802339030000,2019,84470,257630,342100,MKT
06079802339050000,2021,133482,305518,439000,MKT
06079802339050000,2020,85253,317747,403000,MKT
06079802339050000,2019,85253,317747,403000,MKT
06079802339070000,2021,133482,253118,386600,MKT
06079802339070000,2020,85253,251447,336700,MKT
06079802339070000,2019,85253,251447,336700,MKT
06079802339090000,2021,133482,301718,435200,MKT
06079802339090000,2020,85253,296547,381800,MKT
06079802339090000,2019,85253,296547,381800,MKT
06079802339110000,2021,133482,298618,432100,MKT
06079802339110000,2020,85253,286947,372200,MKT
06079802339110000,2019,85253,286947,372200,MKT
06079802339130000,2021,133482,360318,493800,MKT
06079802339130000,2020,85253,343747,429000,MKT
06079802339130000,2019,85253,339347,424600,MKT
06079802339150000,2021,133482,299918,433400,MKT
06079802339150000,2020,85253,294347,379600,MKT
06079802339150000,2019,85253,294347,379600,MKT
06079802339170000,2021,133482,344618,478100,MKT
06079802339170000,2020,85253,330847,416100,MKT
06079802339170000,2019,85253,330847,416100,MKT
06079802339190000,2021,132387,296913,429300,MKT
06079802339190000,2020,83893,294607,378500,MKT
06079802339190000,2019,83893,294607,378500,MKT
06079802339210000,2021,133482,282718,416200,MKT
06079802339210000,2020,85253,288247,373500,MKT
06079802339210000,2019,85253,288247,373500,MKT
06079802339220000,2021,138414,0,138414,COST
06079802339220000,2020,91509,0,91509,COST
06079802339220000,2019,91509,0,91509,COST
06079802339230000,2021,138700,306000,444700,MKT
06079802339230000,2020,91879,298221,390100,MKT
06079802339230000,2019,91879,298221,390100,MKT
06079802339240000,2021,138270,276530,414800,MKT
06079802339240000,2020,91324,268476,359800,MKT
06079802339240000,2019,91324,268176,359500,MKT
06079802339250000,2021,134219,291681,425900,MKT
06079802339250000,2020,86174,335526,421700,MKT
06079802339250000,2019,86174,335526,421700,MKT
06079802339260000,2021,134428,335572,470000,MKT
06079802339260000,2020,86436,339364,425800,MKT
06079802339260000,2019,86436,339364,425800,MKT
06079802339270000,2021,134428,317372,451800,MKT
06079802339270000,2020,86436,350664,437100,MKT
06079802339270000,2019,86436,350664,437100,MKT
06079802339280000,2021,134428,434472,568900,MKT
06079802339280000,2020,86436,364564,451000,MKT
06079802339280000,2019,86436,364564,451000,MKT
06079802339290000,2021,134419,311881,446300,MKT
06079802339290000,2020,86425,323075,409500,MKT
06079802339290000,2019,86425,323075,409500,MKT
06079802339310000,2021,133050,229550,362600,MKT
06079802339310000,2020,84715,236885,321600,MKT
06079802339310000,2019,84715,236885,321600,MKT
06079802339330000,2021,132540,267660,400200,MKT
06079802339330000,2020,84082,261018,345100,MKT
06079802339330000,2019,84082,261018,345100,MKT
06079802340010000,2021,131077,296223,427300,MKT
06079802340010000,2020,82280,288920,371200,MKT
06079802340010000,2019,82280,288920,371200,MKT
06079802340030000,2021,124326,316474,440800,MKT
06079802340030000,2020,74212,322088,396300,MKT
06079802340030000,2019,74212,322088,396300,MKT
06079802340050000,2021,129078,309222,438300,MKT
06079802340050000,2020,79849,304951,384800,MKT
06079802340050000,2019,79849,304951,384800,MKT
06079802340070000,2021,129078,296522,425600,MKT
06079802340070000,2020,79849,284951,364800,MKT
06079802340070000,2019,79849,284951,364800,MKT
06079802340090000,2021,129078,306422,435500,MKT
06079802340090000,2020,79849,293151,373000,MKT
06079802340090000,2019,79849,293151,373000,MKT
06079802340110000,2021,129043,306457,435500,MKT
06079802340110000,2020,79807,293093,372900,MKT
06079802340110000,2019,79807,293093,372900,MKT
06079802340130000,2021,129043,306457,435500,MKT
06079802340130000,2020,79807,293093,372900,MKT
06079802340130000,2019,79807,293093,372900,MKT
06079802340150000,2021,129043,308657,437700,MKT
06079802340150000,2020,79807,294493,374300,MKT
06079802340150000,2019,79807,294493,374300,MKT
06079802340170000,2021,129048,356952,486000,MKT
06079802340170000,2020,79813,346487,426300,MKT
06079802340170000,2019,79813,346487,426300,MKT
06079802340190000,2021,131926,326374,458300,MKT
06079802340190000,2020,83324,326576,409900,MKT
06079802340190000,2019,83324,326576,409900,MKT
06079802340210000,2021,131926,441774,573700,MKT
06079802340210000,2020,83324,386676,470000,MKT
06079802340210000,2019,83324,386676,470000,MKT
06079802340230000,2021,128579,302621,431200,MKT
06079802340230000,2020,79247,290753,370000,MKT
06079802340230000,2019,79247,290753,370000,MKT
06079802340250000,2021,128579,359121,487700,MKT
06079802340250000,2020,79247,351253,430500,MKT
06079802340250000,2019,79247,351253,430500,MKT
06079802340270000,2021,128579,326921,455500,MKT
06079802340270000,2020,79247,311653,390900,MKT
06079802340270000,2019,79247,311653,390900,MKT
06079802340290000,2021,128574,286226,414800,MKT
06079802340290000,2020,79241,284159,363400,MKT
06079802340290000,2019,79241,284159,363400,MKT
06079802340310000,2021,128669,277531,406200,MKT
06079802340310000,2020,79356,265844,345200,MKT
06079802340310000,2019,79356,265844,345200,MKT
06079802340330000,2021,128669,293631,422300,MKT
06079802340330000,2020,79356,283844,363200,MKT
06079802340330000,2019,79356,283844,363200,MKT
06079802340350000,2021,128669,436131,564800,MKT
06079802340350000,2020,79356,402844,482200,MKT
06079802340350000,2019,79356,402844,482200,MKT
06079802340370000,2021,124326,343774,468100,MKT
06079802340370000,2020,74212,333388,407600,MKT
06079802340370000,2019,74212,333388,407600,MKT
06079802340390000,2021,131077,308923,440000,MKT
06079802340390000,2020,82280,321420,403700,MKT
06079802340390000,2019,82280,321420,403700,MKT
06079802341010000,2021,128929,342871,471800,MKT
06079802341010000,2020,79669,334831,414500,MKT
06079802341010000,2019,79669,334831,414500,MKT
06079802341030000,2021,127507,290693,418200,MKT
06079802341030000,2020,77963,291237,369200,MKT
06079802341030000,2019,77963,291237,369200,MKT
06079802341050000,2021,130260,374040,504300,MKT
06079802341050000,2020,81283,346617,427900,MKT
06079802341050000,2019,81283,346617,427900,MKT
06079802341070000,2021,146910,396390,543300,MKT
06079802341070000,2020,106679,368221,474900,MKT
06079802341070000,2019,106679,368221,474900,MKT
06079802341096500,2021,85130,0,85130,COST
06079802341096500,2020,111468,0,111468,COST
06079802341096500,2019,111468,0,111468,COST
06079802341116500,2021,56425,0,56425,COST
06079802341116500,2020,49948,0,49948,COST
06079802341116500,2019,49948,0,49948,COST
06079802341130000,2021,144357,386543,530900,MKT
06079802341130000,2020,103091,360609,463700,MKT
06079802341130000,2019,103091,360609,463700,MKT
06079802341150000,2021,129385,318615,448000,MKT
06079802341150000,2020,80220,300280,380500,MKT
06079802341150000,2019,80220,300280,380500,MKT
06079802341170000,2021,127461,356239,483700,MKT
06079802341170000,2020,77908,334792,412700,MKT
06079802341170000,2019,77908,359892,437800,MKT
06079802341190000,2021,130367,414633,545000,MKT
06079802341190000,2020,81413,361187,442600,MKT
06079802341190000,2019,81413,361187,442600,MKT
06079802342010000,2021,139219,226381,365600,MKT
06079802342010000,2020,92551,230249,322800,MKT
06079802342010000,2019,92551,230249,322800,MKT
06079802342030000,2021,134188,295412,429600,MKT
06079802342030000,2020,86135,305065,391200,MKT
06079802342030000,2019,86135,305065,391200,MKT
06079802342040000,2021,135312,260688,396000,MKT
06079802342040000,2020,87550,257150,344700,MKT
06079802342040000,2019,87550,257150,344700,MKT
06079802342050000,2021,132853,233147,366000,MKT
06079802342050000,2020,84470,243530,328000,MKT
06079802342050000,2019,84470,243530,328000,MKT
06079802342070000,2021,132853,298947,431800,MKT
06079802342070000,2020,84470,282830,367300,MKT
06079802342070000,2019,84470,282830,367300,MKT
06079802342090000,2021,143481,451119,594600,MKT
06079802342090000,2020,84470,431930,516400,MKT
06079802342090000,2019,84470,431930,516400,MKT
06079802342110000,2021,143481,371319,514800,MKT
06079802342110000,2020,84470,366730,451200,MKT
06079802342110000,2019,84470,366730,451200,MKT
06079802342130000,2021,143481,468419,611900,MKT
06079802342130000,2020,84470,461530,546000,MKT
06079802342130000,2019,84470,461530,546000,MKT
06079802342150000,2021,141942,479958,621900,MKT
06079802342150000,2020,82711,459589,542300,MKT
06079802342150000,2019,82711,458389,541100,MKT
06079802342170000,2021,142491,446909,589400,MKT
06079802342170000,2020,83336,400664,484000,MKT
06079802342170000,2019,83336,400664,484000,MKT
06079802342190000,2021,141743,326357,468100,MKT
06079802342190000,2020,82484,316816,399300,MKT
06079802342190000,2019,82484,316816,399300,MKT
06079802342210000,2021,150850,311550,462400,MKT
06079802342210000,2020,93145,331955,425100,MKT
06079802342210000,2019,93145,331955,425100,MKT
06079802342230000,2021,135282,339118,474400,MKT
06079802342230000,2020,87511,339389,426900,MKT
06079802342230000,2019,87511,339389,426900,MKT
06079802342250000,2021,133613,300287,433900,MKT
06079802342250000,2020,85416,294084,379500,MKT
06079802342250000,2019,85416,294084,379500,MKT
06079802342270000,2021,134614,332386,467000,MKT
06079802342270000,2020,86670,326430,413100,MKT
06079802342270000,2019,86670,330830,417500,MKT
06079802342290000,2021,134143,267857,402000,MKT
06079802342290000,2020,86079,258721,344800,MKT
06079802342290000,2019,86079,258721,344800,MKT
06079802342310000,2021,133500,330600,464100,MKT
06079802342310000,2020,85275,333925,419200,OVR
06079802342310000,2019,85275,333925,419200,MKT
06079802342330000,2021,133500,290400,423900,MKT
06079802342330000,2020,85275,314025,399300,MKT
06079802342330000,2019,85275,314025,399300,MKT
06079802342350000,2021,133500,307600,441100,MKT
06079802342350000,2020,85275,300125,385400,MKT
06079802342350000,2019,85275,300125,385400,MKT
06079802342370000,2021,133509,301291,434800,MKT
06079802342370000,2020,85286,313114,398400,MKT
06079802342370000,2019,85286,313114,398400,MKT
06079802343010000,2021,112757,243743,356500,MKT
06079802343010000,2020,69065,242435,311500,MKT
06079802343010000,2019,69065,242435,311500,MKT
06079802343030000,2021,132853,271747,404600,MKT
06079802343030000,2020,84470,266630,351100,OVR
06079802343030000,2019,84470,266630,351100,MKT
06079802343050000,2021,132853,248547,381400,MKT
06079802343050000,2020,84470,247030,331500,MKT
06079802343050000,2019,84470,247030,331500,MKT
06079802343070000,2021,132853,230547,363400,MKT
06079802343070000,2020,84470,242030,326500,MKT
06079802343070000,2019,84470,242030,326500,MKT
06079802343090000,2021,132853,232447,365300,MKT
06079802343090000,2020,84470,240230,324700,MKT
06079802343090000,2019,84470,240730,325200,MKT
06079802343110000,2021,135063,226837,361900,MKT
06079802343110000,2020,87235,237965,325200,MKT
06079802343110000,2019,87235,237965,325200,MKT
06079802343130000,2021,132378,247022,379400,MKT
06079802343130000,2020,83882,251118,335000,MKT
06079802343130000,2019,83882,251118,335000,MKT
06079802343150000,2021,135565,238135,373700,MKT
06079802343150000,2020,87869,256431,344300,MKT
06079802343150000,2019,87869,256431,344300,MKT
06079802343170000,2021,131404,257796,389200,MKT
06079802343170000,2020,82682,256218,338900,MKT
06079802343170000,2019,82682,256218,338900,MKT
06079802343190000,2021,131257,223043,354300,MKT
06079802343190000,2020,82502,239298,321800,MKT
06079802343190000,2019,82502,239298,321800,MKT
06079802343210000,2021,132825,266375,399200,MKT
06079802343210000,2020,84436,256864,341300,MKT
06079802343210000,2019,84436,256864,341300,MKT
06079802343230000,2021,132853,291047,423900,MKT
06079802343230000,2020,84470,311030,395500,MKT
06079802343230000,2019,84470,311030,395500,MKT
06079802343250000,2021,132853,241447,374300,MKT
06079802343250000,2020,84470,247730,332200,MKT
06079802343250000,2019,84470,247730,332200,MKT
06079802343270000,2021,133418,266782,400200,MKT
06079802343270000,2020,85174,261426,346600,MKT
06079802343270000,2019,85174,261426,346600,MKT
06079802343290000,2021,129592,249308,378900,MKT
06079802343290000,2020,80471,247329,327800,MKT
06079802343290000,2019,80471,248329,328800,MKT
06079802343310000,2021,131926,293574,425500,MKT
06079802343310000,2020,83324,330876,414200,MKT
06079802343310000,2019,83324,297576,380900,MKT
06079802343330000,2021,143910,494790,638700,MKT
06079802343330000,2020,84964,439936,524900,MKT
06079802343330000,2019,84964,439936,524900,MKT
06079802343350000,2021,144821,420679,565500,MKT
06079802343350000,2020,86017,359883,445900,MKT
06079802343350000,2019,86017,359883,445900,MKT
06079802343370000,2021,144375,313125,457500,MKT
06079802343370000,2020,85501,344599,430100,OVR
06079802343370000,2019,85501,344599,430100,MKT
06079802343410000,2021,144375,286625,431000,MKT
06079802343410000,2020,85501,281199,366700,MKT
06079802343410000,2019,85501,281599,367100,MKT
06079802343430000,2021,144336,400564,544900,MKT
06079802343430000,2020,85456,383644,469100,MKT
06079802343430000,2019,85456,383644,469100,MKT
06079802343450000,2021,142207,320193,462400,MKT
06079802343450000,2020,83012,319988,403000,MKT
06079802343450000,2019,83012,319988,403000,MKT
06079802343470000,2021,131082,457818,588900,MKT
06079802343470000,2020,82286,428914,511200,MKT
06079802343470000,2019,82286,428914,511200,MKT
06079802343490000,2021,129680,307620,437300,MKT
06079802343490000,2020,80578,314622,395200,MKT
06079802343490000,2019,80578,314622,395200,MKT
06079802343510000,2021,129405,298695,428100,MKT
06079802343510000,2020,80244,287956,368200,MKT
06079802343510000,2019,80244,287956,368200,MKT
06079802343530000,2021,127115,296485,423600,MKT
06079802343530000,2020,77496,290004,367500,MKT
06079802343530000,2019,77496,290004,367500,MKT
06079802343550000,2021,128864,304936,433800,MKT
06079802343550000,2020,79591,304309,383900,MKT
06079802343550000,2019,79591,304309,383900,MKT
06079802343570000,2021,129813,363087,492900,MKT
06079802343570000,2020,80739,347561,428300,OVR
06079802343570000,2019,80739,347561,428300,MKT
06079802343590000,2021,129212,295488,424700,MKT
06079802343590000,2020,80011,293589,373600,MKT
06079802343590000,2019,80011,293589,373600,MKT
06079802343610000,2021,130139,280861,411000,MKT
06079802343610000,2020,81135,276365,357500,MKT
06079802343610000,2019,81135,276365,357500,MKT
06079802343630000,2021,137296,327304,464600,MKT
06079802343630000,2020,90072,308728,398800,MKT
06079802343630000,2019,90072,308728,398800,MKT
06079802343650000,2021,128609,305691,434300,MKT
06079802343650000,2020,79284,319916,399200,MKT
06079802343650000,2019,79284,311116,390400,MKT
06079802343670000,2021,127600,440100,567700,MKT
06079802343670000,2020,78074,382426,460500,MKT
06079802343670000,2019,78074,382426,460500,MKT
06079802343690000,2021,127538,447762,575300,MKT
06079802343690000,2020,78000,387400,465400,OVR
06079802343690000,2019,78000,387400,465400,MKT
06079802343710000,2021,128044,293756,421800,MKT
06079802343710000,2020,78605,285795,364400,MKT
06079802343710000,2019,78605,285795,364400,MKT
06079802343730000,2021,127528,303272,430800,MKT
06079802343730000,2020,77988,305112,383100,MKT
06079802343730000,2019,77988,305112,383100,MKT
06079802343750000,2021,128038,263162,391200,MKT
06079802343750000,2020,78599,244701,323300,MKT
06079802343750000,2019,78599,244701,323300,MKT
06079802343770000,2021,127517,294383,421900,MKT
06079802343770000,2020,77976,280624,358600,MKT
06079802343770000,2019,77976,280624,358600,MKT
06079802343790000,2021,128028,290772,418800,MKT
06079802343790000,2020,78586,287914,366500,MKT
06079802343790000,2019,78586,287914,366500,MKT
06079802343810000,2021,127512,272388,399900,MKT
06079802343810000,2020,77969,260831,338800,MKT
06079802343810000,2019,77969,260831,338800,MKT
06079802343830000,2021,128018,238782,366800,MKT
06079802343830000,2020,78574,234226,312800,MKT
06079802343830000,2019,78574,234226,312800,MKT
06079802343850000,2021,131912,278688,410600,MKT
06079802343850000,2020,83307,294593,377900,MKT
06079802343850000,2019,83307,289793,373100,MKT
06079802343876500,2021,63131,0,63131,COST
06079802343876500,2020,62191,0,62191,COST
06079802343876500,2019,62191,0,62191,COST
06079802344010000,2021,126362,252038,378400,MKT
06079802344010000,2020,89524,260676,350200,MKT
06079802344010000,2019,89524,260676,350200,MKT
06079802344030000,2021,148844,322056,470900,MKT
06079802344030000,2020,109437,344963,454400,MKT
06079802344030000,2019,109437,344963,454400,MKT
06079802344050000,2021,148844,298256,447100,MKT
06079802344050000,2020,109437,321663,431100,MKT
06079802344050000,2019,109437,321663,431100,MKT
06079802344070000,2021,147508,280292,427800,MKT
06079802344070000,2020,107528,286472,394000,MKT
06079802344070000,2019,107528,283572,391100,MKT
06079802344090000,2021,149126,311874,461000,MKT
06079802344090000,2020,109843,310557,420400,MKT
06079802344090000,2019,109843,310557,420400,MKT
06079802344110000,2021,149321,270079,419400,MKT
06079802344110000,2020,110124,278176,388300,MKT
06079802344110000,2019,110124,278176,388300,MKT
06079802344130000,2021,147978,333122,481100,MKT
06079802344130000,2020,108198,321102,429300,OVR
06079802344130000,2019,108198,321102,429300,MKT
06079802344150000,2021,147924,269176,417100,MKT
06079802344150000,2020,108122,246378,354500,OVR
06079802344150000,2019,108122,246378,354500,MKT
06079802344170000,2021,142665,316435,459100,MKT
06079802344170000,2020,100745,363755,464500,OVR
06079802344170000,2019,100745,363755,464500,MKT
06079802344190000,2021,142891,306209,449100,MKT
06079802344190000,2020,101057,329243,430300,MKT
06079802344190000,2019,101057,329243,430300,MKT
06079802344210000,2021,146138,294262,440400,MKT
06079802344210000,2020,105588,300212,405800,MKT
06079802344210000,2019,105588,291412,397000,MKT
06079802344230000,2021,146138,292462,438600,MKT
06079802344230000,2020,105588,321312,426900,MKT
06079802344230000,2019,105588,321312,426900,MKT
06079802344250000,2021,146138,255962,402100,MKT
06079802344250000,2020,105588,261812,367400,MKT
06079802344250000,2019,105588,261812,367400,MKT
06079802344270000,2021,146138,252262,398400,MKT
06079802344270000,2020,105588,249512,355100,OVR
06079802344270000,2019,105588,249512,355100,MKT
06079802344290000,2021,146138,305762,451900,MKT
06079802344290000,2020,105588,310512,416100,MKT
06079802344290000,2019,105588,310512,416100,MKT
06079802344310000,2021,146138,303062,449200,MKT
06079802344310000,2020,105588,301312,406900,MKT
06079802344310000,2019,105588,301312,406900,MKT
06079802344330000,2021,146138,257362,403500,MKT
06079802344330000,2020,105588,259012,364600,MKT
06079802344330000,2019,105588,259012,364600,MKT
06079802344350000,2021,147734,302166,449900,MKT
06079802344350000,2020,107850,307550,415400,MKT
06079802344350000,2019,107850,307550,415400,MKT
06079802345016500,2021,96238,0,96238,COST
06079802345016500,2020,141618,0,141618,COST
06079802345016500,2019,141618,0,141618,COST
06079802346010000,2021,108451,268749,377200,MKT
06079802346010000,2020,64010,252290,316300,MKT
06079802346010000,2019,64010,252290,316300,MKT
06079802346030000,2021,106392,247108,353500,MKT
06079802346030000,2020,61660,252840,314500,MKT
06079802346030000,2019,61660,252840,314500,MKT
06079802346050000,2021,109822,260878,370700,MKT
06079802346050000,2020,65599,256301,321900,MKT
06079802346050000,2019,65599,256301,321900,MKT
06079802346070000,2021,134277,289223,423500,MKT
06079802346070000,2020,100795,292505,393300,MKT
06079802346070000,2019,100795,292505,393300,MKT
06079802346090000,2021,142367,370633,513000,MKT
06079802346090000,2020,100335,350065,450400,MKT
06079802346090000,2019,100335,350065,450400,MKT
06079802346110000,2021,157021,339879,496900,MKT
06079802346110000,2020,121479,357421,478900,OVR
06079802346110000,2019,121479,357421,478900,MKT
06079802346130000,2021,135543,244457,380000,MKT
06079802346130000,2020,87841,244259,332100,OVR
06079802346130000,2019,87841,244259,332100,MKT
06079802346150000,2021,134098,280802,414900,MKT
06079802346150000,2020,86023,283477,369500,MKT
06079802346150000,2019,86023,283477,369500,MKT
06079802346170000,2021,131833,267367,399200,MKT
06079802346170000,2020,83209,257991,341200,MKT
06079802346170000,2019,83209,257991,341200,MKT
06079802346190000,2021,134098,263602,397700,MKT
06079802346190000,2020,86023,264077,350100,MKT
06079802346190000,2019,86023,264077,350100,MKT
06079802346210000,2021,131072,238828,369900,MKT
06079802346210000,2020,82275,245325,327600,MKT
06079802346210000,2019,82275,245325,327600,MKT
06079802346230000,2021,146138,300462,446600,MKT
06079802346230000,2020,105588,325012,430600,MKT
06079802346230000,2019,105588,325012,430600,MKT
06079802346250000,2021,149677,316423,466100,MKT
06079802346250000,2020,110636,308764,419400,MKT
06079802346250000,2019,110636,308764,419400,MKT
06079802346270000,2021,156279,250021,406300,MKT
06079802346270000,2020,120361,257939,378300,MKT
06079802346270000,2019,120361,257939,378300,MKT
06079802346290000,2021,152682,264518,417200,MKT
06079802346290000,2020,115013,267787,382800,MKT
06079802346290000,2019,115013,267787,382800,MKT
06079802346310000,2021,131357,252043,383400,MKT
06079802346310000,2020,82624,248176,330800,MKT
06079802346310000,2019,82624,248176,330800,MKT
06079802346330000,2021,127517,247783,375300,MKT
06079802346330000,2020,77976,252624,330600,MKT
06079802346330000,2019,77976,252624,330600,MKT
06079802346350000,2021,140269,305231,445500,MKT
06079802346350000,2020,97469,307431,404900,MKT
06079802346350000,2019,97469,307431,404900,MKT
06079802346370000,2021,140269,304231,444500,MKT
06079802346370000,2020,97469,306331,403800,MKT
06079802346370000,2019,97469,306331,403800,MKT
06079802348430000,2021,140269,265931,406200,MKT
06079802348430000,2020,97469,272231,369700,MKT
06079802348430000,2019,97469,272231,369700,MKT
06079802348450000,2021,140269,345331,485600,MKT
06079802348450000,2020,97469,352031,449500,MKT
06079802348450000,2019,97469,352031,449500,MKT
06079802348470000,2021,140269,333931,474200,MKT
06079802348470000,2020,97469,343631,441100,MKT
06079802348470000,2019,97469,343631,441100,MKT
06079802348490000,2021,140269,524531,664800,MKT
06079802348490000,2020,97469,426131,523600,MKT
06079802348490000,2019,97469,426131,523600,MKT
06079802348510000,2021,140269,284031,424300,MKT
06079802348510000,2020,97469,297231,394700,MKT
06079802348510000,2019,97469,297231,394700,MKT
06079802348530000,2021,140269,339931,480200,MKT
06079802348530000,2020,97469,346631,444100,MKT
06079802348530000,2019,97469,346631,444100,MKT
06079802348550000,2021,140269,281631,421900,MKT
06079802348550000,2020,97469,290831,388300,MKT
06079802348550000,2019,97469,290831,388300,MKT
06079802348570000,2021,140269,345631,485900,MKT
06079802348570000,2020,97469,330731,428200,MKT
06079802348570000,2019,97469,330731,428200,MKT
06079802348590000,2021,147719,341381,489100,MKT
06079802348590000,2020,107829,325871,433700,OVR
06079802348590000,2019,107829,325871,433700,MKT
06079802350010000,2021,128028,246972,375000,MKT
06079802350010000,2020,78586,242314,320900,MKT
06079802350010000,2019,78586,242314,320900,MKT
06079802350030000,2021,124874,228826,353700,MKT
06079802350030000,2020,74852,233848,308700,MKT
06079802350030000,2019,74852,233848,308700,MKT
06079802350050000,2021,124874,245526,370400,MKT
06079802350050000,2020,74852,244248,319100,MKT
06079802350050000,2019,74852,244248,319100,MKT
06079802350070000,2021,124874,255726,380600,MKT
06079802350070000,2020,74852,254248,329100,MKT
06079802350070000,2019,74852,254248,329100,MKT
06079802350090000,2021,124874,262626,387500,MKT
06079802350090000,2020,74852,248848,323700,MKT
06079802350090000,2019,74852,248848,323700,MKT
06079802350110000,2021,124874,261326,386200,MKT
06079802350110000,2020,74852,253248,328100,MKT
06079802350110000,2019,74852,250848,325700,MKT
06079802350130000,2021,124874,240026,364900,MKT
06079802350130000,2020,74852,246748,321600,MKT
06079802350130000,2019,74852,246748,321600,MKT
06079802350150000,2021,138271,270629,408900,MKT
06079802350150000,2020,78586,273614,352200,MKT
06079802350150000,2019,78586,247414,326000,OVR
06079802350170000,2021,128028,238372,366400,MKT
06079802350170000,2020,78586,243914,322500,MKT
06079802350170000,2019,78586,243914,322500,MKT
06079802350190000,2021,124874,235626,360500,MKT
06079802350190000,2020,74852,240348,315200,MKT
06079802350190000,2019,74852,240348,315200,MKT
06079802350210000,2021,124874,264526,389400,MKT
06079802350210000,2020,74852,253348,328200,MKT
06079802350210000,2019,74852,253348,328200,MKT
06079802350230000,2021,124874,259826,384700,MKT
06079802350230000,2020,74852,247148,322000,MKT
06079802350230000,2019,74852,247148,322000,MKT
06079802350250000,2021,124874,231226,356100,MKT
06079802350250000,2020,74852,232748,307600,MKT
06079802350250000,2019,74852,232748,307600,MKT
06079802350270000,2021,124874,253226,378100,MKT
06079802350270000,2020,74852,246448,321300,MKT
06079802350270000,2019,74852,246448,321300,MKT
06079802350290000,2021,124874,259726,384600,MKT
06079802350290000,2020,74852,247748,322600,MKT
06079802350290000,2019,74852,247748,322600,MKT
06079802350310000,2021,128028,229372,357400,MKT
06079802350310000,2020,78586,238514,317100,OVR
06079802350310000,2019,78586,238514,317100,MKT
06079802351010000,2021,128028,230272,358300,MKT
06079802351010000,2020,78586,239214,317800,MKT
06079802351010000,2019,78586,239214,317800,MKT
06079802351030000,2021,124874,254826,379700,MKT
06079802351030000,2020,74852,252848,327700,MKT
06079802351030000,2019,74852,252848,327700,MKT
06079802351050000,2021,124874,245026,369900,MKT
06079802351050000,2020,74852,242548,317400,MKT
06079802351050000,2019,74852,242548,317400,MKT
06079802351070000,2021,124874,241126,366000,MKT
06079802351070000,2020,74852,242848,317700,MKT
06079802351070000,2019,74852,242848,317700,MKT
06079802351090000,2021,124874,259326,384200,MKT
06079802351090000,2020,74852,250648,325500,MKT
06079802351090000,2019,74852,250648,325500,MKT
06079802351110000,2021,124874,258626,383500,MKT
06079802351110000,2020,74852,262148,337000,MKT
06079802351110000,2019,74852,262148,337000,MKT
06079802351130000,2021,124874,287326,412200,MKT
06079802351130000,2020,74852,248948,323800,OVR
06079802351130000,2019,74852,248948,323800,MKT
06079802351150000,2021,128028,262972,391000,MKT
06079802351150000,2020,78586,248914,327500,OVR
06079802351150000,2019,78586,248914,327500,MKT
06079802351170000,2021,128028,269772,397800,MKT
06079802351170000,2020,78586,258214,336800,OVR
06079802351170000,2019,78586,258214,336800,MKT
06079802351190000,2021,124874,290226,415100,MKT
06079802351190000,2020,74852,287748,362600,MKT
06079802351190000,2019,74852,287748,362600,MKT
06079802351210000,2021,124874,293126,418000,MKT
06079802351210000,2020,74852,298448,373300,MKT
06079802351210000,2019,74852,298448,373300,MKT
06079802351230000,2021,124874,229726,354600,MKT
06079802351230000,2020,74852,238748,313600,MKT
06079802351230000,2019,74852,238748,313600,MKT
06079802351250000,2021,124874,275826,400700,MKT
06079802351250000,2020,74852,277148,352000,MKT
06079802351250000,2019,74852,277148,352000,MKT
06079802351270000,2021,124874,316326,441200,MKT
06079802351270000,2020,74852,304248,379100,MKT
06079802351270000,2019,74852,304248,379100,MKT
06079802351290000,2021,124874,249526,374400,MKT
06079802351290000,2020,74852,250148,325000,MKT
06079802351290000,2019,74852,250148,325000,MKT
06079802351310000,2021,128028,241072,369100,MKT
06079802351310000,2020,78586,243814,322400,MKT
06079802351310000,2019,78586,243814,322400,MKT
06079802352010000,2021,128028,279872,407900,MKT
06079802352010000,2020,78586,275114,353700,MKT
06079802352010000,2019,78586,275114,353700,MKT
06079802352030000,2021,124874,275226,400100,MKT
06079802352030000,2020,74852,278948,353800,MKT
06079802352030000,2019,74852,278948,353800,MKT
06079802352050000,2021,124874,277826,402700,MKT
06079802352050000,2020,74852,272048,346900,MKT
06079802352050000,2019,74852,272048,346900,MKT
06079802352070000,2021,124874,277026,401900,MKT
06079802352070000,2020,74852,275348,350200,MKT
06079802352070000,2019,74852,275348,350200,MKT
06079802352090000,2021,124874,302526,427400,MKT
06079802352090000,2020,74852,298348,373200,MKT
06079802352090000,2019,74852,298348,373200,MKT
06079802352110000,2021,124874,290526,415400,MKT
06079802352110000,2020,74852,295648,370500,MKT
06079802352110000,2019,74852,295648,370500,MKT
06079802352130000,2021,124874,250226,375100,MKT
06079802352130000,2020,74852,251348,326200,MKT
06079802352130000,2019,74852,251348,326200,MKT
06079802352150000,2021,128028,300372,428400,MKT
06079802352150000,2020,78586,296914,375500,MKT
06079802352150000,2019,78586,296914,375500,MKT
06079802352170000,2021,128028,267872,395900,MKT
06079802352170000,2020,78586,263314,341900,MKT
06079802352170000,2019,78586,263314,341900,MKT
06079802352190000,2021,124874,290426,415300,MKT
06079802352190000,2020,74852,305448,380300,MKT
06079802352190000,2019,74852,305448,380300,MKT
06079802352210000,2021,124874,313426,438300,MKT
06079802352210000,2020,74852,312348,387200,MKT
06079802352210000,2019,74852,312348,387200,MKT
06079802352230000,2021,124874,271626,396500,MKT
06079802352230000,2020,74852,256148,331000,MKT
06079802352230000,2019,74852,255848,330700,MKT
06079802352250000,2021,124874,273326,398200,MKT
06079802352250000,2020,74852,252848,327700,MKT
06079802352250000,2019,74852,252848,327700,MKT
06079802352270000,2021,124874,291026,415900,MKT
06079802352270000,2020,74852,300348,375200,MKT
06079802352270000,2019,74852,300348,375200,MKT
06079802352290000,2021,124874,250126,375000,MKT
06079802352290000,2020,74852,250948,325800,MKT
06079802352290000,2019,74852,250948,325800,MKT
06079802352310000,2021,128028,232172,360200,MKT
06079802352310000,2020,78586,241514,320100,MKT
06079802352310000,2019,78586,241514,320100,MKT
06079802353010000,2021,131926,295174,427100,MKT
06079802353010000,2020,83324,306176,389500,OVR
06079802353010000,2019,83324,306176,389500,MKT
06079802353030000,2021,129528,264972,394500,MKT
06079802353030000,2020,80394,250806,331200,MKT
06079802353030000,2019,80394,250806,331200,MKT
06079802353050000,2021,131926,307074,439000,MKT
06079802353050000,2020,83324,295076,378400,OVR
06079802353050000,2019,83324,295076,378400,MKT
06079802353070000,2021,131926,288874,420800,MKT
06079802353070000,2020,83324,288176,371500,MKT
06079802353070000,2019,83324,288176,371500,MKT
06079802353090000,2021,129528,305772,435300,MKT
06079802353090000,2020,80394,317306,397700,MKT
06079802353090000,2019,80394,317306,397700,MKT
06079802353110000,2021,131926,277974,409900,MKT
06079802353110000,2020,83324,288076,371400,MKT
06079802353110000,2019,83324,288076,371400,MKT
06079802354010000,2021,127916,0,127916,COST
06079802354010000,2020,78452,0,78452,COST
06079802354010000,2019,78452,0,78452,COST
06079802354030000,2021,126975,257225,384200,MKT
06079802354030000,2020,77329,246971,324300,MKT
06079802354030000,2019,77329,246971,324300,MKT
06079802354050000,2021,130939,240061,371000,MKT
06079802354050000,2020,82111,229889,312000,MKT
06079802354050000,2019,82111,229889,312000,MKT
06079802354070000,2021,130173,222327,352500,MKT
06079802354070000,2020,81177,233123,314300,MKT
06079802354070000,2019,81177,233123,314300,MKT
06079802354090000,2021,140873,236227,377100,MKT
06079802354090000,2020,94709,239191,333900,MKT
06079802354090000,2019,94709,239191,333900,MKT
06079802354110000,2021,118033,241067,359100,MKT
06079802354110000,2020,75513,236587,312100,MKT
06079802354110000,2019,75513,236587,312100,MKT
06079802354130000,2021,106552,228548,335100,MKT
06079802354130000,2020,61841,235359,297200,MKT
06079802354130000,2019,61841,235359,297200,MKT
06079802354150000,2021,106415,243485,349900,MKT
06079802354150000,2020,61686,239514,301200,MKT
06079802354150000,2019,61686,239514,301200,MKT
06079802354170000,2021,106410,292890,399300,MKT
06079802354170000,2020,61681,289319,351000,MKT
06079802354170000,2019,61681,289319,351000,MKT
06079802354190000,2021,106410,281590,388000,MKT
06079802354190000,2020,61681,284519,346200,MKT
06079802354190000,2019,61681,284519,346200,MKT
06079802354210000,2021,106433,288167,394600,MKT
06079802354210000,2020,61707,284693,346400,MKT
06079802354210000,2019,61707,284693,346400,MKT
06079802355010000,2021,128282,278018,406300,MKT
06079802355010000,2020,78890,277710,356600,MKT
06079802355010000,2019,78890,275710,354600,MKT
06079802355030000,2021,125950,299850,425800,MKT
06079802355030000,2020,76115,327085,403200,MKT
06079802355030000,2019,76115,327085,403200,MKT
06079802355050000,2021,128282,270318,398600,MKT
06079802355050000,2020,78890,275310,354200,MKT
06079802355050000,2019,78890,275310,354200,MKT
06079802355070000,2021,127661,305539,433200,MKT
06079802355070000,2020,78147,292853,371000,MKT
06079802355070000,2019,78147,292853,371000,MKT
06079802355090000,2021,127656,271044,398700,MKT
06079802355090000,2020,78141,267959,346100,MKT
06079802355090000,2019,78141,267959,346100,MKT
06079802355110000,2021,127656,298344,426000,MKT
06079802355110000,2020,78141,298359,376500,MKT
06079802355110000,2019,78141,298359,376500,MKT
06079802355130000,2021,127656,289744,417400,MKT
06079802355130000,2020,78141,270159,348300,MKT
06079802355130000,2019,78141,270059,348200,MKT
06079802355150000,2021,132894,352806,485700,MKT
06079802355150000,2020,84521,330979,415500,MKT
06079802355150000,2019,84521,330979,415500,MKT
06079802355170000,2021,132972,283428,416400,MKT
06079802355170000,2020,84618,278482,363100,MKT
06079802355170000,2019,84618,278482,363100,MKT
06079802355190000,2021,127656,256144,383800,MKT
06079802355190000,2020,78141,249959,328100,MKT
06079802355190000,2019,78141,249959,328100,MKT
06079802355210000,2021,127656,232144,359800,MKT
06079802355210000,2020,78141,243359,321500,OVR
06079802355210000,2019,78141,243359,321500,MKT
06079802355230000,2021,127656,263744,391400,MKT
06079802355230000,2020,78141,251559,329700,MKT
06079802355230000,2019,78141,251559,329700,MKT
06079802355250000,2021,127661,288439,416100,MKT
06079802355250000,2020,78147,280253,358400,MKT
06079802355250000,2019,78147,280253,358400,MKT
06079802356010000,2021,117767,305433,423200,MKT
06079802356010000,2020,75181,290019,365200,MKT
06079802356010000,2019,75181,290019,365200,MKT
06079802356030000,2021,110984,275416,386400,MKT
06079802356030000,2020,66961,261239,328200,MKT
06079802356030000,2019,66961,261239,328200,MKT
06079802356050000,2021,113170,274030,387200,MKT
06079802356050000,2020,69559,258641,328200,MKT
06079802356050000,2019,69559,258641,328200,MKT
06079802356070000,2021,113170,266030,379200,MKT
06079802356070000,2020,69559,254741,324300,MKT
06079802356070000,2019,69559,254741,324300,MKT
06079802356090000,2021,113170,244730,357900,MKT
06079802356090000,2020,69559,236041,305600,MKT
06079802356090000,2019,69559,236041,305600,MKT
06079802356110000,2021,113166,270034,383200,MKT
06079802356110000,2020,69554,267346,336900,MKT
06079802356110000,2019,69554,267346,336900,MKT
06079802356130000,2021,110984,258216,369200,MKT
06079802356130000,2020,66961,258939,325900,MKT
06079802356130000,2019,66961,258939,325900,MKT
06079802356150000,2021,117767,254233,372000,MKT
06079802356150000,2020,75181,252119,327300,MKT
06079802356150000,2019,75181,252119,327300,MKT
06079802356176500,2021,40086,0,40086,COST
06079802356176500,2020,25629,0,25629,COST
06079802356176500,2019,25629,0,25629,COST
06079802357010000,2021,135312,298088,433400,MKT
06079802357010000,2020,87550,319650,407200,MKT
06079802357010000,2019,87550,319650,407200,MKT
06079802357030000,2021,130027,242073,372100,MKT
06079802357030000,2020,80999,247601,328600,MKT
06079802357030000,2019,80999,247601,328600,MKT
06079802357050000,2021,127517,272883,400400,MKT
06079802357050000,2020,77976,272424,350400,MKT
06079802357050000,2019,77976,272424,350400,MKT
06079802357070000,2021,130027,295873,425900,MKT
06079802357070000,2020,80999,309301,390300,MKT
06079802357070000,2019,80999,309301,390300,MKT
06079802357090000,2021,130027,271773,401800,MKT
06079802357090000,2020,80999,270401,351400,MKT
06079802357090000,2019,80999,270401,351400,MKT
06079802357110000,2021,127517,246283,373800,MKT
06079802357110000,2020,77976,250924,328900,MKT
06079802357110000,2019,77976,250924,328900,MKT
06079802357130000,2021,130027,253273,383300,MKT
06079802357130000,2020,80999,249301,330300,MKT
06079802357130000,2019,80999,249301,330300,MKT
06079802357150000,2021,135312,310788,446100,MKT
06079802357150000,2020,87550,333950,421500,MKT
06079802357150000,2019,87550,333950,421500,MKT
06079802357170000,2021,135312,234088,369400,MKT
06079802357170000,2020,87550,237550,325100,MKT
06079802357170000,2019,87550,237550,325100,MKT
06079802357190000,2021,130027,306373,436400,MKT
06079802357190000,2020,80999,316401,397400,MKT
06079802357190000,2019,80999,316401,397400,MKT
06079802357210000,2021,127517,286483,414000,MKT
06079802357210000,2020,77976,304924,382900,MKT
06079802357210000,2019,77976,304924,382900,MKT
06079802357230000,2021,130027,293173,423200,MKT
06079802357230000,2020,80999,292801,373800,OVR
06079802357230000,2019,80999,292801,373800,MKT
06079802357250000,2021,130027,284573,414600,MKT
06079802357250000,2020,80999,304701,385700,MKT
06079802357250000,2019,80999,304701,385700,MKT
06079802357270000,2021,127517,230783,358300,MKT
06079802357270000,2020,77976,241424,319400,MKT
06079802357270000,2019,77976,241424,319400,MKT
06079802357290000,2021,130027,285473,415500,MKT
06079802357290000,2020,80999,285201,366200,MKT
06079802357290000,2019,80999,285201,366200,MKT
06079802357310000,2021,135312,419188,554500,MKT
06079802357310000,2020,87550,350850,438400,OVR
06079802357310000,2019,87550,350850,438400,MKT
06079802358010000,2021,135312,333588,468900,MKT
06079802358010000,2020,87550,335250,422800,MKT
06079802358010000,2019,87550,335250,422800,MKT
06079802358030000,2021,130231,263969,394200,MKT
06079802358030000,2020,81248,268752,350000,MKT
06079802358030000,2019,81248,268752,350000,MKT
06079802358050000,2021,127517,247783,375300,MKT
06079802358050000,2020,77976,248124,326100,MKT
06079802358050000,2019,77976,248124,326100,MKT
06079802358070000,2021,130260,278540,408800,MKT
06079802358070000,2020,81283,273717,355000,MKT
06079802358070000,2019,81283,273717,355000,MKT
06079802358090000,2021,130260,290940,421200,MKT
06079802358090000,2020,81283,298617,379900,MKT
06079802358090000,2019,81283,298617,379900,MKT
06079802358110000,2021,127517,306183,433700,MKT
06079802358110000,2020,77976,315824,393800,MKT
06079802358110000,2019,77976,315824,393800,MKT
06079802358130000,2021,130231,280769,411000,MKT
06079802358130000,2020,81248,275352,356600,MKT
06079802358130000,2019,81248,275352,356600,MKT
06079802358150000,2021,135312,350688,486000,MKT
06079802358150000,2020,87550,333850,421400,MKT
06079802358150000,2019,87550,333850,421400,MKT
06079802359010000,2021,117767,266833,384600,MKT
06079802359010000,2020,75181,258119,333300,MKT
06079802359010000,2019,75181,258119,333300,MKT
06079802359030000,2021,110984,277716,388700,MKT
06079802359030000,2020,66961,275239,342200,MKT
06079802359030000,2019,66961,275239,342200,MKT
06079802359050000,2021,113344,230356,343700,MKT
06079802359050000,2020,69768,248032,317800,MKT
06079802359050000,2019,69768,248032,317800,MKT
06079802359070000,2021,34011,0,34011,COST
06079802359070000,2020,20940,0,20940,COST
06079802359070000,2019,20940,0,20940,COST
06079802360010000,2021,133649,277251,410900,MKT
06079802360010000,2020,85461,273639,359100,MKT
06079802360010000,2019,85461,273639,359100,MKT
06079802360030000,2021,125950,285550,411500,MKT
06079802360030000,2020,76115,279485,355600,MKT
06079802360030000,2019,76115,279485,355600,MKT
06079802360050000,2021,128629,255371,384000,MKT
06079802360050000,2020,79308,264492,343800,MKT
06079802360050000,2019,79308,264492,343800,MKT
06079802360070000,2021,128659,0,128659,COST
06079802360070000,2020,79344,0,79344,COST
06079802360070000,2019,79344,0,79344,COST
06079802360090000,2021,133482,0,133482,COST
06079802360090000,2020,85253,0,85253,COST
06079802360090000,2019,85253,0,85253,COST
06079802360110000,2021,133482,372918,506400,MKT
06079802360110000,2020,85253,336547,421800,MKT
06079802360110000,2019,85253,336547,421800,MKT
06079802360130000,2021,133482,303918,437400,MKT
06079802360130000,2020,85253,312547,397800,MKT
06079802360130000,2019,85253,312547,397800,MKT
06079802360150000,2021,133649,310151,443800,MKT
06079802360150000,2020,85461,298039,383500,MKT
06079802360150000,2019,85461,298039,383500,MKT
06079802361010000,2021,133649,293051,426700,MKT
06079802361010000,2020,85461,302039,387500,MKT
06079802361010000,2019,85461,302039,387500,MKT
06079802361030000,2021,125950,269450,395400,MKT
06079802361030000,2020,76115,271685,347800,MKT
06079802361030000,2019,76115,267185,343300,MKT
06079802361050000,2021,128428,278372,406800,MKT
06079802361050000,2020,79066,346334,425400,OVR
06079802361050000,2019,79066,346334,425400,MKT
06079802361070000,2021,128428,340472,468900,MKT
06079802361070000,2020,79066,337134,416200,OVR
06079802361070000,2019,79066,337134,416200,MKT
06079802361090000,2021,128428,336172,464600,MKT
06079802361090000,2020,79066,338834,417900,MKT
06079802361090000,2019,79066,338834,417900,MKT
06079802361110000,2021,128428,329172,457600,MKT
06079802361110000,2020,79066,332634,411700,OVR
06079802361110000,2019,79066,332634,411700,MKT
06079802361130000,2021,125950,300850,426800,MKT
06079802361130000,2020,76115,300585,376700,OVR
06079802361130000,2019,76115,300585,376700,MKT
06079802361150000,2021,133649,297951,431600,MKT
06079802361150000,2020,85461,291039,376500,MKT
06079802361150000,2019,85461,290839,376300,MKT
06079802361170000,2021,133649,272051,405700,MKT
06079802361170000,2020,85461,265039,350500,OVR
06079802361170000,2019,85461,265039,350500,MKT
06079802361190000,2021,125950,296050,422000,MKT
06079802361190000,2020,76115,289885,366000,MKT
06079802361190000,2019,76115,289885,366000,MKT
06079802361210000,2021,128428,330972,459400,MKT
06079802361210000,2020,79066,320834,399900,MKT
06079802361210000,2019,79066,320834,399900,MKT
06079802361230000,2021,128428,292772,421200,MKT
06079802361230000,2020,79066,290234,369300,MKT
06079802361230000,2019,79066,290234,369300,MKT
06079802361250000,2021,128428,288372,416800,MKT
06079802361250000,2020,79066,299734,378800,OVR
06079802361250000,2019,79066,299734,378800,MKT
06079802361270000,2021,128428,279772,408200,MKT
06079802361270000,2020,79066,291034,370100,OVR
06079802361270000,2019,79066,291034,370100,MKT
06079802361290000,2021,125950,293750,419700,MKT
06079802361290000,2020,76115,290885,367000,MKT
06079802361290000,2019,76115,290885,367000,MKT
06079802361310000,2021,133649,316851,450500,MKT
06079802361310000,2020,85461,311839,397300,MKT
06079802361310000,2019,85461,311839,397300,MKT
06079802362010000,2021,133649,286951,420600,MKT
06079802362010000,2020,85461,275939,361400,MKT
06079802362010000,2019,85461,275939,361400,MKT
06079802362030000,2021,125950,245750,371700,MKT
06079802362030000,2020,76115,244785,320900,MKT
06079802362030000,2019,76115,244785,320900,MKT
06079802362050000,2021,128428,252872,381300,MKT
06079802362050000,2020,79066,243734,322800,MKT
06079802362050000,2019,79066,243734,322800,MKT
06079802362070000,2021,128428,277572,406000,MKT
06079802362070000,2020,79066,272134,351200,MKT
06079802362070000,2019,79066,272134,351200,MKT
06079802362090000,2021,128428,307772,436200,MKT
06079802362090000,2020,79066,305734,384800,MKT
06079802362090000,2019,79066,292034,371100,MKT
06079802362110000,2021,128428,280972,409400,MKT
06079802362110000,2020,79066,267334,346400,MKT
06079802362110000,2019,79066,267334,346400,MKT
06079802362130000,2021,125950,278650,404600,MKT
06079802362130000,2020,76115,261685,337800,MKT
06079802362130000,2019,76115,261685,337800,MKT
06079802362150000,2021,133649,317051,450700,MKT
06079802362150000,2020,85461,318139,403600,MKT
06079802362150000,2019,85461,318139,403600,MKT
06079802362170000,2021,133649,283351,417000,MKT
06079802362170000,2020,85461,305339,390800,MKT
06079802362170000,2019,85461,305339,390800,MKT
06079802362190000,2021,125950,285350,411300,MKT
06079802362190000,2020,76115,299485,375600,OVR
06079802362190000,2019,76115,299485,375600,MKT
06079802362210000,2021,128428,245372,373800,MKT
06079802362210000,2020,79066,250634,329700,OVR
06079802362210000,2019,79066,250634,329700,MKT
06079802362230000,2021,128428,317072,445500,MKT
06079802362230000,2020,79066,299834,378900,MKT
06079802362230000,2019,79066,295034,374100,MKT
06079802362250000,2021,128428,286672,415100,MKT
06079802362250000,2020,79066,282534,361600,OVR
06079802362250000,2019,79066,282534,361600,MKT
06079802362270000,2021,128428,262572,391000,MKT
06079802362270000,2020,79066,251034,330100,OVR
06079802362270000,2019,79066,251034,330100,MKT
06079802362290000,2021,125950,283350,409300,MKT
06079802362290000,2020,76115,276185,352300,MKT
06079802362290000,2019,76115,281985,358100,MKT
06079802362310000,2021,133554,272846,406400,MKT
06079802362310000,2020,85343,275057,360400,MKT
06079802362310000,2019,85343,275057,360400,MKT
06079802363010000,2021,133649,302851,436500,MKT
06079802363010000,2020,85461,298639,384100,MKT
06079802363010000,2019,85461,298639,384100,MKT
06079802363030000,2021,125950,251450,377400,MKT
06079802363030000,2020,76115,248285,324400,MKT
06079802363030000,2019,76115,248285,324400,MKT
06079802363050000,2021,128634,268566,397200,MKT
06079802363050000,2020,79314,263486,342800,MKT
06079802363050000,2019,79314,263486,342800,MKT
06079802363070000,2021,128659,337441,466100,MKT
06079802363070000,2020,79344,337356,416700,OVR
06079802363070000,2019,79344,337356,416700,MKT
06079802363090000,2021,128659,292241,420900,MKT
06079802363090000,2020,79344,288256,367600,MKT
06079802363090000,2019,79344,288256,367600,MKT
06079802363110000,2021,128629,300471,429100,MKT
06079802363110000,2020,79308,296792,376100,MKT
06079802363110000,2019,79308,296792,376100,MKT
06079802363130000,2021,125950,280350,406300,MKT
06079802363130000,2020,76115,273185,349300,MKT
06079802363130000,2019,76115,273185,349300,MKT
06079802363150000,2021,133649,303851,437500,MKT
06079802363150000,2020,85461,298339,383800,OVR
06079802363150000,2019,85461,298339,383800,MKT
06079802364010000,2021,38793,0,38793,COST
06079802364010000,2020,24040,0,24040,COST
06079802364010000,2019,24040,0,24040,COST
06079802364030000,2021,129282,304718,434000,MKT
06079802364030000,2020,80095,312805,392900,MKT
06079802364030000,2019,80095,312805,392900,MKT
06079802364050000,2021,126588,336212,462800,MKT
06079802364050000,2020,76871,332729,409600,MKT
06079802364050000,2019,76871,332729,409600,MKT
06079802364070000,2021,134330,338870,473200,MKT
06079802364070000,2020,86313,338187,424500,OVR
06079802364070000,2019,86313,338187,424500,MKT
06079802364090000,2021,134330,349370,483700,MKT
06079802364090000,2020,86313,342187,428500,OVR
06079802364090000,2019,86313,342187,428500,MKT
06079802364110000,2021,126588,279212,405800,MKT
06079802364110000,2020,76871,271829,348700,MKT
06079802364110000,2019,76871,271829,348700,MKT
06079802364130000,2021,129252,313948,443200,MKT
06079802364130000,2020,80059,298641,378700,MKT
06079802364130000,2019,80059,298641,378700,MKT
06079802364150000,2021,38769,0,38769,COST
06079802364150000,2020,24011,0,24011,COST
06079802364150000,2019,24011,0,24011,COST
06079802365010000,2021,134348,278152,412500,MKT
06079802365010000,2020,86336,280364,366700,MKT
06079802365010000,2019,86336,280364,366700,MKT
06079802365030000,2021,129666,247634,377300,MKT
06079802365030000,2020,80560,245640,326200,MKT
06079802365030000,2019,80560,245640,326200,MKT
06079802365050000,2021,129666,302634,432300,MKT
06079802365050000,2020,80560,295440,376000,MKT
06079802365050000,2019,80560,295440,376000,MKT
06079802365070000,2021,126594,329306,455900,MKT
06079802365070000,2020,76877,334023,410900,MKT
06079802365070000,2019,76877,334023,410900,MKT
06079802365090000,2021,131635,263865,395500,MKT
06079802365090000,2020,82966,268634,351600,MKT
06079802365090000,2019,82966,268634,351600,MKT
06079802365110000,2021,133391,285909,419300,MKT
06079802365110000,2020,85140,277860,363000,MKT
06079802365110000,2019,85140,277860,363000,MKT
06079802365130000,2021,138948,375152,514100,MKT
06079802365130000,2020,92200,375800,468000,MKT
06079802365130000,2019,92200,375800,468000,MKT
06079802365150000,2021,133054,301546,434600,MKT
06079802365150000,2020,84720,297480,382200,MKT
06079802365150000,2019,84720,297480,382200,MKT
06079802365170000,2021,128784,294716,423500,MKT
06079802365170000,2020,79495,288805,368300,MKT
06079802365170000,2019,79495,288805,368300,MKT
06079802365190000,2021,129316,301484,430800,MKT
06079802365190000,2020,80137,293963,374100,MKT
06079802365190000,2019,80137,293963,374100,MKT
06079802365210000,2021,126594,282606,409200,MKT
06079802365210000,2020,76877,300923,377800,MKT
06079802365210000,2019,76877,300923,377800,MKT
06079802365230000,2021,129316,290884,420200,MKT
06079802365230000,2020,80137,322863,403000,MKT
06079802365230000,2019,80137,322863,403000,MKT
06079802365250000,2021,129316,328984,458300,MKT
06079802365250000,2020,80137,332563,412700,MKT
06079802365250000,2019,80137,332563,412700,MKT
06079802365270000,2021,134348,288552,422900,MKT
06079802365270000,2020,86336,289564,375900,MKT
06079802365270000,2019,86336,289564,375900,MKT
06079802366010000,2021,134993,406307,541300,MKT
06079802366010000,2020,87147,374953,462100,MKT
06079802366010000,2019,87147,374953,462100,MKT
06079802366030000,2021,125955,304645,430600,MKT
06079802366030000,2020,76122,314778,390900,MKT
06079802366030000,2019,76122,314778,390900,MKT
06079802366050000,2021,125955,280945,406900,MKT
06079802366050000,2020,76122,301578,377700,MKT
06079802366050000,2019,76122,301578,377700,MKT
06079802366070000,2021,125960,288940,414900,MKT
06079802366070000,2020,76128,288372,364500,MKT
06079802366070000,2019,76128,288372,364500,MKT
06079802366090000,2021,125960,346040,472000,MKT
06079802366090000,2020,76128,348272,424400,MKT
06079802366090000,2019,76128,348272,424400,MKT
06079802366110000,2021,125966,275934,401900,MKT
06079802366110000,2020,76134,281566,357700,MKT
06079802366110000,2019,76134,281566,357700,MKT
06079802366130000,2021,126756,322544,449300,MKT
06079802366130000,2020,77069,333731,410800,MKT
06079802366130000,2019,77069,333731,410800,MKT
06079802366150000,2021,126761,240939,367700,MKT
06079802366150000,2020,77075,251225,328300,MKT
06079802366150000,2019,77075,251225,328300,MKT
06079802366170000,2021,126766,338834,465600,MKT
06079802366170000,2020,77082,334818,411900,MKT
06079802366170000,2019,77082,334818,411900,MKT
06079802366190000,2021,126766,338734,465500,MKT
06079802366190000,2020,77082,329618,406700,MKT
06079802366190000,2019,77082,329618,406700,MKT
06079802366210000,2021,126772,323228,450000,MKT
06079802366210000,2020,77088,322112,399200,MKT
06079802366210000,2019,77088,322112,399200,MKT
06079802366230000,2021,131762,293838,425600,MKT
06079802366230000,2020,83122,293578,376700,MKT
06079802366230000,2019,83122,293578,376700,MKT
06079802367010000,2021,132001,363599,495600,MKT
06079802367010000,2020,83417,356183,439600,MKT
06079802367010000,2019,83417,356183,439600,MKT
06079802367030000,2021,127042,367958,495000,MKT
06079802367030000,2020,77410,356590,434000,MKT
06079802367030000,2019,77410,356590,434000,MKT
06079802367050000,2021,125458,312742,438200,MKT
06079802367050000,2020,75537,318663,394200,MKT
06079802367050000,2019,75537,318663,394200,MKT
06079802367070000,2021,127048,272552,399600,MKT
06079802367070000,2020,77416,276884,354300,MKT
06079802367070000,2019,77416,276884,354300,MKT
06079802367090000,2021,127048,341452,468500,MKT
06079802367090000,2020,77416,340884,418300,MKT
06079802367090000,2019,77416,340884,418300,MKT
06079802367110000,2021,112651,321249,433900,MKT
06079802367110000,2020,68938,307962,376900,MKT
06079802367110000,2019,68938,307962,376900,MKT
06079802368010000,2021,131959,297741,429700,MKT
06079802368010000,2020,83365,304635,388000,MKT
06079802368010000,2019,83365,304635,388000,MKT
06079802368030000,2021,129034,272166,401200,MKT
06079802368030000,2020,79795,275105,354900,MKT
06079802368030000,2019,79795,275105,354900,MKT
06079802368050000,2021,129528,256272,385800,MKT
06079802368050000,2020,80394,252906,333300,MKT
06079802368050000,2019,80394,252906,333300,MKT
06079802368070000,2021,129528,418372,547900,MKT
06079802368070000,2020,80394,400606,481000,MKT
06079802368070000,2019,80394,400606,481000,MKT
06079802368090000,2021,129528,315072,444600,MKT
06079802368090000,2020,80394,302606,383000,MKT
06079802368090000,2019,80394,295306,375700,MKT
06079802368110000,2021,129528,305172,434700,MKT
06079802368110000,2020,80394,298706,379100,MKT
06079802368110000,2019,80394,298706,379100,MKT
06079802368130000,2021,129528,376972,506500,MKT
06079802368130000,2020,80394,348706,429100,MKT
06079802368130000,2019,80394,348706,429100,MKT
06079802368150000,2021,129528,319072,448600,MKT
06079802368150000,2020,80394,309806,390200,MKT
06079802368150000,2019,80394,309806,390200,MKT
06079802368170000,2021,129528,311472,441000,MKT
06079802368170000,2020,80394,307606,388000,MKT
06079802368170000,2019,80394,307606,388000,MKT
06079802368190000,2021,129528,288772,418300,MKT
06079802368190000,2020,80394,275506,355900,MKT
06079802368190000,2019,80394,275506,355900,MKT
06079802368210000,2021,131926,305374,437300,MKT
06079802368210000,2020,83324,292576,375900,MKT
06079802368210000,2019,83324,292576,375900,MKT
06079802368230000,2021,131926,323674,455600,MKT
06079802368230000,2020,83324,322176,405500,MKT
06079802368230000,2019,83324,322176,405500,MKT
06079802368250000,2021,129528,404172,533700,MKT
06079802368250000,2020,80394,351606,432000,MKT
06079802368250000,2019,80394,346906,427300,MKT
06079802368270000,2021,129528,344272,473800,MKT
06079802368270000,2020,80394,340306,420700,MKT
06079802368270000,2019,80394,340306,420700,MKT
06079802368290000,2021,129528,287172,416700,MKT
06079802368290000,2020,80394,292306,372700,MKT
06079802368290000,2019,80394,292306,372700,MKT
06079802368310000,2021,129528,239672,369200,MKT
06079802368310000,2020,80394,245606,326000,MKT
06079802368310000,2019,80394,245606,326000,MKT
06079802368330000,2021,129528,299772,429300,MKT
06079802368330000,2020,80394,321806,402200,MKT
06079802368330000,2019,80394,321806,402200,MKT
06079802368350000,2021,129528,341472,471000,MKT
06079802368350000,2020,80394,339306,419700,MKT
06079802368350000,2019,80394,339306,419700,MKT
06079802368370000,2021,129528,287572,417100,MKT
06079802368370000,2020,80394,306106,386500,MKT
06079802368370000,2019,80394,306106,386500,MKT
06079802368390000,2021,129528,468972,598500,MKT
06079802368390000,2020,80394,418806,499200,MKT
06079802368390000,2019,80394,418806,499200,MKT
06079802368410000,2021,129034,320166,449200,MKT
06079802368410000,2020,79795,325905,405700,MKT
06079802368410000,2019,79795,325905,405700,MKT
06079802368430000,2021,132029,427871,559900,MKT
06079802368430000,2020,83451,382249,465700,MKT
06079802368430000,2019,83451,382249,465700,MKT
06079802369010000,2021,132206,347094,479300,MKT
06079802369010000,2020,83670,338430,422100,MKT
06079802369010000,2019,83670,338430,422100,MKT
06079802369030000,2021,129034,351166,480200,MKT
06079802369030000,2020,79795,341205,421000,MKT
06079802369030000,2019,79795,341205,421000,MKT
06079802369050000,2021,129528,350572,480100,MKT
06079802369050000,2020,80394,327406,407800,MKT
06079802369050000,2019,80394,337006,417400,MKT
06079802369070000,2021,129528,280872,410400,MKT
06079802369070000,2020,80394,272206,352600,MKT
06079802369070000,2019,80394,272206,352600,MKT
06079802369090000,2021,139890,324610,464500,MKT
06079802369090000,2020,80394,374106,454500,MKT
06079802369090000,2019,80394,374106,454500,MKT
06079802369110000,2021,139890,342410,482300,MKT
06079802369110000,2020,80394,355706,436100,MKT
06079802369110000,2019,80394,355706,436100,MKT
06079802369130000,2021,129528,456272,585800,MKT
06079802369130000,2020,80394,414906,495300,MKT
06079802369130000,2019,80394,414906,495300,MKT
06079802369150000,2021,139890,291710,431600,MKT
06079802369150000,2020,80394,294306,374700,MKT
06079802369150000,2019,80394,294306,374700,MKT
06079802369170000,2021,139890,325210,465100,MKT
06079802369170000,2020,80394,342306,422700,MKT
06079802369170000,2019,80394,342306,422700,MKT
06079802369190000,2021,138854,386946,525800,MKT
06079802369190000,2020,79235,383765,463000,MKT
06079802369190000,2019,79235,383765,463000,MKT
06079802369210000,2021,142903,452997,595900,MKT
06079802369210000,2020,83807,413593,497400,MKT
06079802369210000,2019,83807,413593,497400,MKT
06079802369230000,2021,131926,335574,467500,MKT
06079802369230000,2020,83324,362676,446000,MKT
06079802369230000,2019,83324,362676,446000,MKT
06079802369250000,2021,129528,309572,439100,MKT
06079802369250000,2020,80394,316506,396900,OVR
06079802369250000,2019,80394,316506,396900,MKT
06079802369270000,2021,129528,297472,427000,MKT
06079802369270000,2020,80394,313106,393500,MKT
06079802369270000,2019,80394,313106,393500,MKT
06079802369290000,2021,129528,363072,492600,MKT
06079802369290000,2020,80394,347906,428300,MKT
06079802369290000,2019,80394,347906,428300,MKT
06079802369310000,2021,129528,295472,425000,MKT
06079802369310000,2020,80394,285006,365400,MKT
06079802369310000,2019,80394,285006,365400,MKT
06079802369330000,2021,129528,282572,412100,MKT
06079802369330000,2020,80394,269706,350100,MKT
06079802369330000,2019,80394,269706,350100,MKT
06079802369350000,2021,129528,368972,498500,MKT
06079802369350000,2020,80394,348706,429100,MKT
06079802369350000,2019,80394,348706,429100,MKT
06079802369370000,2021,129528,289072,418600,MKT
06079802369370000,2020,80394,290806,371200,MKT
06079802369370000,2019,80394,290806,371200,MKT
06079802369390000,2021,129528,342272,471800,MKT
06079802369390000,2020,80394,353206,433600,MKT
06079802369390000,2019,80394,353206,433600,MKT
06079802369410000,2021,129034,317766,446800,MKT
06079802369410000,2020,79795,306205,386000,MKT
06079802369410000,2019,79795,306205,386000,MKT
06079802369430000,2021,132136,288664,420800,MKT
06079802369430000,2020,83583,303217,386800,MKT
06079802369430000,2019,83583,303217,386800,MKT
06079802401107000,2021,943835,26280,970115,COST
06079802401107000,2020,795158,30880,826038,COST
06079802401107000,2019,795158,30880,826038,COST
06079802401180000,2021,371772,455228,827000,INCOME
06079802401180000,2020,465018,317382,782400,INCOME
06079802401180000,2019,465018,317382,782400,INCOME
06079802401300000,2021,1170108,398010,1568118,COST
06079802401300000,2020,910416,385900,1296316,COST
06079802401300000,2019,910416,385900,1296316,COST
06079802403010000,2021,664494,649020,1313514,COST
06079802403010000,2020,684173,154827,839000,INCOME
06079802403010000,2019,684173,154827,839000,INCOME
06079802404017000,2021,145468,0,145468,COST
06079802404017000,2020,92519,0,92519,COST
06079802404017000,2019,92519,0,92519,COST
06079802404020000,2021,149488,235312,384800,INCOME
06079802404020000,2020,92519,242881,335400,INCOME
06079802404020000,2019,92519,242881,335400,INCOME
06079802404030000,2021,149488,235312,384800,INCOME
06079802404030000,2020,92519,242881,335400,INCOME
06079802404030000,2019,92519,242881,335400,INCOME
06079802404040000,2021,151924,227680,379604,COST
06079802404040000,2020,95484,297516,393000,INCOME
06079802404040000,2019,95484,297516,393000,INCOME
06079802404107000,2021,974174,27520,1001694,COST
06079802404107000,2020,1106430,26640,1133070,COST
06079802404107000,2019,1106430,26640,1133070,COST
06079802405010000,2021,889463,302540,1192003,COST
06079802405010000,2020,809507,369793,1179300,INCOME
06079802405010000,2019,809507,369793,1179300,INCOME
06079802405037000,2021,952173,8930,961103,COST
06079802405037000,2020,833480,9280,842760,COST
06079802405037000,2019,833480,9280,842760,COST
06079802405057000,2021,943620,11660,955280,COST
06079802405057000,2020,830265,12130,842395,COST
06079802405057000,2019,830265,12130,842395,COST
06079802405070000,2021,899139,824361,1723500,INCOME
06079802405070000,2020,813268,848832,1662100,INCOME
06079802405070000,2019,813268,848832,1662100,INCOME
06079802405097000,2021,587158,13120,600278,COST
06079802405097000,2020,890700,12700,903400,COST
06079802405097000,2019,890700,12700,903400,COST
06079802405137000,2021,776851,19700,796551,COST
06079802405137000,2020,1004188,19070,1023258,COST
06079802405137000,2019,1004188,19070,1023258,COST
06079802405177000,2021,1004183,19670,1023853,COST
06079802405177000,2020,852687,19040,871727,COST
06079802405177000,2019,852687,19040,871727,COST
06079802406010000,2021,143393,163507,306900,MKT
06079802406010000,2020,98044,68060,166104,COST
06079802406010000,2019,98044,68060,166104,COST
06079802406030000,2021,148306,257194,405500,MKT
06079802406030000,2020,104708,264392,369100,MKT
06079802406030000,2019,104708,264392,369100,MKT
06079802406050000,2021,139564,273036,412600,MKT
06079802406050000,2020,93000,274400,367400,MKT
06079802406050000,2019,93000,274400,367400,MKT
06079802406070000,2021,133182,228618,361800,MKT
06079802406070000,2020,84879,226721,311600,MKT
06079802406070000,2019,84879,226721,311600,MKT
06079802406090000,2021,139352,281048,420400,MKT
06079802406090000,2020,92723,271577,364300,MKT
06079802406090000,2019,92723,271577,364300,MKT
06079802407037000,2021,935811,24540,960351,COST
06079802407037000,2020,827315,23820,851135,COST
06079802407037000,2019,827315,23820,851135,COST
06079802407050000,2021,632922,1583678,2216600,INCOME
06079802407050000,2020,699706,1376594,2076300,INCOME
06079802407050000,2019,699706,1376594,2076300,INCOME
06079802407070000,2021,634935,0,634935,COST
06079802407070000,2020,308376,0,308376,COST
06079802407070000,2019,308376,0,308376,COST
06079802407090000,2021,634935,0,634935,COST
06079802407090000,2020,308376,0,308376,COST
06079802407090000,2019,308376,0,308376,COST
06079802407110000,2021,741770,1117330,1859100,INCOME
06079802407110000,2020,748926,1028274,1777200,INCOME
06079802407110000,2019,748926,1028274,1777200,INCOME
06079802407130000,2021,653260,790140,1443400,INCOME
06079802407130000,2020,709251,625649,1334900,INCOME
06079802407130000,2019,709251,625649,1334900,INCOME
06079802407150000,2021,784344,765856,1550200,INCOME
06079802407150000,2020,767047,559600,1326647,COST
06079802407150000,2019,767047,559600,1326647,COST
06079802407170000,2021,1081522,2499630,3581152,COST
06079802407170000,2020,880224,2395520,3275744,COST
06079802407170000,2019,880224,2395520,3275744,COST
06079802407190000,2021,648829,746071,1394900,INCOME
06079802407190000,2020,707186,630914,1338100,INCOME
06079802407190000,2019,707186,630914,1338100,INCOME
06079802407217000,2021,579360,12580,591940,COST
06079802407217000,2020,645147,13030,658177,COST
06079802407217000,2019,645147,13030,658177,COST
06079802407230000,2021,557941,1195259,1753200,INCOME
06079802407230000,2020,634820,994480,1629300,INCOME
06079802407230000,2019,634820,994480,1629300,INCOME
06079802407257000,2021,495591,14250,509841,COST
06079802407257000,2020,603398,14840,618238,COST
06079802407257000,2019,603398,14840,618238,COST
06079802407270000,2021,484740,1318860,1803600,INCOME
06079802407270000,2020,597703,1126497,1724200,INCOME
06079802407270000,2019,597703,1126497,1724200,INCOME
06079802407290000,2021,613449,1429151,2042600,INCOME
06079802407290000,2020,661143,1291457,1952600,INCOME
06079802407290000,2019,661143,1291457,1952600,INCOME
06079802407350000,2021,674295,1517405,2191700,INCOME
06079802407350000,2020,688478,1406722,2095200,INCOME
06079802407350000,2019,688478,1406722,2095200,INCOME
06079802407400000,2021,490018,682482,1172500,INCOME
06079802407400000,2020,600482,516118,1116600,INCOME
06079802407400000,2019,600482,516118,1116600,INCOME
06079802408010000,2021,139207,580,139787,COST
06079802408010000,2020,92535,600,93135,COST
06079802408010000,2019,92535,600,93135,COST
06079802408020000,2021,131072,255828,386900,MKT
06079802408020000,2020,82275,258025,340300,MKT
06079802408020000,2019,82275,258025,340300,MKT
06079802408030000,2021,133946,229354,363300,MKT
06079802408030000,2020,85832,236968,322800,MKT
06079802408030000,2019,85832,236968,322800,MKT
06079802408040000,2021,135334,282666,418000,MKT
06079802408040000,2020,87577,280423,368000,MKT
06079802408040000,2019,87577,280423,368000,MKT
06079802408050000,2021,135391,222109,357500,MKT
06079802408050000,2020,87649,230951,318600,MKT
06079802408050000,2019,87649,231551,319200,MKT
06079802408060000,2021,136113,235387,371500,MKT
06079802408060000,2020,88563,233337,321900,MKT
06079802408060000,2019,88563,233337,321900,MKT
06079802408070000,2021,135786,306614,442400,MKT
06079802408070000,2020,88148,297252,385400,MKT
06079802408070000,2019,88148,297252,385400,MKT
06079802408080000,2021,134053,262647,396700,MKT
06079802408080000,2020,85967,273433,359400,OVR
06079802408080000,2019,85967,273433,359400,MKT
06079802408090000,2021,133504,441696,575200,MKT
06079802408090000,2020,85281,387819,473100,MKT
06079802408090000,2019,85281,387819,473100,MKT
06079802408100000,2021,130891,236309,367200,MKT
06079802408100000,2020,82053,240247,322300,MKT
06079802408100000,2019,82053,240247,322300,MKT
06079802408110000,2021,131612,241088,372700,MKT
06079802408110000,2020,82937,247563,330500,MKT
06079802408110000,2019,82937,247563,330500,MKT
06079802408120000,2021,136997,299703,436700,MKT
06079802408120000,2020,89690,308710,398400,MKT
06079802408120000,2019,89690,308710,398400,MKT
06079802408270000,2021,135682,237818,373500,MKT
06079802408270000,2020,88017,238883,326900,MKT
06079802408270000,2019,88017,238883,326900,MKT
06079802408290000,2021,141207,315793,457000,MKT
06079802408290000,2020,95148,308352,403500,MKT
06079802408290000,2019,95148,308352,403500,MKT
06079802408310000,2021,132132,279768,411900,MKT
06079802408310000,2020,83578,278522,362100,MKT
06079802408310000,2019,83578,278522,362100,MKT
06079802408330000,2021,135547,283553,419100,MKT
06079802408330000,2020,87847,284053,371900,MKT
06079802408330000,2019,87847,284053,371900,MKT
06079802408350000,2021,139836,238864,378700,MKT
06079802408350000,2020,93353,233947,327300,MKT
06079802408350000,2019,93353,233947,327300,MKT
06079802408370000,2021,139584,308216,447800,MKT
06079802408370000,2020,93026,290574,383600,MKT
06079802408370000,2019,93026,290574,383600,MKT
06079802408390000,2021,142251,286549,428800,MKT
06079802408390000,2020,96526,274874,371400,MKT
06079802408390000,2019,96526,274874,371400,MKT
06079802408410000,2021,139336,243964,383300,MKT
06079802408410000,2020,92702,234198,326900,MKT
06079802408410000,2019,92702,234198,326900,MKT
06079802408430000,2021,140877,279723,420600,MKT
06079802408430000,2020,94714,275086,369800,MKT
06079802408430000,2019,94714,275086,369800,MKT
06079802408450000,2021,141370,267330,408700,MKT
06079802408450000,2020,95362,270138,365500,MKT
06079802408450000,2019,95362,270138,365500,MKT
06079802408470000,2021,141168,289432,430600,MKT
06079802408470000,2020,95097,290003,385100,MKT
06079802408470000,2019,95097,290003,385100,MKT
06079802409010000,2021,150385,311715,462100,MKT
06079802409010000,2020,107592,294608,402200,MKT
06079802409010000,2019,107592,294608,402200,MKT
06079802409020000,2021,140355,300945,441300,MKT
06079802409020000,2020,94031,301269,395300,MKT
06079802409020000,2019,94031,301269,395300,MKT
06079802409040000,2021,139243,241257,380500,MKT
06079802409040000,2020,92582,247018,339600,OVR
06079802409040000,2019,92582,247018,339600,MKT
06079802409060000,2021,139098,309502,448600,MKT
06079802409060000,2020,92394,316806,409200,MKT
06079802409060000,2019,92394,316806,409200,MKT
06079802409080000,2021,139243,298857,438100,MKT
06079802409080000,2020,92582,303418,396000,MKT
06079802409080000,2019,92582,303418,396000,MKT
06079802409100000,2021,138402,272098,410500,MKT
06079802409100000,2020,91494,278606,370100,MKT
06079802409100000,2019,91494,278606,370100,MKT
06079802409120000,2021,135850,262950,398800,MKT
06079802409120000,2020,88230,261570,349800,MKT
06079802409120000,2019,88230,261570,349800,MKT
06079802409140000,2021,133018,240382,373400,MKT
06079802409140000,2020,84675,246525,331200,MKT
06079802409140000,2019,84675,246525,331200,MKT
06079802409160000,2021,137467,301733,439200,MKT
06079802409160000,2020,90291,297009,387300,MKT
06079802409160000,2019,90291,297009,387300,MKT
06079802409180000,2021,133681,231019,364700,MKT
06079802409180000,2020,85501,244499,330000,MKT
06079802409180000,2019,85501,244499,330000,MKT
06079802409200000,2021,137383,340917,478300,MKT
06079802409200000,2020,90184,333616,423800,MKT
06079802409200000,2019,90184,333616,423800,MKT
06079802409220000,2021,135094,238806,373900,MKT
06079802409220000,2020,87274,248126,335400,MKT
06079802409220000,2019,87274,248126,335400,MKT
06079802409240000,2021,135094,275806,410900,MKT
06079802409240000,2020,87274,285426,372700,MKT
06079802409240000,2019,87274,285426,372700,MKT
06079802409260000,2021,141036,336664,477700,MKT
06079802409260000,2020,94924,312876,407800,MKT
06079802409260000,2019,94924,312876,407800,MKT
06079802409486500,2021,73232,0,73232,COST
06079802409486500,2020,83088,0,83088,COST
06079802409486500,2019,83088,0,83088,COST
06079802409500000,2021,135247,288253,423500,MKT
06079802409500000,2020,87467,284333,371800,MKT
06079802409500000,2019,87467,284333,371800,MKT
06079802409520000,2021,134326,245874,380200,MKT
06079802409520000,2020,86308,247592,333900,MKT
06079802409520000,2019,86308,247592,333900,MKT
06079802409540000,2021,134330,266170,400500,MKT
06079802409540000,2020,86313,274587,360900,MKT
06079802409540000,2019,86313,274587,360900,MKT
06079802414010000,2021,141188,157612,298800,MKT
06079802414010000,2020,95123,40970,136093,COST
06079802414010000,2019,95123,40970,136093,COST
06079802414020000,2021,135216,219184,354400,MKT
06079802414020000,2020,87428,230072,317500,MKT
06079802414020000,2019,87428,230072,317500,MKT
06079802414030000,2021,135208,265592,400800,MKT
06079802414030000,2020,87417,259883,347300,MKT
06079802414030000,2019,87417,251883,339300,MKT
06079802414040000,2021,135216,219384,354600,MKT
06079802414040000,2020,87428,233272,320700,MKT
06079802414040000,2019,87428,233272,320700,MKT
06079802414050000,2021,135216,216984,352200,MKT
06079802414050000,2020,87428,227272,314700,MKT
06079802414050000,2019,87428,227272,314700,MKT
06079802414070000,2021,135216,267484,402700,MKT
06079802414070000,2020,87428,256872,344300,MKT
06079802414070000,2019,87428,256872,344300,MKT
06079802414090000,2021,135216,242284,377500,MKT
06079802414090000,2020,87428,242972,330400,MKT
06079802414090000,2019,87428,242972,330400,MKT
06079802414110000,2021,134844,264156,399000,MKT
06079802414110000,2020,86959,264141,351100,MKT
06079802414110000,2019,86959,264141,351100,MKT
06079802415010000,2021,151113,291787,442900,MKT
06079802415010000,2020,108611,284589,393200,MKT
06079802415010000,2019,108611,284589,393200,MKT
06079802415020000,2021,140504,285496,426000,MKT
06079802415020000,2020,94226,272874,367100,MKT
06079802415020000,2019,94226,272874,367100,MKT
06079802415030000,2021,139344,331156,470500,MKT
06079802415030000,2020,92713,304687,397400,MKT
06079802415030000,2019,92713,304687,397400,MKT
06079802415040000,2021,132944,272356,405300,MKT
06079802415040000,2020,84584,273716,358300,MKT
06079802415040000,2019,84584,273716,358300,MKT
06079802415050000,2021,134707,234693,369400,MKT
06079802415050000,2020,86787,236213,323000,MKT
06079802415050000,2019,86787,236213,323000,MKT
06079802415060000,2021,135794,282406,418200,MKT
06079802415060000,2020,88159,283341,371500,MKT
06079802415060000,2019,88159,283341,371500,MKT
06079802415070000,2021,135794,245106,380900,MKT
06079802415070000,2020,88159,246341,334500,MKT
06079802415070000,2019,88159,246341,334500,MKT
06079802415080000,2021,136561,238039,374600,MKT
06079802415080000,2020,89134,234766,323900,MKT
06079802415080000,2019,89134,234766,323900,MKT
06079802415090000,2021,134330,253170,387500,MKT
06079802415090000,2020,86313,247387,333700,MKT
06079802415090000,2019,86313,247387,333700,MKT
06079802415100000,2021,132949,271851,404800,MKT
06079802415100000,2020,84590,265910,350500,MKT
06079802415100000,2019,84590,265910,350500,MKT
06079802415110000,2021,133541,262159,395700,MKT
06079802415110000,2020,85326,264274,349600,MKT
06079802415110000,2019,85326,264274,349600,MKT
06079802415120000,2021,134098,254202,388300,MKT
06079802415120000,2020,86023,255977,342000,MKT
06079802415120000,2019,86023,255977,342000,MKT
06079802415130000,2021,133541,236659,370200,MKT
06079802415130000,2020,85326,225374,310700,MKT
06079802415130000,2019,85326,225374,310700,MKT
06079802415140000,2021,137228,236172,373400,MKT
06079802415140000,2020,89986,241214,331200,MKT
06079802415140000,2019,89986,241214,331200,MKT
06079802415160000,2021,135695,266505,402200,MKT
06079802415160000,2020,88033,265167,353200,MKT
06079802415160000,2019,88033,265167,353200,MKT
06079802415170000,2021,131588,240912,372500,MKT
06079802415170000,2020,82908,240792,323700,MKT
06079802415170000,2019,82908,240792,323700,MKT
06079802415180000,2021,132136,262064,394200,MKT
06079802415180000,2020,83583,261817,345400,MKT
06079802415180000,2019,83583,261817,345400,MKT
06079802415190000,2021,131588,263712,395300,MKT
06079802415190000,2020,82908,260192,343100,MKT
06079802415190000,2019,82908,260192,343100,MKT
06079802415200000,2021,132136,280764,412900,MKT
06079802415200000,2020,83583,295217,378800,MKT
06079802415200000,2019,83583,295217,378800,MKT
06079802415210000,2021,132392,251508,383900,MKT
06079802415210000,2020,83899,255001,338900,MKT
06079802415210000,2019,83899,255001,338900,MKT
06079802415220000,2021,132085,270715,402800,MKT
06079802415220000,2020,83520,267880,351400,MKT
06079802415220000,2019,83520,267880,351400,MKT
06079802415230000,2021,133644,263956,397600,MKT
06079802415230000,2020,85456,262344,347800,MKT
06079802415230000,2019,85456,262344,347800,MKT
06079802415240000,2021,133644,265856,399500,MKT
06079802415240000,2020,85456,257544,343000,MKT
06079802415240000,2019,85456,257544,343000,MKT
06079802415250000,2021,133649,286751,420400,MKT
06079802415250000,2020,85461,277039,362500,MKT
06079802415250000,2019,85461,277039,362500,MKT
06079802415260000,2021,130589,293611,424200,MKT
06079802415260000,2020,81683,271817,353500,MKT
06079802415260000,2019,81683,271817,353500,MKT
06079802415270000,2021,134228,232672,366900,MKT
06079802415270000,2020,86185,239615,325800,MKT
06079802415270000,2019,86185,239615,325800,MKT
06079802415280000,2021,133423,304377,437800,MKT
06079802415280000,2020,85179,299521,384700,MKT
06079802415280000,2019,85179,299521,384700,MKT
06079802415290000,2021,135033,235067,370100,MKT
06079802415290000,2020,87197,235603,322800,MKT
06079802415290000,2019,87197,235603,322800,MKT
06079802415300000,2021,133086,304914,438000,MKT
06079802415300000,2020,84760,303840,388600,MKT
06079802415300000,2019,84760,303840,388600,MKT
06079802415310000,2021,134512,314688,449200,MKT
06079802415310000,2020,86542,297358,383900,MKT
06079802415310000,2019,86542,297358,383900,MKT
06079802415320000,2021,135474,255226,390700,MKT
06079802415320000,2020,87753,254247,342000,MKT
06079802415320000,2019,87753,254247,342000,MKT
06079802415330000,2021,145032,339868,484900,MKT
06079802415330000,2020,100243,324757,425000,MKT
06079802415330000,2019,100243,324757,425000,MKT
06079802416010000,2021,140260,281540,421800,MKT
06079802416010000,2020,93907,267793,361700,MKT
06079802416010000,2019,93907,267793,361700,MKT
06079802416020000,2021,135203,300397,435600,MKT
06079802416020000,2020,87412,303088,390500,MKT
06079802416020000,2019,87412,303088,390500,MKT
06079802416030000,2021,135203,283697,418900,MKT
06079802416030000,2020,87412,266288,353700,MKT
06079802416030000,2019,87412,266288,353700,MKT
06079802416040000,2021,135203,283897,419100,MKT
06079802416040000,2020,87412,277488,364900,MKT
06079802416040000,2019,87412,277488,364900,MKT
06079802416050000,2021,135203,294797,430000,MKT
06079802416050000,2020,87412,286388,373800,MKT
06079802416050000,2019,87412,286388,373800,MKT
06079802416060000,2021,135203,378997,514200,MKT
06079802416060000,2020,87412,307388,394800,MKT
06079802416060000,2019,87412,319688,407100,MKT
06079802416070000,2021,134618,305382,440000,MKT
06079802416070000,2020,86675,309725,396400,MKT
06079802416070000,2019,86675,309725,396400,MKT
06079802416080000,2021,134618,278582,413200,MKT
06079802416080000,2020,86675,263525,350200,MKT
06079802416080000,2019,86675,263525,350200,MKT
06079802416090000,2021,133739,417161,550900,MKT
06079802416090000,2020,85574,371926,457500,MKT
06079802416090000,2019,85574,324926,410500,MKT
06079802416100000,2021,132503,284097,416600,MKT
06079802416100000,2020,84037,284463,368500,MKT
06079802416100000,2019,84037,284463,368500,MKT
06079802416110000,2021,133205,325895,459100,MKT
06079802416110000,2020,84908,323692,408600,MKT
06079802416110000,2019,84908,323692,408600,MKT
06079802416120000,2021,135299,245901,381200,MKT
06079802416120000,2020,87533,250467,338000,MKT
06079802416120000,2019,87533,250467,338000,MKT
06079802416130000,2021,134610,326790,461400,MKT
06079802416130000,2020,86664,307936,394600,MKT
06079802416130000,2019,86664,307936,394600,MKT
06079802416140000,2021,132234,285366,417600,MKT
06079802416140000,2020,83704,278996,362700,MKT
06079802416140000,2019,83704,278996,362700,MKT
06079802416150000,2021,132517,335399,467916,OVR
06079802416150000,2020,84054,313246,397300,MKT
06079802416150000,2019,84054,312146,396200,MKT
06079802416160000,2021,132183,277017,409200,MKT
06079802416160000,2020,83641,275459,359100,MKT
06079802416160000,2019,83641,275459,359100,MKT
06079802416170000,2021,133337,293563,426900,MKT
06079802416170000,2020,85072,299328,384400,MKT
06079802416170000,2019,85072,299328,384400,MKT
06079802416180000,2021,133946,287054,421000,MKT
06079802416180000,2020,85832,299368,385200,MKT
06079802416180000,2019,85832,299368,385200,MKT
06079802416190000,2021,134508,279992,414500,MKT
06079802416190000,2020,86536,275664,362200,MKT
06079802416190000,2019,86536,275664,362200,MKT
06079802416210000,2021,134517,285683,420200,MKT
06079802416210000,2020,86547,292453,379000,MKT
06079802416210000,2019,86547,292453,379000,MKT
06079802416220000,2021,134490,257110,391600,MKT
06079802416220000,2020,86514,261086,347600,MKT
06079802416220000,2019,86514,261086,347600,MKT
06079802416230000,2021,133368,236632,370000,MKT
06079802416230000,2020,85111,245589,330700,MKT
06079802416230000,2019,85111,245589,330700,MKT
06079802416250000,2021,158460,348040,506500,MKT
06079802416250000,2020,119157,342543,461700,MKT
06079802416250000,2019,119157,342543,461700,MKT
06079802416306500,2021,55426,0,55426,COST
06079802416306500,2020,48237,0,48237,COST
06079802416306500,2019,48237,0,48237,COST
06079802416356500,2021,87077,0,87077,COST
06079802416356500,2020,116499,0,116499,COST
06079802416356500,2019,116499,0,116499,COST
06079802417010000,2021,2622711,23681989,26304700,INCOME
06079802417010000,2020,1399939,18476861,19876800,INCOME
06079802417010000,2019,1399939,18476861,19876800,INCOME
06079802417180000,2021,244734,287566,532300,MKT
06079802417180000,2020,271395,239010,510405,COST
06079802417180000,2019,271395,239010,510405,COST
06079802417246500,2021,21577,0,21577,COST
06079802417246500,2020,7650,0,7650,COST
06079802417246500,2019,7650,0,7650,COST
06079802417250000,2021,136391,292209,428600,MKT
06079802417250000,2020,77358,283042,360400,MKT
06079802417250000,2019,77358,283042,360400,MKT
06079802417300000,2021,134888,301812,436700,MKT
06079802417300000,2020,75702,312798,388500,MKT
06079802417300000,2019,75702,312798,388500,MKT
06079802417350000,2021,134548,299352,433900,MKT
06079802417350000,2020,75330,303070,378400,MKT
06079802417350000,2019,75330,303070,378400,MKT
06079802417400000,2021,134512,347488,482000,MKT
06079802417400000,2020,75291,331909,407200,MKT
06079802417400000,2019,75291,331909,407200,MKT
06079802417450000,2021,134627,305973,440600,MKT
06079802417450000,2020,75417,329083,404500,MKT
06079802417450000,2019,75417,329083,404500,MKT
06079802417500000,2021,180426,827974,1008400,INCOME
06079802417500000,2020,92615,751985,844600,INCOME
06079802417500000,2019,92615,751985,844600,INCOME
06079802417550000,2021,188929,819471,1008400,INCOME
06079802417550000,2020,96389,748211,844600,INCOME
06079802417550000,2019,96389,748211,844600,INCOME
06079802417600000,2021,121353,266847,388200,MKT
06079802417600000,2020,61586,268514,330100,MKT
06079802417600000,2019,61586,268514,330100,MKT
06079802417650000,2021,123961,266839,390800,MKT
06079802417650000,2020,64195,264505,328700,MKT
06079802417650000,2019,64195,264505,328700,MKT
06079802417700000,2021,154998,713602,868600,INCOME
06079802417700000,2020,81031,655869,736900,INCOME
06079802417700000,2019,81031,655869,736900,INCOME
06079802418010000,2021,384758,0,384758,COST
06079802418010000,2020,673144,0,673144,COST
06079802418010000,2019,673144,0,673144,COST
06079802418280000,2021,1386825,1926575,3313400,INCOME
06079802418280000,2020,1065526,1157074,2222600,INCOME
06079802418280000,2019,1065526,1157074,2222600,INCOME
06079802418400000,2021,1248771,2064629,3313400,INCOME
06079802418400000,2020,1018722,1865278,2884000,INCOME
06079802418400000,2019,1018722,1865278,2884000,INCOME
06079802419010000,2021,131295,297305,428600,MKT
06079802419010000,2020,71817,287883,359700,MKT
06079802419010000,2019,71817,283183,355000,MKT
06079802419030000,2021,131701,276799,408500,MKT
06079802419030000,2020,72251,290349,362600,MKT
06079802419030000,2019,72251,290349,362600,MKT
06079802419057000,2021,134210,0,134210,COST
06079802419057000,2020,74961,0,74961,COST
06079802419057000,2019,74961,0,74961,COST
06079802419090000,2021,129906,335794,465700,MKT
06079802419090000,2020,70341,334659,405000,MKT
06079802419090000,2019,70341,334659,405000,MKT
06079802419110000,2021,129906,317494,447400,MKT
06079802419110000,2020,70341,318959,389300,MKT
06079802419110000,2019,70341,318959,389300,MKT
06079802419130000,2021,129906,266694,396600,MKT
06079802419130000,2020,70341,267859,338200,MKT
06079802419130000,2019,70341,267859,338200,MKT
06079802420016500,2021,65622,0,65622,COST
06079802420016500,2020,58350,0,58350,COST
06079802420016500,2019,58350,0,58350,COST
06079802420027000,2021,149488,0,149488,COST
06079802420027000,2020,92519,0,92519,COST
06079802420027000,2019,92519,0,92519,COST
06079802420110000,2021,125447,258553,384000,MKT
06079802420110000,2020,65706,252994,318700,MKT
06079802420110000,2019,65706,252994,318700,MKT
06079802420130000,2021,125453,258247,383700,MKT
06079802420130000,2020,65711,259889,325600,MKT
06079802420130000,2019,65711,259889,325600,MKT
06079802420157000,2021,127517,0,127517,COST
06079802420157000,2020,67839,0,67839,COST
06079802420157000,2019,67839,0,67839,COST
06079802420190000,2021,125447,270353,395800,MKT
06079802420190000,2020,65706,262194,327900,MKT
06079802420190000,2019,65706,262194,327900,MKT
06079802420210000,2021,125447,263553,389000,MKT
06079802420210000,2020,65706,253894,319600,MKT
06079802420210000,2019,65706,253894,319600,MKT
06079802421010000,2021,130444,344856,475300,MKT
06079802421010000,2020,70911,343289,414200,MKT
06079802421010000,2019,70911,343289,414200,MKT
06079802421030000,2021,131809,301491,433300,MKT
06079802421030000,2020,72367,302133,374500,MKT
06079802421030000,2019,72367,302133,374500,MKT
06079802421050000,2021,125216,288184,413400,MKT
06079802421050000,2020,65469,278631,344100,MKT
06079802421050000,2019,65469,278631,344100,MKT
06079802421070000,2021,125216,297884,423100,MKT
06079802421070000,2020,65469,292931,358400,MKT
06079802421070000,2019,65469,279431,344900,MKT
06079802421090000,2021,125216,297584,422800,MKT
06079802421090000,2020,65469,298731,364200,MKT
06079802421090000,2019,65469,298731,364200,MKT
06079802421110000,2021,125216,284984,410200,MKT
06079802421110000,2020,65469,284431,349900,MKT
06079802421110000,2019,65469,284431,349900,MKT
06079802421130000,2021,125216,307184,432400,MKT
06079802421130000,2020,65469,327931,393400,MKT
06079802421130000,2019,65469,327931,393400,MKT
06079802421150000,2021,125216,337684,462900,MKT
06079802421150000,2020,65469,322231,387700,MKT
06079802421150000,2019,65469,322231,387700,MKT
06079802421170000,2021,139939,325261,465200,MKT
06079802421170000,2020,81334,335866,417200,MKT
06079802421170000,2019,81334,335866,417200,MKT
06079802421190000,2021,141482,290718,432200,MKT
06079802421190000,2020,83093,290407,373500,MKT
06079802421190000,2019,83093,290407,373500,MKT
06079802421210000,2021,141536,305864,447400,MKT
06079802421210000,2020,83155,311745,394900,MKT
06079802421210000,2019,83155,311745,394900,MKT
06079802422010000,2021,141137,273863,415000,MKT
06079802422010000,2020,82699,283201,365900,MKT
06079802422010000,2019,82699,283201,365900,MKT
06079802422030000,2021,136237,437463,573700,MKT
06079802422030000,2020,77187,382413,459600,MKT
06079802422030000,2019,77187,382413,459600,MKT
06079802422050000,2021,134223,288677,422900,MKT
06079802422050000,2020,74976,316824,391800,MKT
06079802422050000,2019,74976,316824,391800,MKT
06079802422070000,2021,128684,266616,395300,MKT
06079802422070000,2020,69056,263744,332800,MKT
06079802422070000,2019,69056,263744,332800,MKT
06079802422090000,2021,128322,312278,440600,MKT
06079802422090000,2020,68677,333223,401900,MKT
06079802422090000,2019,68677,333223,401900,MKT
06079802422110000,2021,128322,246278,374600,MKT
06079802422110000,2020,68677,249923,318600,MKT
06079802422110000,2019,68677,249923,318600,MKT
06079802422130000,2021,128302,253798,382100,MKT
06079802422130000,2020,68656,259044,327700,MKT
06079802422130000,2019,68656,259044,327700,MKT
06079802422150000,2021,128297,310603,438900,MKT
06079802422150000,2020,68650,319850,388500,MKT
06079802422150000,2019,68650,319850,388500,MKT
06079802422170000,2021,128312,272488,400800,MKT
06079802422170000,2020,68666,276034,344700,MKT
06079802422170000,2019,68666,276034,344700,MKT
06079802422197000,2021,134214,620,134834,COST
06079802422197000,2020,74966,610,75576,COST
06079802422197000,2019,74966,610,75576,COST
06079802423010000,2021,135230,312070,447300,MKT
06079802423010000,2020,76077,296923,373000,MKT
06079802423010000,2019,76077,296923,373000,MKT
06079802423030000,2021,129837,258363,388200,MKT
06079802423030000,2020,70268,256232,326500,MKT
06079802423030000,2019,70268,256232,326500,MKT
06079802423057000,2021,142072,0,142072,COST
06079802423057000,2020,83772,0,83772,COST
06079802423057000,2019,83772,0,83772,COST
06079802423090000,2021,140461,279339,419800,MKT
06079802423090000,2020,81928,291372,373300,MKT
06079802423090000,2019,81928,291372,373300,MKT
06079802423110000,2021,134557,281943,416500,MKT
06079802423110000,2020,75340,292560,367900,MKT
06079802423110000,2019,75340,292560,367900,MKT
06079802423130000,2021,129217,271583,400800,MKT
06079802423130000,2020,69615,273285,342900,MKT
06079802423130000,2019,69615,273285,342900,MKT
06079802423150000,2021,128984,253116,382100,MKT
06079802423150000,2020,69370,263730,333100,MKT
06079802423150000,2019,69370,263730,333100,MKT
06079802423170000,2021,127001,288199,415200,MKT
06079802423170000,2020,67303,271797,339100,MKT
06079802423170000,2019,67303,271797,339100,MKT
06079802423190000,2021,127001,303199,430200,MKT
06079802423190000,2020,67303,289497,356800,MKT
06079802423190000,2019,67303,289497,356800,MKT
06079802423210000,2021,127001,312299,439300,MKT
06079802423210000,2020,67303,341797,409100,MKT
06079802423210000,2019,67303,341797,409100,MKT
06079802423230000,2021,131485,306515,438000,MKT
06079802423230000,2020,72019,295581,367600,MKT
06079802423230000,2019,72019,309381,381400,MKT
06079802425010000,2021,111172,250828,362000,MKT
06079802425010000,2020,67182,255518,322700,MKT
06079802425010000,2019,67182,250218,317400,MKT
06079802425030000,2021,104873,218827,323700,MKT
06079802425030000,2020,59953,218647,278600,MKT
06079802425030000,2019,59953,230547,290500,MKT
06079802425050000,2021,104873,205627,310500,MKT
06079802425050000,2020,59953,224647,284600,MKT
06079802425050000,2019,59953,224647,284600,MKT
06079802425070000,2021,104873,216527,321400,MKT
06079802425070000,2020,59953,215847,275800,MKT
06079802425070000,2019,59953,215847,275800,MKT
06079802425090000,2021,104873,219027,323900,MKT
06079802425090000,2020,59953,219447,279400,MKT
06079802425090000,2019,59953,219447,279400,MKT
06079802425110000,2021,104873,224127,329000,MKT
06079802425110000,2020,59953,242147,302100,MKT
06079802425110000,2019,59953,259547,319500,MKT
06079802425130000,2021,104873,225327,330200,MKT
06079802425130000,2020,59953,223947,283900,MKT
06079802425130000,2019,59953,223947,283900,MKT
06079802425150000,2021,104873,220727,325600,MKT
06079802425150000,2020,59953,220847,280800,MKT
06079802425150000,2019,59953,220847,280800,MKT
06079802425170000,2021,104873,223827,328700,MKT
06079802425170000,2020,59953,225447,285400,MKT
06079802425170000,2019,59953,215747,275700,MKT
06079802425190000,2021,104873,218427,323300,MKT
06079802425190000,2020,59953,217547,277500,MKT
06079802425190000,2019,59953,217547,277500,MKT
06079802425210000,2021,111617,199983,311600,MKT
06079802425210000,2020,67709,230391,298100,MKT
06079802425210000,2019,67709,230391,298100,MKT
06079802427010000,2021,128028,222972,351000,MKT
06079802427010000,2020,78586,219414,298000,MKT
06079802427010000,2019,78586,219414,298000,MKT
06079802427030000,2021,120292,218908,339200,MKT
06079802427030000,2020,69585,223515,293100,MKT
06079802427030000,2019,69585,223515,293100,MKT
06079802427050000,2021,120292,216608,336900,MKT
06079802427050000,2020,69585,220215,289800,MKT
06079802427050000,2019,69585,220215,289800,MKT
06079802427070000,2021,120292,223008,343300,MKT
06079802427070000,2020,69585,233715,303300,MKT
06079802427070000,2019,69585,233715,303300,MKT
06079802427090000,2021,120292,223008,343300,MKT
06079802427090000,2020,69585,233715,303300,MKT
06079802427090000,2019,69585,233715,303300,MKT
06079802427110000,2021,120292,194708,315000,MKT
06079802427110000,2020,69585,205615,275200,MKT
06079802427110000,2019,69585,205615,275200,MKT
06079802427130000,2021,120292,222608,342900,MKT
06079802427130000,2020,69585,233415,303000,MKT
06079802427130000,2019,69585,233415,303000,MKT
06079802427150000,2021,120292,229908,350200,MKT
06079802427150000,2020,69585,228415,298000,MKT
06079802427150000,2019,69585,228415,298000,MKT
06079802427170000,2021,120292,262608,382900,MKT
06079802427170000,2020,69585,252715,322300,MKT
06079802427170000,2019,69585,252715,322300,MKT
06079802427190000,2021,120292,194508,314800,MKT
06079802427190000,2020,69585,205615,275200,MKT
06079802427190000,2019,69585,205615,275200,MKT
06079802427210000,2021,128028,221072,349100,MKT
06079802427210000,2020,78586,225614,304200,MKT
06079802427210000,2019,78586,225614,304200,MKT
06079802427230000,2021,128069,206031,334100,MKT
06079802427230000,2020,78635,215965,294600,MKT
06079802427230000,2019,78635,215965,294600,MKT
06079802427250000,2021,120316,212384,332700,MKT
06079802427250000,2020,69612,217588,287200,MKT
06079802427250000,2019,69612,217588,287200,MKT
06079802427270000,2021,120316,203584,323900,MKT
06079802427270000,2020,69612,223988,293600,MKT
06079802427270000,2019,69612,223988,293600,MKT
06079802427290000,2021,120316,213784,334100,MKT
06079802427290000,2020,69612,217588,287200,MKT
06079802427290000,2019,69612,217588,287200,MKT
06079802427310000,2021,120316,209984,330300,MKT
06079802427310000,2020,69612,237688,307300,MKT
06079802427310000,2019,69612,237688,307300,MKT
06079802427330000,2021,120316,203584,323900,MKT
06079802427330000,2020,69612,223988,293600,MKT
06079802427330000,2019,69612,223988,293600,MKT
06079802427350000,2021,120316,207084,327400,MKT
06079802427350000,2020,69612,225988,295600,MKT
06079802427350000,2019,69612,225988,295600,MKT
06079802427370000,2021,120316,203584,323900,MKT
06079802427370000,2020,69612,223988,293600,MKT
06079802427370000,2019,69612,223988,293600,MKT
06079802427390000,2021,120316,234784,355100,MKT
06079802427390000,2020,69612,230988,300600,MKT
06079802427390000,2019,69612,230988,300600,MKT
06079802427410000,2021,120316,212884,333200,MKT
06079802427410000,2020,69612,226888,296500,MKT
06079802427410000,2019,69612,226888,296500,MKT
06079802427430000,2021,128844,216856,345700,MKT
06079802427430000,2020,79567,219533,299100,MKT
06079802427430000,2019,79567,217833,297400,MKT
06079802429010000,2021,131442,240058,371500,MKT
06079802429010000,2020,82728,237472,320200,MKT
06079802429010000,2019,82728,237472,320200,MKT
06079802429030000,2021,120987,215913,336900,MKT
06079802429030000,2020,70371,217929,288300,MKT
06079802429030000,2019,70371,217929,288300,MKT
06079802429050000,2021,120993,203607,324600,MKT
06079802429050000,2020,70378,223922,294300,MKT
06079802429050000,2019,70378,223922,294300,MKT
06079802429070000,2021,120993,222707,343700,MKT
06079802429070000,2020,70378,226722,297100,MKT
06079802429070000,2019,70378,226722,297100,MKT
06079802429090000,2021,120993,212007,333000,MKT
06079802429090000,2020,70378,214522,284900,MKT
06079802429090000,2019,70378,214522,284900,MKT
06079802429110000,2021,120993,203607,324600,MKT
06079802429110000,2020,70378,223922,294300,MKT
06079802429110000,2019,70378,223922,294300,MKT
06079802429130000,2021,120993,222307,343300,MKT
06079802429130000,2020,70378,221122,291500,MKT
06079802429130000,2019,70378,221122,291500,MKT
06079802429150000,2021,120993,200007,321000,MKT
06079802429150000,2020,70378,230422,300800,MKT
06079802429150000,2019,70378,230422,300800,MKT
06079802429170000,2021,120993,212007,333000,MKT
06079802429170000,2020,70378,214522,284900,MKT
06079802429170000,2019,70378,214522,284900,MKT
06079802429190000,2021,120987,215713,336700,MKT
06079802429190000,2020,70371,217729,288100,MKT
06079802429190000,2019,70371,217729,288100,MKT
06079802429210000,2021,128130,224870,353000,MKT
06079802429210000,2020,78708,229592,308300,MKT
06079802429210000,2019,78708,229592,308300,MKT
06079802429230000,2021,128064,206136,334200,MKT
06079802429230000,2020,78629,216771,295400,MKT
06079802429230000,2019,78629,216771,295400,MKT
06079802429250000,2021,120987,217813,338800,MKT
06079802429250000,2020,70371,221929,292300,MKT
06079802429250000,2019,70371,221929,292300,MKT
06079802429270000,2021,120993,207307,328300,MKT
06079802429270000,2020,70378,228422,298800,MKT
06079802429270000,2019,70378,228422,298800,MKT
06079802429290000,2021,122066,207334,329400,MKT
06079802429290000,2020,71602,219098,290700,MKT
06079802429290000,2019,71602,219098,290700,MKT
06079802429310000,2021,122066,204134,326200,MKT
06079802429310000,2020,71602,226698,298300,OVR
06079802429310000,2019,71602,226698,298300,MKT
06079802429330000,2021,122066,218534,340600,MKT
06079802429330000,2020,71602,221498,293100,MKT
06079802429330000,2019,71602,221498,293100,MKT
06079802429350000,2021,122066,203634,325700,MKT
06079802429350000,2020,71602,223898,295500,MKT
06079802429350000,2019,71602,223898,295500,MKT
06079802429370000,2021,122066,214434,336500,MKT
06079802429370000,2020,71602,219798,291400,MKT
06079802429370000,2019,71602,219798,291400,MKT
06079802429390000,2021,122066,211234,333300,MKT
06079802429390000,2020,71602,221098,292700,MKT
06079802429390000,2019,71602,221098,292700,MKT
06079802429410000,2021,122066,203634,325700,MKT
06079802429410000,2020,71602,223898,295500,MKT
06079802429410000,2019,71602,226698,298300,MKT
06079802429430000,2021,130853,222547,353400,MKT
06079802429430000,2020,82006,229494,311500,MKT
06079802429430000,2019,82006,229494,311500,MKT
06079802431010000,2021,130018,204882,334900,MKT
06079802431010000,2020,80988,215012,296000,MKT
06079802431010000,2019,80988,215012,296000,MKT
06079802431030000,2021,122614,220086,342700,MKT
06079802431030000,2020,72230,243270,315500,MKT
06079802431030000,2019,72230,243270,315500,MKT
06079802431050000,2021,122614,229886,352500,MKT
06079802431050000,2020,72230,228570,300800,MKT
06079802431050000,2019,72230,228570,300800,MKT
06079802431070000,2021,122614,203586,326200,MKT
06079802431070000,2020,72230,223870,296100,MKT
06079802431070000,2019,72230,223870,296100,MKT
06079802431090000,2021,122614,215386,338000,MKT
06079802431090000,2020,72230,217370,289600,MKT
06079802431090000,2019,72230,217370,289600,MKT
06079802431110000,2021,122614,201786,324400,MKT
06079802431110000,2020,72230,214870,287100,MKT
06079802431110000,2019,72230,214870,287100,MKT
06079802431130000,2021,122614,203586,326200,MKT
06079802431130000,2020,72230,223870,296100,MKT
06079802431130000,2019,72230,223870,296100,MKT
06079802431150000,2021,122614,215986,338600,MKT
06079802431150000,2020,72230,217970,290200,MKT
06079802431150000,2019,72230,200770,273000,MKT
06079802431170000,2021,122614,232086,354700,MKT
06079802431170000,2020,72230,251070,323300,MKT
06079802431170000,2019,72230,251070,323300,MKT
06079802431190000,2021,122614,203586,326200,MKT
06079802431190000,2020,72230,223870,296100,MKT
06079802431190000,2019,72230,223870,296100,MKT
06079802431210000,2021,128130,225170,353300,MKT
06079802431210000,2020,78708,229992,308700,MKT
06079802431210000,2019,78708,229992,308700,MKT
06079802431230000,2021,128028,219672,347700,MKT
06079802431230000,2020,78586,232014,310600,MKT
06079802431230000,2019,78586,232014,310600,MKT
06079802431250000,2021,122066,208234,330300,MKT
06079802431250000,2020,71602,227098,298700,MKT
06079802431250000,2019,71602,227098,298700,MKT
06079802431270000,2021,122066,218134,340200,MKT
06079802431270000,2020,71602,220998,292600,MKT
06079802431270000,2019,71602,220998,292600,MKT
06079802431290000,2021,122066,206134,328200,MKT
06079802431290000,2020,71602,224698,296300,MKT
06079802431290000,2019,71602,224698,296300,MKT
06079802431310000,2021,122066,226434,348500,MKT
06079802431310000,2020,71602,235798,307400,MKT
06079802431310000,2019,71602,235798,307400,MKT
06079802431330000,2021,122066,206634,328700,MKT
06079802431330000,2020,71602,225298,296900,MKT
06079802431330000,2019,71602,225298,296900,MKT
06079802431350000,2021,122066,226134,348200,MKT
06079802431350000,2020,71602,223998,295600,MKT
06079802431350000,2019,71602,223998,295600,MKT
06079802431370000,2021,122066,206134,328200,MKT
06079802431370000,2020,71602,224698,296300,MKT
06079802431370000,2019,71602,224698,296300,MKT
06079802431390000,2021,122066,227934,350000,MKT
06079802431390000,2020,71602,254398,326000,MKT
06079802431390000,2019,71602,254398,326000,MKT
06079802431410000,2021,122066,206134,328200,MKT
06079802431410000,2020,71602,224698,296300,MKT
06079802431410000,2019,71602,224698,296300,MKT
06079802431430000,2021,131196,204604,335800,MKT
06079802431430000,2020,82426,211874,294300,MKT
06079802431430000,2019,82426,211874,294300,MKT
06079802433010000,2021,132862,249038,381900,MKT
06079802433010000,2020,84482,258218,342700,MKT
06079802433010000,2019,84482,258218,342700,MKT
06079802433030000,2021,124100,203000,327100,MKT
06079802433030000,2020,73949,215051,289000,MKT
06079802433030000,2019,73949,215051,289000,MKT
06079802433050000,2021,124100,205200,329300,MKT
06079802433050000,2020,73949,212451,286400,MKT
06079802433050000,2019,73949,212451,286400,MKT
06079802433070000,2021,124100,203000,327100,MKT
06079802433070000,2020,73949,215051,289000,MKT
06079802433070000,2019,73949,215051,289000,MKT
06079802433090000,2021,124100,221400,345500,MKT
06079802433090000,2020,73949,234751,308700,MKT
06079802433090000,2019,73949,234751,308700,MKT
06079802433110000,2021,124100,203000,327100,MKT
06079802433110000,2020,73949,215051,289000,MKT
06079802433110000,2019,73949,215051,289000,MKT
06079802433130000,2021,124100,219300,343400,MKT
06079802433130000,2020,73949,221551,295500,MKT
06079802433130000,2019,73949,221551,295500,MKT
06079802433150000,2021,124100,203000,327100,MKT
06079802433150000,2020,73949,215051,289000,MKT
06079802433150000,2019,73949,215051,289000,MKT
06079802433170000,2021,124100,208500,332600,MKT
06079802433170000,2020,73949,216351,290300,MKT
06079802433170000,2019,73949,216351,290300,MKT
06079802433190000,2021,128463,298537,427000,MKT
06079802433190000,2020,79108,295792,374900,MKT
06079802433190000,2019,79108,295792,374900,MKT
06079802433210000,2021,128367,215533,343900,MKT
06079802433210000,2020,78993,218007,297000,MKT
06079802433210000,2019,78993,218007,297000,MKT
06079802433230000,2021,122967,240633,363600,MKT
06079802433230000,2020,72637,244663,317300,MKT
06079802433230000,2019,72637,244663,317300,MKT
06079802433250000,2021,122967,243633,366600,MKT
06079802433250000,2020,72637,248863,321500,MKT
06079802433250000,2019,72637,248863,321500,MKT
06079802433270000,2021,122967,210333,333300,MKT
06079802433270000,2020,72637,224163,296800,MKT
06079802433270000,2019,72637,224163,296800,MKT
06079802433290000,2021,122967,235133,358100,MKT
06079802433290000,2020,72637,233863,306500,MKT
06079802433290000,2019,72637,233863,306500,MKT
06079802433310000,2021,122967,212233,335200,MKT
06079802433310000,2020,72637,222963,295600,MKT
06079802433310000,2019,72637,222963,295600,MKT
06079802433330000,2021,122967,224133,347100,MKT
06079802433330000,2020,72637,227863,300500,MKT
06079802433330000,2019,72637,227863,300500,MKT
06079802433350000,2021,122967,212633,335600,MKT
06079802433350000,2020,72637,238263,310900,MKT
06079802433350000,2019,72637,238263,310900,MKT
06079802433370000,2021,122967,232233,355200,MKT
06079802433370000,2020,72637,242263,314900,MKT
06079802433370000,2019,72637,242263,314900,MKT
06079802433390000,2021,132830,206170,339000,MKT
06079802433390000,2020,84442,219558,304000,MKT
06079802433390000,2019,84442,219558,304000,MKT
06079802435010000,2021,132406,226994,359400,MKT
06079802435010000,2020,83916,229284,313200,MKT
06079802435010000,2019,83916,229284,313200,MKT
06079802435030000,2021,120292,203008,323300,MKT
06079802435030000,2020,69585,222915,292500,MKT
06079802435030000,2019,69585,222915,292500,MKT
06079802435050000,2021,120292,221108,341400,MKT
06079802435050000,2020,69585,248915,318500,MKT
06079802435050000,2019,69585,248915,318500,MKT
06079802435070000,2021,120292,244808,365100,MKT
06079802435070000,2020,69585,244015,313600,MKT
06079802435070000,2019,69585,244015,313600,MKT
06079802435090000,2021,120292,212408,332700,MKT
06079802435090000,2020,69585,217515,287100,MKT
06079802435090000,2019,69585,217515,287100,MKT
06079802435110000,2021,120292,206208,326500,MKT
06079802435110000,2020,69585,226015,295600,MKT
06079802435110000,2019,69585,222915,292500,MKT
06079802435130000,2021,120292,204408,324700,MKT
06079802435130000,2020,69585,216415,286000,MKT
06079802435130000,2019,69585,216415,286000,MKT
06079802435150000,2021,120292,207108,327400,MKT
06079802435150000,2020,69585,227515,297100,MKT
06079802435150000,2019,69585,227515,297100,MKT
06079802435170000,2021,120292,215708,336000,MKT
06079802435170000,2020,69585,220315,289900,MKT
06079802435170000,2019,69585,220315,289900,MKT
06079802435190000,2021,128028,263772,391800,MKT
06079802435190000,2020,78586,262014,340600,MKT
06079802435190000,2019,78586,262014,340600,MKT
06079802435210000,2021,128028,248872,376900,MKT
06079802435210000,2020,78586,244214,322800,MKT
06079802435210000,2019,78586,244214,322800,MKT
06079802435230000,2021,123211,216889,340100,MKT
06079802435230000,2020,72918,231582,304500,MKT
06079802435230000,2019,72918,231582,304500,MKT
06079802435250000,2021,123211,215989,339200,MKT
06079802435250000,2020,72918,220982,293900,MKT
06079802435250000,2019,72918,220982,293900,MKT
06079802435270000,2021,123211,207989,331200,MKT
06079802435270000,2020,72918,227382,300300,MKT
06079802435270000,2019,72918,227382,300300,MKT
06079802435290000,2021,123211,230389,353600,MKT
06079802435290000,2020,72918,228782,301700,MKT
06079802435290000,2019,72918,228782,301700,MKT
06079802435310000,2021,123211,207089,330300,MKT
06079802435310000,2020,72918,226082,299000,MKT
06079802435310000,2019,72918,226082,299000,MKT
06079802435330000,2021,123211,232489,355700,MKT
06079802435330000,2020,72918,242982,315900,MKT
06079802435330000,2019,72918,242982,315900,MKT
06079802435350000,2021,123211,207089,330300,MKT
06079802435350000,2020,72918,226082,299000,MKT
06079802435350000,2019,72918,226082,299000,MKT
06079802435370000,2021,132415,235885,368300,MKT
06079802435370000,2020,83928,240872,324800,MKT
06079802435370000,2019,83928,240872,324800,MKT
06079802437010000,2021,132415,223985,356400,MKT
06079802437010000,2020,83928,227672,311600,OVR
06079802437010000,2019,83928,227672,311600,MKT
06079802437030000,2021,120892,202608,323500,MKT
06079802437030000,2020,70263,216237,286500,MKT
06079802437030000,2019,70263,216237,286500,MKT
06079802437050000,2021,120892,209608,330500,MKT
06079802437050000,2020,70263,228437,298700,MKT
06079802437050000,2019,70263,228437,298700,MKT
06079802437070000,2021,120892,208708,329600,MKT
06079802437070000,2020,70263,236937,307200,MKT
06079802437070000,2019,70263,236937,307200,MKT
06079802437090000,2021,120892,210908,331800,MKT
06079802437090000,2020,70263,229937,300200,MKT
06079802437090000,2019,70263,229937,300200,MKT
06079802437110000,2021,120892,211308,332200,MKT
06079802437110000,2020,70263,221237,291500,MKT
06079802437110000,2019,70263,221237,291500,MKT
06079802437130000,2021,120892,210308,331200,MKT
06079802437130000,2020,70263,229337,299600,MKT
06079802437130000,2019,70263,229337,299600,MKT
06079802437150000,2021,120892,229408,350300,MKT
06079802437150000,2020,70263,239637,309900,MKT
06079802437150000,2019,70263,239637,309900,MKT
06079802437170000,2021,128028,272572,400600,MKT
06079802437170000,2020,78586,274414,353000,MKT
06079802437170000,2019,78586,274414,353000,MKT
06079802437190000,2021,128028,232172,360200,MKT
06079802437190000,2020,78586,238414,317000,MKT
06079802437190000,2019,78586,238414,317000,MKT
06079802437210000,2021,124326,208774,333100,MKT
06079802437210000,2020,74212,217488,291700,MKT
06079802437210000,2019,74212,217488,291700,MKT
06079802437230000,2021,124326,203974,328300,MKT
06079802437230000,2020,74212,216488,290700,MKT
06079802437230000,2019,74212,216488,290700,MKT
06079802437250000,2021,124326,238674,363000,MKT
06079802437250000,2020,74212,220488,294700,MKT
06079802437250000,2019,74212,220488,294700,MKT
06079802437270000,2021,124326,215974,340300,MKT
06079802437270000,2020,74212,218488,292700,MKT
06079802437270000,2019,74212,218488,292700,MKT
06079802437290000,2021,124326,245874,370200,MKT
06079802437290000,2020,74212,256688,330900,MKT
06079802437290000,2019,74212,256688,330900,MKT
06079802437310000,2021,124326,206074,330400,MKT
06079802437310000,2020,74212,218988,293200,MKT
06079802437310000,2019,74212,218988,293200,MKT
06079802437330000,2021,132415,235885,368300,MKT
06079802437330000,2020,83928,240872,324800,MKT
06079802437330000,2019,83928,240872,324800,MKT
06079802439010000,2021,132415,252185,384600,MKT
06079802439010000,2020,83928,256172,340100,MKT
06079802439010000,2019,83928,256172,340100,MKT
06079802439030000,2021,121483,221717,343200,MKT
06079802439030000,2020,70935,250065,321000,MKT
06079802439030000,2019,70935,250065,321000,MKT
06079802439050000,2021,121483,223117,344600,MKT
06079802439050000,2020,70935,222665,293600,MKT
06079802439050000,2019,70935,222665,293600,MKT
06079802439070000,2021,121483,230417,351900,MKT
06079802439070000,2020,70935,233765,304700,MKT
06079802439070000,2019,70935,233765,304700,MKT
06079802439090000,2021,121483,229417,350900,MKT
06079802439090000,2020,70935,257265,328200,MKT
06079802439090000,2019,70935,257265,328200,MKT
06079802439110000,2021,121483,230717,352200,MKT
06079802439110000,2020,70935,229865,300800,MKT
06079802439110000,2019,70935,229865,300800,MKT
06079802439130000,2021,121483,204017,325500,MKT
06079802439130000,2020,70935,224265,295200,MKT
06079802439130000,2019,70935,224265,295200,MKT
06079802439150000,2021,128028,253972,382000,MKT
06079802439150000,2020,78586,255614,334200,MKT
06079802439150000,2019,78586,255614,334200,MKT
06079802439197000,2021,231628,12220,243848,COST
06079802439197000,2020,249990,14490,264480,COST
06079802439197000,2019,249990,14490,264480,COST
06079802450040000,2021,180292,453408,633700,INCOME
06079802450040000,2020,106385,465015,571400,INCOME
06079802450040000,2019,106385,465015,571400,INCOME
06079802450070000,2021,180408,453292,633700,INCOME
06079802450070000,2020,106444,464956,571400,INCOME
06079802450070000,2019,106444,464956,571400,INCOME
06079802450100000,2021,180399,453301,633700,INCOME
06079802450100000,2020,106440,464960,571400,INCOME
06079802450100000,2019,106440,464960,571400,INCOME
06079802450130000,2021,180390,453310,633700,INCOME
06079802450130000,2020,106435,464965,571400,INCOME
06079802450130000,2019,106435,464965,571400,INCOME
06079802450160000,2021,180283,453417,633700,INCOME
06079802450160000,2020,106380,465020,571400,INCOME
06079802450160000,2019,106380,465020,571400,INCOME
06079802450190000,2021,207825,425875,633700,INCOME
06079802450190000,2020,120343,451057,571400,INCOME
06079802450190000,2019,120343,451057,571400,INCOME
06079802450220000,2021,203972,429728,633700,INCOME
06079802450220000,2020,118405,452995,571400,INCOME
06079802450220000,2019,118405,452995,571400,INCOME
06079802450250000,2021,180292,453408,633700,INCOME
06079802450250000,2020,106385,465015,571400,INCOME
06079802450250000,2019,106385,465015,571400,INCOME
06079802450280000,2021,180534,453166,633700,INCOME
06079802450280000,2020,106509,464891,571400,INCOME
06079802450280000,2019,106509,464891,571400,INCOME
06079802450310000,2021,180534,453166,633700,INCOME
06079802450310000,2020,106509,464891,571400,INCOME
06079802450310000,2019,106509,464891,571400,INCOME
06079802450340000,2021,180534,453166,633700,INCOME
06079802450340000,2020,106509,464891,571400,INCOME
06079802450340000,2019,106509,464891,571400,INCOME
06079802450370000,2021,186507,447193,633700,INCOME
06079802450370000,2020,109559,461841,571400,INCOME
06079802450370000,2019,109559,461841,571400,INCOME
06079802450400000,2021,186507,447193,633700,INCOME
06079802450400000,2020,109559,461841,571400,INCOME
06079802450400000,2019,109559,461841,571400,INCOME
06079802450430000,2021,180534,453166,633700,INCOME
06079802450430000,2020,106509,464891,571400,INCOME
06079802450430000,2019,106509,464891,571400,INCOME
06079802450450000,2021,180534,657166,837700,INCOME
06079802450450000,2020,106509,464891,571400,INCOME
06079802450450000,2019,106509,464891,571400,INCOME
06079802450480000,2021,180534,453166,633700,INCOME
06079802450480000,2020,106509,464891,571400,INCOME
06079802450480000,2019,106509,464891,571400,INCOME
06079802450510000,2021,184569,449131,633700,INCOME
06079802450510000,2020,108571,462829,571400,INCOME
06079802450510000,2019,108571,462829,571400,INCOME
06079802450540000,2021,195043,438657,633700,INCOME
06079802450540000,2020,113896,457504,571400,INCOME
06079802450540000,2019,113896,457504,571400,INCOME
06079802450570000,2021,207139,426561,633700,INCOME
06079802450570000,2020,119998,451402,571400,INCOME
06079802450570000,2019,119998,451402,571400,INCOME
06079802450600000,2021,184197,449503,633700,INCOME
06079802450600000,2020,108381,463019,571400,INCOME
06079802450600000,2019,108381,463019,571400,INCOME
06079802450630000,2021,181009,452691,633700,INCOME
06079802450630000,2020,106752,464648,571400,INCOME
06079802450630000,2019,106752,464648,571400,INCOME
06079802450660000,2021,181421,452279,633700,INCOME
06079802450660000,2020,106963,464437,571400,INCOME
06079802450660000,2019,106963,464437,571400,INCOME
06079802450690000,2021,180534,453166,633700,INCOME
06079802450690000,2020,106509,464891,571400,INCOME
06079802450690000,2019,106509,464891,571400,INCOME
06079802450720000,2021,192957,397943,590900,INCOME
06079802450720000,2020,112838,406262,519100,INCOME
06079802450720000,2019,112838,406262,519100,INCOME
06079802450726500,2021,51097,0,51097,COST
06079802450726500,2020,41157,0,41157,COST
06079802450726500,2019,41157,0,41157,COST
06079803101010000,2021,5402,0,5402,COST
06079803101010000,2020,5027,0,5027,COST
06079803101010000,2019,5027,0,5027,COST
06079803101017000,2021,995868,30400,1026268,COST
06079803101017000,2020,924601,30220,954821,COST
06079803101017000,2019,924601,30220,954821,COST
06079803101070000,2021,164514,300086,464600,MKT
06079803101070000,2020,165664,261636,427300,MKT
06079803101070000,2019,165664,261636,427300,MKT
06079803101080000,2021,297458,664950,962408,COST
06079803101080000,2020,260663,408837,669500,MKT
06079803101080000,2019,260663,408837,669500,MKT
06079803101090000,2021,418922,9700,428622,COST
06079803101090000,2020,382838,9420,392258,COST
06079803101090000,2019,382838,9420,392258,COST
06079803101207000,2021,310385,17150,327535,COST
06079803101207000,2020,374086,20430,394516,COST
06079803101207000,2019,374086,20430,394516,COST
06079803101250000,2021,181815,11720,193535,COST
06079803101250000,2020,131708,11340,143048,COST
06079803101250000,2019,131708,11340,143048,COST
06079803101300000,2021,229630,659270,888900,COST
06079803101300000,2020,207744,600856,808600,MKT
06079803101300000,2019,207744,600856,808600,MKT
06079803101350000,2021,53233,42630,95863,COST
06079803101350000,2020,72138,40680,112818,COST
06079803101350000,2019,72138,40680,112818,COST
06079803101606500,2021,52729,0,52729,COST
06079803101606500,2020,331809,0,331809,COST
06079803101606500,2019,331809,0,331809,COST
06079803101700000,2021,353344,0,353344,COST
06079803101700000,2020,570043,0,570043,COST
06079803101700000,2019,570043,0,570043,COST
06079803102016500,2021,85377,0,85377,COST
06079803102016500,2020,94744,0,94744,COST
06079803102016500,2019,94744,0,94744,COST
06079803102030000,2021,142247,397753,540000,MKT
06079803102030000,2020,81578,0,81578,COST
06079803102030000,2019,81578,0,81578,COST
06079803102050000,2021,142247,383453,525700,MKT
06079803102050000,2020,81578,0,81578,COST
06079803102050000,2019,81578,0,81578,COST
06079803102070000,2021,142247,418301,560548,MRA
06079803102070000,2020,81578,0,81578,COST
06079803102070000,2019,81578,0,81578,COST
06079803102090000,2021,142247,313653,455900,MKT
06079803102090000,2020,81578,297622,379200,MKT
06079803102090000,2019,81578,0,81578,COST
06079803102110000,2021,142247,364053,506300,MKT
06079803102110000,2020,81578,327622,409200,MKT
06079803102110000,2019,81578,0,81578,COST
06079803102130000,2021,142247,315653,457900,MKT
06079803102130000,2020,81578,310222,391800,MKT
06079803102130000,2019,81578,310222,391800,MKT
06079803102150000,2021,142247,368953,511200,MKT
06079803102150000,2020,81578,332622,414200,MKT
06079803102150000,2019,81578,332622,414200,MKT
06079803102170000,2021,142247,310853,453100,MKT
06079803102170000,2020,81578,291322,372900,MKT
06079803102170000,2019,81578,291322,372900,MKT
06079803102190000,2021,142247,356753,499000,MKT
06079803102190000,2020,81578,330322,411900,MKT
06079803102190000,2019,81578,330322,411900,MKT
06079803102210000,2021,142247,416553,558800,MKT
06079803102210000,2020,81578,371722,453300,MKT
06079803102210000,2019,81578,371722,453300,MKT
06079803102230000,2021,148199,592001,740200,MKT
06079803102230000,2020,88372,513728,602100,MKT
06079803102230000,2019,88372,506728,595100,MKT
06079803103010000,2021,132416,268384,400800,MKT
06079803103010000,2020,70935,257365,328300,MKT
06079803103010000,2019,70935,257365,328300,MKT
06079803103030000,2021,129103,258197,387300,MKT
06079803103030000,2020,67512,259688,327200,MKT
06079803103030000,2019,67512,259688,327200,MKT
06079803103050000,2021,129103,300297,429400,MKT
06079803103050000,2020,67512,288088,355600,MKT
06079803103050000,2019,67512,288088,355600,MKT
06079803103070000,2021,129103,287997,417100,MKT
06079803103070000,2020,67512,274188,341700,MKT
06079803103070000,2019,67512,274188,341700,MKT
06079803103090000,2021,129103,267497,396600,MKT
06079803103090000,2020,67512,266488,334000,MKT
06079803103090000,2019,67512,266488,334000,MKT
06079803103110000,2021,129103,266397,395500,MKT
06079803103110000,2020,67512,265388,332900,MKT
06079803103110000,2019,67512,265388,332900,MKT
06079803103130000,2021,129103,268297,397400,MKT
06079803103130000,2020,67512,270388,337900,MKT
06079803103130000,2019,67512,270388,337900,MKT
06079803103150000,2021,135516,336784,472300,MKT
06079803103150000,2020,74212,350788,425000,MKT
06079803103150000,2019,74212,350788,425000,MKT
06079803103170000,2021,135516,348484,484000,MKT
06079803103170000,2020,74212,337588,411800,MKT
06079803103170000,2019,74212,337588,411800,MKT
06079803103190000,2021,129103,313397,442500,MKT
06079803103190000,2020,67512,302288,369800,MKT
06079803103190000,2019,67512,302288,369800,MKT
06079803103210000,2021,129103,272797,401900,MKT
06079803103210000,2020,67512,267688,335200,MKT
06079803103210000,2019,67512,267688,335200,MKT
06079803103230000,2021,129103,265697,394800,MKT
06079803103230000,2020,67512,264188,331700,MKT
06079803103230000,2019,67512,264188,331700,MKT
06079803103250000,2021,129103,271497,400600,MKT
06079803103250000,2020,67512,271988,339500,MKT
06079803103250000,2019,67512,271988,339500,MKT
06079803103270000,2021,129103,275097,404200,MKT
06079803103270000,2020,67512,269988,337500,MKT
06079803103270000,2019,67512,269988,337500,MKT
06079803103290000,2021,129103,280297,409400,MKT
06079803103290000,2020,67512,274488,342000,MKT
06079803103290000,2019,67512,274488,342000,MKT
06079803103310000,2021,132416,344984,477400,MKT
06079803103310000,2020,70935,332765,403700,MKT
06079803103310000,2019,70935,332765,403700,MKT
06079803104010000,2021,168644,653356,822000,MKT
06079803104010000,2020,118027,577873,695900,MKT
06079803104010000,2019,118027,577873,695900,MKT
06079803104030000,2021,156472,0,156472,COST
06079803104030000,2020,101972,0,101972,COST
06079803104030000,2019,101972,0,101972,COST
06079803104050000,2021,156472,274728,431200,MKT
06079803104050000,2020,101972,260028,362000,MKT
06079803104050000,2019,101972,260028,362000,MKT
06079803104070000,2021,156472,0,156472,COST
06079803104070000,2020,101972,0,101972,COST
06079803104070000,2019,101972,0,101972,COST
06079803104090000,2021,156472,478328,634800,MKT
06079803104090000,2020,101972,412928,514900,MKT
06079803104090000,2019,101972,412928,514900,MKT
06079803104110000,2021,142247,368653,510900,MKT
06079803104110000,2020,81578,335122,416700,MKT
06079803104110000,2019,81578,335122,416700,MKT
06079803104130000,2021,148199,458901,607100,MKT
06079803104130000,2020,88372,414628,503000,MKT
06079803104130000,2019,88372,414628,503000,MKT
06079803104150000,2021,139026,300374,439400,MKT
06079803104150000,2020,105018,336282,441300,MKT
06079803104150000,2019,105018,336282,441300,MKT
06079803104170000,2021,142439,337161,479600,MKT
06079803104170000,2020,110108,370392,480500,MKT
06079803104170000,2019,110108,370392,480500,MKT
06079803105010000,2021,127482,333144,460626,MRA
06079803105010000,2020,85253,322247,407500,MKT
06079803105010000,2019,85253,311147,396400,MKT
06079803105030000,2021,123035,341865,464900,MKT
06079803105030000,2020,79545,340555,420100,MKT
06079803105030000,2019,79545,340555,420100,MKT
06079803105050000,2021,123035,352665,475700,MKT
06079803105050000,2020,79545,329355,408900,MKT
06079803105050000,2019,79545,329355,408900,MKT
06079803105070000,2021,123035,288465,411500,MKT
06079803105070000,2020,79545,284855,364400,MKT
06079803105070000,2019,79545,284855,364400,MKT
06079803105090000,2021,123035,453165,576200,MKT
06079803105090000,2020,79545,416555,496100,MKT
06079803105090000,2019,79545,416555,496100,MKT
06079803105110000,2021,123035,413765,536800,MKT
06079803105110000,2020,79545,372155,451700,MKT
06079803105110000,2019,79545,372155,451700,MKT
06079803105130000,2021,122652,339648,462300,MKT
06079803105130000,2020,79062,350238,429300,MKT
06079803105130000,2019,79062,350238,429300,MKT
06079803105150000,2021,137178,437022,574200,MKT
06079803105150000,2020,98367,394833,493200,MKT
06079803105150000,2019,98367,394833,493200,MKT
06079803105170000,2021,142726,421174,563900,MKT
06079803105170000,2020,106281,387119,493400,MKT
06079803105170000,2019,106281,387119,493400,MKT
06079803105190000,2021,122333,446467,568800,MKT
06079803105190000,2020,78662,393338,472000,MKT
06079803105190000,2019,78662,393338,472000,MKT
06079803105210000,2021,122333,459967,582300,MKT
06079803105210000,2020,78662,396938,475600,MKT
06079803105210000,2019,78662,385338,464000,MKT
06079803105230000,2021,123261,304239,427500,MKT
06079803105230000,2020,79830,291470,371300,MKT
06079803105230000,2019,79830,291470,371300,MKT
06079803105250000,2021,122333,321167,443500,MKT
06079803105250000,2020,78662,307738,386400,MKT
06079803105250000,2019,78662,307738,386400,MKT
06079803105270000,2021,122333,309767,432100,MKT
06079803105270000,2020,78662,296538,375200,MKT
06079803105270000,2019,78662,296538,375200,MKT
06079803105290000,2021,122333,287467,409800,MKT
06079803105290000,2020,78662,285738,364400,MKT
06079803105290000,2019,78662,285738,364400,MKT
06079803105310000,2021,126343,325157,451500,MKT
06079803105310000,2020,83773,0,83773,COST
06079803105310000,2019,83773,0,83773,COST
06079803105336500,2021,86348,0,86348,COST
06079803105336500,2020,137763,0,137763,COST
06079803105336500,2019,137763,0,137763,COST
06079803106010000,2021,126016,482584,608600,MKT
06079803106010000,2020,83351,445549,528900,MKT
06079803106010000,2019,83351,445549,528900,MKT
06079803106030000,2021,122535,357165,479700,MKT
06079803106030000,2020,78915,337885,416800,MKT
06079803106030000,2019,78915,337885,416800,MKT
06079803106050000,2021,122535,302165,424700,MKT
06079803106050000,2020,78915,296185,375100,MKT
06079803106050000,2019,78915,296185,375100,MKT
06079803106070000,2021,122535,324465,447000,MKT
06079803106070000,2020,78915,310485,389400,MKT
06079803106070000,2019,78915,310485,389400,MKT
06079803106090000,2021,122535,302065,424600,MKT
06079803106090000,2020,78915,295885,374800,MKT
06079803106090000,2019,78915,295885,374800,MKT
06079803106110000,2021,122535,301565,424100,MKT
06079803106110000,2020,78915,295385,374300,MKT
06079803106110000,2019,78915,295385,374300,MKT
06079803106130000,2021,126350,401350,527700,MKT
06079803106130000,2020,83782,370918,454700,MKT
06079803106130000,2019,83782,370918,454700,MKT
06079803106150000,2021,124786,399514,524300,MKT
06079803106150000,2020,81770,373430,455200,MKT
06079803106150000,2019,81770,373430,455200,MKT
06079803106170000,2021,122535,476165,598700,MKT
06079803106170000,2020,78915,424985,503900,MKT
06079803106170000,2019,78915,424985,503900,MKT
06079803106190000,2021,122535,401465,524000,MKT
06079803106190000,2020,78915,377885,456800,MKT
06079803106190000,2019,78915,377885,456800,MKT
06079803106210000,2021,122535,283265,405800,MKT
06079803106210000,2020,78915,274385,353300,MKT
06079803106210000,2019,78915,274385,353300,MKT
06079803106230000,2021,122535,401865,524400,MKT
06079803106230000,2020,78915,372785,451700,MKT
06079803106230000,2019,78915,372785,451700,MKT
06079803106250000,2021,122535,377465,500000,MKT
06079803106250000,2020,78915,344685,423600,MKT
06079803106250000,2019,78915,344685,423600,MKT
06079803106270000,2021,126016,387584,513600,MKT
06079803106270000,2020,83351,336149,419500,MKT
06079803106270000,2019,83351,336149,419500,MKT
06079803107010000,2021,131949,409551,541500,MKT
06079803107010000,2020,91181,378619,469800,MKT
06079803107010000,2019,91181,376519,467700,MKT
06079803107030000,2021,127345,350655,478000,MKT
06079803107030000,2020,85074,339426,424500,MKT
06079803107030000,2019,85074,339426,424500,MKT
06079803107050000,2021,127345,398655,526000,MKT
06079803107050000,2020,85074,363826,448900,MKT
06079803107050000,2019,85074,363826,448900,MKT
06079803107070000,2021,127345,359955,487300,MKT
06079803107070000,2020,85074,371526,456600,OVR
06079803107070000,2019,85074,371526,456600,MKT
06079803107090000,2021,127345,350255,477600,MKT
06079803107090000,2020,85074,341226,426300,MKT
06079803107090000,2019,85074,341226,426300,MKT
06079803107110000,2021,127345,411955,539300,MKT
06079803107110000,2020,85074,388226,473300,MKT
06079803107110000,2019,85074,388226,473300,MKT
06079803107130000,2021,130922,266678,397600,MKT
06079803107130000,2020,89801,257499,347300,MKT
06079803107130000,2019,89801,257499,347300,MKT
06079803107150000,2021,128618,335182,463800,MKT
06079803107150000,2020,86743,330957,417700,MKT
06079803107150000,2019,86743,330957,417700,MKT
06079803107170000,2021,125372,284628,410000,MKT
06079803107170000,2020,82520,269080,351600,MKT
06079803107170000,2019,82520,269080,351600,MKT
06079803107190000,2021,127348,326970,454318,MRA
06079803107190000,2020,85079,311021,396100,MKT
06079803107190000,2019,85079,311021,396100,MKT
06079803107210000,2021,127348,276952,404300,MKT
06079803107210000,2020,85079,267721,352800,MKT
06079803107210000,2019,85079,267721,352800,MKT
06079803107230000,2021,127348,462552,589900,MKT
06079803107230000,2020,85079,429821,514900,MKT
06079803107230000,2019,85079,429821,514900,MKT
06079803107250000,2021,127348,405752,533100,MKT
06079803107250000,2020,85079,378521,463600,MKT
06079803107250000,2019,85079,378521,463600,MKT
06079803107270000,2021,131949,462251,594200,MKT
06079803107270000,2020,91181,408419,499600,MKT
06079803107270000,2019,91181,408419,499600,MKT
06079803108010000,2021,123134,423466,546600,MKT
06079803108010000,2020,79670,399730,479400,MKT
06079803108010000,2019,79670,399730,479400,MKT
06079803108030000,2021,118537,423463,542000,MKT
06079803108030000,2020,73968,396132,470100,MKT
06079803108030000,2019,73968,396132,470100,MKT
06079803108050000,2021,118537,302863,421400,MKT
06079803108050000,2020,73968,291732,365700,MKT
06079803108050000,2019,73968,291732,365700,MKT
06079803108070000,2021,118537,473363,591900,MKT
06079803108070000,2020,73968,422532,496500,MKT
06079803108070000,2019,73968,435332,509300,MKT
06079803108090000,2021,118537,301363,419900,MKT
06079803108090000,2020,73968,296832,370800,MKT
06079803108090000,2019,73968,296832,370800,MKT
06079803108110000,2021,118537,329363,447900,MKT
06079803108110000,2020,73968,315132,389100,MKT
06079803108110000,2019,73968,315132,389100,MKT
06079803108130000,2021,118537,382063,500600,MKT
06079803108130000,2020,73968,358132,432100,MKT
06079803108130000,2019,73968,358132,432100,MKT
06079803108150000,2021,118537,278263,396800,MKT
06079803108150000,2020,73968,279732,353700,MKT
06079803108150000,2019,73968,279732,353700,MKT
06079803108170000,2021,118537,445763,564300,MKT
06079803108170000,2020,73968,396332,470300,MKT
06079803108170000,2019,73968,396332,470300,MKT
06079803108190000,2021,120645,417255,537900,MKT
06079803108190000,2020,76556,377644,454200,MKT
06079803108190000,2019,76556,377644,454200,MKT
06079803108210000,2021,125205,455895,581100,MKT
06079803108210000,2020,82306,413094,495400,MKT
06079803108210000,2019,82306,413094,495400,MKT
06079803108230000,2021,118537,286963,405500,MKT
06079803108230000,2020,73968,282432,356400,MKT
06079803108230000,2019,73968,282432,356400,MKT
06079803108250000,2021,118537,373372,491909,MRA
06079803108250000,2020,73968,342432,416400,MKT
06079803108250000,2019,73968,337132,411100,MKT
06079803108270000,2021,118537,469763,588300,MKT
06079803108270000,2020,73968,408232,482200,MKT
06079803108270000,2019,73968,408232,482200,MKT
06079803108290000,2021,118537,285863,404400,MKT
06079803108290000,2020,73968,280932,354900,MKT
06079803108290000,2019,73968,280932,354900,MKT
06079803108310000,2021,118537,444063,562600,MKT
06079803108310000,2020,73968,390232,464200,MKT
06079803108310000,2019,73968,390232,464200,MKT
06079803108330000,2021,118537,287663,406200,MKT
06079803108330000,2020,73968,283132,357100,MKT
06079803108330000,2019,73968,283132,357100,MKT
06079803108350000,2021,118537,359663,478200,MKT
06079803108350000,2020,73968,346732,420700,MKT
06079803108350000,2019,73968,346732,420700,MKT
06079803108370000,2021,118537,287363,405900,MKT
06079803108370000,2020,73968,283232,357200,MKT
06079803108370000,2019,73968,283232,357200,MKT
06079803109010000,2021,147255,409745,557000,MKT
06079803109010000,2020,117492,371308,488800,MKT
06079803109010000,2019,117492,371308,488800,MKT
06079803109030000,2021,123726,541574,665300,MKT
06079803109030000,2020,80419,494081,574500,MKT
06079803109030000,2019,80419,494081,574500,MKT
06079803109050000,2021,123726,301474,425200,MKT
06079803109050000,2020,80419,332381,412800,MKT
06079803109050000,2019,80419,332381,412800,MKT
06079803109070000,2021,123726,363174,486900,MKT
06079803109070000,2020,80419,367881,448300,MKT
06079803109070000,2019,80419,367881,448300,MKT
06079803109090000,2021,123726,498774,622500,MKT
06079803109090000,2020,80419,453681,534100,MKT
06079803109090000,2019,80419,453681,534100,MKT
06079803109110000,2021,123726,452474,576200,MKT
06079803109110000,2020,80419,395481,475900,MKT
06079803109110000,2019,80419,395481,475900,MKT
06079803109130000,2021,123726,413274,537000,MKT
06079803109130000,2020,80419,378481,458900,MKT
06079803109130000,2019,80419,372581,453000,MKT
06079803109150000,2021,108959,353841,462800,MKT
06079803109150000,2020,86176,329324,415500,MKT
06079803109150000,2019,86176,0,86176,COST
06079803109170000,2021,755459,1112340,1867799,COST
06079803109170000,2020,551384,1027616,1579000,INCOME
06079803109170000,2019,551384,1027616,1579000,INCOME
06079803110010000,2021,135036,498064,633100,MKT
06079803110010000,2020,99215,460385,559600,MKT
06079803110010000,2019,99215,460385,559600,MKT
06079803110030000,2021,143670,436830,580500,MKT
06079803110030000,2020,111974,384226,496200,MKT
06079803110030000,2019,111974,384226,496200,MKT
06079803110050000,2021,133704,493696,627400,MKT
06079803110050000,2020,93563,428537,522100,MKT
06079803110050000,2019,93563,428537,522100,MKT
06079803110070000,2021,143321,538879,682200,MKT
06079803110070000,2020,107149,460051,567200,MKT
06079803110070000,2019,107149,460051,567200,MKT
06079803110090000,2021,128883,0,128883,COST
06079803110090000,2020,208896,0,208896,COST
06079803110090000,2019,208896,0,208896,COST
06079803110110000,2021,128878,0,128878,COST
06079803110130000,2021,128878,0,128878,COST
06079803110150000,2021,128968,0,128968,COST
06079803110170000,2021,128898,0,128898,COST
06079803111016500,2021,66827,0,66827,COST
06079803111016500,2020,83539,0,83539,COST
06079803111016500,2019,83539,0,83539,COST
06079803111030000,2021,135036,465064,600100,MKT
06079803111030000,2020,99215,0,99215,COST
06079803111030000,2019,99215,0,99215,COST
06079803111050000,2021,143670,501230,644900,MKT
06079803111050000,2020,111974,428526,540500,MKT
06079803111050000,2019,111974,0,111974,COST
06079803111070000,2021,147074,512626,659700,MKT
06079803111070000,2020,93563,0,93563,COST
06079803111070000,2019,93563,0,93563,COST
06079803111090000,2021,143324,0,143324,COST
06079803111090000,2020,107152,0,107152,COST
06079803111090000,2019,107152,0,107152,COST
06079803111110000,2021,127320,0,127320,COST
06079803111130000,2021,128943,0,128943,COST
06079803111150000,2021,128888,0,128888,COST
06079803111170000,2021,129048,0,129048,COST
06079803111190000,2021,128843,0,128843,COST
06079803111210000,2021,129108,0,129108,COST
06079803111230000,2021,128928,0,128928,COST
06079803111250000,2021,129138,0,129138,COST
06079803111270000,2021,128863,0,128863,COST
06079803201010000,2021,3940,403310,407250,COST
06079803201010000,2020,3667,411750,415417,COST
06079803201010000,2019,3667,400690,404357,COST
06079803201020000,2021,1789573,0,1789573,COST
06079803201020000,2020,508645,0,508645,COST
06079803201020000,2019,508645,0,508645,COST
06079803202020000,2021,132275,458325,590600,MKT
06079803202020000,2020,98977,0,98977,COST
06079803202020000,2019,98977,0,98977,COST
06079803202040000,2021,123754,0,123754,COST
06079803202040000,2020,86914,0,86914,COST
06079803202040000,2019,86914,0,86914,COST
06079803202060000,2021,124217,550083,674300,MKT
06079803202060000,2020,87550,472650,560200,MKT
06079803202060000,2019,87550,472650,560200,MKT
06079803202080000,2021,124217,542933,667150,OVR
06079803202080000,2020,87550,455250,542800,MKT
06079803202080000,2019,87550,455250,542800,MKT
06079803202100000,2021,124524,0,124524,COST
06079803202100000,2020,87973,0,87973,COST
06079803202100000,2019,87973,0,87973,COST
06079803202120000,2021,130387,0,130387,COST
06079803202120000,2020,96239,0,96239,COST
06079803202120000,2019,96239,0,96239,COST
06079803203020000,2021,130387,517813,648200,MKT
06079803203020000,2020,96239,508661,604900,MKT
06079803203020000,2019,96239,546461,642700,MKT
06079803203040000,2021,126660,566940,693600,MKT
06079803203040000,2020,90942,0,90942,COST
06079803203040000,2019,90942,0,90942,COST
06079803203060000,2021,126951,506449,633400,MKT
06079803203060000,2020,91351,432849,524200,MKT
06079803203060000,2019,91351,432849,524200,MKT
06079803203080000,2021,126458,0,126458,COST
06079803203080000,2020,90660,0,90660,COST
06079803203080000,2019,90660,0,90660,COST
06079803203100000,2021,126458,528742,655200,MKT
06079803203100000,2020,90660,489140,579800,MKT
06079803203100000,2019,90660,489140,579800,MKT
06079803203120000,2021,124217,0,124217,COST
06079803203120000,2020,87550,0,87550,COST
06079803203120000,2019,87550,0,87550,COST
06079803203140000,2021,124217,614383,738600,MKT
06079803203140000,2020,87550,468250,555800,MKT
06079803203140000,2019,87550,468250,555800,MKT
06079803203160000,2021,130387,0,130387,COST
06079803203160000,2020,96239,0,96239,COST
06079803203160000,2019,96239,0,96239,COST
06079803204020000,2021,156237,531163,687400,MKT
06079803204020000,2020,96239,469661,565900,MKT
06079803204020000,2019,96239,469661,565900,MKT
06079803204040000,2021,148896,492904,641800,MKT
06079803204040000,2020,87610,437990,525600,MKT
06079803204040000,2019,87610,431690,519300,MKT
06079803204060000,2021,148896,0,148896,COST
06079803204060000,2020,87610,0,87610,COST
06079803204060000,2019,87610,0,87610,COST
06079803204080000,2021,149383,0,149383,COST
06079803204080000,2020,88170,0,88170,COST
06079803204080000,2019,88170,0,88170,COST
06079803204100000,2021,149383,0,149383,COST
06079803204100000,2020,88170,0,88170,COST
06079803204100000,2019,88170,0,88170,COST
06079803204120000,2021,149383,617217,766600,MKT
06079803204120000,2020,88170,580530,668700,MKT
06079803204120000,2019,88170,0,88170,COST
06079803204140000,2021,149383,537100,686483,COST
06079803204140000,2020,88170,525650,613820,COST
06079803204140000,2019,88170,0,88170,COST
06079803204160000,2021,149383,417817,567200,MKT
06079803204160000,2020,88170,360230,448400,MKT
06079803204160000,2019,88170,360230,448400,MKT
06079803204180000,2021,149383,410017,559400,MKT
06079803204180000,2020,88170,379630,467800,MKT
06079803204180000,2019,88170,379630,467800,MKT
06079803204200000,2021,149159,467241,616400,MKT
06079803204200000,2020,87913,403387,491300,MKT
06079803204200000,2019,87913,405687,493600,MKT
06079803204220000,2021,149159,0,149159,COST
06079803204220000,2020,87913,0,87913,COST
06079803204220000,2019,87913,0,87913,COST
06079803204240000,2021,149159,0,149159,COST
06079803204240000,2020,87913,0,87913,COST
06079803204240000,2019,87913,0,87913,COST
06079803204260000,2021,149159,491041,640200,MKT
06079803204260000,2020,87913,417387,505300,MKT
06079803204260000,2019,87913,0,87913,COST
06079803204280000,2021,149705,490795,640500,MKT
06079803204280000,2020,88541,430159,518700,MKT
06079803204280000,2019,88541,0,88541,COST
06079803204300000,2021,158500,0,158500,COST
06079803204300000,2020,98977,0,98977,COST
06079803204300000,2019,98977,0,98977,COST
06079803205020000,2021,165612,536088,701700,MKT
06079803205020000,2020,120298,0,120298,COST
06079803205020000,2019,120298,0,120298,COST
06079803205040000,2021,158932,431768,590700,MKT
06079803205040000,2020,111010,0,111010,COST
06079803205040000,2019,111010,0,111010,COST
06079803205060000,2021,158932,0,158932,COST
06079803205060000,2020,111010,0,111010,COST
06079803205060000,2019,111010,0,111010,COST
06079803205080000,2021,158932,0,158932,COST
06079803205080000,2020,111010,0,111010,COST
06079803205080000,2019,111010,0,111010,COST
06079803205100000,2021,158932,0,158932,COST
06079803205100000,2020,111010,0,111010,COST
06079803205100000,2019,111010,0,111010,COST
06079803205120000,2021,158932,429668,588600,MKT
06079803205120000,2020,111010,0,111010,COST
06079803205120000,2019,111010,0,111010,COST
06079803205140000,2021,158932,0,158932,COST
06079803205140000,2020,111010,0,111010,COST
06079803205140000,2019,111010,0,111010,COST
06079803205160000,2021,160767,693533,854300,MKT
06079803205160000,2020,113525,191440,304965,COST
06079803205160000,2019,113525,0,113525,COST
06079803205180000,2021,163011,599989,763000,MKT
06079803205180000,2020,116639,519561,636200,MKT
06079803205180000,2019,116639,519561,636200,MKT
06079803205200000,2021,162970,440530,603500,MKT
06079803205200000,2020,116581,406019,522600,MKT
06079803205200000,2019,116581,0,116581,COST
06079803205220000,2021,162970,430130,593100,MKT
06079803205220000,2020,116581,0,116581,COST
06079803205220000,2019,116581,0,116581,COST
06079803205240000,2021,162741,460259,623000,MKT
06079803205240000,2020,116262,423238,539500,MKT
06079803205240000,2019,116262,0,116262,COST
06079803206020000,2021,138210,0,138210,COST
06079803206020000,2020,96239,0,96239,COST
06079803206020000,2019,96239,0,96239,COST
06079803206040000,2021,132790,0,132790,COST
06079803206040000,2020,89009,0,89009,COST
06079803206040000,2019,89009,0,89009,COST
06079803206060000,2021,132790,463510,596300,MKT
06079803206060000,2020,89009,419091,508100,MKT
06079803206060000,2019,89009,417091,506100,MKT
06079803206080000,2021,132790,473610,606400,MKT
06079803206080000,2020,89009,401050,490059,COST
06079803206080000,2019,89009,0,89009,COST
06079803206100000,2021,132790,487210,620000,MKT
06079803206100000,2020,89009,0,89009,COST
06079803206100000,2019,89009,0,89009,COST
06079803206120000,2021,132790,627610,760400,MKT
06079803206120000,2020,89009,545991,635000,MKT
06079803206120000,2019,89009,0,89009,COST
06079803206140000,2021,132790,0,132790,COST
06079803206140000,2020,89009,0,89009,COST
06079803206140000,2019,89009,0,89009,COST
06079803206160000,2021,156704,502996,659700,MKT
06079803206160000,2020,89544,441356,530900,MKT
06079803206160000,2019,89544,0,89544,COST
06079803206180000,2021,157181,0,157181,COST
06079803206180000,2020,90077,0,90077,COST
06079803206180000,2019,90077,0,90077,COST
06079803206200000,2021,157181,492619,649800,MKT
06079803206200000,2020,90077,467523,557600,MKT
06079803206200000,2019,90077,0,90077,COST
06079803206220000,2021,145538,417262,562800,MKT
06079803206220000,2020,90077,141950,232027,COST
06079803206220000,2019,90077,0,90077,COST
06079803206240000,2021,149717,609383,759100,MKT
06079803206240000,2020,95194,0,95194,COST
06079803206240000,2019,95194,0,95194,COST
06079803206260000,2021,146629,0,146629,COST
06079803206260000,2020,130266,0,130266,COST
06079803206260000,2019,104212,0,104212,COST
06079803206280000,2021,165397,578303,743700,MKT
06079803206280000,2020,115623,539377,655000,MKT
06079803206280000,2019,115623,0,115623,COST
06079803206300000,2021,149573,0,149573,COST
06079803206300000,2020,95016,0,95016,COST
06079803206300000,2019,95016,0,95016,COST
06079803206320000,2021,150709,0,150709,COST
06079803206320000,2020,96430,0,96430,COST
06079803206320000,2019,96430,0,96430,COST
06079803206340000,2021,134897,0,134897,COST
06079803206340000,2020,106665,0,106665,COST
06079803206340000,2019,106665,0,106665,COST
06079803206360000,2021,148596,365504,514100,MKT
06079803206360000,2020,93809,347991,441800,MKT
06079803206360000,2019,93809,0,93809,COST
06079803206380000,2021,148985,0,148985,COST
06079803206380000,2020,94288,0,94288,COST
06079803206380000,2019,94288,0,94288,COST
06079803206406500,2021,81218,0,81218,COST
06079803206406500,2020,90757,0,90757,COST
06079803206406500,2019,90757,0,90757,COST
06079803207016500,2021,106651,0,106651,COST
06079803207016500,2020,173062,0,173062,COST
06079803207016500,2019,173062,0,173062,COST
06079803207020000,2021,151255,514245,665500,MKT
06079803207020000,2020,112924,431720,544644,COST
06079803207020000,2019,10,0,10,COST
06079803207040000,2021,137492,0,137492,COST
06079803207040000,2020,90323,0,90323,COST
06079803207040000,2019,10,0,10,COST
06079803207060000,2021,140248,0,140248,COST
06079803207060000,2020,93891,0,93891,COST
06079803207060000,2019,11,0,11,COST
06079803207080000,2021,151203,0,151203,COST
06079803207080000,2020,135922,0,135922,COST
06079803207080000,2019,15,0,15,COST
06079803207100000,2021,140814,0,140814,COST
06079803207100000,2020,94632,0,94632,COST
06079803207100000,2019,11,0,11,COST
06079803207120000,2021,141678,538020,679698,COST
06079803207120000,2020,95768,0,95768,COST
06079803207120000,2019,12,0,12,COST
06079803207140000,2021,147837,616363,764200,MKT
06079803207140000,2020,104062,0,104062,COST
06079803207140000,2019,14,0,14,COST
06079803207160000,2021,142757,270000,412757,COST
06079803207160000,2020,121497,0,121497,COST
06079803207160000,2019,12,0,12,COST
06079803207180000,2021,141620,146840,288460,COST
06079803207180000,2020,95692,0,95692,COST
06079803207180000,2019,12,0,12,COST
06079803207200000,2021,132174,412226,544400,MKT
06079803207200000,2020,83629,0,83629,COST
06079803207200000,2019,9,0,9,COST
06079803207220000,2021,136160,0,136160,COST
06079803207220000,2020,110779,0,110779,COST
06079803207220000,2019,10,0,10,COST
06079803207240000,2021,136258,489342,625600,MKT
06079803207240000,2020,110935,298180,409115,COST
06079803207240000,2019,10,0,10,COST
06079803207260000,2021,135945,0,135945,COST
06079803207260000,2020,88350,0,88350,COST
06079803207260000,2019,10,0,10,COST
06079803207280000,2021,139892,0,139892,COST
06079803207280000,2020,93426,0,93426,COST
06079803207280000,2019,11,0,11,COST
06079803207300000,2021,142034,0,142034,COST
06079803207300000,2020,120298,0,120298,COST
06079803207300000,2019,12,0,12,COST
06079803208020000,2021,139892,0,139892,COST
06079803208020000,2020,93426,0,93426,COST
06079803208020000,2019,11,0,11,COST
06079803208040000,2021,135434,0,135434,COST
06079803208040000,2020,87704,0,87704,COST
06079803208040000,2019,10,0,10,COST
06079803208060000,2021,135434,219680,355114,COST
06079803208060000,2020,87704,0,87704,COST
06079803208060000,2019,10,0,10,COST
06079803208080000,2021,139892,0,139892,COST
06079803208080000,2020,93426,0,93426,COST
06079803208080000,2019,11,0,11,COST
06079803209020000,2021,136391,0,136391,COST
06079803209020000,2020,88917,0,88917,COST
06079803209020000,2019,10,0,10,COST
06079803209040000,2021,131875,0,131875,COST
06079803209040000,2020,83261,0,83261,COST
06079803209040000,2019,9,0,9,COST
06079803209060000,2021,132215,225110,357325,COST
06079803209060000,2020,83681,0,83681,COST
06079803209060000,2019,9,0,9,COST
06079803209080000,2021,136391,0,136391,COST
06079803209080000,2020,88917,0,88917,COST
06079803209080000,2019,10,0,10,COST
06079803209100000,2021,142148,0,142148,COST
06079803209100000,2020,96390,0,96390,COST
06079803209100000,2019,12,0,12,COST
06079803209120000,2021,137974,0,137974,COST
06079803209120000,2020,90942,0,90942,COST
06079803209120000,2019,11,0,11,COST
06079803209140000,2021,137974,0,137974,COST
06079803209140000,2020,90942,0,90942,COST
06079803209140000,2019,10,0,10,COST
06079803209160000,2021,133906,0,133906,COST
06079803209160000,2020,85782,0,85782,COST
06079803209160000,2019,9,0,9,COST
06079803209180000,2021,130531,0,130531,COST
06079803209180000,2020,81613,0,81613,COST
06079803209180000,2019,8,0,8,COST
06079803209200000,2021,134317,0,134317,COST
06079803209200000,2020,86297,0,86297,COST
06079803209200000,2019,9,0,9,COST
06079803209220000,2021,141528,0,141528,COST
06079803209220000,2020,95571,0,95571,COST
06079803209220000,2019,12,0,12,COST
06079803209240000,2021,145857,0,145857,COST
06079803209240000,2020,101360,0,101360,COST
06079803209240000,2019,13,0,13,COST
06079803209260000,2021,128054,0,128054,COST
06079803209260000,2020,107965,0,107965,COST
06079803209260000,2019,15,0,15,COST
06079803210020000,2021,138545,0,138545,COST
06079803210020000,2020,91678,0,91678,COST
06079803210020000,2019,11,0,11,COST
06079803210040000,2021,131560,287200,418760,COST
06079803210040000,2020,82873,0,82873,COST
06079803210040000,2019,9,0,9,COST
06079803210060000,2021,143080,0,143080,COST
06079803210060000,2020,97627,0,97627,COST
06079803210060000,2019,12,0,12,COST
06079803210080000,2021,140595,0,140595,COST
06079803210080000,2020,94345,0,94345,COST
06079803210080000,2019,11,0,11,COST
06079803210100000,2021,136616,0,136616,COST
06079803210100000,2020,89204,0,89204,COST
06079803210100000,2019,10,0,10,COST
06079803210120000,2021,138712,0,138712,COST
06079803210120000,2020,91895,0,91895,COST
06079803210120000,2019,11,0,11,COST
06079803210140000,2021,130168,0,130168,COST
06079803210140000,2020,81171,0,81171,COST
06079803210140000,2019,8,0,8,COST
06079803210160000,2021,131034,0,131034,COST
06079803210160000,2020,82228,0,82228,COST
06079803210160000,2019,9,0,9,COST
06079803210180000,2021,140958,0,140958,COST
06079803210180000,2020,94821,0,94821,COST
06079803210180000,2019,11,0,11,COST
06079803210200000,2021,130786,0,130786,COST
06079803210200000,2020,81924,0,81924,COST
06079803210200000,2019,9,0,9,COST
06079803210220000,2021,135447,0,135447,COST
06079803210220000,2020,87720,0,87720,COST
06079803210220000,2019,9,0,9,COST
06079803210240000,2021,140039,0,140039,COST
06079803210240000,2020,93617,0,93617,COST
06079803210240000,2019,11,0,11,COST
06079803210260000,2021,140552,0,140552,COST
06079803210260000,2020,94288,0,94288,COST
06079803210260000,2019,11,0,11,COST
06079803211020000,2021,154473,0,154473,COST
06079803211020000,2020,117661,0,117661,COST
06079803211020000,2019,11,0,11,COST
06079803211040000,2021,150371,0,150371,COST
06079803211040000,2020,111640,0,111640,COST
06079803211040000,2019,10,0,10,COST
06079803211060000,2021,150367,506633,657000,MKT
06079803211060000,2020,111634,453866,565500,MKT
06079803211060000,2019,10,0,10,COST
06079803211080000,2021,150367,340780,491147,COST
06079803211080000,2020,111634,0,111634,COST
06079803211080000,2019,111634,0,111634,COST
06079803211100000,2021,150530,0,150530,COST
06079803211100000,2020,111870,0,111870,COST
06079803211100000,2019,111870,0,111870,COST
06079803211120000,2021,150479,546521,697000,MKT
06079803211120000,2020,111796,477604,589400,MKT
06079803211120000,2019,10,0,10,COST
06079803211140000,2021,150479,661221,811700,MKT
06079803211140000,2020,111796,201720,313516,COST
06079803211140000,2019,10,0,10,COST
06079803211160000,2021,150479,528321,678800,MKT
06079803211160000,2020,111796,428270,540066,COST
06079803211160000,2019,10,0,10,COST
06079803211180000,2021,150660,537340,688000,MKT
06079803211180000,2020,112059,404620,516679,COST
06079803211180000,2019,112059,0,112059,COST
06079803211200000,2021,162857,461843,624700,MKT
06079803211200000,2020,130447,0,130447,COST
06079803211200000,2019,130447,0,130447,COST
06079803213020000,2021,153885,0,153885,COST
06079803213020000,2020,116789,0,116789,COST
06079803213040000,2021,144321,0,144321,COST
06079803213040000,2020,103040,0,103040,COST
06079803213060000,2021,144451,0,144451,COST
06079803213060000,2020,103222,0,103222,COST
06079803213080000,2021,144451,0,144451,COST
06079803213080000,2020,103222,0,103222,COST
06079803213100000,2021,144347,0,144347,COST
06079803213100000,2020,103076,0,103076,COST
06079803213120000,2021,147306,0,147306,COST
06079803213120000,2020,107241,0,107241,COST
06079803213140000,2021,149983,0,149983,COST
06079803213140000,2020,111078,0,111078,COST
06079803213160000,2021,144970,0,144970,COST
06079803213160000,2020,103946,0,103946,COST
06079803213180000,2021,145355,0,145355,COST
06079803213180000,2020,104486,0,104486,COST
06079803213200000,2021,144959,0,144959,COST
06079803213200000,2020,103932,0,103932,COST
06079803213220000,2021,144122,0,144122,COST
06079803213220000,2020,102763,0,102763,COST
06079803213240000,2021,143350,0,143350,COST
06079803213240000,2020,101692,0,101692,COST
06079803213260000,2021,142713,0,142713,COST
06079803213260000,2020,100812,0,100812,COST
06079803213280000,2021,144763,0,144763,COST
06079803213280000,2020,103657,0,103657,COST
06079803213300000,2021,155541,0,155541,COST
06079803213300000,2020,119254,0,119254,COST
06079803214020000,2021,123856,0,123856,COST
06079803214020000,2020,73665,0,73665,COST
06079803214040000,2021,106957,0,106957,COST
06079803214040000,2020,55324,0,55324,COST
06079803214060000,2021,106941,0,106941,COST
06079803214060000,2020,55307,0,55307,COST
06079803214080000,2021,106924,0,106924,COST
06079803214080000,2020,55291,0,55291,COST
06079803214100000,2021,106916,0,106916,COST
06079803214100000,2020,55282,0,55282,COST
06079803214120000,2021,106899,0,106899,COST
06079803214120000,2020,55265,0,55265,COST
06079803214145001,2021,106882,160320,267202,COST
06079803214145001,2020,55248,0,55248,COST
06079803214165002,2021,106874,160320,267194,COST
06079803214165002,2020,55240,0,55240,COST
06079803214185001,2021,106857,248343,355200,MKT
06079803214185001,2020,55223,0,55223,COST
06079803214205002,2021,110772,248428,359200,MKT
06079803214205002,2020,59241,0,59241,COST
06079803301020000,2021,2393355,0,2393355,COST
06079803301020000,2020,818178,0,818178,COST
06079803301020000,2019,1335,9780,11115,COST
06079803301046500,2021,104982,0,104982,COST
06079803301046500,2020,167816,0,167816,COST
06079803301066500,2021,73653,0,73653,COST
06079803301066500,2020,84023,0,84023,COST
06079803301150000,2021,2528108,12752080,15280188,COST
06079803301150000,2020,1379350,12502980,13882330,COST
06079803301150000,2019,1379350,12502980,13882330,COST
06079803301200000,2021,2042,0,2042,COST
06079803301200000,2020,1901,0,1901,COST
06079803301200000,2019,1901,0,1901,COST
06079803302016500,2021,49754,0,49754,COST
06079803302016500,2020,39073,0,39073,COST
06079803302016500,2019,39073,0,39073,COST
06079803302020000,2021,141281,400719,542000,MKT
06079803302020000,2020,95245,376755,472000,MKT
06079803302020000,2019,95245,376755,472000,MKT
06079803302040000,2021,140728,525772,666500,MKT
06079803302040000,2020,94519,460381,554900,MKT
06079803302040000,2019,94519,460381,554900,MKT
06079803302060000,2021,140701,479699,620400,MKT
06079803302060000,2020,94483,422617,517100,MKT
06079803302060000,2019,94483,391817,486300,MKT
06079803302080000,2021,140673,478127,618800,MKT
06079803302080000,2020,94447,414253,508700,MKT
06079803302080000,2019,94447,414253,508700,MKT
06079803302100000,2021,140646,497554,638200,MKT
06079803302100000,2020,94411,437089,531500,MKT
06079803302100000,2019,94411,434989,529400,MKT
06079803302120000,2021,140622,438578,579200,MKT
06079803302120000,2020,94381,398019,492400,MKT
06079803302120000,2019,94381,398019,492400,MKT
06079803302140000,2021,140481,493319,633800,MKT
06079803302140000,2020,94195,429905,524100,MKT
06079803302140000,2019,94195,429905,524100,MKT
06079803302160000,2021,149835,452365,602200,MKT
06079803302160000,2020,106825,392375,499200,MKT
06079803302160000,2019,106825,392375,499200,MKT
06079803302180000,2021,158693,444907,603600,MKT
06079803302180000,2020,124016,355684,479700,MKT
06079803302180000,2019,124016,355684,479700,MKT
06079803302200000,2021,151612,423888,575500,MKT
06079803302200000,2020,113445,381655,495100,MKT
06079803302200000,2019,113445,381655,495100,MKT
06079803302220000,2021,148844,401156,550000,MKT
06079803302220000,2020,109437,369663,479100,MKT
06079803302220000,2019,109437,369663,479100,MKT
06079803302240000,2021,148844,508556,657400,MKT
06079803302240000,2020,109437,440263,549700,MKT
06079803302240000,2019,109437,0,109437,COST
06079803302260000,2021,148844,0,148844,COST
06079803302260000,2020,109437,0,109437,COST
06079803302260000,2019,109437,0,109437,COST
06079803302280000,2021,148844,479956,628800,MKT
06079803302280000,2020,109437,399063,508500,MKT
06079803302280000,2019,109437,399063,508500,MKT
06079803302300000,2021,148844,444470,593314,COST
06079803302300000,2020,109437,0,109437,COST
06079803302300000,2019,109437,0,109437,COST
06079803302320000,2021,157137,235000,392137,COST
06079803302320000,2020,121654,0,121654,COST
06079803302320000,2019,121654,0,121654,COST
06079803303020000,2021,135369,412531,547900,MKT
06079803303020000,2020,87621,368679,456300,MKT
06079803303020000,2019,87621,0,87621,COST
06079803303040000,2021,134927,426273,561200,MKT
06079803303040000,2020,87064,387936,475000,MKT
06079803303040000,2019,87064,387936,475000,MKT
06079803303060000,2021,134927,387773,522700,MKT
06079803303060000,2020,87064,356536,443600,MKT
06079803303060000,2019,87064,356536,443600,MKT
06079803303080000,2021,134927,411173,546100,MKT
06079803303080000,2020,87064,368836,455900,MKT
06079803303080000,2019,87064,368836,455900,MKT
06079803303100000,2021,134927,454373,589300,MKT
06079803303100000,2020,87064,407436,494500,MKT
06079803303100000,2019,87064,407436,494500,MKT
06079803303120000,2021,135373,500527,635900,MKT
06079803303120000,2020,87627,459273,546900,MKT
06079803303120000,2019,87627,459273,546900,MKT
06079803303140000,2021,138114,0,138114,COST
06079803303140000,2020,91123,0,91123,COST
06079803303140000,2019,91123,0,91123,COST
06079803303160000,2021,139013,0,139013,COST
06079803303160000,2020,92284,0,92284,COST
06079803303160000,2019,92284,0,92284,COST
06079803303180000,2021,136246,471654,607900,MKT
06079803303180000,2020,88732,403668,492400,MKT
06079803303180000,2019,88732,403668,492400,MKT
06079803303200000,2021,134927,450273,585200,MKT
06079803303200000,2020,87064,392836,479900,MKT
06079803303200000,2019,87064,434036,521100,MKT
06079803303220000,2021,134927,412473,547400,MKT
06079803303220000,2020,87064,364236,451300,MKT
06079803303220000,2019,87064,364236,451300,MKT
06079803303240000,2021,134927,448573,583500,MKT
06079803303240000,2020,87064,390736,477800,MKT
06079803303240000,2019,87064,390736,477800,MKT
06079803303260000,2021,134927,436773,571700,MKT
06079803303260000,2020,87064,394636,481700,MKT
06079803303260000,2019,87064,394636,481700,MKT
06079803303280000,2021,136237,435563,571800,MKT
06079803303280000,2020,88721,0,88721,COST
06079803303280000,2019,88721,0,88721,COST
06079803304020000,2021,139840,363060,502900,MKT
06079803304020000,2020,93358,350942,444300,MKT
06079803304020000,2019,93358,350942,444300,MKT
06079803304040000,2021,139364,422936,562300,MKT
06079803304040000,2020,92739,384461,477200,MKT
06079803304040000,2019,92739,384461,477200,MKT
06079803304060000,2021,139372,544828,684200,MKT
06079803304060000,2020,92749,466151,558900,MKT
06079803304060000,2019,92749,0,92749,COST
06079803304080000,2021,139380,482020,621400,MKT
06079803304080000,2020,92760,0,92760,COST
06079803304080000,2019,92760,0,92760,COST
06079803304100000,2021,139392,474408,613800,MKT
06079803304100000,2020,92775,397525,490300,MKT
06079803304100000,2019,92775,397525,490300,MKT
06079803304120000,2021,139947,0,139947,COST
06079803304120000,2020,93498,0,93498,COST
06079803304120000,2019,93498,0,93498,COST
06079803304140000,2021,144197,0,144197,COST
06079803304140000,2020,99120,0,99120,COST
06079803304140000,2019,99120,0,99120,COST
06079803304160000,2021,145082,0,145082,COST
06079803304160000,2020,100311,0,100311,COST
06079803304160000,2019,100311,0,100311,COST
06079803304180000,2021,141025,399075,540100,MKT
06079803304180000,2020,94908,372892,467800,MKT
06079803304180000,2019,94908,372892,467800,MKT
06079803304200000,2021,139388,369612,509000,MKT
06079803304200000,2020,92770,343430,436200,MKT
06079803304200000,2019,92770,343430,436200,MKT
06079803304220000,2021,139380,442520,581900,MKT
06079803304220000,2020,92760,383140,475900,MKT
06079803304220000,2019,92760,211950,304710,COST
06079803304240000,2021,139372,479328,618700,MKT
06079803304240000,2020,92749,434651,527400,MKT
06079803304240000,2019,92749,430951,523700,MKT
06079803304260000,2021,139364,368236,507600,MKT
06079803304260000,2020,92739,348161,440900,MKT
06079803304260000,2019,92739,348161,440900,MKT
06079803304280000,2021,140814,450686,591500,MKT
06079803304280000,2020,94632,399368,494000,MKT
06079803304280000,2019,94632,399368,494000,MKT
06079803305010000,2021,334388,0,334388,COST
06079803305010000,2020,597629,0,597629,COST
06079803305010000,2019,597629,0,597629,COST
06079803306020000,2021,137729,0,137729,COST
06079803306020000,2020,90628,0,90628,COST
06079803306020000,2019,90628,0,90628,COST
06079803306040000,2021,137700,306230,443930,COST
06079803306040000,2020,90591,0,90591,COST
06079803306040000,2019,90591,0,90591,COST
06079803306060000,2021,137671,0,137671,COST
06079803306060000,2020,90553,0,90553,COST
06079803306060000,2019,90553,0,90553,COST
06079803306080000,2021,137605,563370,700975,COST
06079803306080000,2020,90468,484532,575000,OVR
06079803306080000,2019,90468,484532,575000,OVR
06079803306100000,2021,141304,712570,853874,COST
06079803306100000,2020,95276,711580,806856,COST
06079803306100000,2019,95276,711580,806856,COST
06079803306120000,2021,137073,431627,568700,MKT
06079803306120000,2020,89787,0,89787,COST
06079803306120000,2019,89787,0,89787,COST
06079803306140000,2021,137846,0,137846,COST
06079803306140000,2020,90777,0,90777,COST
06079803306140000,2019,90777,0,90777,COST
06079803306160000,2021,143586,0,143586,COST
06079803306160000,2020,98302,0,98302,COST
06079803306160000,2019,98302,0,98302,COST
06079803306180000,2021,136493,542580,679073,COST
06079803306180000,2020,89047,542330,631377,COST
06079803306180000,2019,89047,542330,631377,COST
06079803306200000,2021,136284,513650,649934,COST
06079803306200000,2020,88781,511190,599971,COST
06079803306200000,2019,88781,511190,599971,COST
06079803306220000,2021,136455,476630,613085,COST
06079803306220000,2020,88998,471490,560488,COST
06079803306220000,2019,88998,471490,560488,COST
06079803306240000,2021,136455,437790,574245,COST
06079803306240000,2020,88998,438600,527598,COST
06079803306240000,2019,88998,436500,525498,COST
06079803306260000,2021,128544,0,128544,COST
06079803306260000,2020,93602,0,93602,COST
06079803306260000,2019,93602,0,93602,COST
06079803306280000,2021,123928,489672,613600,MKT
06079803306280000,2020,87152,465448,552600,MKT
06079803306280000,2019,87152,391465,478617,OVR
06079803306300000,2021,123417,419983,543400,MKT
06079803306300000,2020,86453,376547,463000,MKT
06079803306300000,2019,86453,376547,463000,MKT
06079803306320000,2021,127435,498050,625485,COST
06079803306320000,2020,92031,498510,590541,COST
06079803306320000,2019,92031,492460,584491,COST
06079803306346500,2021,48225,0,48225,COST
06079803306346500,2020,36764,0,36764,COST
06079803306346500,2019,36764,0,36764,COST
06079803307020000,2021,156237,519163,675400,MKT
06079803307020000,2020,120298,441202,561500,MKT
06079803307020000,2019,120298,441202,561500,MKT
06079803307040000,2021,150942,469658,620600,MKT
06079803307040000,2020,112469,436231,548700,MKT
06079803307040000,2019,112469,436231,548700,MKT
06079803307060000,2021,151930,510370,662300,MKT
06079803307060000,2020,113910,0,113910,COST
06079803307060000,2019,113910,0,113910,COST
06079803307080000,2021,151930,468070,620000,MKT
06079803307080000,2020,113910,425490,539400,MKT
06079803307080000,2019,113910,425490,539400,MKT
06079803307100000,2021,151930,0,151930,COST
06079803307100000,2020,113910,0,113910,COST
06079803307100000,2019,113910,0,113910,COST
06079803307120000,2021,152861,0,152861,COST
06079803307120000,2020,115276,0,115276,COST
06079803307120000,2019,115276,0,115276,COST
06079803307140000,2021,156237,607163,763400,MKT
06079803307140000,2020,120298,538402,658700,MKT
06079803307140000,2019,120298,538402,658700,MKT
06079803308020000,2021,139688,623412,763100,MKT
06079803308020000,2020,93161,502939,596100,MKT
06079803308020000,2019,93161,0,93161,COST
06079803308040000,2021,139235,498365,637600,MKT
06079803308040000,2020,92572,0,92572,COST
06079803308040000,2019,92572,0,92572,COST
06079803308060000,2021,139239,495361,634600,MKT
06079803308060000,2020,92577,434623,527200,MKT
06079803308060000,2019,92577,434623,527200,MKT
06079803308080000,2021,139247,654053,793300,MKT
06079803308080000,2020,92587,523013,615600,MKT
06079803308080000,2019,92587,523013,615600,MKT
06079803308100000,2021,139251,336949,476200,MKT
06079803308100000,2020,92593,333807,426400,MKT
06079803308100000,2019,92593,333807,426400,MKT
06079803308120000,2021,139692,345908,485600,MKT
06079803308120000,2020,93166,342234,435400,MKT
06079803308120000,2019,93166,342234,435400,MKT
06079803308140000,2021,144873,411427,556300,MKT
06079803308140000,2020,100029,377471,477500,MKT
06079803308140000,2019,100029,377471,477500,MKT
06079803308160000,2021,145662,531838,677500,MKT
06079803308160000,2020,101095,457605,558700,MKT
06079803308160000,2019,101095,457605,558700,MKT
06079803308180000,2021,140524,0,140524,COST
06079803308180000,2020,94252,0,94252,COST
06079803308180000,2019,94252,0,94252,COST
06079803308200000,2021,139231,422569,561800,MKT
06079803308200000,2020,92566,382834,475400,MKT
06079803308200000,2019,92566,382834,475400,MKT
06079803308220000,2021,139231,391769,531000,MKT
06079803308220000,2020,92566,353434,446000,MKT
06079803308220000,2019,92566,353434,446000,MKT
06079803308240000,2021,139231,461369,600600,MKT
06079803308240000,2020,92566,398634,491200,MKT
06079803308240000,2019,92566,382934,475500,MKT
06079803308260000,2021,139231,586769,726000,MKT
06079803308260000,2020,92566,453234,545800,MKT
06079803308260000,2019,92566,451434,544000,MKT
06079803308280000,2021,140591,396809,537400,MKT
06079803308280000,2020,94339,366761,461100,MKT
06079803308280000,2019,94339,0,94339,COST
06079803309020000,2021,155528,608972,764500,MKT
06079803309020000,2020,119235,529965,649200,MKT
06079803309020000,2019,119235,529965,649200,MKT
06079803309040000,2021,155430,503170,658600,MKT
06079803309040000,2020,119088,514212,633300,MKT
06079803309040000,2019,119088,514212,633300,MKT
06079803309060000,2021,155498,595002,750500,MKT
06079803309060000,2020,119190,526010,645200,MKT
06079803309060000,2019,119190,440810,560000,MKT
06079803309080000,2021,155498,429702,585200,MKT
06079803309080000,2020,119190,414410,533600,MKT
06079803309080000,2019,119190,414410,533600,MKT
06079803309100000,2021,155498,512702,668200,MKT
06079803309100000,2020,119190,454910,574100,MKT
06079803309100000,2019,119190,0,119190,COST
06079803309120000,2021,155498,638102,793600,MKT
06079803309120000,2020,119190,567110,686300,MKT
06079803309120000,2019,119190,567110,686300,MKT
06079803309140000,2021,154351,430449,584800,MKT
06079803309140000,2020,117480,354500,471980,COST
06079803309140000,2019,117480,0,117480,COST
06079803309160000,2021,160423,693720,854143,COST
06079803309160000,2020,126669,563231,689900,OVR
06079803309160000,2019,126669,737240,863909,COST
06079803309186500,2021,99233,0,99233,COST
06079803309186500,2020,150346,0,150346,COST
06079803309186500,2019,150346,0,150346,COST
06079803310020000,2021,140575,739460,880035,COST
06079803310020000,2020,94319,727840,822159,COST
06079803310020000,2019,94319,0,94319,COST
06079803310040000,2021,137738,543062,680800,MKT
06079803310040000,2020,90639,497861,588500,MKT
06079803310040000,2019,90639,497861,588500,MKT
06079803310060000,2021,137270,510673,647943,MRA
06079803310060000,2020,90039,458961,549000,MKT
06079803310060000,2019,90039,458961,549000,MKT
06079803310080000,2021,137270,475930,613200,MKT
06079803310080000,2020,90039,404861,494900,MKT
06079803310080000,2019,90039,406861,496900,MKT
06079803310100000,2021,137270,598030,735300,MKT
06079803310100000,2020,90039,339000,429039,COST
06079803310100000,2019,90039,0,90039,COST
06079803310120000,2021,137713,507087,644800,MKT
06079803310120000,2020,90607,478693,569300,MKT
06079803310120000,2019,90607,0,90607,COST
06079803310140000,2021,140465,316150,456615,COST
06079803310140000,2020,94175,0,94175,COST
06079803310140000,2019,94175,0,94175,COST
06079803311020000,2021,154908,653992,808900,MKT
06079803311020000,2020,118309,569691,688000,MKT
06079803311020000,2019,118309,0,118309,COST
06079803311040000,2021,150035,629165,779200,MKT
06079803311040000,2020,111153,553647,664800,MKT
06079803311040000,2019,111153,0,111153,COST
06079803311060000,2021,149969,594731,744700,MKT
06079803311060000,2020,111058,427360,538418,COST
06079803311060000,2019,111058,0,111058,COST
06079803311080000,2021,149969,0,149969,COST
06079803311080000,2020,111058,0,111058,COST
06079803311080000,2019,111058,0,111058,COST
06079803311100000,2021,149969,536131,686100,MKT
06079803311100000,2020,111058,0,111058,COST
06079803311100000,2019,111058,0,111058,COST
06079803311120000,2021,149969,520531,670500,MKT
06079803311120000,2020,111058,0,111058,COST
06079803311120000,2019,111058,0,111058,COST
06079803311140000,2021,149950,0,149950,COST
06079803311140000,2020,111030,0,111030,COST
06079803311140000,2019,111030,0,111030,COST
06079803311160000,2021,154986,584314,739300,MKT
06079803311160000,2020,118424,550476,668900,MKT
06079803311160000,2019,118424,550476,668900,MKT
06079803312020000,2021,140935,598365,739300,MKT
06079803312020000,2020,94791,455109,549900,MKT
06079803312020000,2019,94791,0,94791,COST
06079803312040000,2021,136254,492346,628600,MKT
06079803312040000,2020,88743,0,88743,COST
06079803312040000,2019,88743,0,88743,COST
06079803312060000,2021,136314,529186,665500,MKT
06079803312060000,2020,88819,0,88819,COST
06079803312060000,2019,88819,0,88819,COST
06079803312080000,2021,136224,513576,649800,MKT
06079803312080000,2020,88705,0,88705,COST
06079803312080000,2019,88705,0,88705,COST
06079803312100000,2021,136404,0,136404,COST
06079803312100000,2020,88933,0,88933,COST
06079803312100000,2019,88933,0,88933,COST
06079803312120000,2021,136314,0,136314,COST
06079803312120000,2020,88819,0,88819,COST
06079803312120000,2019,88819,0,88819,COST
06079803312140000,2021,136297,0,136297,COST
06079803312140000,2020,88797,0,88797,COST
06079803312140000,2019,88797,0,88797,COST
06079803312160000,2021,140896,0,140896,COST
06079803312160000,2020,94740,0,94740,COST
06079803312160000,2019,94740,0,94740,COST
06079803313016500,2021,117487,0,117487,COST
06079803313016500,2020,209039,0,209039,COST
06079803313016500,2019,209039,0,209039,COST
06079803313020000,2021,208404,657596,866000,MKT
06079803313020000,2020,117512,581888,699400,MKT
06079803313020000,2019,117512,0,117512,COST
06079803313040000,2021,200939,529261,730200,MKT
06079803313040000,2020,109437,499063,608500,MKT
06079803313040000,2019,109437,0,109437,COST
06079803313060000,2021,200939,495661,696600,MKT
06079803313060000,2020,109437,451563,561000,MKT
06079803313060000,2019,109437,0,109437,COST
06079803313080000,2021,200939,0,200939,COST
06079803313080000,2020,109437,0,109437,COST
06079803313080000,2019,109437,0,109437,COST
06079803313100000,2021,200939,579761,780700,MKT
06079803313100000,2020,109437,0,109437,COST
06079803313100000,2019,109437,0,109437,COST
06079803313120000,2021,213351,496149,709500,MKT
06079803313120000,2020,123020,445780,568800,MKT
06079803313120000,2019,123020,445780,568800,MKT
06079803314020000,2021,122090,0,122090,COST
06079803314020000,2020,71628,0,71628,COST
06079803314020000,2019,71628,0,71628,COST
06079803314040000,2021,121483,0,121483,COST
06079803314040000,2020,70935,0,70935,COST
06079803314040000,2019,70935,0,70935,COST
06079803314065001,2021,112537,245963,358500,MKT
06079803314065001,2020,61097,245403,306500,MKT
06079803314065001,2019,61097,0,61097,COST
06079803314085002,2021,112537,245963,358500,MKT
06079803314085002,2020,61097,245403,306500,MKT
06079803314085002,2019,61097,0,61097,COST
06079803314105001,2021,112537,245863,358400,MKT
06079803314105001,2020,61097,245203,306300,MKT
06079803314105001,2019,61097,0,61097,COST
06079803314125002,2021,112537,245863,358400,MKT
06079803314125002,2020,61097,245203,306300,MKT
06079803314125002,2019,61097,0,61097,COST
06079803314140000,2021,118443,0,118443,COST
06079803314140000,2020,67512,0,67512,COST
06079803314140000,2019,67512,0,67512,COST
06079803314160000,2021,118581,0,118581,COST
06079803314160000,2020,84582,0,84582,COST
06079803314160000,2019,84582,0,84582,COST
06079803314186500,2021,72872,0,72872,COST
06079803314186500,2020,82292,0,82292,COST
06079803314186500,2019,82292,0,82292,COST
06079803315010000,2021,2367060,2140210,4507270,COST
06079803315010000,2020,1339765,2119580,3459345,COST
06079803315010000,2019,1339765,2119580,3459345,COST
06079803320010000,2021,201436,319264,520700,MKT
06079803320010000,2020,168283,300617,468900,MKT
06079803320010000,2019,168283,300617,468900,MKT
06079803401107000,2021,324810,0,324810,COST
06079803401107000,2020,483649,0,483649,COST
06079803401107000,2019,483649,0,483649,COST
06079803401200000,2021,488321,0,488321,COST
06079803401200000,2020,454724,0,454724,COST
06079803401200000,2019,454724,0,454724,COST
06079803401360000,2021,195900,242300,438200,MKT
06079803401360000,2020,163100,209900,373000,MKT
06079803401360000,2019,163100,209900,373000,MKT
06079803401390000,2021,281937,419463,701400,MKT
06079803401390000,2020,245445,308700,554145,COST
06079803401390000,2019,245445,308700,554145,COST
06079803402017000,2021,107696,0,107696,COST
06079803402017000,2020,73470,0,73470,COST
06079803402017000,2019,73470,0,73470,COST
06079803402030000,2021,107748,363752,471500,INCOME
06079803402030000,2020,73539,348761,422300,INCOME
06079803402030000,2019,73539,348761,422300,INCOME
06079803402057000,2021,107742,0,107742,COST
06079803402057000,2020,73532,0,73532,COST
06079803402057000,2019,73532,0,73532,COST
06079803402070000,2021,107742,363758,471500,INCOME
06079803402070000,2020,73532,348768,422300,INCOME
06079803402070000,2019,73532,348768,422300,INCOME
06079803402090000,2021,107733,363767,471500,INCOME
06079803402090000,2020,73520,348780,422300,INCOME
06079803402090000,2019,73520,348780,422300,INCOME
06079803402110000,2021,128286,473914,602200,INCOME
06079803402110000,2020,92113,499087,591200,INCOME
06079803402110000,2019,92113,499087,591200,INCOME
06079803402130000,2021,128296,343204,471500,INCOME
06079803402130000,2020,92127,330173,422300,INCOME
06079803402130000,2019,92127,330173,422300,INCOME
06079803402150000,2021,128296,343204,471500,INCOME
06079803402150000,2020,92127,330173,422300,INCOME
06079803402150000,2019,92127,330173,422300,INCOME
06079803402170000,2021,128299,343201,471500,INCOME
06079803402170000,2020,92131,330169,422300,INCOME
06079803402170000,2019,92131,330169,422300,INCOME
06079803402190000,2021,128355,343145,471500,INCOME
06079803402190000,2020,92209,330091,422300,INCOME
06079803402190000,2019,92209,330091,422300,INCOME
06079803402210000,2021,128439,343061,471500,INCOME
06079803402210000,2020,92328,329972,422300,INCOME
06079803402210000,2019,92328,329972,422300,INCOME
06079803402230000,2021,128299,343201,471500,INCOME
06079803402230000,2020,92131,330169,422300,INCOME
06079803402230000,2019,92131,330169,422300,INCOME
06079803402250000,2021,128296,343204,471500,INCOME
06079803402250000,2020,92127,330173,422300,INCOME
06079803402250000,2019,92127,330173,422300,INCOME
06079803402270000,2021,128296,0,128296,COST
06079803402270000,2020,92127,0,92127,COST
06079803402270000,2019,92127,0,92127,COST
06079803402290000,2021,128286,371014,499300,INCOME
06079803402290000,2020,92113,346087,438200,INCOME
06079803402290000,2019,92113,346087,438200,INCOME
06079803402310000,2021,128250,473950,602200,INCOME
06079803402310000,2020,92063,414637,506700,INCOME
06079803402310000,2019,92063,414637,506700,INCOME
06079803402330000,2021,128263,473937,602200,INCOME
06079803402330000,2020,92081,414619,506700,INCOME
06079803402330000,2019,92081,330219,422300,INCOME
06079803402350000,2021,128263,473937,602200,INCOME
06079803402350000,2020,92081,330219,422300,INCOME
06079803402350000,2019,92081,330219,422300,INCOME
06079803402370000,2021,128267,408533,536800,INCOME
06079803402370000,2020,92086,414614,506700,INCOME
06079803402370000,2019,92086,414614,506700,INCOME
06079803402390000,2021,128530,408270,536800,INCOME
06079803402390000,2020,92455,414245,506700,INCOME
06079803402390000,2019,92455,414245,506700,INCOME
06079803402410000,2021,141511,502489,644000,INCOME
06079803402410000,2020,115525,475675,591200,INCOME
06079803402410000,2019,115525,475675,591200,INCOME
06079803402430000,2021,141511,395289,536800,INCOME
06079803402430000,2020,115525,391175,506700,INCOME
06079803402430000,2019,115525,391175,506700,INCOME
06079803402450000,2021,141511,395289,536800,INCOME
06079803402450000,2020,115525,391175,506700,INCOME
06079803402450000,2019,115525,391175,506700,INCOME
06079803402477000,2021,141511,0,141511,COST
06079803402477000,2020,115525,0,115525,COST
06079803402477000,2019,115525,0,115525,COST
06079803402490000,2021,141508,395292,536800,INCOME
06079803402490000,2020,115519,391181,506700,INCOME
06079803402490000,2019,115519,391181,506700,INCOME
06079803402517000,2021,141508,0,141508,COST
06079803402517000,2020,115519,0,115519,COST
06079803402517000,2019,115519,0,115519,COST
06079803402537000,2021,141508,0,141508,COST
06079803402537000,2020,115519,0,115519,COST
06079803402537000,2019,115519,0,115519,COST
06079803402557000,2021,141511,0,141511,COST
06079803402557000,2020,115525,0,115525,COST
06079803402557000,2019,115525,0,115525,COST
06079803403016500,2021,39142,0,39142,COST
06079803403016500,2020,30711,0,30711,COST
06079803403016500,2019,30711,0,30711,COST
06079803403036500,2021,48571,0,48571,COST
06079803403036500,2020,46802,0,46802,COST
06079803403036500,2019,46802,0,46802,COST
06079803403050000,2021,140356,310444,450800,MKT
06079803403050000,2020,113691,291209,404900,MKT
06079803403050000,2019,113691,291209,404900,MKT
06079803403070000,2021,141244,281256,422500,MKT
06079803403070000,2020,115099,267501,382600,MKT
06079803403070000,2019,115099,267501,382600,MKT
06079803403090000,2021,140498,335002,475500,MKT
06079803403090000,2020,113915,343785,457700,MKT
06079803403090000,2019,113915,343785,457700,MKT
06079803403110000,2021,141657,294643,436300,MKT
06079803403110000,2020,115757,280843,396600,MKT
06079803403110000,2019,115757,282843,398600,MKT
06079803403130000,2021,143542,304758,448300,MKT
06079803403130000,2020,118782,289518,408300,MKT
06079803403130000,2019,118782,289518,408300,MKT
06079803403150000,2021,137342,279058,416400,MKT
06079803403150000,2020,108974,268926,377900,MKT
06079803403150000,2019,108974,268926,377900,MKT
06079803403170000,2021,124804,277096,401900,MKT
06079803403170000,2020,90402,259798,350200,MKT
06079803403170000,2019,90402,259798,350200,MKT
06079803403190000,2021,145655,247445,393100,MKT
06079803403190000,2020,105172,221628,326800,MKT
06079803403190000,2019,105172,221628,326800,MKT
06079803404010000,2021,122789,268111,390900,MKT
06079803404010000,2020,84566,253434,338000,MKT
06079803404010000,2019,84566,253434,338000,MKT
06079803404030000,2021,118645,0,118645,COST
06079803404030000,2020,79085,0,79085,COST
06079803404030000,2019,79085,0,79085,COST
06079803404050000,2021,118645,316455,435100,MKT
06079803404050000,2020,79085,287715,366800,MKT
06079803404050000,2019,79085,287715,366800,MKT
06079803404070000,2021,122178,268222,390400,MKT
06079803404070000,2020,83747,238153,321900,MKT
06079803404070000,2019,83747,238153,321900,MKT
06079803404090000,2021,131866,269434,401300,MKT
06079803404090000,2020,97196,253104,350300,MKT
06079803404090000,2019,97196,253104,350300,MKT
06079803404110000,2021,131848,314952,446800,MKT
06079803404110000,2020,97170,317430,414600,MKT
06079803404110000,2019,97170,317430,414600,MKT
06079803404130000,2021,131848,260352,392200,MKT
06079803404130000,2020,97170,247430,344600,MKT
06079803404130000,2019,97170,247430,344600,MKT
06079803404150000,2021,127251,269449,396700,MKT
06079803404150000,2020,90668,256032,346700,MKT
06079803404150000,2019,90668,256032,346700,MKT
06079803404170000,2021,127251,289249,416500,MKT
06079803404170000,2020,90668,261632,352300,MKT
06079803404170000,2019,90668,261632,352300,MKT
06079803404190000,2021,132074,290326,422400,MKT
06079803404190000,2020,97496,279004,376500,MKT
06079803404190000,2019,97496,279004,376500,MKT
06079803404210000,2021,120853,257647,378500,MKT
06079803404210000,2020,81983,238317,320300,MKT
06079803404210000,2019,81983,238317,320300,MKT
06079803404230000,2021,121079,278121,399200,MKT
06079803404230000,2020,82283,260517,342800,MKT
06079803404230000,2019,82283,260517,342800,MKT
06079803404250000,2021,121129,257571,378700,MKT
06079803404250000,2020,82349,238251,320600,MKT
06079803404250000,2019,82349,238251,320600,MKT
06079803404270000,2021,121156,248044,369200,MKT
06079803404270000,2020,82384,246416,328800,MKT
06079803404270000,2019,82384,246416,328800,MKT
06079803404290000,2021,121721,290079,411800,MKT
06079803404290000,2020,83136,259364,342500,MKT
06079803404290000,2019,83136,259364,342500,MKT
06079803404310000,2021,123287,260513,383800,MKT
06079803404310000,2020,85236,241364,326600,MKT
06079803404310000,2019,85236,241364,326600,MKT
06079803404330000,2021,121003,274397,395400,MKT
06079803404330000,2020,82181,257619,339800,MKT
06079803404330000,2019,82181,257619,339800,MKT
06079803404350000,2021,121003,245597,366600,MKT
06079803404350000,2020,82181,245819,328000,MKT
06079803404350000,2019,82181,245819,328000,MKT
06079803404370000,2021,120811,282389,403200,MKT
06079803404370000,2020,81927,253673,335600,MKT
06079803404370000,2019,81927,253673,335600,MKT
06079803405010000,2021,131215,288185,419400,MKT
06079803405010000,2020,96262,279538,375800,MKT
06079803405010000,2019,96262,276538,372800,MKT
06079803405030000,2021,127255,269545,396800,MKT
06079803405030000,2020,90673,256227,346900,MKT
06079803405030000,2019,90673,256227,346900,MKT
06079803405050000,2021,142402,290398,432800,MKT
06079803405050000,2020,97179,279021,376200,MKT
06079803405050000,2019,97179,279021,376200,MKT
