id,year,land,building,total,method
06033928406010000,2021,305317,203090,508407,COST
06033928406010000,2020,418456,211180,629636,COST
06033928406010000,2019,418456,211180,629636,COST
06033928406020000,2021,272370,0,272370,COST
06033928406020000,2020,367000,0,367000,COST
06033928406020000,2019,367000,0,367000,COST
06033928406030000,2021,271109,175720,446829,COST
06033928406030000,2020,365049,184300,549349,OVR
06033928406030000,2019,365049,184300,549349,COST
06033928406040000,2021,283173,330140,613313,COST
06033928406040000,2020,383775,227300,611075,COST
06033928406040000,2019,383775,227300,611075,COST
06033928406050000,2021,229443,0,229443,COST
06033928406050000,2020,188388,0,188388,COST
06033928406050000,2019,188388,0,188388,COST
06033928406060000,2021,236292,753430,989722,COST
06033928406060000,2020,194864,472120,666984,COST
06033928406060000,2019,194864,472120,666984,COST
06033928406070000,2021,245800,1308960,1554760,COST
06033928406070000,2020,203900,714530,918430,OVR
06033928406070000,2019,203900,714530,918430,COST
06033928406080000,2021,262015,0,262015,COST
06033928406080000,2020,219431,0,219431,COST
06033928406080000,2019,219431,0,219431,COST
06033928406110000,2021,393385,623830,1017215,COST
06033928406110000,2020,350023,381120,731143,COST
06033928406110000,2019,350023,381120,731143,COST
06033928421010000,2021,330171,2549070,2879241,COST
06033928421010000,2020,457830,1505470,1963300,COST
06033928421010000,2019,457830,1505470,1963300,COST
06033928421020000,2021,315607,0,315607,COST
06033928421020000,2020,434703,0,434703,COST
06033928421020000,2019,434703,0,434703,COST
06033928421030000,2021,319169,507490,826659,COST
06033928421030000,2020,440345,527870,968215,COST
06033928421030000,2019,440345,527870,968215,COST
06033928421040000,2021,330171,579629,909800,MKT
06033928421040000,2020,457830,414840,872670,COST
06033928421040000,2019,457830,414840,872670,COST
06033928421050000,2021,323500,659700,983200,MKT
06033928421050000,2020,447218,479200,926418,COST
06033928421050000,2019,447218,479200,926418,COST
06033928421060000,2021,309148,645150,954298,COST
06033928421060000,2020,424495,669350,1093845,COST
06033928421060000,2019,424495,669350,1093845,COST
06033928421070000,2021,296278,1180,297458,COST
06033928421070000,2020,404254,940,405194,COST
06033928421070000,2019,404254,940,405194,COST
06033928421080000,2021,284318,691500,975818,COST
06033928421080000,2020,385558,725510,1111068,COST
06033928421080000,2019,385558,725510,1111068,COST
06033928421870000,2021,404904,0,404904,COST
06033928421870000,2020,361825,0,361825,COST
06033928421870000,2019,361825,0,361825,COST
06033928450400000,2021,5660,0,5660,COST
06033928450400000,2020,3086,0,3086,COST
06033928450400000,2019,3086,0,3086,COST
06033929101010000,2021,219237,62980,282217,COST
06033929101010000,2020,119166,53120,172286,COST
06033929101010000,2019,119166,53120,172286,COST
06033930110010000,2021,8085,0,8085,COST
06033930110010000,2020,4343,0,4343,COST
06033930110010000,2019,4343,0,4343,COST
06033930120010000,2021,183381,999700,1183081,COST
06033930120010000,2020,120225,855060,975285,COST
06033930120010000,2019,120225,855060,975285,COST
06033930130010000,2021,183381,2167210,2350591,COST
06033930130010000,2020,120225,1797030,1917255,COST
06033930130010000,2019,120225,1797030,1917255,COST
06033930140010000,2021,183381,2883160,3066541,COST
06033930140010000,2020,120225,2850180,2970405,COST
06033930140010000,2019,120225,2850180,2970405,COST
06033930150010000,2021,8649,0,8649,COST
06033930150010000,2020,4651,0,4651,COST
06033930150010000,2019,4651,0,4651,COST
06033930160010000,2021,183381,1150140,1333521,COST
06033930160010000,2020,120225,978200,1098425,COST
06033930160010000,2019,120225,978200,1098425,COST
06033930170010000,2021,184666,1868500,2053166,COST
06033930170010000,2020,120929,1558990,1679919,COST
06033930170010000,2019,120929,1558990,1679919,COST
06033930180010000,2021,10305,0,10305,COST
06033930180010000,2020,5556,0,5556,COST
06033930180010000,2019,5556,0,5556,COST
06033930210010000,2021,8109,0,8109,COST
06033930210010000,2020,4356,0,4356,COST
06033930210010000,2019,4356,0,4356,COST
06033930220010000,2021,398011,0,398011,COST
06033930220010000,2020,297092,0,297092,COST
06033930220010000,2019,297092,0,297092,COST
06033930230010000,2021,8085,0,8085,COST
06033930230010000,2020,4343,0,4343,COST
06033930230010000,2019,4343,0,4343,COST
06033930240010000,2021,8085,0,8085,COST
06033930240010000,2020,4343,0,4343,COST
06033930240010000,2019,4343,0,4343,COST
06033930260010000,2021,14448,0,14448,COST
06033930260010000,2020,7793,0,7793,COST
06033930260010000,2019,7793,0,7793,COST
06033930270010000,2021,8234,0,8234,COST
06033930270010000,2020,4424,0,4424,COST
06033930270010000,2019,4424,0,4424,COST
06033930280010000,2021,183674,1049990,1233664,COST
06033930280010000,2020,120386,885590,1005976,COST
06033930280010000,2019,120386,885590,1005976,COST
06033930310010000,2021,183389,1888860,2072249,COST
06033930310010000,2020,120230,1556190,1676420,COST
06033930310010000,2019,120230,1184200,1304430,COST
06033930320010000,2021,397837,0,397837,COST
06033930320010000,2020,296943,0,296943,COST
06033930320010000,2019,296943,0,296943,COST
06033930330010000,2021,8085,0,8085,COST
06033930330010000,2020,4343,0,4343,COST
06033930330010000,2019,4343,0,4343,COST
06033930340010000,2021,8085,0,8085,COST
06033930340010000,2020,4343,0,4343,COST
06033930340010000,2019,4343,0,4343,COST
06033930350010000,2021,398531,0,398531,COST
06033930350010000,2020,297538,0,297538,COST
06033930350010000,2019,297538,0,297538,COST
06033930360010000,2021,8085,0,8085,COST
06033930360010000,2020,4343,0,4343,COST
06033930360010000,2019,4343,0,4343,COST
06033930370010000,2021,183381,912240,1095621,COST
06033930370010000,2020,120225,776780,897005,COST
06033930370010000,2019,120225,776780,897005,COST
06033930380010000,2021,8085,0,8085,COST
06033930380010000,2020,4343,0,4343,COST
06033930380010000,2019,4343,0,4343,COST
06033930410010000,2021,8085,0,8085,COST
06033930410010000,2020,4343,0,4343,COST
06033930410010000,2019,4343,0,4343,COST
06033930420010000,2021,8085,0,8085,COST
06033930420010000,2020,4343,0,4343,COST
06033930420010000,2019,4343,0,4343,COST
06033930430010000,2021,8085,0,8085,COST
06033930430010000,2020,4343,0,4343,COST
06033930430010000,2019,4343,0,4343,COST
06033930440010000,2021,8085,0,8085,COST
06033930440010000,2020,4343,0,4343,COST
06033930440010000,2019,4343,0,4343,COST
06033930450010000,2021,8085,0,8085,COST
06033930450010000,2020,4343,0,4343,COST
06033930450010000,2019,4343,0,4343,COST
06033930460010000,2021,8085,0,8085,COST
06033930460010000,2020,4343,0,4343,COST
06033930460010000,2019,4343,0,4343,COST
06033930470010000,2021,183381,2165590,2348971,COST
06033930470010000,2020,120225,1848370,1968595,COST
06033930470010000,2019,120225,1848370,1968595,COST
06033930480010000,2021,183381,959630,1143011,COST
06033930480010000,2020,120225,782780,903005,COST
06033930480010000,2019,120225,782780,903005,COST
06033931101010000,2021,213245,0,213245,COST
06033931101010000,2020,114912,0,114912,COST
06033931101010000,2019,114912,0,114912,COST
06033932101010000,2021,231812,0,231812,COST
06033932101010000,2020,124816,0,124816,COST
06033932101010000,2019,124816,0,124816,COST
06033933101010000,2021,246885,0,246885,COST
06033933101010000,2020,133170,0,133170,COST
06033933101010000,2019,133170,0,133170,COST
06033934101010000,2021,248830,0,248830,COST
06033934101010000,2020,133899,0,133899,COST
06033934101010000,2019,133899,0,133899,COST
06033935101010000,2021,243726,0,243726,COST
06033935101010000,2020,131122,0,131122,COST
06033935101010000,2019,131122,0,131122,COST
06033936101010000,2021,232084,0,232084,COST
06033936101010000,2020,124908,0,124908,COST
06033936101010000,2019,124908,0,124908,COST
06034001101010000,2021,238993,0,238993,COST
06034001101010000,2020,128657,0,128657,COST
06034001101010000,2019,128657,0,128657,COST
06034002101010000,2021,255366,0,255366,COST
06034002101010000,2020,137243,0,137243,COST
06034002101010000,2019,137243,0,137243,COST
06034003101010000,2021,139866,0,139866,COST
06034003101010000,2020,76504,0,76504,COST
06034003101010000,2019,76504,0,76504,COST
06034004101010000,2021,168627,0,168627,COST
06034004101010000,2020,91632,0,91632,COST
06034004101010000,2019,91632,0,91632,COST
06034005101010000,2021,247880,0,247880,COST
06034005101010000,2020,133307,0,133307,COST
06034005101010000,2019,133307,0,133307,COST
06034006101010000,2021,317817,0,317817,COST
06034006101010000,2020,171227,0,171227,COST
06034006101010000,2019,171227,0,171227,COST
06034007101010000,2021,321597,0,321597,COST
06034007101010000,2020,173214,0,173214,COST
06034007101010000,2019,173214,0,173214,COST
06034008101010000,2021,250312,0,250312,COST
06034008101010000,2020,134586,0,134586,COST
06034008101010000,2019,134586,0,134586,COST
06034009101010000,2021,48972,0,48972,COST
06034009101010000,2020,27231,0,27231,COST
06034009101010000,2019,27231,0,27231,COST
06034009201010000,2021,100318,0,100318,COST
06034009201010000,2020,54234,0,54234,COST
06034009201010000,2019,54234,0,54234,COST
06034010101010000,2021,254356,0,254356,COST
06034010101010000,2020,136712,0,136712,COST
06034010101010000,2019,136712,0,136712,COST
06034011101010000,2021,256304,0,256304,COST
06034011101010000,2020,137736,0,137736,COST
06034011101010000,2019,137736,0,137736,COST
06034012101010000,2021,252719,0,252719,COST
06034012101010000,2020,135850,0,135850,COST
06034012101010000,2019,135850,0,135850,COST
06034013101010000,2021,256398,0,256398,COST
06034013101010000,2020,137785,0,137785,COST
06034013101010000,2019,137785,0,137785,COST
06034014101010000,2021,195601,0,195601,COST
06034014101010000,2020,105818,0,105818,COST
06034014101010000,2019,105818,0,105818,COST
06034015101010000,2021,235900,0,235900,COST
06034015101010000,2020,127008,0,127008,COST
06034015101010000,2019,127008,0,127008,COST
06034016101010000,2021,107723,0,107723,COST
06034016101010000,2020,58125,0,58125,COST
06034016101010000,2019,58125,0,58125,COST
06034016201010000,2021,42999,0,42999,COST
06034016201010000,2020,24092,0,24092,COST
06034016201010000,2019,24092,0,24092,COST
06034017101010000,2021,124238,0,124238,COST
06034017101010000,2020,68291,0,68291,COST
06034017101010000,2019,68291,0,68291,COST
06034018101010000,2021,350277,0,350277,COST
06034018101010000,2020,188294,0,188294,COST
06034018101010000,2019,188294,0,188294,COST
06034019101010000,2021,65000,0,65000,COST
06034019101010000,2020,34920,0,34920,COST
06034019101010000,2019,34920,0,34920,COST
06034019201010000,2021,295344,0,295344,COST
06034019201010000,2020,158668,0,158668,COST
06034019201010000,2019,158668,0,158668,COST
06034020101010000,2021,223493,0,223493,COST
06034020101010000,2020,120483,0,120483,COST
06034020101010000,2019,120483,0,120483,COST
06034021101010000,2021,66201,0,66201,COST
06034021101010000,2020,36292,0,36292,COST
06034021101010000,2019,36292,0,36292,COST
06034021201010000,2021,76189,0,76189,COST
06034021201010000,2020,41544,0,41544,COST
06034021201010000,2019,41544,0,41544,COST
06034022101010000,2021,224433,0,224433,COST
06034022101010000,2020,120978,0,120978,COST
06034022101010000,2019,120978,0,120978,COST
06034023101010000,2021,245933,0,245933,COST
06034023101010000,2020,132284,0,132284,COST
06034023101010000,2019,132284,0,132284,COST
06034024101010000,2021,250424,0,250424,COST
06034024101010000,2020,134644,0,134644,COST
06034024101010000,2019,134644,0,134644,COST
06034025101010000,2021,248046,0,248046,COST
06034025101010000,2020,133394,0,133394,COST
06034025101010000,2019,133394,0,133394,COST
06034026101010000,2021,248481,0,248481,COST
06034026101010000,2020,133623,0,133623,COST
06034026101010000,2019,133623,0,133623,COST
06034027101010000,2021,233775,0,233775,COST
06034027101010000,2020,125890,0,125890,COST
06034027101010000,2019,125890,0,125890,COST
06034028101010000,2021,23593,0,23593,COST
06034028101010000,2020,13879,0,13879,COST
06034028101010000,2019,13879,0,13879,COST
06034028201010000,2021,74047,0,74047,COST
06034028201010000,2020,40405,0,40405,COST
06034028201010000,2019,40405,0,40405,COST
06034029101010000,2021,246154,0,246154,COST
06034029101010000,2020,132400,0,132400,COST
06034029101010000,2019,132400,0,132400,COST
06034030101010000,2021,360344,0,360344,COST
06034030101010000,2020,193588,0,193588,COST
06034030101010000,2019,193588,0,193588,COST
06034031101010000,2021,349100,0,349100,COST
06034031101010000,2020,187675,0,187675,COST
06034031101010000,2019,187675,0,187675,COST
06034032101010000,2021,241748,0,241748,COST
06034032101010000,2020,130082,0,130082,COST
06034032101010000,2019,130082,0,130082,COST
06034033101010000,2021,149136,0,149136,COST
06034033101010000,2020,81383,0,81383,COST
06034033101010000,2019,81383,0,81383,COST
06034034101010000,2021,230986,0,230986,COST
06034034101010000,2020,124424,0,124424,COST
06034034101010000,2019,124424,0,124424,COST
06034035101010000,2021,213580,0,213580,COST
06034035101010000,2020,115270,0,115270,COST
06034035101010000,2019,115270,0,115270,COST
06034036101010000,2021,192899,0,192899,COST
06034036101010000,2020,104395,0,104395,COST
06034036101010000,2019,104395,0,104395,COST
06042701101010000,2021,117099,0,117099,COST
06042701101010000,2020,64926,0,64926,COST
06042701101010000,2019,64926,0,64926,COST
06042702101010000,2021,149481,0,149481,COST
06042702101010000,2020,81910,0,81910,COST
06042702101010000,2019,81910,0,81910,COST
06042703101010000,2021,174938,0,174938,COST
06042703101010000,2020,95368,0,95368,COST
06042703101010000,2019,95368,0,95368,COST
06042704101010000,2021,58621,0,58621,COST
06042704101010000,2020,33668,0,33668,COST
06042704101010000,2019,33668,0,33668,COST
06042709101010000,2021,129706,0,129706,COST
06042709101010000,2020,70220,0,70220,COST
06042709101010000,2019,70220,0,70220,COST
06042709301010000,2021,41808,0,41808,COST
06042709301010000,2020,22667,0,22667,COST
06042709301010000,2019,22667,0,22667,COST
06042710101010000,2021,105636,0,105636,COST
06042710101010000,2020,58366,0,58366,COST
06042710101010000,2019,58366,0,58366,COST
06042711101010000,2021,25875,0,25875,COST
06042711101010000,2020,16475,0,16475,COST
06042711101010000,2019,16475,0,16475,COST
06042712101010000,2021,85359,0,85359,COST
06042712101010000,2020,47732,0,47732,COST
06042712101010000,2019,47732,0,47732,COST
06042713101010000,2021,131386,0,131386,COST
06042713101010000,2020,71869,0,71869,COST
06042713101010000,2019,71869,0,71869,COST
06042714101010000,2021,142208,0,142208,COST
06042714101010000,2020,77544,0,77544,COST
06042714101010000,2019,77544,0,77544,COST
06042715101010000,2021,148866,0,148866,COST
06042715101010000,2020,79921,0,79921,COST
06042715101010000,2019,79921,0,79921,COST
06042715301010000,2021,90261,290,90551,COST
06042715301010000,2020,48446,300,48746,COST
06042715301010000,2019,48446,300,48746,COST
06042716101010000,2021,223075,0,223075,COST
06042716101010000,2020,119949,0,119949,COST
06042716101010000,2019,119949,0,119949,COST
06042721101010000,2021,60980,0,60980,COST
06042721101010000,2020,32720,0,32720,COST
06042721101010000,2019,32720,0,32720,COST
06042721201010000,2021,60980,0,60980,COST
06042721201010000,2020,32720,0,32720,COST
06042721201010000,2019,32720,0,32720,COST
06042721301010000,2021,309518,3976770,4286288,COST
06042721301010000,2020,238117,3346700,3584817,COST
06042721301010000,2019,238117,2324650,2562767,COST
06042721401010000,2021,60751,0,60751,COST
06042721401010000,2020,32597,0,32597,COST
06042721401010000,2019,32597,0,32597,COST
06042722101010000,2021,47092,0,47092,COST
06042722101010000,2020,25897,0,25897,COST
06042722101010000,2019,25897,0,25897,COST
06042722301010000,2021,117531,0,117531,COST
06042722301010000,2020,63124,0,63124,COST
06042722301010000,2019,63124,0,63124,COST
06042722412050000,2021,1108,0,1108,COST
06042722412050000,2020,1031,0,1031,COST
06042722412050000,2019,1031,0,1031,COST
06042722418050000,2021,247157,1436790,1683947,COST
06042722418050000,2020,205163,1287110,1492273,COST
06042722418050000,2019,205163,1287110,1492273,COST
06042722448010000,2021,247294,1188800,1436094,COST
06042722448010000,2020,205290,945960,1151250,COST
06042722448010000,2019,205290,945960,1151250,COST
06042722448100000,2021,1163,0,1163,COST
06042722448100000,2020,1082,0,1082,COST
06042722448100000,2019,1082,0,1082,COST
06042722448200000,2021,1162,0,1162,COST
06042722448200000,2020,1082,0,1082,COST
06042722448200000,2019,1082,0,1082,COST
06042723101010000,2021,56155,0,56155,COST
06042723101010000,2020,30561,0,30561,COST
06042723101010000,2019,30561,0,30561,COST
06042723201100000,2021,913,0,913,COST
06042723201100000,2020,850,0,850,COST
06042723201100000,2019,850,0,850,COST
06042723302010000,2021,52555,0,52555,COST
06042723302010000,2020,30520,0,30520,COST
06042723302010000,2019,30520,0,30520,COST
06042723401010000,2021,65695,0,65695,COST
06042723401010000,2020,35595,0,35595,COST
06042723401010000,2019,35595,0,35595,COST
06042724101010000,2021,224244,0,224244,COST
06042724101010000,2020,120562,0,120562,COST
06042724101010000,2019,120562,0,120562,COST
06042725101010000,2021,61106,0,61106,COST
06042725101010000,2020,34292,0,34292,COST
06042725101010000,2019,34292,0,34292,COST
06042725201106500,2021,559,0,559,COST
06042725201106500,2020,520,0,520,COST
06042725201106500,2019,520,0,520,COST
06042725301010000,2021,246892,3738910,3985802,COST
06042725301010000,2020,204916,3140720,3345636,COST
06042725301010000,2019,204916,1774120,1979036,COST
06042725304010000,2021,246852,183130,429982,COST
06042725304010000,2020,204879,155620,360499,COST
06042725304010000,2019,1030,0,1030,COST
06042725306140000,2021,1305,0,1305,COST
06042725306140000,2020,1215,0,1215,COST
06042725306140000,2019,1215,0,1215,COST
06042725306170000,2021,305127,0,305127,COST
06042725306170000,2020,261405,0,261405,COST
06042725306170000,2019,261405,0,261405,COST
06042725306400000,2021,8414,0,8414,COST
06042725306400000,2020,4562,0,4562,COST
06042725306400000,2019,4562,0,4562,COST
06042725306500000,2021,7669,0,7669,COST
06042725306500000,2020,4115,0,4115,COST
06042725306500000,2019,4115,0,4115,COST
06042725306600000,2021,254304,3639880,3894184,COST
06042725306600000,2020,208463,3064810,3273273,COST
06042725306600000,2019,208463,3064810,3273273,COST
06042725306700000,2021,8618,0,8618,COST
06042725306700000,2020,4624,0,4624,COST
06042725306700000,2019,4624,0,4624,COST
06042725401010000,2021,101542,0,101542,COST
06042725401010000,2020,73833,0,73833,COST
06042725401010000,2019,73833,0,73833,COST
06042726101010000,2021,492632,4356480,4849112,COST
06042726101010000,2020,408760,3921610,4330370,COST
06042726101010000,2019,408760,3921610,4330370,COST
06042726101150000,2021,500614,686220,1186834,COST
06042726101150000,2020,461728,572110,1033838,COST
06042726101150000,2019,461728,704530,1166258,COST
06042726102010000,2021,1708,0,1708,COST
06042726102010000,2020,989,0,989,COST
06042726102010000,2019,989,0,989,COST
06042726102100000,2021,323,0,323,COST
06042726102100000,2020,2238,0,2238,COST
06042726102100000,2019,2238,0,2238,COST
06042726124010000,2021,6701,0,6701,COST
06042726124010000,2020,3795,0,3795,COST
06042726124010000,2019,3795,0,3795,COST
06042726201010000,2021,247351,1810720,2058071,COST
06042726201010000,2020,205343,1498580,1703923,COST
06042726201010000,2019,205343,1498580,1703923,COST
06042726202010000,2021,4807,0,4807,COST
06042726202010000,2020,2619,0,2619,COST
06042726202010000,2019,2619,0,2619,COST
06042726202100000,2021,2420,0,2420,COST
06042726202100000,2020,1367,0,1367,COST
06042726202100000,2019,1367,0,1367,COST
06042726254010000,2021,247157,2075770,2322927,COST
06042726254010000,2020,205163,1727490,1932653,COST
06042726254010000,2019,205163,1601400,1806563,COST
06042726260010000,2021,246852,2492590,2739442,COST
06042726260010000,2020,204879,2103980,2308859,COST
06042726260010000,2019,204879,2103980,2308859,COST
06042726266010000,2021,7626,0,7626,COST
06042726266010000,2020,4092,0,4092,COST
06042726266010000,2019,4092,0,4092,COST
06042726301010000,2021,525159,4567490,5092649,COST
06042726301010000,2020,480795,3243370,3724165,COST
06042726301010000,2019,480795,3243370,3724165,COST
06042726302010000,2021,44613,0,44613,COST
06042726302010000,2020,36656,0,36656,COST
06042726302010000,2019,36656,0,36656,COST
06042726348010000,2021,256878,64450,321328,COST
06042726348010000,2020,209942,44610,254552,COST
06042726348010000,2019,209942,44610,254552,COST
06042726360070000,2021,246983,4137550,4384533,COST
06042726360070000,2020,205001,3599640,3804641,COST
06042726360070000,2019,205001,3599640,3804641,COST
06042726372010000,2021,7626,0,7626,COST
06042726372010000,2020,4092,0,4092,COST
06042726372010000,2019,4092,0,4092,COST
06042726401010000,2021,695,0,695,COST
06042726401010000,2020,647,0,647,COST
06042726401010000,2019,647,0,647,COST
06042726401100000,2021,536698,2012760,2549458,COST
06042726401100000,2020,500172,1686950,2187122,COST
06042726401100000,2019,500172,856760,1356932,COST
06042726401200000,2021,536698,0,536698,COST
06042726401200000,2020,500172,0,500172,COST
06042726401200000,2019,500172,0,500172,COST
06042726401500000,2021,470863,3580010,4050873,COST
06042726401500000,2020,430340,3046620,3476960,OVR
06042726401500000,2019,430340,3046620,3476960,COST
06042726401550000,2021,489830,15470,505300,COST
06042726401550000,2020,450317,12790,463107,COST
06042726401550000,2019,450317,12790,463107,COST
06042726401580000,2021,466955,0,466955,COST
06042726401580000,2020,426239,0,426239,COST
06042726401580000,2019,426239,0,426239,COST
06042726401600000,2021,472501,4522970,4995471,COST
06042726401600000,2020,432061,3421530,3853591,COST
06042726401600000,2019,432061,3421530,3853591,COST
06042726401700000,2021,500198,2092760,2592958,COST
06042726401700000,2020,461287,1750730,2212017,COST
06042726401700000,2019,461287,1750730,2212017,COST
06042726401900000,2021,529197,1848640,2377837,COST
06042726401900000,2020,492147,1685340,2177487,COST
06042726401900000,2019,492147,1685340,2177487,COST
06042726472010000,2021,4657,0,4657,COST
06042726472010000,2020,2711,0,2711,COST
06042726472010000,2019,2711,0,2711,COST
06042727101010000,2021,246852,6688830,6935682,COST
06042727101010000,2020,204879,5582910,5787789,COST
06042727101010000,2019,204879,5582910,5787789,COST
06042727101120000,2021,142,0,142,COST
06042727101120000,2020,132,0,132,COST
06042727101120000,2019,132,0,132,COST
06042727101160000,2021,254015,2555020,2809035,COST
06042727101160000,2020,208428,2144940,2353368,COST
06042727101160000,2019,208428,2144940,2353368,COST
06042727136010000,2021,9516,0,9516,COST
06042727136010000,2020,5167,0,5167,COST
06042727136010000,2019,5167,0,5167,COST
06042727136220000,2021,254681,1362560,1617241,COST
06042727136220000,2020,208682,919070,1127752,COST
06042727136220000,2019,208682,919070,1127752,COST
06042727136340000,2021,253560,2371440,2625000,COST
06042727136340000,2020,208072,1714620,1922692,COST
06042727136340000,2019,208072,1714620,1922692,COST
06042727166050000,2021,1108,0,1108,COST
06042727166050000,2020,1031,0,1031,COST
06042727166050000,2019,1031,0,1031,COST
06042727201010000,2021,72163,0,72163,COST
06042727201010000,2020,38937,0,38937,COST
06042727201010000,2019,40403,0,40403,COST
06042727201100000,2021,72356,0,72356,COST
06042727201100000,2020,38916,0,38916,COST
06042727201100000,2019,38916,0,38916,COST
06042727301010000,2021,430339,985460,1415799,COST
06042727301010000,2020,388063,738960,1127023,COST
06042727301010000,2019,388063,738960,1127023,COST
06042727302010000,2021,439897,0,439897,COST
06042727302010000,2020,397983,0,397983,COST
06042727338440000,2021,245800,697260,943060,COST
06042727338440000,2020,203900,581850,785750,COST
06042727338440000,2019,203900,581850,785750,COST
06042727338470000,2021,245800,319930,565730,COST
06042727338470000,2020,203900,312700,516600,MKT
06042727338470000,2019,203900,312700,516600,MKT
06042727406010000,2021,492746,2342420,2835166,COST
06042727406010000,2020,408866,1964710,2373576,COST
06042727406010000,2019,205018,1291110,1496128,COST
06042727412010000,2021,255415,3916690,4172105,COST
06042727412010000,2020,209188,3382370,3591558,COST
06042727412010000,2019,209188,3382370,3591558,COST
06042727412170000,2021,9527,9140,18667,COST
06042727412170000,2020,5203,11180,16383,COST
06042727412170000,2019,5203,11180,16383,COST
06042727412310000,2021,247327,1914630,2161957,COST
06042727412310000,2020,205325,1432290,1637615,COST
06042727412310000,2019,205325,1432290,1637615,COST
06042728110010000,2021,253045,1377630,1630675,COST
06042728110010000,2020,207787,961530,1169317,COST
06042728110010000,2019,207787,961530,1169317,COST
06042728120010000,2021,6902,0,6902,COST
06042728120010000,2020,3751,0,3751,COST
06042728120010000,2019,3751,0,3751,COST
06042728130010000,2021,253647,2610510,2864157,COST
06042728130010000,2020,208110,2288290,2496400,COST
06042728130010000,2019,208110,2288290,2496400,COST
06042728140010000,2021,7623,0,7623,COST
06042728140010000,2020,4090,0,4090,COST
06042728140010000,2019,4090,0,4090,COST
06042728150010000,2021,253078,1113890,1366968,COST
06042728150010000,2020,207805,1020180,1227985,COST
06042728150010000,2019,207805,1020180,1227985,COST
06042728160010000,2021,253070,2240530,2493600,COST
06042728160010000,2020,207801,2184940,2392741,COST
06042728160010000,2019,207801,2184940,2392741,COST
06042728170010000,2021,7623,0,7623,COST
06042728170010000,2020,4090,0,4090,COST
06042728170010000,2019,4090,0,4090,COST
06042728180010000,2021,253463,3263450,3516913,COST
06042728180010000,2020,208017,1324960,1532977,COST
06042728180010000,2019,4318,0,4318,COST
06042728245010000,2021,460553,0,460553,COST
06042728245010000,2020,419531,0,419531,COST
06042728245010000,2019,419531,0,419531,COST
06042728245120000,2021,519330,0,519330,COST
06042728245120000,2020,481618,0,481618,COST
06042728245120000,2019,481618,0,481618,COST
06042728245220000,2021,424854,0,424854,COST
06042728245220000,2020,382384,0,382384,COST
06042728245220000,2019,382384,0,382384,COST
06042728245300000,2021,406721,0,406721,COST
06042728245300000,2020,426805,0,426805,COST
06042728245300000,2019,1642,0,1642,COST
06042728249010000,2021,277412,0,277412,COST
06042728249010000,2020,234311,0,234311,COST
06042728249010000,2019,234311,0,234311,COST
06042728250010000,2021,500691,1404050,1904741,COST
06042728250010000,2020,207800,1147090,1354890,COST
06042728250010000,2019,207800,1147090,1354890,COST
06042728250100000,2021,500891,0,500891,COST
06042728250250000,2021,435672,0,435672,COST
06042728250250000,2020,1307,0,1307,COST
06042728250250000,2019,1307,0,1307,COST
06042728250330000,2021,433981,0,433981,COST
06042728250330000,2020,391839,0,391839,COST
06042728250330000,2019,391839,0,391839,COST
06042728280010000,2021,507833,1456340,1964173,COST
06042728280010000,2020,469387,1312120,1781507,OVR
06042728280010000,2019,469387,1312120,1781507,COST
06042728280100000,2021,434405,1155060,1589465,COST
06042728280100000,2020,392279,971290,1363569,COST
06042728280100000,2019,392279,197930,590209,COST
06042728310010000,2021,1959873,2850,1962723,COST
06042728310010000,2020,1159178,2750,1161928,COST
06042728310010000,2019,1159178,2750,1161928,COST
06042728360017000,2021,743175,966620,1709795,COST
06042728360017000,2020,470652,863000,1333652,COST
06042728360017000,2019,470652,93340,563992,COST
06042728401350100,2021,330098,0,330098,COST
06042728401350100,2020,286132,0,286132,COST
06042728401350100,2019,286132,0,286132,COST
06042733101010000,2021,527887,0,527887,COST
06042733101010000,2020,302953,0,302953,COST
06042733101010000,2019,1347231,0,1347231,COST
06042733301010000,2021,167925,2039575,2207500,MKT
06042733301010000,2020,245039,1115400,1360439,COST
06042733301010000,2019,245039,157030,402069,COST
06042733301030000,2021,176422,2408878,2585300,MKT
06042733301030000,2020,256621,2118979,2375600,MKT
06042733301030000,2019,256621,487950,744571,COST
06042733301050000,2021,170823,2384477,2555300,MKT
06042733301050000,2020,248993,2130907,2379900,MKT
06042733301050000,2019,248993,2130907,2379900,MKT
06042733301070000,2021,170823,2669077,2839900,MKT
06042733301070000,2020,248993,2246507,2495500,MKT
06042733301070000,2019,248993,543040,792033,COST
06042733301090000,2021,170823,2669077,2839900,MKT
06042733301090000,2020,248993,2246507,2495500,MKT
06042733301090000,2019,248993,178060,427053,COST
06042733301110000,2021,170823,2655877,2826700,MKT
06042733301110000,2020,248993,2234207,2483200,MKT
06042733301110000,2019,248993,2234207,2483200,MKT
06042733301130000,2021,186938,2389862,2576800,MKT
06042733301130000,2020,270905,2082095,2353000,MKT
06042733301130000,2019,270905,2082095,2353000,MKT
06042733301150000,2021,218540,2402360,2620900,MKT
06042733301150000,2020,313530,2067370,2380900,MKT
06042733301150000,2019,313530,2067370,2380900,MKT
06042733301170000,2021,199029,2805171,3004200,MKT
06042733301170000,2020,287264,2232336,2519600,MKT
06042733301170000,2019,287264,2232336,2519600,MKT
06042733301190000,2021,184387,2813813,2998200,MKT
06042733301190000,2020,267445,2212755,2480200,MKT
06042733301190000,2019,267445,2212755,2480200,MKT
06042733301210000,2021,122,0,122,COST
06042733301210000,2020,66,0,66,COST
06042733301210000,2019,66,0,66,COST
06042733301230000,2021,179132,2656868,2836000,MKT
06042733301230000,2020,260307,2224093,2484400,MKT
06042733301230000,2019,260307,2224093,2484400,MKT
06042733301250000,2021,173654,2656146,2829800,MKT
06042733301250000,2020,252852,2224248,2477100,MKT
06042733301250000,2019,252852,2224248,2477100,MKT
06042733301270000,2021,179132,2670168,2849300,MKT
06042733301270000,2020,260307,2230093,2490400,MKT
06042733301270000,2019,260307,2230093,2490400,MKT
06042733301296500,2021,357689,0,357689,COST
06042733301296500,2020,870489,0,870489,COST
06042733301296500,2019,870489,0,870489,COST
06042733301310000,2021,181786,1902014,2083800,MKT
06042733301310000,2020,263913,1819687,2083600,MKT
06042733301310000,2019,263913,1819687,2083600,MKT
06042733301330000,2021,189442,2411958,2601400,MKT
06042733301330000,2020,274299,2091901,2366200,MKT
06042733301330000,2019,274299,160020,434319,COST
06042733301350000,2021,176422,1907378,2083800,MKT
06042733301350000,2020,256621,1115940,1372561,COST
06042733301350000,2019,66,0,66,COST
06042733301370000,2021,176422,2735378,2911800,MKT
06042733301370000,2020,256621,1414480,1671101,COST
06042733301370000,2019,256621,1218710,1475331,COST
06042733302010000,2021,113,0,113,COST
06042733302010000,2020,61,0,61,COST
06042733302010000,2019,61,0,61,COST
06042733302030000,2021,117,0,117,COST
06042733302030000,2020,63,0,63,COST
06042733302030000,2019,63,0,63,COST
06042733302050000,2021,122,0,122,COST
06042733302050000,2020,66,0,66,COST
06042733302050000,2019,66,0,66,COST
06042733302070000,2021,186938,2251762,2438700,MKT
06042733302070000,2020,270905,1977495,2248400,MKT
06042733302070000,2019,270905,1977495,2248400,MKT
06042733302090000,2021,179132,2249768,2428900,MKT
06042733302090000,2020,260307,1970593,2230900,MKT
06042733302090000,2019,260307,1970593,2230900,MKT
06042733302110000,2021,179132,2249768,2428900,MKT
06042733302110000,2020,260307,1977893,2238200,MKT
06042733302110000,2019,260307,1977893,2238200,MKT
06042733302130000,2021,179132,2250968,2430100,MKT
06042733302130000,2020,260307,1979293,2239600,MKT
06042733302130000,2019,260307,1979293,2239600,MKT
06042733302150000,2021,176422,2259178,2435600,MKT
06042733302150000,2020,256621,1982379,2239000,MKT
06042733302150000,2019,256621,1982379,2239000,MKT
06042733302170000,2021,170823,1901877,2072700,MKT
06042733302170000,2020,248993,1115400,1364393,COST
06042733302170000,2019,248993,218630,467623,COST
06042733302190000,2021,108,0,108,COST
06042733302190000,2020,58,0,58,COST
06042733302190000,2019,58,0,58,COST
06042733303030000,2021,186938,3650462,3837400,MKT
06042733303030000,2020,270905,2347295,2618200,OVR
06042733303030000,2019,270905,2347295,2618200,MKT
06042733303050000,2021,184387,3638813,3823200,MKT
06042733303050000,2020,267445,1695160,1962605,COST
06042733303050000,2019,267445,1241540,1508985,COST
06042733303070000,2021,189442,3639158,3828600,MKT
06042733303070000,2020,274299,1696000,1970299,COST
06042733303070000,2019,274299,240700,514999,COST
06042733304010000,2021,153,0,153,COST
06042733304010000,2020,56,0,56,COST
06042733304010000,2019,56,0,56,COST
06042733304030000,2021,173654,789720,963374,COST
06042733304030000,2020,252852,0,252852,COST
06042733304030000,2019,63,0,63,COST
06042733304050000,2021,167925,1554650,1722575,COST
06042733304050000,2020,245039,0,245039,COST
06042733304050000,2019,58,0,58,COST
06042733304070000,2021,108,0,108,COST
06042733304070000,2020,58,0,58,COST
06042733304070000,2019,58,0,58,COST
06042733304090000,2021,167,0,167,COST
06042733304090000,2020,61,0,61,COST
06042733304090000,2019,61,0,61,COST
06042733401010000,2021,170823,2710077,2880900,MKT
06042733401010000,2020,248993,2329107,2578100,MKT
06042733401010000,2019,248993,0,248993,COST
06042733401030000,2021,179132,2721868,2901000,MKT
06042733401030000,2020,260307,1980570,2240877,COST
06042733401030000,2019,260307,0,260307,COST
06042733401050000,2021,176422,2660078,2836500,MKT
06042733401050000,2020,256621,0,256621,COST
06042733401050000,2019,66,0,66,COST
06042733401070000,2021,176422,2695578,2872000,MKT
06042733401070000,2020,256621,0,256621,COST
06042733401070000,2019,66,0,66,COST
06042733401090000,2021,181786,951370,1133156,COST
06042733401090000,2020,263913,0,263913,COST
06042733401090000,2019,70,0,70,COST
06042733401110000,2021,179132,2751568,2930700,MKT
06042733401110000,2020,260307,0,260307,COST
06042733401110000,2019,68,0,68,COST
06042733401130000,2021,179132,0,179132,COST
06042733401130000,2020,68,0,68,COST
06042733401130000,2019,68,0,68,COST
06042733401150000,2021,122,0,122,COST
06042733401150000,2020,66,0,66,COST
06042733401150000,2019,66,0,66,COST
06042733401170000,2021,122,0,122,COST
06042733401170000,2020,66,0,66,COST
06042733401170000,2019,66,0,66,COST
06042733401190000,2021,126,0,126,COST
06042733401190000,2020,68,0,68,COST
06042733401190000,2019,68,0,68,COST
06042733401250000,2021,9034,0,9034,COST
06042733401250000,2020,4862,0,4862,COST
06042733401300000,2021,1611647,0,1611647,COST
06042733401300000,2020,2710,0,2710,COST
06042733401350000,2021,1542417,0,1542417,COST
06042733401350000,2020,2441,0,2441,COST
06042733401406500,2021,834034,0,834034,COST
06042733401406500,2020,551552,0,551552,COST
06042733402010000,2021,122,0,122,COST
06042733402010000,2020,66,0,66,COST
06042733402010000,2019,66,0,66,COST
06042733402030000,2021,117,0,117,COST
06042733402030000,2020,63,0,63,COST
06042733402030000,2019,63,0,63,COST
06042733402050000,2021,170823,1748320,1919143,COST
06042733402050000,2020,61,0,61,COST
06042733402050000,2019,61,0,61,COST
06042733402070000,2021,164956,0,164956,COST
06042733402070000,2020,56,0,56,COST
06042733402070000,2019,56,0,56,COST
06042733402090000,2021,164956,2172444,2337400,MKT
06042733402090000,2020,240984,789740,1030724,COST
06042733402090000,2019,240984,0,240984,COST
06042733402110000,2021,164956,2176744,2341700,MKT
06042733402110000,2020,240984,402760,643744,COST
06042733402110000,2019,56,0,56,COST
06042733402130000,2021,164956,3157330,3322286,COST
06042733402130000,2020,240984,1256180,1497164,COST
06042733402130000,2019,240984,0,240984,COST
06042733402150000,2021,161912,3157330,3319242,COST
06042733402150000,2020,236820,867660,1104480,COST
06042733402150000,2019,53,0,53,COST
06042733402170000,2021,176422,0,176422,COST
06042733402170000,2020,61,0,61,COST
06042733402170000,2019,61,0,61,COST
06042733402190000,2021,104,0,104,COST
06042733402190000,2020,56,0,56,COST
06042733402190000,2019,56,0,56,COST
06042733402210000,2021,108,0,108,COST
06042733402210000,2020,58,0,58,COST
06042733402210000,2019,58,0,58,COST
06042733402230000,2021,117,0,117,COST
06042733402230000,2020,63,0,63,COST
06042733402230000,2019,63,0,63,COST
06042733402250000,2021,149,0,149,COST
06042733402250000,2020,80,0,80,COST
06042733402250000,2019,80,0,80,COST
06042733402270000,2021,239,0,239,COST
06042733402270000,2020,66,0,66,COST
06042733402270000,2019,66,0,66,COST
06042734102010000,2021,163620,1604210,1767830,COST
06042734102010000,2020,125922,1367320,1493242,COST
06042734102010000,2019,125922,1367320,1493242,COST
06042734102030000,2021,159920,0,159920,COST
06042734102030000,2020,122656,0,122656,COST
06042734102030000,2019,122656,0,122656,COST
06042734102050000,2021,158644,0,158644,COST
06042734102050000,2020,121531,0,121531,COST
06042734102050000,2019,121531,0,121531,COST
06042734102070000,2021,168278,0,168278,COST
06042734102070000,2020,130050,0,130050,COST
06042734102070000,2019,130050,0,130050,COST
06042734102090000,2021,163620,1446980,1610600,MKT
06042734102090000,2020,125922,1106430,1232352,COST
06042734102090000,2019,125922,1106430,1232352,COST
06042734102110000,2021,148983,0,148983,COST
06042734102110000,2020,113066,0,113066,COST
06042734102110000,2019,113066,0,113066,COST
06042734103010000,2021,218220,619620,837840,COST
06042734103010000,2020,177838,635462,813300,MKT
06042734103010000,2019,177838,635462,813300,MKT
06042734103030000,2021,216219,1423520,1639739,COST
06042734103030000,2020,175965,1205970,1381935,OVR
06042734103030000,2019,175965,1205970,1381935,COST
06042734103050000,2021,195981,0,195981,COST
06042734103050000,2020,157176,0,157176,COST
06042734103050000,2019,157176,0,157176,COST
06042734103070000,2021,224919,853781,1078700,MKT
06042734103070000,2020,184126,629574,813700,MKT
06042734103070000,2019,184126,629574,813700,MKT
06042734103090000,2021,213137,1030763,1243900,MKT
06042734103090000,2020,173087,726413,899500,MKT
06042734103090000,2019,173087,726413,899500,MKT
06042734103110000,2021,214175,786325,1000500,MKT
06042734103110000,2020,174056,701644,875700,MKT
06042734103110000,2019,174056,701644,875700,MKT
06042734103130000,2021,253845,557330,811175,COST
06042734103130000,2020,211587,565713,777300,MKT
06042734103130000,2019,211587,565713,777300,MKT
06042734103150000,2021,249968,0,249968,COST
06042734103150000,2020,207878,0,207878,COST
06042734103150000,2019,170118,0,170118,COST
06042734103190000,2021,198465,1192270,1390735,COST
06042734103190000,2020,159467,1055533,1215000,MKT
06042734103190000,2019,159467,0,159467,COST
06042734103210000,2021,185258,918780,1104038,COST
06042734103210000,2020,147336,877264,1024600,MKT
06042734103210000,2019,147336,877264,1024600,MKT
06042734103230000,2021,193423,0,193423,COST
06042734103230000,2020,154821,0,154821,COST
06042734103230000,2019,154821,0,154821,COST
06042734103250000,2021,208866,1337734,1546600,MKT
06042734103250000,2020,169107,1135593,1304700,MKT
06042734103250000,2019,169107,144720,313827,COST
06042734103270000,2021,194711,952520,1147231,COST
06042734103270000,2020,156007,0,156007,COST
06042734103270000,2019,156007,0,156007,COST
06042734103290000,2021,180854,0,180854,COST
06042734103290000,2020,143318,0,143318,COST
06042734103290000,2019,143318,0,143318,COST
06042734103310000,2021,186675,903100,1089775,COST
06042734103310000,2020,148631,824169,972800,MKT
06042734103310000,2019,148631,824169,972800,MKT
06042734103330000,2021,207767,2390880,2598647,COST
06042734103330000,2020,168085,2077810,2245895,COST
06042734103330000,2019,168085,2077810,2245895,COST
06042734103350000,2021,202066,0,202066,COST
06042734103350000,2020,162797,0,162797,COST
06042734103350000,2019,162797,0,162797,COST
06042734103370000,2021,177779,0,177779,COST
06042734103370000,2020,140522,0,140522,COST
06042734103370000,2019,140522,0,140522,COST
06042734103390000,2021,192116,1427300,1619416,COST
06042734103390000,2020,153620,1220660,1374280,COST
06042734103390000,2019,153620,1220660,1374280,COST
06042734104016500,2021,77243,0,77243,COST
06042734104016500,2020,41821,0,41821,COST
06042734104016500,2019,41821,0,41821,COST
06042734104030000,2021,284279,2020560,2304839,COST
06042734104030000,2020,218409,2102980,2321389,COST
06042734104030000,2019,218409,2102980,2321389,COST
06042734104050000,2021,276581,857510,1134091,COST
06042734104050000,2020,211628,614270,825898,COST
06042734104050000,2019,211628,614270,825898,COST
06042734104070000,2021,266229,0,266229,COST
06042734104070000,2020,202552,0,202552,COST
06042734104070000,2019,202552,0,202552,COST
06042734104090000,2021,289759,1691450,1981209,COST
06042734104090000,2020,223254,1626850,1850104,OVR
06042734104090000,2019,223254,1626850,1850104,COST
06042734104110000,2021,257246,0,257246,COST
06042734104110000,2020,194719,0,194719,COST
06042734104110000,2019,194719,0,194719,COST
06042734104130000,2021,282398,0,282398,COST
06042734104130000,2020,216750,0,216750,COST
06042734104130000,2019,216750,0,216750,COST
06042734104150000,2021,282398,1114930,1397328,COST
06042734104150000,2020,216750,1030050,1246800,MKT
06042734104150000,2019,216750,1030050,1246800,MKT
06042734104170000,2021,321464,1568240,1889704,COST
06042734104170000,2020,251546,1324560,1576106,COST
06042734104170000,2019,251546,1324560,1576106,COST
06042734104210000,2021,328381,0,328381,COST
06042734104210000,2020,257776,0,257776,COST
06042734104210000,2019,257776,0,257776,COST
06042734104230000,2021,317148,1120360,1437508,COST
06042734104230000,2020,247669,937570,1185239,COST
06042734104230000,2019,247669,937570,1185239,COST
06042734105010000,2021,272546,0,272546,COST
06042734105010000,2020,208084,0,208084,COST
06042734105010000,2019,208084,0,208084,COST
06042734105030000,2021,259558,0,259558,COST
06042734105030000,2020,196731,0,196731,COST
06042734105030000,2019,196731,0,196731,COST
06042734105050000,2021,254887,525160,780047,COST
06042734105050000,2020,192668,0,192668,COST
06042734105050000,2019,192668,0,192668,COST
06042734105070000,2021,286132,666268,952400,MKT
06042734105070000,2020,220046,299550,519596,COST
06042734105070000,2019,220046,0,220046,COST
06042734105090000,2021,276581,0,276581,COST
06042734105090000,2020,211628,0,211628,COST
06042734105090000,2019,211628,0,211628,COST
06042734105110000,2021,268372,0,268372,COST
06042734105110000,2020,204426,0,204426,COST
06042734105110000,2019,204426,0,204426,COST
06042734105130000,2021,295016,0,295016,COST
06042734105130000,2020,227915,0,227915,COST
06042734105130000,2019,227915,0,227915,COST
06042734105150000,2021,266229,0,266229,COST
06042734105150000,2020,144680,0,144680,COST
06042734105150000,2019,144680,0,144680,COST
06042734105170000,2021,259558,0,259558,COST
06042734105170000,2020,140522,0,140522,COST
06042734105170000,2019,140522,0,140522,COST
06042734105190000,2021,264047,1486900,1750947,COST
06042734105190000,2020,143318,1309850,1453168,COST
06042734105190000,2019,143318,1309850,1453168,COST
06042734105210000,2021,280489,0,280489,COST
06042734105210000,2020,153620,0,153620,COST
06042734105210000,2019,153620,0,153620,COST
06042734105230000,2021,272546,0,272546,COST
06042734105230000,2020,148631,0,148631,COST
06042734105230000,2019,148631,0,148631,COST
06042734105250000,2021,295016,979900,1274916,COST
06042734105250000,2020,162797,1070203,1233000,MKT
06042734105250000,2019,162797,1070203,1233000,MKT
06042734105290000,2021,185258,0,185258,COST
06042734105290000,2020,147336,0,147336,COST
06042734105290000,2019,147336,0,147336,COST
06042734105310000,2021,190788,946012,1136800,MKT
06042734105310000,2020,152400,750900,903300,COST
06042734105310000,2019,152400,750900,903300,COST
06042734105336500,2021,164396,0,164396,COST
06042734105336500,2020,153855,0,153855,COST
06042734105336500,2019,153855,0,153855,COST
06042734106010000,2021,185258,0,185258,COST
06042734106010000,2020,147336,0,147336,COST
06042734106010000,2019,147336,0,147336,COST
06042734106030000,2021,205529,1063240,1268769,COST
06042734106030000,2020,166006,1001894,1167900,MKT
06042734106030000,2019,166006,1001894,1167900,MKT
06042734106050000,2021,199682,0,199682,COST
06042734106050000,2020,160591,0,160591,COST
06042734106050000,2019,160591,0,160591,COST
06042734106070000,2021,199682,950118,1149800,MKT
06042734106070000,2020,160591,865609,1026200,MKT
06042734106070000,2019,160591,865609,1026200,MKT
06042734106110000,2021,202066,0,202066,COST
06042734106110000,2020,162797,0,162797,COST
06042734106110000,2019,162797,0,162797,COST
06042734106130000,2021,208866,0,208866,COST
06042734106130000,2020,169107,0,169107,COST
06042734106130000,2019,169107,0,169107,COST
06042734106150000,2021,180854,0,180854,COST
06042734106150000,2020,143318,0,143318,COST
06042734106150000,2019,143318,0,143318,COST
06042734106170000,2021,192116,0,192116,COST
06042734106170000,2020,153620,0,153620,COST
06042734106170000,2019,153620,0,153620,COST
06042734107010000,2021,168278,829222,997500,MKT
06042734107010000,2020,130050,742650,872700,MKT
06042734107010000,2019,130050,742650,872700,MKT
06042734107030000,2021,167141,0,167141,COST
06042734107030000,2020,129040,0,129040,COST
06042734107030000,2019,129040,0,129040,COST
06042734107050000,2021,180757,834616,1015373,OVR
06042734107050000,2020,141191,676409,817600,MKT
06042734107050000,2019,141191,676409,817600,MKT
06042734107070000,2021,180757,0,180757,COST
06042734107070000,2020,141191,0,141191,COST
06042734107070000,2019,141191,0,141191,COST
06042734107090000,2021,168278,0,168278,COST
06042734107090000,2020,130050,0,130050,COST
06042734107090000,2019,130050,0,130050,COST
06042734107110000,2021,169399,0,169399,COST
06042734107110000,2020,131046,0,131046,COST
06042734107110000,2019,131046,0,131046,COST
06042734150050000,2021,274,0,274,COST
06042734150050000,2020,254,0,254,COST
06042734150050000,2019,254,0,254,COST
06042734150180000,2021,494271,739260,1233531,COST
06042734150180000,2020,380113,500440,880553,COST
06042734150180000,2019,380113,500440,880553,COST
06042734150200000,2021,513865,1224660,1738525,COST
06042734150200000,2020,397478,1033644,1431122,OVR
06042734150200000,2019,397478,1033644,1431122,MRA
06042734150230000,2021,577244,707010,1284254,COST
06042734150230000,2020,454310,589540,1043850,COST
06042734150230000,2019,454310,589540,1043850,COST
06042734150246500,2021,287114,0,287114,COST
06042734150246500,2020,243928,0,243928,COST
06042734150246500,2019,243928,0,243928,COST
06042734150260000,2021,577244,1005830,1583074,COST
06042734150260000,2020,454310,628080,1082390,COST
06042734150260000,2019,454310,628080,1082390,COST
06042734150280000,2021,576101,628570,1204671,COST
06042734150280000,2020,453277,417723,871000,OVR
06042734150280000,2019,453277,417723,871000,OVR
06042734201010000,2021,9131,0,9131,COST
06042734201010000,2020,4915,0,4915,COST
06042734201010000,2019,4915,0,4915,COST
06042734201120000,2021,9025,0,9025,COST
06042734201120000,2020,4858,0,4858,COST
06042734201120000,2019,4858,0,4858,COST
06042734201250000,2021,9395,0,9395,COST
06042734201250000,2020,5061,0,5061,COST
06042734201250000,2019,5061,0,5061,COST
06042734201370000,2021,7477,0,7477,COST
06042734201370000,2020,4056,0,4056,COST
06042734201370000,2019,4056,0,4056,COST
06042734301010000,2021,1544987,0,1544987,COST
06042734301010000,2020,2451,0,2451,COST
06042734301010000,2019,3195,0,3195,COST
06042734301250000,2021,5486,0,5486,COST
06042734301250000,2020,2960,0,2960,COST
06042734301250000,2019,2960,0,2960,COST
06042734301320000,2021,5528,0,5528,COST
06042734301320000,2020,2982,0,2982,COST
06042734301320000,2019,2982,0,2982,COST
06042734301380000,2021,1728027,0,1728027,COST
06042734301380000,2020,1178180,0,1178180,COST
06042734301380000,2019,1178180,0,1178180,COST
06042734301440000,2021,12801,0,12801,COST
06042734301440000,2020,6901,0,6901,COST
06042734301440000,2019,6901,0,6901,COST
06042734301486500,2021,361288,0,361288,COST
06042734301486500,2020,252153,0,252153,COST
06042734301486500,2019,252153,0,252153,COST
06042734301500000,2021,308542,0,308542,COST
06042734301500000,2020,264769,0,264769,COST
06042734301500000,2019,264769,0,264769,COST
06042734301530000,2021,343647,0,343647,COST
06042734301530000,2020,299669,0,299669,COST
06042734301530000,2019,299669,0,299669,COST
06042734301536500,2021,144543,0,144543,COST
06042734301536500,2020,132704,0,132704,COST
06042734301536500,2019,132704,0,132704,COST
06042734301550000,2021,294736,1179430,1474166,COST
06042734301550000,2020,251202,512550,763752,COST
06042734301550000,2019,251202,0,251202,COST
06042734301570000,2021,321671,1291650,1613321,COST
06042734301570000,2020,277755,1084920,1362675,COST
06042734301570000,2019,277755,1084920,1362675,COST
06042734301590000,2021,298323,944820,1243143,COST
06042734301590000,2020,254718,0,254718,COST
06042734301590000,2019,254718,0,254718,COST
06042734301750000,2021,14670,0,14670,COST
06042734301750000,2020,7896,0,7896,COST
06042734301750000,2019,8314,0,8314,COST
06042734340120000,2021,9025,0,9025,COST
06042734340120000,2020,4858,0,4858,COST
06042734340120000,2019,4858,0,4858,COST
06042734340240000,2021,12985,0,12985,COST
06042734340240000,2020,6988,0,6988,COST
06042734340240000,2019,6988,0,6988,COST
06042734442010000,2021,320126,0,320126,COST
06042734442010000,2020,276223,0,276223,COST
06042734442010000,2019,276223,0,276223,COST
06042734442040000,2021,387028,1016890,1403918,COST
06042734442040000,2020,343532,855920,1199452,COST
06042734442040000,2019,343532,855920,1199452,COST
06042734442070000,2021,389777,949880,1339657,COST
06042734442070000,2020,346337,807870,1154207,COST
06042734442070000,2019,346337,807870,1154207,COST
06042734442110000,2021,394281,1139810,1534091,COST
06042734442110000,2020,350940,687150,1038090,COST
06042734442110000,2019,350940,687150,1038090,COST
06042734442130000,2021,1139,0,1139,COST
06042734442130000,2020,1060,0,1060,COST
06042734442130000,2019,1060,0,1060,COST
06042734442510000,2021,452964,764050,1217014,COST
06042734442510000,2020,370437,643790,1014227,COST
06042734442510000,2019,370437,643790,1014227,COST
06042734460010000,2021,231111,959789,1190900,MKT
06042734460010000,2020,170966,837934,1008900,MKT
06042734460010000,2019,170966,837934,1008900,MKT
06042734460030000,2021,221626,1192574,1414200,MKT
06042734460030000,2020,162928,1065240,1228168,COST
06042734460030000,2019,162928,1065240,1228168,COST
06042734460050000,2021,210275,0,210275,COST
06042734460050000,2020,153377,0,153377,COST
06042734460050000,2019,153377,0,153377,COST
06042734460070000,2021,211132,857020,1068152,COST
06042734460070000,2020,154095,749970,904065,COST
06042734460070000,2019,154095,749970,904065,COST
06042734460110000,2021,274603,1295500,1570103,COST
06042734460110000,2020,208429,1093540,1301969,COST
06042734460110000,2019,208429,1093540,1301969,COST
06042734460130000,2021,242097,1310703,1552800,MKT
06042734460130000,2020,180337,1009290,1189627,COST
06042734460130000,2019,180337,0,180337,COST
06042734460150000,2021,240037,1089863,1329900,MKT
06042734460150000,2020,178575,1042540,1221115,OVR
06042734460150000,2019,178575,1042540,1221115,COST
06042734460170000,2021,212508,832992,1045500,MKT
06042734460170000,2020,155250,752150,907400,MKT
06042734460170000,2019,155250,752150,907400,MKT
06042734460190000,2021,212823,832677,1045500,MKT
06042734460190000,2020,155514,772786,928300,MKT
06042734460190000,2019,155514,772786,928300,MKT
06042734460210000,2021,229620,1077480,1307100,MKT
06042734460210000,2020,169699,926701,1096400,MKT
06042734460210000,2019,169699,926701,1096400,MKT
06042734460230000,2021,245039,1280061,1525100,MKT
06042734460230000,2020,182857,1033443,1216300,MKT
06042734460230000,2019,182857,1033443,1216300,MKT
06042734460250000,2021,238992,989308,1228300,MKT
06042734460250000,2020,177682,857218,1034900,OVR
06042734460250000,2019,177682,857218,1034900,MKT
06042734460270000,2021,219303,938497,1157800,MKT
06042734460270000,2020,160968,831632,992600,MKT
06042734460270000,2019,160968,831632,992600,MKT
06042734460290000,2021,225656,0,225656,COST
06042734460290000,2020,166338,0,166338,COST
06042734460290000,2019,166338,0,166338,COST
06042734460310000,2021,268288,1064012,1332300,MKT
06042734460310000,2020,202930,891000,1093930,COST
06042734460310000,2019,202930,891000,1093930,COST
06042734460330000,2021,219499,893901,1113400,MKT
06042734460330000,2020,161133,792167,953300,MKT
06042734460330000,2019,161133,792167,953300,MKT
06042734460370000,2021,286556,968444,1255000,MKT
06042734460370000,2020,218886,866914,1085800,MKT
06042734460370000,2019,218886,866914,1085800,MKT
06042734460390000,2021,230675,1113825,1344500,MKT
06042734460390000,2020,170595,964505,1135100,OVR
06042734460390000,2019,170595,964505,1135100,MKT
06042734460410000,2021,225104,1022096,1247200,MKT
06042734460410000,2020,165870,846430,1012300,MKT
06042734460410000,2019,165870,846430,1012300,MKT
06042734460430000,2021,228465,0,228465,COST
06042734460430000,2020,168719,0,168719,COST
06042734460430000,2019,168719,0,168719,COST
06042734460450000,2021,224734,1277866,1502600,MKT
06042734460450000,2020,165556,983450,1149006,COST
06042734460450000,2019,165556,983450,1149006,COST
06042734460470000,2021,240834,839866,1080700,MKT
06042734460470000,2020,179256,790544,969800,MKT
06042734460470000,2019,179256,790544,969800,MKT
06042734460490000,2021,266149,0,266149,COST
06042734460490000,2020,201072,0,201072,COST
06042734460490000,2019,201072,0,201072,COST
06042734460510000,2021,234200,1044000,1278200,MKT
06042734460510000,2020,173594,904550,1078144,COST
06042734460510000,2019,173594,904550,1078144,COST
06042734460530000,2021,257866,959734,1217600,MKT
06042734460530000,2020,193899,769970,963869,COST
06042734460530000,2019,193899,769970,963869,COST
06042734460570000,2021,208208,1410492,1618700,MKT
06042734460570000,2020,151646,1297780,1449426,COST
06042734460570000,2019,151646,1297780,1449426,COST
06042734460590000,2021,200643,0,200643,COST
06042734460590000,2020,145332,0,145332,COST
06042734460590000,2019,145332,0,145332,COST
06042734460610000,2021,217324,1005176,1222500,MKT
06042734460610000,2020,159300,875510,1034810,COST
06042734460610000,2019,159300,875510,1034810,COST
06042734460630000,2021,222767,1028633,1251400,MKT
06042734460630000,2020,163893,847607,1011500,MKT
06042734460630000,2019,163893,847607,1011500,MKT
06042734460650000,2021,236209,0,236209,COST
06042734460650000,2020,175307,0,175307,COST
06042734460650000,2019,175307,0,175307,COST
06042734460670000,2021,238911,0,238911,COST
06042734460670000,2020,177613,0,177613,COST
06042734460670000,2019,177613,0,177613,COST
06042734460690000,2021,212298,1798440,2010738,COST
06042734460690000,2020,155074,1526400,1681474,COST
06042734460690000,2019,155074,1740590,1895664,COST
06042734460710000,2021,223802,0,223802,COST
06042734460710000,2020,164768,0,164768,COST
06042734460710000,2019,164768,0,164768,COST
06042734460730000,2021,254969,1147631,1402600,MKT
06042734460730000,2020,191397,1173470,1364867,COST
06042734460730000,2019,191397,997850,1189247,COST
06042734460756500,2021,137823,0,137823,COST
06042734460756500,2020,113076,0,113076,COST
06042734460756500,2019,113076,0,113076,COST
06042734460780000,2021,245800,1117000,1362800,MKT
06042734460780000,2020,183510,993390,1176900,MKT
06042734460780000,2019,183510,993390,1176900,MKT
06042734460800000,2021,297732,1220568,1518300,MKT
06042734460800000,2020,228724,1069476,1298200,MKT
06042734460800000,2019,228724,1069476,1298200,MKT
06042734460830000,2021,365470,1834560,2200030,COST
06042734460830000,2020,289473,1578430,1867903,COST
06042734460830000,2019,289473,1578430,1867903,COST
06042734460870000,2021,371171,1303560,1674731,COST
06042734460870000,2020,294667,1181150,1475817,OVR
06042734460870000,2019,294667,1181150,1475817,COST
06042734460910000,2021,249162,1210970,1460132,COST
06042734460910000,2020,186397,1015090,1201487,COST
06042734460910000,2019,186397,1015090,1201487,COST
06042734460930000,2021,257457,0,257457,COST
06042734460930000,2020,193545,0,193545,COST
06042734460930000,2019,193545,0,193545,COST
06042734460950000,2021,225473,1503690,1729163,COST
06042734460950000,2020,166182,1297520,1463702,COST
06042734460950000,2019,166182,1297520,1463702,COST
06042734460970000,2021,229709,0,229709,COST
06042734460970000,2020,169774,0,169774,COST
06042734460970000,2019,169774,0,169774,COST
06042734460990000,2021,264616,0,264616,COST
06042734460990000,2020,199742,0,199742,COST
06042734460990000,2019,199742,0,199742,COST
06042734462010000,2021,277701,1002099,1279800,MKT
06042734462010000,2020,211132,910268,1121400,MKT
06042734462010000,2019,211132,910268,1121400,MKT
06042734462070000,2021,226480,1259120,1485600,MKT
06042734462070000,2020,167035,1069600,1236635,COST
06042734462070000,2019,167035,1069600,1236635,COST
06042734462100000,2021,242645,915855,1158500,MKT
06042734462100000,2020,180806,848694,1029500,MKT
06042734462100000,2019,180806,553720,734526,COST
06042734462130000,2021,235042,0,235042,COST
06042734462130000,2020,174311,0,174311,COST
06042734462130000,2019,174311,0,174311,COST
06042734462160000,2021,217024,1109876,1326900,MKT
06042734462160000,2020,159047,997353,1156400,MKT
06042734462160000,2019,159047,997353,1156400,MKT
06042734462190000,2021,238344,0,238344,COST
06042734462190000,2020,177128,0,177128,COST
06042734462190000,2019,177128,0,177128,COST
06042734462220000,2021,219889,967511,1187400,MKT
06042734462220000,2020,161462,784938,946400,MKT
06042734462220000,2019,161462,784938,946400,MKT
06042734462250000,2021,216823,944900,1161723,COST
06042734462250000,2020,158878,793480,952358,COST
06042734462250000,2019,158878,793480,952358,COST
06042734462280000,2021,224548,1207052,1431600,MKT
06042734462280000,2020,165399,951001,1116400,MKT
06042734462280000,2019,165399,0,165399,COST
06042734462310000,2021,232667,1009433,1242100,MKT
06042734462310000,2020,172289,763670,935959,COST
06042734462310000,2019,172289,0,172289,COST
06042734462330000,2021,256150,0,256150,COST
06042734462330000,2020,192417,0,192417,COST
06042734462330000,2019,192417,0,192417,COST
06042734462360000,2021,228911,845589,1074500,MKT
06042734462360000,2020,169097,707650,876747,COST
06042734462360000,2019,169097,707650,876747,COST
06042734462390000,2021,219205,938695,1157900,MKT
06042734462390000,2020,160885,844415,1005300,MKT
06042734462390000,2019,160885,826515,987400,MKT
06042734462420000,2021,250551,477150,727701,COST
06042734462420000,2020,187592,0,187592,COST
06042734462420000,2019,187592,0,187592,COST
06042734466230000,2021,213241,704559,917800,MKT
06042734466230000,2020,155866,670434,826300,MKT
06042734466230000,2019,155866,670434,826300,MKT
06042734466250000,2021,210060,0,210060,COST
06042734466250000,2020,153196,0,153196,COST
06042734466250000,2019,153196,0,153196,COST
06042734474010000,2021,216723,889277,1106000,MKT
06042734474010000,2020,158793,724580,883373,COST
06042734474010000,2019,158793,724580,883373,COST
06042734474030000,2021,227928,544780,772708,COST
06042734474030000,2020,168263,564437,732700,MKT
06042734474030000,2019,168263,564437,732700,MKT
06042734474050000,2021,225473,1164927,1390400,MKT
06042734474050000,2020,166182,0,166182,COST
06042734474050000,2019,166182,0,166182,COST
06042734474070000,2021,223051,0,223051,COST
06042734474070000,2020,164132,0,164132,COST
06042734474070000,2019,164132,0,164132,COST
06042734474090000,2021,214484,1110416,1324900,MKT
06042734474090000,2020,156910,597200,754110,COST
06042734474090000,2019,156910,112980,269890,COST
06042734474110000,2021,214484,1014780,1229264,COST
06042734474110000,2020,156910,708390,865300,MKT
06042734474110000,2019,156910,708390,865300,MKT
06042734474130000,2021,220375,0,220375,COST
06042734474130000,2020,161872,0,161872,COST
06042734474130000,2019,161872,0,161872,COST
06042734474150000,2021,223802,448620,672422,COST
06042734474150000,2020,164768,464332,629100,MKT
06042734474150000,2019,164768,464332,629100,MKT
06042734474170000,2021,247157,995743,1242900,MKT
06042734474170000,2020,184675,881625,1066300,MKT
06042734474170000,2019,184675,881625,1066300,MKT
06042734474190000,2021,244118,1495490,1739608,COST
06042734474190000,2020,182068,1278100,1460168,COST
06042734474190000,2019,182068,1278100,1460168,COST
06042734474210000,2021,215610,1040190,1255800,MKT
06042734474210000,2020,157857,889643,1047500,MKT
06042734474210000,2019,157857,889643,1047500,MKT
06042734474230000,2021,229355,0,229355,COST
06042734474230000,2020,169474,0,169474,COST
06042734474230000,2019,169474,0,169474,COST
06042734474250000,2021,240037,941360,1181397,COST
06042734474250000,2020,178575,796590,975165,COST
06042734474250000,2019,178575,796590,975165,COST
06042734474270000,2021,228822,1005178,1234000,MKT
06042734474270000,2020,169022,902978,1072000,OVR
06042734474270000,2019,169022,902978,1072000,MKT
06042734474290000,2021,260892,960708,1221600,MKT
06042734474290000,2020,196515,1074120,1270635,COST
06042734474290000,2019,196515,1074120,1270635,COST
06042734474306500,2021,62658,0,62658,COST
06042734474306500,2020,45709,0,45709,COST
06042734474306500,2019,45709,0,45709,COST
06042734474310000,2021,252995,0,252995,COST
06042734474310000,2020,189696,0,189696,COST
06042734474310000,2019,189696,0,189696,COST
06042734474330000,2021,219401,1007399,1226800,MKT
06042734474330000,2020,161050,940960,1102010,OVR
06042734474330000,2019,161050,940960,1102010,COST
06042734474350000,2021,240913,690190,931103,COST
06042734474350000,2020,179324,661490,840814,COST
06042734474350000,2019,179324,661490,840814,COST
06042734474370000,2021,229620,727810,957430,COST
06042734474370000,2020,169699,676340,846039,OVR
06042734474370000,2019,169699,676340,846039,COST
06042734474390000,2021,229355,838945,1068300,MKT
06042734474390000,2020,169474,631670,801144,COST
06042734474390000,2019,169474,631670,801144,COST
06042734474410000,2021,236623,924677,1161300,MKT
06042734474410000,2020,175660,822960,998620,COST
06042734474410000,2019,175660,822960,998620,COST
06042734474430000,2021,225932,1520880,1746812,COST
06042734474430000,2020,166571,1267840,1434411,COST
06042734474430000,2019,166571,1267840,1434411,COST
06042734474450000,2021,226115,1069485,1295600,MKT
06042734474450000,2020,166726,878940,1045666,COST
06042734474450000,2019,166726,878940,1045666,COST
06042734476010000,2021,279363,0,279363,COST
06042734476010000,2020,212585,0,212585,COST
06042734476010000,2019,212585,0,212585,COST
06042734476030000,2021,245039,0,245039,COST
06042734476030000,2020,182857,0,182857,COST
06042734476030000,2019,182857,0,182857,COST
06042734476050000,2021,238506,950994,1189500,MKT
06042734476050000,2020,177267,853560,1030827,OVR
06042734476050000,2019,177267,853560,1030827,COST
06042734476076500,2021,140129,0,140129,COST
06042734476076500,2020,115253,0,115253,COST
06042734476076500,2019,115253,0,115253,COST
06042734476190000,2021,247082,1016718,1263800,MKT
06042734476190000,2020,184610,801490,986100,MKT
06042734476190000,2019,184610,801490,986100,MKT
06042735101020000,2021,245800,535980,781780,COST
06042735101020000,2020,203900,494300,698200,MKT
06042735101020000,2019,203900,411060,614960,COST
06042735101020900,2021,5423,0,5423,COST
06042735101020900,2020,3017,0,3017,COST
06042735101020900,2019,3017,0,3017,COST
06042735101040000,2021,255139,435110,690249,COST
06042735101040000,2020,208960,273870,482830,COST
06042735101040000,2019,208960,273870,482830,COST
06042735105010000,2021,1110,31180,32290,COST
06042735105010000,2020,1033,31650,32683,COST
06042735105010000,2019,1033,31650,32683,COST
06042735112070000,2021,1125,0,1125,COST
06042735112070000,2020,1048,0,1048,COST
06042735112070000,2019,1048,0,1048,COST
06042735118110000,2021,246869,2670070,2916939,COST
06042735118110000,2020,204895,1661730,1866625,COST
06042735118110000,2019,204895,1661730,1866625,COST
06042735148050000,2021,249701,5255700,5505401,COST
06042735148050000,2020,207530,4450150,4657680,COST
06042735148050000,2019,207530,4450150,4657680,COST
06042735205010000,2021,6278,0,6278,COST
06042735205010000,2020,3614,0,3614,COST
06042735205010000,2019,3614,0,3614,COST
06042735230010000,2021,250128,380650,630778,COST
06042735230010000,2020,207927,339800,547727,COST
06042735230010000,2019,207927,339800,547727,COST
06042735301010000,2021,246883,1917310,2164193,COST
06042735301010000,2020,204908,1614500,1819408,COST
06042735301010000,2019,204857,1614500,1819357,COST
06042735302010000,2021,299595,1128360,1427955,COST
06042735302010000,2020,255966,10900,266866,COST
06042735302010000,2019,255966,10900,266866,COST
06042735302017000,2021,397230,28010,425240,COST
06042735302017000,2020,353957,27110,381067,COST
06042735302017000,2019,353957,27110,381067,COST
06042735303017000,2021,669989,327940,997929,COST
06042735303017000,2020,645381,300760,946141,COST
06042735303017000,2019,645381,300760,946141,COST
06042735304017000,2021,374629,10700,385329,COST
06042735304017000,2020,330916,12740,343656,COST
06042735304017000,2019,330916,12740,343656,COST
06042735304030000,2021,364970,900090,1265060,COST
06042735304030000,2020,321131,582170,903301,OVR
06042735304030000,2019,321131,582170,903301,COST
06042735304060000,2021,373445,1450250,1823695,COST
06042735304060000,2020,329714,1220100,1549814,COST
06042735304060000,2019,329714,1220100,1549814,COST
06042735304070000,2021,349203,938740,1287943,COST
06042735304070000,2020,305242,801080,1106322,COST
06042735304070000,2019,305242,801080,1106322,COST
06042735304100000,2021,367361,2030000,2397361,COST
06042735304100000,2020,323550,1282670,1606220,COST
06042735304100000,2019,323550,1282670,1606220,COST
06042735304140000,2021,372312,0,372312,COST
06042735304140000,2020,328565,0,328565,COST
06042735304140000,2019,328565,0,328565,COST
06042735304180000,2021,419892,2380770,2800662,COST
06042735304180000,2020,377257,1711010,2088267,COST
06042735304180000,2019,377257,1711010,2088267,COST
06042735304200000,2021,383956,2233830,2617786,COST
06042735304200000,2020,340400,1775390,2115790,COST
06042735304200000,2019,340400,1775390,2115790,COST
06042735304240000,2021,366527,0,366527,COST
06042735304240000,2020,322705,0,322705,COST
06042735304240000,2019,322705,0,322705,COST
06042735304280000,2021,363082,832450,1195532,COST
06042735304280000,2020,319223,621570,940793,COST
06042735304280000,2019,319223,621570,940793,COST
06042735304320000,2021,377612,874570,1252182,COST
06042735304320000,2020,333946,736350,1070296,COST
06042735304320000,2019,333946,736350,1070296,COST
06042735304380000,2021,246138,2274390,2520528,COST
06042735304380000,2020,204214,1828050,2032264,COST
06042735304380000,2019,204214,1828050,2032264,COST
06042735305010000,2021,416199,2498170,2914369,COST
06042735305010000,2020,373448,1873320,2246768,COST
06042735305010000,2019,373448,1873320,2246768,COST
06042735305250000,2021,3937,0,3937,COST
06042735305250000,2020,3664,0,3664,COST
06042735305250000,2019,3664,0,3664,COST
06042735305300000,2021,404606,0,404606,COST
06042735305300000,2020,361520,0,361520,COST
06042735305300000,2019,361520,0,361520,COST
06042735305350000,2021,446398,0,446398,COST
06042735305350000,2020,404749,0,404749,COST
06042735305350000,2019,404749,0,404749,COST
06042735305400000,2021,412788,2064450,2477238,COST
06042735305400000,2020,369933,1713020,2082953,COST
06042735305400000,2019,369933,1713020,2082953,COST
06042735305450000,2021,428317,3441350,3869667,COST
06042735305450000,2020,385968,2684670,3070638,COST
06042735305450000,2019,385968,2529780,2915748,COST
06042735305500000,2021,429537,0,429537,COST
06042735305500000,2020,387232,0,387232,COST
06042735305500000,2019,387232,0,387232,COST
06042735305557000,2021,474266,0,474266,COST
06042735305557000,2020,333356,0,333356,COST
06042735305557000,2019,260713,0,260713,COST
06042735305650000,2021,501,0,501,COST
06042735305650000,2020,466,0,466,COST
06042735305650000,2019,466,0,466,COST
06042735305700000,2021,245847,3629530,3875377,COST
06042735305700000,2020,203943,3066110,3270053,COST
06042735305700000,2019,203943,1911200,2115143,COST
06042735305750000,2021,313,0,313,COST
06042735305750000,2020,291,0,291,COST
06042735305750000,2019,291,0,291,COST
06042735305800000,2021,576,0,576,COST
06042735305800000,2020,536,0,536,COST
06042735305800000,2019,536,0,536,COST
06042735401010000,2021,338768,1112332,1451100,MKT
06042735401010000,2020,315073,813827,1128900,MKT
06042735401010000,2019,315073,813827,1128900,MKT
06042735401020000,2021,338768,765703,1104471,MRA
06042735401020000,2020,315073,607340,922413,COST
06042735401020000,2019,315073,607340,922413,COST
06042735401030000,2021,348586,821014,1169600,MKT
06042735401030000,2020,330966,667290,998256,COST
06042735401030000,2019,330966,722534,1053500,MKT
06042735401040000,2021,338768,1709532,2048300,MKT
06042735401040000,2020,315073,1093627,1408700,MKT
06042735401040000,2019,315073,1093627,1408700,MKT
06042735401050000,2021,348586,1355314,1703900,MKT
06042735401050000,2020,330966,956700,1287666,COST
06042735401050000,2019,330966,956700,1287666,COST
06042735401060000,2021,364769,0,364769,COST
06042735401060000,2020,357873,0,357873,COST
06042735401060000,2019,357873,0,357873,COST
06042735401070000,2021,422912,1394070,1816982,COST
06042735401070000,2020,461707,1180740,1642447,COST
06042735401070000,2019,461707,1180740,1642447,COST
06042735401080000,2021,362189,0,362189,COST
06042735401080000,2020,353524,0,353524,COST
06042735401080000,2019,353524,0,353524,COST
06042735401090000,2021,373071,1633390,2006461,COST
06042735401090000,2020,372017,1396710,1768727,COST
06042735401090000,2019,372017,1396710,1768727,COST
06042735401100000,2021,337750,1707730,2045480,COST
06042735401100000,2020,313443,1486810,1800253,COST
06042735401100000,2019,313443,1486810,1800253,COST
06042735401110000,2021,329317,1159890,1489207,COST
06042735401110000,2020,300085,995215,1295300,MKT
06042735401110000,2019,300085,995215,1295300,MKT
06042735401120000,2021,329317,0,329317,COST
06042735401120000,2020,300085,0,300085,COST
06042735401120000,2019,300085,0,300085,COST
06042735401130000,2021,314411,481989,796400,MKT
06042735401130000,2020,277073,413430,690503,COST
06042735401130000,2019,277073,413430,690503,COST
06042735401140000,2021,330400,901400,1231800,MKT
06042735401140000,2020,301787,593630,895417,COST
06042735401140000,2019,301787,593630,895417,COST
06042735401150000,2021,338768,921132,1259900,MKT
06042735401150000,2020,315073,613820,928893,COST
06042735401150000,2019,315073,613820,928893,COST
06042735401160000,2021,311965,450835,762800,MKT
06042735401160000,2020,273370,426160,699530,COST
06042735401160000,2019,273370,297820,571190,COST
06042735401170000,2021,382488,975550,1358038,COST
06042735401170000,2020,388339,814490,1202829,COST
06042735401170000,2019,388339,814490,1202829,COST
06042735401180000,2021,348586,670914,1019500,MKT
06042735401180000,2020,330966,463800,794766,COST
06042735401180000,2019,330966,463800,794766,COST
06042735401190000,2021,351408,1668440,2019848,COST
06042735401190000,2020,335594,1437820,1773414,COST
06042735401190000,2019,335594,1437820,1773414,COST
06042735401200000,2021,331472,1398728,1730200,MKT
06042735401200000,2020,303476,884380,1187856,COST
06042735401200000,2019,303476,884380,1187856,COST
06042735401210000,2021,336722,1683480,2020202,COST
06042735401210000,2020,311802,1457670,1769472,COST
06042735401210000,2019,311802,1457670,1769472,COST
06042735401220000,2021,355995,1769980,2125975,COST
06042735401220000,2020,343174,1485770,1828944,COST
06042735401220000,2019,343174,218360,561534,COST
06042735401230000,2021,326018,742582,1068600,MKT
06042735401230000,2020,294927,674673,969600,MKT
06042735401230000,2019,294927,674673,969600,MKT
06042735401240000,2021,327128,1606372,1933500,MKT
06042735401240000,2020,296657,959870,1256527,COST
06042735401240000,2019,296657,959870,1256527,COST
06042735401250000,2021,364769,0,364769,COST
06042735401250000,2020,357873,0,357873,COST
06042735401250000,2019,357873,0,357873,COST
06042735401260000,2021,330400,0,330400,COST
06042735401260000,2020,301787,0,301787,COST
06042735401260000,2019,301787,0,301787,COST
06042735401280000,2021,416801,2511280,2928081,COST
06042735401280000,2020,260250,1015250,1275500,OVR
06042735401280000,2019,260250,1015250,1275500,OVR
06042735401290000,2021,349534,0,349534,COST
06042735401290000,2020,332516,0,332516,COST
06042735401290000,2019,332516,0,332516,COST
06042735401300000,2021,349534,1538450,1887984,OVR
06042735401300000,2020,332516,1093780,1426296,COST
06042735401300000,2019,332516,1093780,1426296,COST
06042735401310000,2021,349534,1071666,1421200,MKT
06042735401310000,2020,332516,579670,912186,COST
06042735401310000,2019,332516,579670,912186,COST
06042735401320000,2021,386255,620530,1006785,COST
06042735401320000,2020,394950,581310,976260,COST
06042735401320000,2019,394950,581310,976260,COST
06042735401330000,2021,354177,1238623,1592800,MKT
06042735401330000,2020,340162,1378920,1719082,COST
06042735401330000,2019,340162,1378920,1719082,COST
06042735401340000,2021,334646,762354,1097000,MKT
06042735401340000,2020,308498,653940,962438,OVR
06042735401340000,2019,308498,653940,962438,COST
06042735401350000,2021,353259,1536041,1889300,MKT
06042735401350000,2020,338645,998940,1337585,COST
06042735401350000,2019,338645,998940,1337585,COST
06042735401360000,2021,343760,569440,913200,MKT
06042735401360000,2020,323113,509660,832773,COST
06042735401360000,2019,323113,509660,832773,COST
06042735401370000,2021,337750,1171150,1508900,MKT
06042735401370000,2020,313443,849757,1163200,MKT
06042735401370000,2019,313443,849757,1163200,MKT
06042735401380000,2021,334646,1780254,2114900,MKT
06042735401380000,2020,308498,1010010,1318508,COST
06042735401380000,2019,308498,1010010,1318508,COST
06042735401406500,2021,116388,0,116388,COST
06042735401406500,2020,118792,0,118792,COST
06042735401406500,2019,118792,0,118792,COST
06042735401450000,2021,107604,0,107604,COST
06042735401450000,2020,104295,0,104295,COST
06042735401450000,2019,65287,0,65287,COST
06042735402010000,2021,457648,784220,1241868,COST
06042735402010000,2020,346903,640770,987673,COST
06042735402010000,2019,346903,640770,987673,COST
06042735402020000,2021,402242,653958,1056200,MKT
06042735402020000,2020,277764,525436,803200,MKT
06042735402020000,2019,277764,525436,803200,MKT
06042735402030000,2021,402242,1605758,2008000,MKT
06042735402030000,2020,277764,1004790,1282554,COST
06042735402030000,2019,277764,1004790,1282554,COST
06042735402040000,2021,231720,310680,542400,MKT
06042735402040000,2020,162984,258616,421600,MKT
06042735402040000,2019,162984,258616,421600,MKT
06042735402050000,2021,231720,0,231720,COST
06042735402050000,2020,162984,0,162984,COST
06042735402050000,2019,162984,0,162984,COST
06042735402070000,2021,284981,1048850,1333831,COST
06042735402070000,2020,232762,835630,1068392,COST
06042735402070000,2019,232762,835630,1068392,COST
06042735402080000,2021,279821,689979,969800,MKT
06042735402080000,2020,225550,541950,767500,MKT
06042735402080000,2019,225550,541950,767500,MKT
06042735402090000,2021,342548,0,342548,COST
06042735402090000,2020,286748,0,286748,COST
06042735402090000,2019,286748,0,286748,COST
06042735402100000,2021,269676,458624,728300,MKT
06042735402100000,2020,211651,395449,607100,MKT
06042735402100000,2019,211651,395449,607100,MKT
06042735402110000,2021,252895,929205,1182100,MKT
06042735402110000,2020,267164,731300,998464,COST
06042735402110000,2019,267164,731300,998464,COST
06042735402120000,2021,233137,808363,1041500,MKT
06042735402120000,2020,164704,738880,903584,MRA
06042735402120000,2019,164704,738880,903584,MRA
06042735402130000,2021,231720,1103980,1335700,MKT
06042735402130000,2020,162984,560410,723394,COST
06042735402130000,2019,162984,429910,592894,COST
06042735402140000,2021,231720,439110,670830,COST
06042735402140000,2020,162984,0,162984,COST
06042735402140000,2019,162984,0,162984,COST
06042735402150000,2021,231720,0,231720,COST
06042735402150000,2020,162984,0,162984,COST
06042735402150000,2019,162984,0,162984,COST
06042735402160000,2021,231720,718380,950100,MKT
06042735402160000,2020,162984,652916,815900,MKT
06042735402160000,2019,162984,652916,815900,MKT
06042735402170000,2021,231720,882980,1114700,MKT
06042735402170000,2020,162984,645416,808400,MKT
06042735402170000,2019,162984,645416,808400,MKT
06042735402180000,2021,231720,1022280,1254000,MKT
06042735402180000,2020,162984,778720,941704,COST
06042735402180000,2019,162984,778720,941704,COST
06042735402190000,2021,248732,0,248732,COST
06042735402190000,2020,184137,0,184137,COST
06042735402190000,2019,184137,0,184137,COST
06042735403010000,2021,350288,655712,1006000,MKT
06042735403010000,2020,298000,489700,787700,MKT
06042735403010000,2019,298000,489700,787700,MKT
06042735403020000,2021,303291,0,303291,COST
06042735403020000,2020,232514,0,232514,COST
06042735403020000,2019,232514,0,232514,COST
06042735403030000,2021,303291,867509,1170800,MKT
06042735403030000,2020,232514,631286,863800,MKT
06042735403030000,2019,232514,631286,863800,MKT
06042735403040000,2021,303291,1187509,1490800,MKT
06042735403040000,2020,232514,991260,1223774,OVR
06042735403040000,2019,232514,991260,1223774,COST
06042735403050000,2021,256173,1122290,1378463,COST
06042735403050000,2020,273155,929470,1202625,COST
06042735403050000,2019,273155,929470,1202625,COST
06042735404010000,2021,296110,1134980,1431090,COST
06042735404010000,2020,223113,919660,1142773,COST
06042735404010000,2019,223113,919660,1142773,COST
06042735404020000,2021,307852,0,307852,COST
06042735404020000,2020,238569,0,238569,COST
06042735404020000,2019,238569,0,238569,COST
06042735404030000,2021,296976,886424,1183400,MKT
06042735404030000,2020,224238,692462,916700,MKT
06042735404030000,2019,224238,692462,916700,MKT
06042735404040000,2021,327241,1764560,2091801,COST
06042735404040000,2020,265036,1410490,1675526,COST
06042735404040000,2019,265036,604980,870016,COST
06042735404050000,2021,239649,0,239649,COST
06042735404050000,2020,172709,0,172709,COST
06042735404050000,2019,172709,0,172709,COST
06042735404060000,2021,240204,581196,821400,MKT
06042735404060000,2020,173397,559803,733200,MKT
06042735404060000,2019,173397,559803,733200,MKT
06042735404070000,2021,254496,0,254496,COST
06042735404070000,2020,191548,0,191548,COST
06042735404070000,2019,191548,0,191548,COST
06042735404080000,2021,253606,1122994,1376600,MKT
06042735404080000,2020,190396,789550,979946,COST
06042735404080000,2019,190396,789550,979946,COST
06042735404090000,2021,260776,639024,899800,MKT
06042735404090000,2020,199762,499638,699400,MKT
06042735404090000,2019,199762,499638,699400,MKT
06042735404100000,2021,234365,0,234365,COST
06042735404100000,2020,193548,0,193548,COST
06042735404100000,2019,193548,0,193548,COST
06042735405010000,2021,178455,0,178455,COST
06042735405010000,2020,121035,0,121035,COST
06042735405010000,2019,121035,0,121035,COST
06042735405020000,2021,194784,972716,1167500,MKT
06042735405020000,2020,140736,773464,914200,MKT
06042735405020000,2019,140736,773464,914200,MKT
06042735405030000,2021,167043,395240,562283,COST
06042735405030000,2020,108013,0,108013,COST
06042735405030000,2019,108013,0,108013,COST
06042735405040000,2021,247297,449103,696400,MKT
06042735405040000,2020,182311,393289,575600,MKT
06042735405040000,2019,182311,393289,575600,MKT
06042735405050000,2021,260702,0,260702,COST
06042735405050000,2020,199665,0,199665,COST
06042735405050000,2019,199665,0,199665,COST
06042735405060000,2021,358681,0,358681,COST
06042735405060000,2020,310406,0,310406,COST
06042735405060000,2019,310406,0,310406,COST
06042735405070000,2021,175760,818040,993800,MKT
06042735405070000,2020,187149,314570,501719,COST
06042735405070000,2019,187149,0,187149,COST
06042735405080000,2021,232633,686267,918900,MKT
06042735405080000,2020,164091,569509,733600,MKT
06042735405080000,2019,164091,569509,733600,MKT
06042735405090000,2021,239670,602730,842400,MKT
06042735405090000,2020,172735,499365,672100,MKT
06042735405090000,2019,172735,499365,672100,MKT
06042735405100000,2021,265667,428633,694300,MKT
06042735405100000,2020,206260,390640,596900,MKT
06042735405100000,2019,206260,390640,596900,MKT
06042735407010000,2021,1042014,98970,1140984,COST
06042735407010000,2020,1555364,95230,1650594,COST
06042735407010000,2019,1555364,95230,1650594,COST
06042735409010000,2021,231720,0,231720,COST
06042735409010000,2020,162984,0,162984,COST
06042735409010000,2019,162984,0,162984,COST
06042735409020000,2021,231720,453280,685000,MKT
06042735409020000,2020,162984,436316,599300,MKT
06042735409020000,2019,162984,436316,599300,MKT
06042735409030000,2021,228461,360939,589400,MKT
06042735409030000,2020,159056,353544,512600,MKT
06042735409030000,2019,159056,353544,512600,MKT
06042735409040000,2021,231720,687580,919300,MKT
06042735409040000,2020,162984,624716,787700,MKT
06042735409040000,2019,162984,624716,787700,MKT
06042735409050000,2021,231720,576480,808200,MKT
06042735409050000,2020,162984,468116,631100,MKT
06042735409050000,2019,162984,468116,631100,MKT
06042735409060000,2021,305553,0,305553,COST
06042735409060000,2020,262453,0,262453,COST
06042735409060000,2019,262453,0,262453,COST
06042735409070000,2021,352338,929790,1282128,COST
06042735409070000,2020,335448,799050,1134498,OVR
06042735409070000,2019,335448,799050,1134498,COST
06042735409080000,2021,360094,1028200,1388294,COST
06042735409080000,2020,348269,841970,1190239,COST
06042735409080000,2019,348269,841970,1190239,COST
06042735409090000,2021,443552,499860,943412,COST
06042735409090000,2020,328705,397850,726555,COST
06042735409090000,2019,328705,397850,726555,COST
06042735409100000,2021,443552,822240,1265792,COST
06042735409100000,2020,328705,667810,996515,COST
06042735409100000,2019,328705,667810,996515,COST
06042735409110000,2021,323729,0,323729,COST
06042735409110000,2020,353224,0,353224,COST
06042735409110000,2019,353224,0,353224,COST
06042735409120000,2021,311956,804644,1116600,MKT
06042735409120000,2020,216378,618022,834400,MKT
06042735409120000,2019,216378,618022,834400,MKT
06042735409130000,2021,310195,767605,1077800,MKT
06042735409130000,2020,214278,587222,801500,MKT
06042735409130000,2019,214278,587222,801500,MKT
06042735409140000,2021,301236,716750,1017986,COST
06042735409140000,2020,203729,0,203729,COST
06042735409140000,2019,203729,0,203729,COST
06042735409150000,2021,291959,1019441,1311400,MKT
06042735409150000,2020,193043,891320,1084363,COST
06042735409150000,2019,193043,506457,699500,MKT
06042735409160000,2021,301236,353764,655000,MKT
06042735409160000,2020,203729,320971,524700,MKT
06042735409160000,2019,203729,320971,524700,MKT
06042735409170000,2021,77656,0,77656,COST
06042735409170000,2020,59169,0,59169,COST
06042735409170000,2019,44222,0,44222,COST
06042735412010000,2021,1330,0,1330,COST
06042735412010000,2020,1237,0,1237,COST
06042735412010000,2019,1237,0,1237,COST
06042736101010000,2021,339781,957619,1297400,MKT
06042736101010000,2020,316698,759190,1075888,COST
06042736101010000,2019,316698,759190,1075888,COST
06042736101020000,2021,335689,839211,1174900,MKT
06042736101020000,2020,310156,759344,1069500,MKT
06042736101020000,2019,310156,759344,1069500,MKT
06042736101030000,2021,335689,0,335689,COST
06042736101030000,2020,310156,0,310156,COST
06042736101030000,2019,310156,0,310156,COST
06042736101040000,2021,346675,1047025,1393700,MKT
06042736101040000,2020,327847,909853,1237700,MKT
06042736101040000,2019,327847,909853,1237700,MKT
06042736101050000,2021,361321,771979,1133300,MKT
06042736101050000,2020,352065,638290,990355,OVR
06042736101050000,2019,352065,638290,990355,COST
06042736101060000,2021,358681,0,358681,COST
06042736101060000,2020,347647,0,347647,COST
06042736101060000,2019,347647,0,347647,COST
06042736101070000,2021,402079,1442630,1844709,COST
06042736101070000,2020,423231,1258340,1681571,COST
06042736101070000,2019,423231,1258340,1681571,COST
06042736101090000,2021,404634,0,404634,COST
06042736101090000,2020,427874,0,427874,COST
06042736101090000,2019,427874,0,427874,COST
06042736101100000,2021,295618,0,295618,COST
06042736101100000,2020,299376,0,299376,COST
06042736101100000,2019,299376,0,299376,COST
06042736101110000,2021,284127,0,284127,COST
06042736101110000,2020,279614,0,279614,COST
06042736101110000,2019,430175,0,430175,COST
06042736101120000,2021,394249,0,394249,COST
06042736101120000,2020,409135,0,409135,COST
06042736101120000,2019,409135,0,409135,COST
06042736101130000,2021,373071,1084160,1457231,COST
06042736101130000,2020,372017,929680,1301697,COST
06042736101130000,2019,372017,929680,1301697,COST
06042736101140000,2021,403227,0,403227,COST
06042736101140000,2020,425315,0,425315,COST
06042736101140000,2019,425315,0,425315,COST
06042736101150000,2021,386998,0,386998,COST
06042736101150000,2020,396260,0,396260,COST
06042736101150000,2019,396260,0,396260,COST
06042736101160000,2021,375478,788922,1164400,MKT
06042736101160000,2020,376162,521880,898042,COST
06042736101160000,2019,376162,521880,898042,COST
06042736101170000,2021,373878,0,373878,COST
06042736101170000,2020,373405,0,373405,COST
06042736101170000,2019,373405,0,373405,COST
06042736101180000,2021,355088,0,355088,COST
06042736101180000,2020,341669,0,341669,COST
06042736101180000,2019,341669,0,341669,COST
06042736101220000,2021,231720,544480,776200,MKT
06042736101220000,2020,162984,504516,667500,MKT
06042736101220000,2019,162984,504516,667500,MKT
06042736101230000,2021,284703,1241520,1526223,COST
06042736101230000,2020,232372,1059170,1291542,OVR
06042736101230000,2019,232372,1059170,1291542,COST
06042736101250000,2021,231720,0,231720,COST
06042736101250000,2020,162984,0,162984,COST
06042736101250000,2019,162984,0,162984,COST
06042736101260000,2021,261135,415965,677100,MKT
06042736101260000,2020,200236,378564,578800,MKT
06042736101260000,2019,200236,378564,578800,MKT
06042736101280000,2021,261135,885065,1146200,MKT
06042736101280000,2020,200236,647964,848200,MKT
06042736101280000,2019,200236,647964,848200,MKT
06042736101290000,2021,231720,680710,912430,COST
06042736101290000,2020,162984,547430,710414,COST
06042736101290000,2019,162984,547430,710414,COST
06042736101300000,2021,231720,0,231720,COST
06042736101300000,2020,162984,0,162984,COST
06042736101300000,2019,162984,0,162984,COST
06042736101310000,2021,231720,453000,684720,COST
06042736101310000,2020,162984,367030,530014,COST
06042736101310000,2019,162984,367416,530400,MKT
06042736101320000,2021,168865,0,168865,COST
06042736101320000,2020,174682,0,174682,COST
06042736101320000,2019,174682,0,174682,COST
06042736101330000,2021,168865,0,168865,COST
06042736101330000,2020,174682,0,174682,COST
06042736101330000,2019,174682,0,174682,COST
06042736101340000,2021,168865,0,168865,COST
06042736101340000,2020,174682,0,174682,COST
06042736101340000,2019,174682,0,174682,COST
06042736101350000,2021,300725,619520,920245,COST
06042736101350000,2020,255351,503449,758800,MKT
06042736101350000,2019,255351,503449,758800,MKT
06042736101370000,2021,231720,0,231720,COST
06042736101370000,2020,162984,0,162984,COST
06042736101370000,2019,162984,0,162984,COST
06042736101380000,2021,231720,0,231720,COST
06042736101380000,2020,162984,0,162984,COST
06042736101380000,2019,162984,0,162984,COST
06042736101390000,2021,231720,0,231720,COST
06042736101390000,2020,162984,0,162984,COST
06042736101390000,2019,162984,0,162984,COST
06042736101400000,2021,273429,0,273429,COST
06042736101400000,2020,203729,0,203729,COST
06042736101400000,2019,203729,0,203729,COST
06042736101410000,2021,273429,361871,635300,MKT
06042736101410000,2020,203729,333271,537000,MKT
06042736101410000,2019,203729,333271,537000,MKT
06042736101470000,2021,335994,429306,765300,MKT
06042736101470000,2020,203729,364371,568100,MKT
06042736101470000,2019,203729,364371,568100,MKT
06042736101480000,2021,335994,566606,902600,MKT
06042736101480000,2020,203729,412871,616600,MKT
06042736101480000,2019,203729,412871,616600,MKT
06042736101490000,2021,335994,1052570,1388564,COST
06042736101490000,2020,203729,611050,814779,COST
06042736101490000,2019,203729,559871,763600,MKT
06042736101500000,2021,335994,819206,1155200,MKT
06042736101500000,2020,203729,618971,822700,MKT
06042736101500000,2019,203729,535871,739600,MKT
06042736101510000,2021,335994,527160,863154,COST
06042736101510000,2020,203729,550171,753900,MKT
06042736101510000,2019,203729,550171,753900,MKT
06042736101520000,2021,335994,0,335994,COST
06042736101520000,2020,203729,0,203729,COST
06042736101520000,2019,203729,0,203729,COST
06042736101530000,2021,335994,409006,745000,MKT
06042736101530000,2020,203729,394471,598200,MKT
06042736101530000,2019,203729,394471,598200,MKT
06042736101540000,2021,335994,387806,723800,MKT
06042736101540000,2020,203729,373171,576900,MKT
06042736101540000,2019,203729,373171,576900,MKT
06042736101550000,2021,335994,300106,636100,MKT
06042736101550000,2020,203729,308971,512700,MKT
06042736101550000,2019,203729,308971,512700,MKT
06042736101560000,2021,335994,344706,680700,MKT
06042736101560000,2020,203729,273571,477300,MKT
06042736101560000,2019,203729,233760,437489,COST
06042736101570000,2021,335994,848906,1184900,MKT
06042736101570000,2020,203729,615971,819700,MKT
06042736101570000,2019,203729,615971,819700,MKT
06042736101580000,2021,335994,0,335994,COST
06042736101580000,2020,203729,0,203729,COST
06042736101580000,2019,203729,0,203729,COST
06042736101590000,2021,335994,553206,889200,MKT
06042736101590000,2020,203729,445371,649100,MKT
06042736101590000,2019,203729,445371,649100,MKT
06042736101600000,2021,335994,0,335994,COST
06042736101600000,2020,203729,0,203729,COST
06042736101600000,2019,203729,0,203729,COST
06042736101610000,2021,335994,1959140,2295134,COST
06042736101610000,2020,203729,800120,1003849,COST
06042736101610000,2019,203729,223540,427269,COST
06042736101620000,2021,335994,467020,803014,COST
06042736101620000,2020,203729,466971,670700,MKT
06042736101620000,2019,203729,466971,670700,MKT
06042736101630000,2021,335994,0,335994,COST
06042736101630000,2020,203729,0,203729,COST
06042736101630000,2019,203729,0,203729,COST
06042736101640000,2021,346729,887971,1234700,MKT
06042736101640000,2020,215071,639529,854600,MKT
06042736101640000,2019,215071,639529,854600,MKT
06042736101650000,2021,335994,0,335994,COST
06042736101650000,2020,203729,0,203729,COST
06042736101650000,2019,203729,0,203729,COST
06042736101660000,2021,334859,866630,1201489,COST
06042736101660000,2020,202545,741055,943600,MKT
06042736101660000,2019,202545,741055,943600,MKT
06042736102010000,2021,380186,0,380186,COST
06042736102010000,2020,384323,0,384323,COST
06042736102010000,2019,384323,0,384323,COST
06042736102020000,2021,497234,0,497234,COST
06042736102020000,2020,388339,0,388339,COST
06042736102020000,2019,388339,0,388339,COST
06042736102030000,2021,527664,0,527664,COST
06042736102030000,2020,430175,0,430175,COST
06042736102030000,2019,430175,0,430175,COST
06042736102040000,2021,527664,966230,1493894,COST
06042736102040000,2020,430175,844960,1275135,COST
06042736102040000,2019,430175,844960,1275135,COST
06042736102050000,2021,515273,0,515273,COST
06042736102050000,2020,412923,0,412923,COST
06042736102050000,2019,412923,0,412923,COST
06042736102060000,2021,368144,1351000,1719144,COST
06042736102060000,2020,363596,1249390,1612986,COST
06042736102060000,2019,363596,1249390,1612986,COST
06042736103010000,2021,335994,0,335994,COST
06042736103010000,2020,203729,0,203729,COST
06042736103010000,2019,203729,0,203729,COST
06042736103020000,2021,335994,960440,1296434,COST
06042736103020000,2020,203729,766850,970579,COST
06042736103020000,2019,203729,766850,970579,COST
06042736103030000,2021,335994,687206,1023200,MKT
06042736103030000,2020,203729,542271,746000,MKT
06042736103030000,2019,203729,542271,746000,MKT
06042736103040000,2021,335994,486206,822200,MKT
06042736103040000,2020,203729,398971,602700,MKT
06042736103040000,2019,203729,398971,602700,MKT
06042736103050000,2021,335994,0,335994,COST
06042736103050000,2020,203729,0,203729,COST
06042736103050000,2019,203729,0,203729,COST
06042736103060000,2021,335994,532506,868500,MKT
06042736103060000,2020,203729,470871,674600,MKT
06042736103060000,2019,203729,470871,674600,MKT
06042736103070000,2021,335994,0,335994,COST
06042736103070000,2020,203729,0,203729,COST
06042736103070000,2019,203729,0,203729,COST
06042736103080000,2021,412881,1079110,1491991,COST
06042736103080000,2020,290539,864230,1154769,COST
06042736103080000,2019,290539,864230,1154769,COST
06042736103100000,2021,335994,1122706,1458700,MKT
06042736103100000,2020,203729,861130,1064859,COST
06042736103100000,2019,203729,861130,1064859,COST
06042736103110000,2021,335994,858006,1194000,MKT
06042736103110000,2020,203729,630771,834500,MKT
06042736103110000,2019,203729,630771,834500,MKT
06042736103120000,2021,335994,0,335994,COST
06042736103120000,2020,203729,0,203729,COST
06042736103120000,2019,203729,0,203729,COST
06042736103130000,2021,335994,369306,705300,MKT
06042736103130000,2020,203729,302571,506300,MKT
06042736103130000,2019,203729,302571,506300,MKT
06042736103140000,2021,335994,618906,954900,MKT
06042736103140000,2020,203729,562471,766200,MKT
06042736103140000,2019,203729,562471,766200,MKT
06042736103150000,2021,335994,0,335994,COST
06042736103150000,2020,203729,0,203729,COST
06042736103150000,2019,203729,0,203729,COST
06042736103160000,2021,335994,0,335994,COST
06042736103160000,2020,203729,0,203729,COST
06042736103160000,2019,203729,0,203729,COST
06042736103170000,2021,273429,796671,1070100,MKT
06042736103170000,2020,250995,657770,908765,COST
06042736103170000,2019,250995,657770,908765,COST
06042736103180000,2021,273328,778372,1051700,MKT
06042736103180000,2020,250834,540966,791800,MKT
06042736103180000,2019,250834,540966,791800,MKT
06042736103190000,2021,273429,350071,623500,MKT
06042736103190000,2020,250995,270705,521700,MKT
06042736103190000,2019,250995,270705,521700,MKT
06042736103200000,2021,273429,0,273429,COST
06042736103200000,2020,250995,0,250995,COST
06042736103200000,2019,250995,0,250995,COST
06042736103210000,2021,273429,997671,1271100,MKT
06042736103210000,2020,250995,712605,963600,MKT
06042736103210000,2019,250995,712605,963600,MKT
06042736103220000,2021,268946,0,268946,COST
06042736103220000,2020,243947,0,243947,COST
06042736103220000,2019,243947,0,243947,COST
06042736103230000,2021,277569,640931,918500,MKT
06042736103230000,2020,257576,501224,758800,MKT
06042736103230000,2019,257576,501224,758800,MKT
06042736103240000,2021,273429,526314,799743,OVR
06042736103240000,2020,250995,429105,680100,MKT
06042736103240000,2019,250995,429105,680100,MKT
06042736103250000,2021,273429,608871,882300,MKT
06042736103250000,2020,250995,400305,651300,MKT
06042736103250000,2019,250995,400305,651300,MKT
06042736103260000,2021,273429,690771,964200,MKT
06042736103260000,2020,250995,504105,755100,MKT
06042736103260000,2019,250995,504105,755100,MKT
06042736103270000,2021,273429,513471,786900,MKT
06042736103270000,2020,250995,420605,671600,MKT
06042736103270000,2019,250995,420605,671600,MKT
06042736103280000,2021,273429,410371,683800,MKT
06042736103280000,2020,250995,347105,598100,MKT
06042736103280000,2019,250995,347105,598100,MKT
06042736103290000,2021,273429,398371,671800,MKT
06042736103290000,2020,250995,306505,557500,MKT
06042736103290000,2019,250995,306505,557500,MKT
06042736103300000,2021,273429,298371,571800,MKT
06042736103300000,2020,250995,329605,580600,MKT
06042736103300000,2019,250995,329605,580600,MKT
06042736103310000,2021,403658,39950,443608,COST
06042736103310000,2020,490966,52550,543516,COST
06042736103310000,2019,490966,52550,543516,COST
06042736103407000,2021,770593,0,770593,COST
06042736103407000,2020,1495336,0,1495336,COST
06042736103407000,2019,1495336,0,1495336,COST
06042736103450000,2021,166503,0,166503,COST
06042736103450000,2020,220120,0,220120,COST
06042736103450000,2019,109968,0,109968,COST
06042736103500000,2021,539851,1489610,2029461,COST
06042736103500000,2020,1161584,1242670,2404254,COST
06042736103500000,2019,1161584,1242670,2404254,COST
06042736104010000,2021,231720,784280,1016000,MKT
06042736104010000,2020,162984,624916,787900,MKT
06042736104010000,2019,162984,624916,787900,MKT
06042736104020000,2021,231720,596680,828400,MKT
06042736104020000,2020,162984,487616,650600,MKT
06042736104020000,2019,162984,487616,650600,MKT
06042736104030000,2021,231720,612574,844294,MRA
06042736104030000,2020,162984,515716,678700,MKT
06042736104030000,2019,162984,515716,678700,MKT
06042736104040000,2021,231720,615880,847600,MKT
06042736104040000,2020,162984,498416,661400,MKT
06042736104040000,2019,162984,498416,661400,MKT
06042736104050000,2021,231720,653280,885000,MKT
06042736104050000,2020,162984,592216,755200,MKT
06042736104050000,2019,162984,592216,755200,MKT
06042736104060000,2021,231720,679080,910800,MKT
06042736104060000,2020,162984,619216,782200,MKT
06042736104060000,2019,162984,619216,782200,MKT
06042736104070000,2021,231720,444380,676100,MKT
06042736104070000,2020,162984,407016,570000,MKT
06042736104070000,2019,162984,407016,570000,MKT
06042736104080000,2021,231720,0,231720,COST
06042736104080000,2020,162984,0,162984,COST
06042736104080000,2019,162984,0,162984,COST
06042736104090000,2021,231720,0,231720,COST
06042736104090000,2020,162984,0,162984,COST
06042736104090000,2019,162984,0,162984,COST
06042736104100000,2021,231720,779280,1011000,MKT
06042736104100000,2020,162984,598870,761854,COST
06042736104100000,2019,162984,598870,761854,COST
06042736104110000,2021,231720,923180,1154900,MKT
06042736104110000,2020,162984,755410,918394,COST
06042736104110000,2019,162984,755410,918394,COST
06042736104120000,2021,230584,713616,944200,MKT
06042736104120000,2020,161610,605290,766900,MKT
06042736104120000,2019,161610,605290,766900,MKT
06042736104157000,2021,325573,0,325573,COST
06042736104157000,2020,292770,0,292770,COST
06042736104157000,2019,292770,0,292770,COST
06042736104217000,2021,440804,0,440804,COST
06042736104217000,2020,493399,0,493399,COST
06042736104217000,2019,493399,0,493399,COST
06042736105080000,2021,380530,145740,526270,COST
06042736105080000,2020,549196,141050,690246,COST
06042736105080000,2019,549196,141050,690246,COST
06042736105100000,2021,343785,1074300,1418085,COST
06042736105100000,2020,461066,1029010,1490076,COST
06042736105100000,2019,461066,1029010,1490076,COST
06042736201427000,2021,465456,0,465456,COST
06042736201427000,2020,509331,0,509331,COST
06042736201427000,2019,509331,0,509331,COST
06042736203010000,2021,418657,0,418657,COST
06042736203010000,2020,453734,0,453734,COST
06042736203010000,2019,453734,0,453734,COST
06042736203020000,2021,412393,2342890,2755283,COST
06042736203020000,2020,442104,1672970,2115074,COST
06042736203020000,2019,442104,1672970,2115074,COST
06042736203030000,2021,348586,0,348586,COST
06042736203030000,2020,330966,0,330966,COST
06042736203030000,2019,330966,0,330966,COST
06042736203040000,2021,352338,988762,1341100,MKT
06042736203040000,2020,337124,656970,994094,COST
06042736203040000,2019,337124,656970,994094,COST
06042736203050000,2021,342777,0,342777,COST
06042736203050000,2020,321522,0,321522,COST
06042736203050000,2019,321522,0,321522,COST
06042736203060000,2021,362189,2293290,2655479,COST
06042736203060000,2020,353524,1939930,2293454,COST
06042736203060000,2019,353524,1889580,2243104,COST
06042736203070000,2021,324903,1123797,1448700,MKT
06042736203070000,2020,293190,790720,1083910,COST
06042736203070000,2019,293190,790720,1083910,COST
06042736203080000,2021,333595,1255005,1588600,MKT
06042736203080000,2020,306832,968630,1275462,OVR
06042736203080000,2019,306832,968630,1275462,COST
06042736203090000,2021,328225,1158675,1486900,MKT
06042736203090000,2020,298374,984826,1283200,MKT
06042736203090000,2019,298374,984826,1283200,MKT
06042736203100000,2021,331472,893128,1224600,MKT
06042736203100000,2020,303476,780824,1084300,MKT
06042736203100000,2019,303476,780824,1084300,MKT
06042736203110000,2021,331472,1081128,1412600,MKT
06042736203110000,2020,303476,829780,1133256,COST
06042736203110000,2019,303476,829780,1133256,COST
06042736203120000,2021,315619,1203450,1519069,COST
06042736203120000,2020,278910,1078030,1356940,COST
06042736203120000,2019,278910,1078030,1356940,COST
06042736203130000,2021,434496,0,434496,COST
06042736203130000,2020,307834,0,307834,COST
06042736203130000,2019,307834,0,307834,COST
06042736203140000,2021,450094,1960170,2410264,COST
06042736203140000,2020,327116,1742830,2069946,COST
06042736203140000,2019,327116,1742830,2069946,COST
06042736203150000,2021,327128,0,327128,COST
06042736203150000,2020,296657,0,296657,COST
06042736203150000,2019,296657,0,296657,COST
06042736203160000,2021,313195,1758060,2071255,COST
06042736203160000,2020,275230,1385090,1660320,COST
06042736203160000,2019,275230,1385090,1660320,COST
06042736203170000,2021,313195,1034305,1347500,MKT
06042736203170000,2020,275230,735540,1010770,COST
06042736203170000,2019,275230,735540,1010770,COST
06042736203180000,2021,309472,0,309472,COST
06042736203180000,2020,269618,0,269618,COST
06042736203180000,2019,269618,0,269618,COST
06042736203190000,2021,304335,1421565,1725900,MKT
06042736203190000,2020,261957,875140,1137097,COST
06042736203190000,2019,261957,875140,1137097,COST
06042736203200000,2021,426683,615490,1042173,COST
06042736203200000,2020,298362,518720,817082,COST
06042736203200000,2019,298362,518720,817082,COST
06042736203210000,2021,397331,717020,1114351,COST
06042736203210000,2020,263893,724207,988100,MKT
06042736203210000,2019,263893,724207,988100,MKT
06042736203220000,2021,339781,901819,1241600,MKT
06042736203220000,2020,316698,784902,1101600,MKT
06042736203220000,2019,316698,784902,1101600,MKT
06042736203230000,2021,335689,3016260,3351949,COST
06042736203230000,2020,310156,2622240,2932396,COST
06042736203230000,2019,310156,2622240,2932396,COST
06042736203240000,2021,323775,0,323775,COST
06042736203240000,2020,291440,0,291440,COST
06042736203240000,2019,291440,0,291440,COST
06042736203250000,2021,359567,0,359567,COST
06042736203250000,2020,349127,0,349127,COST
06042736203250000,2019,349127,0,349127,COST
06042736203260000,2021,359567,1637420,1996987,COST
06042736203260000,2020,349127,1395680,1744807,COST
06042736203260000,2019,349127,1395680,1744807,COST
06042736203270000,2021,355995,1384905,1740900,MKT
06042736203270000,2020,343174,730710,1073884,COST
06042736203270000,2019,343174,730710,1073884,COST
06042736203280000,2021,349534,0,349534,COST
06042736203280000,2020,332516,0,332516,COST
06042736203280000,2019,332516,0,332516,COST
06042736205010000,2021,673131,5233140,5906271,COST
06042736205010000,2020,461336,4371670,4833006,COST
06042736205010000,2019,461336,4371670,4833006,COST
06042736205020000,2021,2256,0,2256,COST
06042736205020000,2020,2099,0,2099,COST
06042736205020000,2019,2099,0,2099,COST
06042736205030000,2021,240153,0,240153,COST
06042736205030000,2020,248545,0,248545,COST
06042736205030000,2019,248545,0,248545,COST
06042736205040000,2021,8763,0,8763,COST
06042736205040000,2020,4965,0,4965,COST
06042736205040000,2019,4965,0,4965,COST
06042736205057000,2021,800138,0,800138,COST
06042736205057000,2020,452038,0,452038,COST
06042736205057000,2019,997885,0,997885,COST
06042736205060000,2021,197065,0,197065,COST
06042736205060000,2020,295727,0,295727,COST
06042736205060000,2019,134486,0,134486,COST
06042736205070000,2021,128472,0,128472,COST
06042736205070000,2020,141532,0,141532,COST
06042736205070000,2019,80680,0,80680,COST
06042736205080000,2021,495636,15470,511106,COST
06042736205080000,2020,865806,26260,892066,COST
06042736205080000,2019,865806,26260,892066,COST
06042736205120000,2021,235716,0,235716,COST
06042736205120000,2020,240688,0,240688,COST
06042736205120000,2019,240688,0,240688,COST
06042736302010000,2021,231720,349280,581000,MKT
06042736302010000,2020,162984,280016,443000,MKT
06042736302010000,2019,162984,280016,443000,MKT
06042736302020000,2021,231720,427280,659000,MKT
06042736302020000,2020,162984,403616,566600,MKT
06042736302020000,2019,162984,399916,562900,MKT
06042736302030000,2021,231720,492580,724300,MKT
06042736302030000,2020,162984,433016,596000,MKT
06042736302030000,2019,162984,433016,596000,MKT
06042736302040000,2021,231720,422980,654700,MKT
06042736302040000,2020,162984,347216,510200,MKT
06042736302040000,2019,162984,347216,510200,MKT
06042736302050000,2021,231720,721980,953700,MKT
06042736302050000,2020,162984,574316,737300,MKT
06042736302050000,2019,162984,574316,737300,MKT
06042736302060000,2021,231720,414980,646700,MKT
06042736302060000,2020,162984,364516,527500,MKT
06042736302060000,2019,162984,364516,527500,MKT
06042736302070000,2021,231720,920580,1152300,MKT
06042736302070000,2020,162984,688840,851824,COST
06042736302070000,2019,162984,688840,851824,COST
06042736302090000,2021,284668,984932,1269600,MKT
06042736302090000,2020,232322,786910,1019232,COST
06042736302090000,2019,232322,786910,1019232,COST
06042736302100000,2021,231720,612180,843900,MKT
06042736302100000,2020,162984,538116,701100,MKT
06042736302100000,2019,162984,538116,701100,MKT
06042736302110000,2021,231720,429580,661300,MKT
06042736302110000,2020,162984,237360,400344,COST
06042736302110000,2019,162984,237360,400344,COST
06042736302120000,2021,231720,888980,1120700,MKT
06042736302120000,2020,162984,713316,876300,MKT
06042736302120000,2019,162984,719916,882900,MKT
06042736302130000,2021,231720,620580,852300,MKT
06042736302130000,2020,162984,523816,686800,MKT
06042736302130000,2019,162984,523816,686800,MKT
06042736302140000,2021,231720,579080,810800,MKT
06042736302140000,2020,162984,482216,645200,MKT
06042736302140000,2019,162984,482216,645200,MKT
06042736302150000,2021,231720,983080,1214800,MKT
06042736302150000,2020,162984,732216,895200,MKT
06042736302150000,2019,162984,410910,573894,COST
06042736302160000,2021,231720,639960,871680,COST
06042736302160000,2020,162984,505016,668000,MKT
06042736302160000,2019,162984,505016,668000,MKT
06042736302170000,2021,231720,833680,1065400,MKT
06042736302170000,2020,162984,673116,836100,MKT
06042736302170000,2019,162984,673116,836100,MKT
06042736302180000,2021,229932,490068,720000,MKT
06042736302180000,2020,160824,433576,594400,MKT
06042736302180000,2019,160824,433576,594400,MKT
06042736302190000,2021,231720,781680,1013400,MKT
06042736302190000,2020,162984,636316,799300,MKT
06042736302190000,2019,162984,636316,799300,MKT
06042736302200000,2021,301236,620464,921700,MKT
06042736302200000,2020,203729,500471,704200,MKT
06042736302200000,2019,203729,500471,704200,MKT
06042736302210000,2021,301236,0,301236,COST
06042736302210000,2020,203729,0,203729,COST
06042736302210000,2019,203729,0,203729,COST
06042736302220000,2021,301236,596564,897800,MKT
06042736302220000,2020,203729,519471,723200,MKT
06042736302220000,2019,203729,519471,723200,MKT
06042736302230000,2021,301236,0,301236,COST
06042736302230000,2020,203729,0,203729,COST
06042736302230000,2019,203729,0,203729,COST
06042736302240000,2021,301221,404679,705900,MKT
06042736302240000,2020,203712,332188,535900,MKT
06042736302240000,2019,203712,332188,535900,MKT
06042736302250000,2021,301236,0,301236,COST
06042736302250000,2020,203729,0,203729,COST
06042736302250000,2019,203729,0,203729,COST
06042736302260000,2021,301236,659164,960400,MKT
06042736302260000,2020,203729,549871,753600,MKT
06042736302260000,2019,203729,549871,753600,MKT
06042736302270000,2021,301236,702564,1003800,MKT
06042736302270000,2020,203729,568671,772400,MKT
06042736302270000,2019,203729,545971,749700,MKT
06042736302297000,2021,649585,244520,894105,COST
06042736302297000,2020,904357,226990,1131347,COST
06042736302297000,2019,904357,226990,1131347,COST
06042736302300000,2021,273429,0,273429,COST
06042736302300000,2020,203729,0,203729,COST
06042736302300000,2019,203729,0,203729,COST
06042736302310000,2021,273429,597671,871100,MKT
06042736302310000,2020,203729,426271,630000,MKT
06042736302310000,2019,203729,426271,630000,MKT
06042736305010000,2021,355458,403742,759200,MKT
06042736305010000,2020,250995,377850,628845,COST
06042736305010000,2019,250995,377850,628845,COST
06042736305020000,2021,41231,0,41231,COST
06042736305020000,2020,23026,0,23026,COST
06042736305020000,2019,23026,0,23026,COST
06042736305030000,2021,355458,1050742,1406200,MKT
06042736305030000,2020,250995,634410,885405,COST
06042736305030000,2019,250995,314040,565035,COST
06042736305040000,2021,355458,430442,785900,MKT
06042736305040000,2020,250995,313405,564400,MKT
06042736305040000,2019,250995,313405,564400,MKT
06042736305050000,2021,355458,0,355458,COST
06042736305050000,2020,250995,0,250995,COST
06042736305050000,2019,250995,0,250995,COST
06042736305060000,2021,353929,412671,766600,MKT
06042736305060000,2020,249138,371162,620300,MKT
06042736305060000,2019,249138,371162,620300,MKT
06042736305070000,2021,355458,801742,1157200,MKT
06042736305070000,2020,250995,627705,878700,MKT
06042736305070000,2019,250995,563505,814500,MKT
06042736305080000,2021,355458,756542,1112000,MKT
06042736305080000,2020,250995,618150,869145,COST
06042736305080000,2019,250995,618150,869145,COST
06042736305090000,2021,355458,375142,730600,MKT
06042736305090000,2020,250995,328605,579600,MKT
06042736305090000,2019,250995,328605,579600,MKT
06042736305100000,2021,355458,710,356168,COST
06042736305100000,2020,250995,690,251685,COST
06042736305100000,2019,250995,300105,551100,MKT
06042736305110000,2021,355458,440342,795800,MKT
06042736305110000,2020,250995,367105,618100,MKT
06042736305110000,2019,250995,383205,634200,MKT
06042736305157000,2021,799806,0,799806,COST
06042736305157000,2020,1014636,0,1014636,COST
06042736305157000,2019,1014636,0,1014636,COST
06042736305160000,2021,355458,843542,1199000,MKT
06042736305160000,2020,250995,593405,844400,MKT
06042736305160000,2019,250995,593405,844400,MKT
06042736305170000,2021,355458,761242,1116700,MKT
06042736305170000,2020,250995,533505,784500,MKT
06042736305170000,2019,250995,533505,784500,MKT
06042736305207000,2021,476363,68480,544843,COST
06042736305207000,2020,653037,0,653037,COST
06042736305207000,2019,653037,0,653037,COST
06042736305210000,2021,273429,423071,696500,MKT
06042736305210000,2020,250995,319520,570515,COST
06042736305210000,2019,250995,319520,570515,COST
06042736305220000,2021,273429,425671,699100,MKT
06042736305220000,2020,250995,306805,557800,MKT
06042736305220000,2019,250995,306805,557800,MKT
06042736305230000,2021,335921,2174810,2510731,COST
06042736305230000,2020,357799,1789780,2147579,COST
06042736305230000,2019,357799,1789780,2147579,COST
06042736305250000,2021,273429,766371,1039800,MKT
06042736305250000,2020,250995,557305,808300,MKT
06042736305250000,2019,250995,557305,808300,MKT
06042736305260000,2021,273429,712371,985800,MKT
06042736305260000,2020,250995,555505,806500,MKT
06042736305260000,2019,250995,555505,806500,MKT
06042736305270000,2021,273429,0,273429,COST
06042736305270000,2020,250995,0,250995,COST
06042736305270000,2019,250995,0,250995,COST
06042736305280000,2021,273429,411271,684700,MKT
06042736305280000,2020,250995,390005,641000,MKT
06042736305280000,2019,250995,390005,641000,MKT
06042736305357000,2021,580887,362550,943437,COST
06042736305357000,2020,919041,343450,1262491,COST
06042736305357000,2019,919041,343450,1262491,COST
06042736305440000,2021,273429,482471,755900,MKT
06042736305440000,2020,250995,488905,739900,MKT
06042736305440000,2019,250995,488905,739900,MKT
06042736305450000,2021,273429,996440,1269869,COST
06042736305450000,2020,250995,808490,1059485,COST
06042736305450000,2019,250995,808490,1059485,COST
06042736305460000,2021,273429,315071,588500,MKT
06042736305460000,2020,250995,264505,515500,MKT
06042736305460000,2019,250995,264505,515500,MKT
06042736305470000,2021,273429,322360,595789,COST
06042736305470000,2020,250995,254960,505955,COST
06042736305470000,2019,250995,370305,621300,MKT
06042736308010000,2021,273429,573471,846900,MKT
06042736308010000,2020,250995,484905,735900,MKT
06042736308010000,2019,250995,484905,735900,MKT
06042736308020000,2021,282592,0,282592,COST
06042736308020000,2020,265657,0,265657,COST
06042736308020000,2019,265657,0,265657,COST
06042736308030000,2021,274238,615062,889300,MKT
06042736308030000,2020,252275,534225,786500,MKT
06042736308030000,2019,252275,534225,786500,MKT
06042736308040000,2021,273429,941571,1215000,MKT
06042736308040000,2020,250995,734205,985200,MKT
06042736308040000,2019,250995,734205,985200,MKT
06042736308050000,2021,273429,861971,1135400,MKT
06042736308050000,2020,250995,653405,904400,MKT
06042736308050000,2019,250995,653405,904400,MKT
06042736308070000,2021,335909,1389950,1725859,COST
06042736308070000,2020,357776,1113760,1471536,COST
06042736308070000,2019,357776,1113760,1471536,COST
06042736308080000,2021,273429,789971,1063400,MKT
06042736308080000,2020,250995,592105,843100,MKT
06042736308080000,2019,250995,592105,843100,MKT
06042736308090000,2021,273429,0,273429,COST
06042736308090000,2020,250995,0,250995,COST
06042736308090000,2019,250995,0,250995,COST
06042736308100000,2021,273429,0,273429,COST
06042736308100000,2020,250995,0,250995,COST
06042736308100000,2019,250995,0,250995,COST
06042736308110000,2021,267230,0,267230,COST
06042736308110000,2020,241273,0,241273,COST
06042736308110000,2019,241273,0,241273,COST
06042736308120000,2021,279319,1553410,1832729,COST
06042736308120000,2020,260379,993720,1254099,OVR
06042736308120000,2019,260379,993720,1254099,MRA
06042736308130000,2021,273429,606371,879800,MKT
06042736308130000,2020,250995,432205,683200,MKT
06042736308130000,2019,250995,432205,683200,MKT
06042736308140000,2021,273429,374471,647900,MKT
06042736308140000,2020,250995,300905,551900,MKT
06042736308140000,2019,250995,300905,551900,MKT
06042736308150000,2021,273429,773471,1046900,MKT
06042736308150000,2020,250995,595505,846500,MKT
06042736308150000,2019,250995,595505,846500,MKT
06042736308160000,2021,231720,585580,817300,MKT
06042736308160000,2020,162984,432316,595300,MKT
06042736308160000,2019,162984,432316,595300,MKT
06042736308170000,2021,231720,0,231720,COST
06042736308170000,2020,162984,0,162984,COST
06042736308170000,2019,162984,0,162984,COST
06042736308180000,2021,231720,697080,928800,MKT
06042736308180000,2020,162984,584316,747300,MKT
06042736308180000,2019,162984,584316,747300,MKT
06042736308190000,2021,231720,0,231720,COST
06042736308190000,2020,162984,0,162984,COST
06042736308190000,2019,162984,0,162984,COST
06042736308200000,2021,231720,421180,652900,MKT
06042736308200000,2020,162984,362716,525700,MKT
06042736308200000,2019,162984,362716,525700,MKT
06042736308210000,2021,231720,436080,667800,MKT
06042736308210000,2020,162984,408416,571400,MKT
06042736308210000,2019,162984,408416,571400,MKT
06042736308220000,2021,248732,765668,1014400,MKT
06042736308220000,2020,184137,620363,804500,OVR
06042736308220000,2019,184137,620363,804500,MKT
06042736402020000,2021,421938,1935300,2357238,COST
06042736402020000,2020,379370,1636800,2016170,COST
06042736402020000,2019,379370,1636800,2016170,COST
06042736402040000,2021,399595,325800,725395,COST
06042736402040000,2020,356380,247820,604200,COST
06042736402040000,2019,356380,247820,604200,COST
06042736402086500,2021,1595,0,1595,COST
06042736402086500,2020,1483,0,1483,COST
06042736402086500,2019,1483,0,1483,COST
06042736402100000,2021,297337,0,297337,COST
06042736402100000,2020,253750,0,253750,COST
06042736402100000,2019,253750,0,253750,COST
06042736402120000,2021,342425,262470,604895,COST
06042736402120000,2020,298444,220110,518554,COST
06042736402120000,2019,298444,220110,518554,COST
06042736402200000,2021,2980,0,2980,COST
06042736402200000,2020,1681,0,1681,COST
06042736402200000,2019,1681,0,1681,COST
06042736402300000,2021,347377,201110,548487,COST
06042736402300000,2020,469395,194610,664005,COST
06042736402300000,2019,469395,194610,664005,COST
06042736402320000,2021,322748,128470,451218,COST
06042736402320000,2020,413549,125900,539449,COST
06042736402320000,2019,413549,125900,539449,COST
06042736402560000,2021,447253,0,447253,COST
06042736402560000,2020,405639,0,405639,COST
06042736402560000,2019,405639,0,405639,COST
06042736403010000,2021,273429,390071,663500,MKT
06042736403010000,2020,250995,275105,526100,MKT
06042736403010000,2019,250995,275105,526100,MKT
06042736403020000,2021,273429,292371,565800,MKT
06042736403020000,2020,250995,198105,449100,MKT
06042736403020000,2019,250995,198105,449100,MKT
06042736403030000,2021,273429,437671,711100,MKT
06042736403030000,2020,250995,366805,617800,MKT
06042736403030000,2019,250995,366805,617800,MKT
06042736403040000,2021,273429,1123971,1397400,MKT
06042736403040000,2020,250995,772905,1023900,MKT
06042736403040000,2019,250995,772905,1023900,MKT
06042736403050000,2021,273429,0,273429,COST
06042736403050000,2020,250995,0,250995,COST
06042736403050000,2019,250995,0,250995,COST
06042736403060000,2021,273429,0,273429,COST
06042736403060000,2020,250995,0,250995,COST
06042736403060000,2019,250995,0,250995,COST
06042736403070000,2021,273429,906471,1179900,MKT
06042736403070000,2020,250995,350250,601245,COST
06042736403070000,2019,250995,0,250995,COST
06042736403080000,2021,273429,500471,773900,MKT
06042736403080000,2020,250995,492305,743300,MKT
06042736403080000,2019,250995,492305,743300,MKT
06042736403090000,2021,273429,0,273429,COST
06042736403090000,2020,250995,0,250995,COST
06042736403090000,2019,250995,0,250995,COST
06042736403100000,2021,272512,0,272512,COST
06042736403100000,2020,249547,0,249547,COST
06042736403100000,2019,249547,0,249547,COST
06042736403110000,2021,273429,705271,978700,MKT
06042736403110000,2020,250995,527105,778100,MKT
06042736403110000,2019,250995,527105,778100,MKT
06042736403120000,2021,273429,0,273429,COST
06042736403120000,2020,250995,0,250995,COST
06042736403120000,2019,250995,0,250995,COST
06042736403130000,2021,273429,525671,799100,MKT
06042736403130000,2020,250995,407705,658700,MKT
06042736403130000,2019,250995,407705,658700,MKT
06042736403207000,2021,548628,171570,720198,COST
06042736403207000,2020,832903,160170,993073,COST
06042736403207000,2019,832903,160170,993073,COST
06042736403280000,2021,273429,0,273429,COST
06042736403280000,2020,250995,0,250995,COST
06042736403280000,2019,250995,0,250995,COST
06042736403290000,2021,273429,878771,1152200,MKT
06042736403290000,2020,250995,675605,926600,OVR
06042736403290000,2019,250995,675605,926600,MKT
06042736403300000,2021,273429,654171,927600,MKT
06042736403300000,2020,250995,508805,759800,MKT
06042736403300000,2019,250995,508805,759800,MKT
06042736403310000,2021,273429,744171,1017600,MKT
06042736403310000,2020,250995,547805,798800,MKT
06042736403310000,2019,250995,545905,796900,MKT
06042736403320000,2021,273429,0,273429,COST
06042736403320000,2020,250995,0,250995,COST
06042736403320000,2019,250995,0,250995,COST
06042736403330000,2021,591973,0,591973,COST
06042736403330000,2020,949461,0,949461,COST
06042736403330000,2019,949461,0,949461,COST
06042736403337000,2021,319408,0,319408,COST
06042736403337000,2020,328044,0,328044,COST
06042736403337000,2019,328044,0,328044,COST
06042736403340000,2021,278142,0,278142,COST
06042736403340000,2020,258493,0,258493,COST
06042736403340000,2019,258493,0,258493,COST
06042736403350000,2021,273429,370671,644100,MKT
06042736403350000,2020,250995,251405,502400,MKT
06042736403350000,2019,250995,251405,502400,MKT
06042736403360000,2021,273429,0,273429,COST
06042736403360000,2020,250995,0,250995,COST
06042736403360000,2019,250995,0,250995,COST
06042736403370000,2021,273429,757371,1030800,MKT
06042736403370000,2020,250995,611105,862100,MKT
06042736403370000,2019,250995,611105,862100,MKT
06042736403380000,2021,273429,321671,595100,MKT
06042736403380000,2020,250995,243505,494500,MKT
06042736403380000,2019,250995,243505,494500,MKT
06042736403390000,2021,273429,0,273429,COST
06042736403390000,2020,250995,0,250995,COST
06042736403390000,2019,250995,0,250995,COST
06042736403400000,2021,273429,615671,889100,MKT
06042736403400000,2020,250995,476805,727800,MKT
06042736403400000,2019,250995,476805,727800,MKT
06042736403410000,2021,273429,0,273429,COST
06042736403410000,2020,250995,0,250995,COST
06042736403410000,2019,250995,0,250995,COST
06042736403420000,2021,273429,593571,867000,MKT
06042736403420000,2020,250995,520105,771100,MKT
06042736403420000,2019,250995,520105,771100,MKT
06042736403430000,2021,273429,0,273429,COST
06042736403430000,2020,250995,0,250995,COST
06042736403430000,2019,250995,0,250995,COST
06042736403440000,2021,273429,700271,973700,MKT
06042736403440000,2020,250995,513805,764800,MKT
06042736403440000,2019,250995,513805,764800,MKT
06042736403450000,2021,273429,445971,719400,MKT
06042736403450000,2020,250995,398505,649500,MKT
06042736403450000,2019,250995,398505,649500,MKT
06042736403460000,2021,273429,428271,701700,MKT
06042736403460000,2020,250995,332805,583800,MKT
06042736403460000,2019,250995,332805,583800,MKT
06042736403470000,2021,273429,0,273429,COST
06042736403470000,2020,250995,0,250995,COST
06042736403470000,2019,250995,0,250995,COST
06042736403487000,2021,523481,75560,599041,COST
06042736403487000,2020,768239,73110,841349,COST
06042736403487000,2019,768239,73110,841349,COST
06042736403620000,2021,161688,0,161688,COST
06042736403620000,2020,48528,0,48528,COST
06042736403620000,2019,48528,0,48528,COST
06042736405040000,2021,2808982,2302690,5111672,COST
06042736405040000,2020,795878,873500,1669378,COST
06042736405040000,2019,795878,873500,1669378,COST
06042736405200000,2021,438022,0,438022,COST
06042736405200000,2020,131467,0,131467,COST
06042736405200000,2019,131467,0,131467,COST
06042736405250000,2021,151953,0,151953,COST
06042736405250000,2020,188041,0,188041,COST
06042736405250000,2019,98590,0,98590,COST
06042736409017000,2021,839111,325590,1164701,COST
06042736409017000,2020,1202444,273910,1476354,COST
06042736409017000,2019,1202444,273910,1476354,COST
06042736409257000,2021,567506,96690,664196,COST
06042736409257000,2020,759063,78750,837813,COST
06042736409257000,2019,759063,78750,837813,COST
06042736415017000,2021,312561,8470,321031,COST
06042736415017000,2020,390327,8840,399167,COST
06042736415017000,2019,390327,8840,399167,COST
06042736415037000,2021,601316,100500,701816,COST
06042736415037000,2020,1207825,104910,1312735,COST
06042736415037000,2019,1207825,104910,1312735,COST
06042736415047003,2021,317562,626238,943800,INCOME
06042736415047003,2020,399211,515589,914800,INCOME
06042736415047003,2019,399211,515589,914800,INCOME
06042736415057000,2021,432276,44100,476376,COST
06042736415057000,2020,635138,44580,679718,COST
06042736415057000,2019,635138,44580,679718,COST
06042736415067004,2021,255507,916493,1172000,INCOME
06042736415067004,2020,283033,758667,1041700,INCOME
06042736415067004,2019,283033,758667,1041700,INCOME
06042736415077000,2021,287347,7320,294667,COST
06042736415077000,2020,342605,7640,350245,COST
06042736415077000,2019,342605,7640,350245,COST
06042736415087002,2021,316852,2089248,2406100,INCOME
06042736415087002,2020,399461,1537739,1937200,INCOME
06042736415087002,2019,399461,1537739,1937200,INCOME
06042736415097000,2021,294420,7730,302150,COST
06042736415097000,2020,355906,8070,363976,COST
06042736415097000,2019,355906,8070,363976,COST
06042736415107000,2021,248552,5290,253842,COST
06042736415107000,2020,272130,5520,277650,COST
06042736415107000,2019,272130,5520,277650,COST
06042736415117000,2021,402168,17160,419328,COST
06042736415117000,2020,570973,17870,588843,COST
06042736415117000,2019,570973,17870,588843,COST
06042736415127007,2021,224693,930107,1154800,INCOME
06042736415127007,2020,231898,830702,1062600,INCOME
06042736415127007,2019,231898,830702,1062600,INCOME
06042736415137005,2021,250373,991127,1241500,INCOME
06042736415137005,2020,276002,1053098,1329100,INCOME
06042736415137005,2019,276002,1053098,1329100,INCOME
06042736415147000,2021,297643,8140,305783,COST
06042736415147000,2020,362235,8490,370725,COST
06042736415147000,2019,362235,8490,370725,COST
06042801101010000,2021,114253,318347,432600,MKT
06042801101010000,2020,88194,329181,417375,OVR
06042801101010000,2019,88194,329181,417375,OVR
06042801101020000,2021,90956,9560,100516,COST
06042801101020000,2020,66899,6200,73099,COST
06042801101020000,2019,66899,6200,73099,COST
06042801101030000,2021,93962,293920,387882,COST
06042801101030000,2020,69445,251155,320600,MKT
06042801101030000,2019,69445,271455,340900,MKT
06042801101040000,2021,97662,0,97662,COST
06042801101040000,2020,72597,0,72597,COST
06042801101040000,2019,72597,0,72597,COST
06042801101050000,2021,101072,310,101382,COST
06042801101050000,2020,75517,310,75827,COST
06042801101050000,2019,75517,310,75827,COST
06042801101060000,2021,118931,272450,391381,COST
06042801101060000,2020,92357,207243,299600,MKT
06042801101060000,2019,92357,207243,299600,MKT
06042801101070000,2021,116175,196490,312665,COST
06042801101070000,2020,89902,156298,246200,MKT
06042801101070000,2019,89902,156298,246200,MKT
06042801101080000,2021,29036,0,29036,COST
06042801101080000,2020,21850,0,21850,COST
06042801101080000,2019,21850,0,21850,COST
06042801102010000,2021,480859,449760,930619,COST
06042801102010000,2020,589357,382010,971367,COST
06042801102010000,2019,589357,382010,971367,COST
06042801102020000,2021,460839,1177250,1638089,COST
06042801102020000,2020,561251,979710,1540961,COST
06042801102020000,2019,561251,979710,1540961,COST
06042801102030000,2021,228665,0,228665,COST
06042801102030000,2020,195745,0,195745,COST
06042801102030000,2019,195745,0,195745,COST
06042801102060000,2021,360835,2646840,3007675,COST
06042801102060000,2020,423498,2139050,2562548,COST
06042801102060000,2019,423498,2139050,2562548,COST
06042801102100000,2021,460710,1834090,2294800,COST
06042801102100000,2020,561072,1493870,2054942,COST
06042801102100000,2019,561072,1493870,2054942,COST
06042801103010000,2021,380367,879390,1259757,COST
06042801103010000,2020,314808,565230,880038,COST
06042801103010000,2019,314808,565230,880038,COST
06042801103020000,2021,365228,284180,649408,COST
06042801103020000,2020,300453,225540,525993,COST
06042801103020000,2019,300453,225540,525993,COST
06042801103030000,2021,371263,597270,968533,COST
06042801103030000,2020,306165,419590,725755,COST
06042801103030000,2019,306165,340080,646245,COST
06042801103040000,2021,368008,997860,1365868,COST
06042801103040000,2020,303083,369031,672114,MRA
06042801103040000,2019,303083,369031,672114,MRA
06042801103060000,2021,409997,346550,756547,COST
06042801103060000,2020,343147,203920,547067,COST
06042801103060000,2019,343147,203920,547067,COST
06042801103070000,2021,415815,802480,1218295,COST
06042801103070000,2020,348747,516963,865710,OVR
06042801103070000,2019,348747,516963,865710,OVR
06042801103080000,2021,392163,0,392163,COST
06042801103080000,2020,326052,0,326052,COST
06042801103080000,2019,326052,0,326052,COST
06042801104010000,2021,236054,0,236054,COST
06042801104010000,2020,184008,0,184008,COST
06042801104010000,2019,184008,0,184008,COST
06042801104020000,2021,164244,271356,435600,MKT
06042801104020000,2020,133832,188068,321900,MKT
06042801104020000,2019,133832,188068,321900,MKT
06042801104030000,2021,165279,616020,781299,COST
06042801104030000,2020,134802,382760,517562,COST
06042801104030000,2019,134802,382760,517562,COST
06042801104040000,2021,165408,541600,707008,COST
06042801104040000,2020,134922,321410,456332,COST
06042801104040000,2019,134922,321410,456332,COST
06042801104050000,2021,165408,0,165408,COST
06042801104050000,2020,134922,0,134922,COST
06042801104050000,2019,134922,0,134922,COST
06042801104060000,2021,165408,321792,487200,MKT
06042801104060000,2020,134922,216978,351900,MKT
06042801104060000,2019,134922,216978,351900,MKT
06042801104070000,2021,165408,405592,571000,MKT
06042801104070000,2020,134922,285878,420800,MKT
06042801104070000,2019,134922,285878,420800,MKT
06042801104080000,2021,165408,584592,750000,MKT
06042801104080000,2020,134922,348590,483512,COST
06042801104080000,2019,134922,348590,483512,COST
06042801104090000,2021,167929,357310,525239,COST
06042801104090000,2020,137288,241512,378800,MKT
06042801104090000,2019,137288,241512,378800,MKT
06042801104100000,2021,164331,655870,820201,COST
06042801104100000,2020,133913,443900,577813,COST
06042801104100000,2019,133913,443900,577813,COST
06042801104116500,2021,51072,0,51072,COST
06042801104116500,2020,41807,0,41807,COST
06042801104116500,2019,41807,0,41807,COST
06042801104120000,2021,172733,679050,851783,COST
06042801104120000,2020,141810,429680,571490,COST
06042801104120000,2019,141810,429680,571490,COST
06042801104130000,2021,167556,433244,600800,MKT
06042801104130000,2020,136938,274520,411458,MRA
06042801104130000,2019,136938,274520,411458,MRA
06042801104140000,2021,166931,619370,786301,COST
06042801104140000,2020,136351,353200,489551,COST
06042801104140000,2019,136351,353200,489551,COST
06042801104150000,2021,169968,0,169968,COST
06042801104150000,2020,139205,0,139205,COST
06042801104150000,2019,139205,0,139205,COST
06042801104160000,2021,174193,997180,1171373,COST
06042801104160000,2020,143188,671180,814368,COST
06042801104160000,2019,143188,671180,814368,COST
06042801104170000,2021,175214,327686,502900,MKT
06042801104170000,2020,144153,195347,339500,MKT
06042801104170000,2019,144153,195347,339500,MKT
06042801104180000,2021,241182,204720,445902,COST
06042801104180000,2020,134721,29720,164441,COST
06042801104180000,2019,134721,0,134721,COST
06042801104190000,2021,163546,0,163546,COST
06042801104190000,2020,133178,0,133178,COST
06042801104190000,2019,133178,0,133178,COST
06042801104200000,2021,161995,350750,512745,COST
06042801104200000,2020,131728,244672,376400,MKT
06042801104200000,2019,131728,244672,376400,MKT
06042801105010000,2021,237489,545690,783179,COST
06042801105010000,2020,132353,338210,470563,COST
06042801105010000,2019,132353,338210,470563,COST
06042801105020000,2021,242798,837470,1080268,COST
06042801105020000,2020,135759,542980,678739,COST
06042801105020000,2019,135759,542980,678739,COST
06042801105030000,2021,258309,0,258309,COST
06042801105030000,2020,145771,0,145771,COST
06042801105030000,2019,145771,0,145771,COST
06042801105040000,2021,168915,560000,728915,COST
06042801105040000,2020,138214,319886,458100,MKT
06042801105040000,2019,138214,319886,458100,MKT
06042801105050000,2021,180236,0,180236,COST
06042801105050000,2020,148911,0,148911,COST
06042801105050000,2019,148911,0,148911,COST
06042801105060000,2021,291742,560180,851922,COST
06042801105060000,2020,167652,366450,534102,COST
06042801105060000,2019,167652,366450,534102,COST
06042801105070000,2021,286955,797640,1084595,COST
06042801105070000,2020,164495,523850,688345,COST
06042801105070000,2019,164495,523850,688345,COST
06042801105080000,2021,286997,654880,941877,COST
06042801105080000,2020,164523,461040,625563,OVR
06042801105080000,2019,164523,461040,625563,COST
06042801105096500,2021,32874,0,32874,COST
06042801105096500,2020,25200,0,25200,COST
06042801105096500,2019,25200,0,25200,COST
06042801105100000,2021,240806,389930,630736,COST
06042801105100000,2020,134480,252910,387390,COST
06042801105100000,2019,134480,252910,387390,COST
06042801105116500,2021,40654,0,40654,COST
06042801105116500,2020,32166,0,32166,COST
06042801105116500,2019,32166,0,32166,COST
06042801105120000,2021,243719,900640,1144359,COST
06042801105120000,2020,136351,526360,662711,COST
06042801105120000,2019,136351,526360,662711,COST
06042801107016500,2021,131780,0,131780,COST
06042801107016500,2020,111370,0,111370,COST
06042801107016500,2019,111370,0,111370,COST
06042801107036500,2021,131780,0,131780,COST
06042801107036500,2020,111370,0,111370,COST
06042801107036500,2019,111370,0,111370,COST
06042801108010000,2021,55638,0,55638,COST
06042801108010000,2020,30006,0,30006,COST
06042801108010000,2019,30006,0,30006,COST
06042801201010000,2021,169967,0,169967,COST
06042801201010000,2020,91309,0,91309,COST
06042801201010000,2019,91309,0,91309,COST
06042801201020000,2021,150785,13310,164095,COST
06042801201020000,2020,186011,12300,198311,COST
06042801201020000,2019,186011,12300,198311,COST
06042801402010000,2021,268374,333730,602104,COST
06042801402010000,2020,371039,211900,582939,COST
06042801402010000,2019,371039,211900,582939,COST
06042801402020000,2021,577,11530,12107,COST
06042801402020000,2020,537,12550,13087,COST
06042801402020000,2019,537,12550,13087,COST
06042801405010000,2021,411655,647420,1059075,COST
06042801405010000,2020,492987,335770,828757,COST
06042801405010000,2019,492987,335770,828757,COST
06042801410010000,2021,193950,825850,1019800,COST
06042801410010000,2020,162003,400490,562493,OVR
06042801410010000,2019,162003,400490,562493,COST
06042801410020000,2021,183112,0,183112,COST
06042801410020000,2020,151645,0,151645,COST
06042801410020000,2019,151645,0,151645,COST
06042801410040000,2021,642296,607670,1249966,COST
06042801410040000,2020,821933,464610,1286543,COST
06042801410040000,2019,821933,464610,1286543,COST
06042801411010000,2021,234302,622630,856932,COST
06042801411010000,2020,201300,419520,620820,OVR
06042801411010000,2019,201300,418920,620220,COST
06042801411030000,2021,187745,1940,189685,COST
06042801411030000,2020,156062,2050,158112,COST
06042801411030000,2019,156062,840,156902,COST
06042801411040000,2021,164685,148115,312800,MKT
06042801411040000,2020,133547,62670,196217,COST
06042801411040000,2019,133547,62670,196217,COST
06042801411050000,2021,162619,521550,684169,COST
06042801411050000,2020,132312,341130,473442,COST
06042801411050000,2019,132312,341130,473442,COST
06042801411060000,2021,161274,209100,370374,COST
06042801411060000,2020,131055,207045,338100,MKT
06042801411060000,2019,131055,207045,338100,MKT
06042801411070000,2021,159904,270596,430500,MKT
06042801411070000,2020,129777,220123,349900,MKT
06042801411070000,2019,129777,220123,349900,MKT
06042801411080000,2021,158507,0,158507,COST
06042801411080000,2020,128474,0,128474,COST
06042801411080000,2019,128474,0,128474,COST
06042801411090000,2021,157082,215318,372400,MKT
06042801411090000,2020,127148,203452,330600,MKT
06042801411090000,2019,127148,203452,330600,MKT
06042801411100000,2021,155627,0,155627,COST
06042801411100000,2020,125796,0,125796,COST
06042801411100000,2019,125796,0,125796,COST
06042801411110000,2021,154141,0,154141,COST
06042801411110000,2020,124416,0,124416,COST
06042801411110000,2019,124416,0,124416,COST
06042801411120000,2021,152622,0,152622,COST
06042801411120000,2020,123009,0,123009,COST
06042801411120000,2019,123009,0,123009,COST
06042801411130000,2021,161725,377070,538795,COST
06042801411130000,2020,131477,221100,352577,COST
06042801411130000,2019,131477,221100,352577,COST
06042802101010000,2021,282033,0,282033,COST
06042802101010000,2020,151330,0,151330,COST
06042802101010000,2019,151330,0,151330,COST
06042803101010000,2021,257596,0,257596,COST
06042803101010000,2020,138515,0,138515,COST
06042803101010000,2019,138515,0,138515,COST
06042804101010000,2021,100322,0,100322,COST
06042804101010000,2020,56030,0,56030,COST
06042804101010000,2019,56030,0,56030,COST
06042805101010000,2021,115831,0,115831,COST
06042805101010000,2020,64176,0,64176,COST
06042805101010000,2019,64176,0,64176,COST
06042806101010000,2021,33278,0,33278,COST
06042806101010000,2020,20888,0,20888,COST
06042806101010000,2019,20888,0,20888,COST
06042807101010000,2021,96519,0,96519,COST
06042807101010000,2020,53585,0,53585,COST
06042807101010000,2019,53585,0,53585,COST
06042808101010000,2021,163501,0,163501,COST
06042808101010000,2020,88710,0,88710,COST
06042808101010000,2019,88710,0,88710,COST
06042809101010000,2021,202501,0,202501,COST
06042809101010000,2020,109160,0,109160,COST
06042809101010000,2019,109160,0,109160,COST
06042810101010000,2021,198144,0,198144,COST
06042810101010000,2020,108117,0,108117,COST
06042810101010000,2019,108117,0,108117,COST
06042811101010000,2021,177889,0,177889,COST
06042811101010000,2020,98688,0,98688,COST
06042811101010000,2019,98688,0,98688,COST
06042812101010000,2021,232543,311590,544133,COST
06042812101010000,2020,199565,206140,405705,COST
06042812101010000,2019,199565,206140,405705,COST
06042812101040000,2021,156793,178407,335200,MKT
06042812101040000,2020,126879,158221,285100,MKT
06042812101040000,2019,126879,158221,285100,MKT
06042812101100000,2021,196312,602588,798900,INCOME
06042812101100000,2020,164271,482329,646600,INCOME
06042812101100000,2019,164271,482329,646600,INCOME
06042812101200000,2021,92718,0,92718,COST
06042812101200000,2020,50021,0,50021,COST
06042812101200000,2019,50021,0,50021,COST
06042812102010000,2021,390685,607680,998365,COST
06042812102010000,2020,464242,497240,961482,COST
06042812102010000,2019,464242,293135,757377,MRA
06042812102020000,2021,358061,216730,574791,COST
06042812102020000,2020,419981,167800,587781,COST
06042812102020000,2019,419981,167800,587781,COST
06042812102040000,2021,235471,0,235471,COST
06042812102040000,2020,202455,0,202455,COST
06042812102040000,2019,202455,0,202455,COST
06042812102060000,2021,364687,320110,684797,COST
06042812102060000,2020,428924,184320,613244,COST
06042812102060000,2019,428924,184320,613244,COST
06042812102100000,2021,407483,224020,631503,COST
06042812102100000,2020,487250,131080,618330,COST
06042812102100000,2019,487250,131080,618330,COST
06042812104050000,2021,149371,0,149371,COST
06042812104050000,2020,120003,0,120003,COST
06042812104050000,2019,120003,0,120003,COST
06042812108100000,2021,467768,351060,818828,COST
06042812108100000,2020,570959,207160,778119,OVR
06042812108100000,2019,570959,207160,778119,COST
06042812201030000,2021,322588,0,322588,COST
06042812201030000,2020,290681,0,290681,COST
06042812201030000,2019,290681,0,290681,COST
06042812202010000,2021,72690,0,72690,COST
06042812202010000,2020,41523,0,41523,COST
06042812202010000,2019,41523,0,41523,COST
06042812401010000,2021,279826,0,279826,COST
06042812401010000,2020,246860,0,246860,COST
06042812401010000,2019,246860,0,246860,COST
06042812490090000,2021,208032,0,208032,COST
06042812490090000,2020,175590,0,175590,COST
06042812490090000,2019,175590,0,175590,COST
06042813101010000,2021,259785,0,259785,COST
06042813101010000,2020,139923,0,139923,COST
06042813101010000,2019,139923,0,139923,COST
06042814101010000,2021,156155,0,156155,COST
06042814101010000,2020,87309,0,87309,COST
06042814101010000,2019,87309,0,87309,COST
06042815101010000,2021,137345,0,137345,COST
06042815101010000,2020,77150,0,77150,COST
06042815101010000,2019,77150,0,77150,COST
06042816101010000,2021,198823,0,198823,COST
06042816101010000,2020,107232,0,107232,COST
06042816101010000,2019,107232,0,107232,COST
06042817101010000,2021,217086,0,217086,COST
06042817101010000,2020,116809,0,116809,COST
06042817101010000,2019,116809,0,116809,COST
06042818101010000,2021,169680,0,169680,COST
06042818101010000,2020,91950,0,91950,COST
06042818101010000,2019,91950,0,91950,COST
06042819101010000,2021,225404,0,225404,COST
06042819101010000,2020,121170,0,121170,COST
06042819101010000,2019,121170,0,121170,COST
06042820101010000,2021,216806,0,216806,COST
06042820101010000,2020,116662,0,116662,COST
06042820101010000,2019,116662,0,116662,COST
06042821101010000,2021,219484,0,219484,COST
06042821101010000,2020,118578,0,118578,COST
06042821101010000,2019,118578,0,118578,COST
06042822101010000,2021,188484,0,188484,COST
06042822101010000,2020,102013,0,102013,COST
06042822101010000,2019,102013,0,102013,COST
06042822101040000,2021,627774,842120,1469894,COST
06042822101040000,2020,800615,686230,1486845,COST
06042822101040000,2019,800615,686230,1486845,COST
06042822101050000,2021,482541,328460,811001,COST
06042822101050000,2020,591727,265040,856767,COST
06042822101050000,2019,591727,265040,856767,COST
06042822101100000,2021,652143,0,652143,COST
06042822101100000,2020,836428,0,836428,COST
06042822101100000,2019,836428,0,836428,COST
06042822105100000,2021,156600,1138840,1295440,COST
06042822105100000,2020,126700,744610,871310,COST
06042822105100000,2019,126700,744610,871310,COST
06042822402010000,2021,409163,604230,1013393,COST
06042822402010000,2020,489560,499210,988770,COST
06042822402010000,2019,489560,311640,801200,COST
